Class,edge_purchases,ep,ep2,id,n_purchases,solo_purchases
2,66,0.5319148936170213,0.9741935483870968,67130910,141,75
1,523,0.4877571008814887,0.9305835010060363,67901421,1021,498
0,766,0.16648531011969533,0.22395833333333334,70645722,919,153
1,498,0.37279596977329976,0.8209302325581396,70748454,794,296
1,3836,0.27362241999621284,0.6767431597528685,82008925,5281,1445
1,38,0.4864864864864865,0.9147286821705426,80125952,74,36
1,1443,0.3957286432160804,0.8673894912427023,70607054,2388,945
0,3151,0.1252082176568573,0.13833199679230151,79785265,3602,451
0,86,0.054945054945054944,0.125,80124318,91,5
0,162,0.06358381502890173,0.1588089330024814,80124424,173,11
1,98,0.26865671641791045,0.605,82065189,134,36
2,291,0.5221674876847291,0.8617511520737328,69514214,609,318
1,350,0.4556765163297045,0.8880778588807786,62511512,643,293
2,12,0.7391304347826086,0.9333333333333333,66114125,46,34
2,0,1.0,1.0,80162136,54,54
1,52,0.36585365853658536,0.8064516129032258,69604983,82,30
0,162,0.16923076923076924,0.4672686230248307,70649726,195,33
1,721,0.2642857142857143,0.5472088215024121,70623833,980,259
0,115,0.09448818897637795,0.1453900709219858,72545802,127,12
0,73,0.013513513513513514,0.028708133971291867,72545935,74,1
0,40,0.14893617021276595,0.30434782608695654,72546243,47,7
0,47,0.0784313725490196,0.125,72546614,51,4
1,10,0.2857142857142857,0.5675675675675675,72946370,14,4
1,1370,0.2521834061135371,0.5105051408135897,74355785,1832,462
1,79,0.3629032258064516,0.6666666666666666,79849056,124,45
0,729,0.14536928487690504,0.4159702878365831,70649110,853,124
1,4258,0.2749872296952154,0.5453563714902808,69225744,5873,1615
2,1215,0.7238636363636364,0.9508670520231214,62482266,4400,3185
0,96,0.2440944881889764,0.4685714285714286,68283124,127,31
0,1100,0.2069214131218457,0.37362637362637363,80118624,1387,287
1,2494,0.2747891829020064,0.6012731481481481,80118627,3439,945
2,839,0.7378944079975008,0.9478584729981379,65966012,3201,2362
2,2317,0.7341975450269588,0.9548577036310107,62819722,8717,6400
2,106,0.6954022988505747,0.8235294117647058,69996633,348,242
2,82,0.6038647342995169,0.7402597402597403,66061275,207,125
2,16613,0.6535132542181993,0.9593413295385241,66279724,47947,31334
1,4462,0.39027056572834107,0.823045267489712,80124966,7318,2856
1,117,0.23529411764705882,0.5675675675675675,80140111,153,36
0,834,0.18792599805258034,0.32916666666666666,80141464,1027,193
1,210,0.45595854922279794,0.8404255319148937,80124832,386,176
2,625,0.7136967475950526,0.975485188968335,66838912,2183,1558
1,815,0.3179916317991632,0.6595092024539877,64260581,1195,380
1,103,0.38323353293413176,0.768595041322314,65256646,167,64
1,5583,0.26924083769633506,0.530257639304973,67610620,7640,2057
1,6757,0.40314459853369844,0.859406337745688,67641273,11321,4564
0,3393,0.2327001356852103,0.45675764551134496,68010985,4422,1029
0,1909,0.15791795324217026,0.32558139534883723,69701254,2267,358
0,3645,0.1742183960126869,0.2707092582566324,70282170,4414,769
1,1057,0.47097097097097096,0.921405750798722,73848726,1998,941
1,7039,0.3447826491668994,0.7737095664143152,80119198,10743,3704
1,1040,0.2929979605710401,0.5975155279503106,80127520,1471,431
0,245,0.24382716049382716,0.39543726235741444,82152758,324,79
0,2734,0.13835486920895051,0.18581501451679802,69961066,3173,439
2,7416,0.6281215525022565,0.9296776894097949,68649616,19942,12526
1,2182,0.32529375386518244,0.6295264623955432,80090003,3234,1052
1,3210,0.4882015306122449,0.8879037365421153,80090073,6272,3062
1,4216,0.27134462495679224,0.6143667296786389,70178486,5786,1570
0,6277,0.20854873282057748,0.41910403554239173,70178500,7931,1654
0,25362,0.17829256439332578,0.31175556706369756,64421812,30865,5503
0,22541,0.1866565634697265,0.3545940355111188,70178472,27714,5173
1,1108,0.2828478964401295,0.5838068181818182,80124967,1545,437
0,8741,0.13369672943508423,0.18019337825959567,80128835,10090,1349
1,158,0.34439834024896265,0.6928571428571428,80124969,241,83
2,141,0.5236486486486487,0.9027777777777778,75417440,296,155
0,28,0.17647058823529413,0.1,67244086,34,6
1,3083,0.27133065469156226,0.5490066225165563,75416831,4231,1148
1,3771,0.4719226999019745,0.8833157338965153,75417104,7141,3370
0,992,0.11507582515611062,0.08419243986254296,78723113,1121,129
1,955,0.3222143364088006,0.6146645865834633,68017005,1409,454
1,209,0.45714285714285713,0.5846994535519126,80090290,385,176
1,4235,0.3863208230691204,0.7027027027027027,70716912,6901,2666
2,17,0.7901234567901234,0.9473684210526315,66750201,81,64
2,1835,0.5384808853118712,0.888034188034188,67694655,3976,2141
2,1861,0.7225700655933214,0.9423692636072573,62831153,6708,4847
1,53,0.3026315789473684,0.625,66493224,76,23
1,1746,0.48312611012433393,0.8769771528998243,80168351,3378,1632
2,108,0.7127659574468085,0.8492063492063492,66749571,376,268
1,10940,0.31445043238501064,0.6837097003266581,70857241,15958,5018
1,3576,0.2713936430317848,0.617692907248636,80140119,4908,1332
0,637,0.1483957219251337,0.24761904761904763,80140125,748,111
2,403,0.7038941954445261,0.9672364672364673,69205710,1361,958
1,4318,0.40383818859588566,0.8019296254256527,80118612,7243,2925
2,3,0.9,0.8571428571428571,69547695,30,27
1,1644,0.26900844819919967,0.5363214837712519,63838775,2249,605
1,1896,0.3439446366782007,0.6842639593908629,75416523,2890,994
2,3,0.5714285714285714,0.0,65950353,7,4
1,22462,0.2543734439834025,0.5451127819548872,65404885,30125,7663
1,4674,0.2812548054743964,0.5769689737470167,80118613,6503,1829
1,1518,0.3065326633165829,0.5725429017160687,80118614,2189,671
2,757,0.7550954383694597,0.9508196721311475,68365150,3091,2334
2,1772,0.5129191863661352,0.9090143218197135,80134983,3638,1866
1,3871,0.32218525652250046,0.6555834378920954,80089996,5711,1840
2,417,0.5128504672897196,0.9596864501679732,69639290,856,439
0,402,0.09049773755656108,0.15021459227467812,67792844,442,40
1,713,0.3254493850520341,0.7055655296229802,73852681,1057,344
2,1031,0.7285413375460769,0.9203910614525139,70862232,3798,2767
1,4094,0.29559532002752925,0.6565562295846944,70178493,5812,1718
1,2390,0.24223208623969564,0.5270137524557956,73637480,3154,764
2,726,0.6320324379118094,0.9698681732580038,68586686,1973,1247
0,7875,0.1830065359477124,0.3471620697515386,65915983,9639,1764
0,4971,0.09420553935860058,0.10705510705510705,73700634,5488,517
0,1870,0.1809023215067893,0.3174858984689766,73637515,2283,413
2,371,0.705087440381558,0.8616071428571429,65949142,1258,887
1,2470,0.3855721393034826,0.8364159473900534,80125009,4020,1550
2,3357,0.7778145476206235,0.9620090148100451,65965592,15109,11752
2,207,0.7104895104895105,0.8923076923076924,80089744,715,508
1,1004,0.378328173374613,0.6062992125984252,68384302,1615,611
2,176,0.6555772994129159,0.8254716981132075,66062255,511,335
2,136,0.6844547563805105,0.8048780487804879,70121905,431,295
2,682,0.6229961304588171,0.9636552440290758,68586896,1809,1127
2,309,0.6811145510835913,0.8859060402684564,66827082,969,660
2,475,0.5605920444033302,0.8013029315960912,68620706,1081,606
1,1573,0.498085513720485,0.8494623655913979,82009345,3134,1561
2,373,0.6266266266266266,0.7658536585365854,65948925,999,626
2,457,0.5107066381156317,0.8270944741532977,66283056,934,477
1,2855,0.366540936321278,0.8130986280093192,69166573,4507,1652
0,172,0.23893805309734514,0.38738738738738737,69489315,226,54
1,2297,0.34221076746849943,0.7559027777777778,69617940,3492,1195
1,13525,0.27288855437879683,0.546684940894295,69705223,18601,5076
1,321,0.2620689655172414,0.5243243243243243,69705265,435,114
0,884,0.09146968139773895,0.1095890410958904,69705293,973,89
0,14063,0.15780332974008862,0.22458222708105577,69705314,16698,2635
1,1349,0.36785379568884724,0.8200946870068385,70657720,2134,785
1,1106,0.3341360626128838,0.632398753894081,71752870,1661,555
1,1971,0.40507093268940536,0.864251968503937,74355792,3313,1342
1,658,0.29094827586206895,0.5399305555555556,74555040,928,270
0,764,0.2382851445663011,0.44058205335489087,80105774,1003,239
2,491,0.5341555977229602,0.9658356417359187,82036044,1054,563
0,1061,0.1429725363489499,0.2131844763423711,72900296,1238,177
0,1088,0.09484193011647254,0.10597519729425028,72900303,1202,114
0,960,0.12168344007319305,0.1618084473527662,72900310,1093,133
0,2029,0.1615702479338843,0.2670640834575261,80116673,2420,391
1,1168,0.3518312985571587,0.8066732090284593,80128633,1802,634
0,5010,0.2101529244836828,0.3889496717724289,58862664,6343,1333
1,2010,0.4095182138660399,0.8816110659072417,65934400,3404,1394
0,1721,0.06821873308067136,0.11373092926490985,66817366,1847,126
0,4016,0.19519038076152304,0.34287945847435564,66817373,4990,974
0,2956,0.16473580107374966,0.24086845466155812,68535586,3539,583
1,1687,0.33240997229916897,0.7110868377935554,69662026,2527,840
0,2989,0.13211382113821138,0.14747899159663866,80127895,3444,455
0,39,0.1702127659574468,0.19,82062467,47,8
0,26509,0.19457357275240786,0.3361992291728432,72748886,32913,6404
0,19647,0.2194899094231686,0.4143059490084986,72748900,25172,5525
1,1647,0.26767452200978215,0.5592156862745098,73756816,2249,602
1,366,0.31203007518796994,0.7658998646820027,63099813,532,166
1,242,0.4634146341463415,0.9223300970873787,68217800,451,209
2,242,0.65625,0.9866369710467706,74046063,704,462
1,1719,0.3145933014354067,0.7451851851851852,67627000,2508,789
1,233,0.28307692307692306,0.5978062157221207,69184423,325,92
1,1911,0.2994868035190616,0.6469262954618603,70628726,2728,817
1,470,0.23452768729641693,0.5739130434782609,68540570,614,144
1,8620,0.3670607239885454,0.8184417441029307,67168493,13619,4999
0,8486,0.18364598364598364,0.3399858707170611,80180384,10395,1909
0,3422,0.14214088744046127,0.1975,80180385,3989,567
0,968,0.23659305993690852,0.40134228187919463,70254296,1268,300
1,1060,0.3851508120649652,0.7998472116119175,68401382,1724,664
1,481,0.38491048593350385,0.8491859468723222,81971143,782,301
1,312,0.40344168260038243,0.8401898734177216,69108725,523,211
0,2013,0.18765133171912832,0.30158102766798417,69607860,2478,465
0,217,0.20512820512820512,0.47739602169981915,80098641,273,56
1,8997,0.40824782951854777,0.8779342723004695,64239000,15204,6207
1,3146,0.272264631043257,0.6474801061007958,66409630,4323,1177
1,23208,0.25772404528881215,0.5228470242722639,67286716,31266,8058
0,945,0.22794117647058823,0.40997830802603036,70640990,1224,279
1,5367,0.35173330112332407,0.7797131147540983,70676326,8279,2912
1,4644,0.3172596295207292,0.7506121680165756,69588386,6802,2158
1,35522,0.3494377495329841,0.799478978218395,70691110,54602,19080
0,306,0.11046511627906977,0.07712765957446809,61400941,344,38
0,92,0.16363636363636364,0.2328767123287671,65330671,110,18
1,5199,0.23091715976331362,0.5128493414712496,68239885,6760,1561
0,9691,0.09817606551274893,0.14200622715581426,70219674,10746,1055
2,697,0.7378713802181271,0.9958333333333333,80127530,2659,1962
1,427,0.3598200899550225,0.8435643564356435,60026603,667,240
0,1988,0.20352564102564102,0.38043869111830275,68544392,2496,508
1,977,0.451123595505618,0.9096244131455399,70409815,1780,803
0,2305,0.1350844277673546,0.15202801283921796,80130312,2665,360
1,11424,0.24970445290949692,0.571712730318258,62414996,15226,3802
0,594,0.2365038560411311,0.48208191126279865,74554452,778,184
2,612,0.5555555555555556,0.9758883248730964,63495376,1377,765
2,3478,0.5061763453073974,0.95173417414504,66644641,7043,3565
0,4958,0.08658806190125276,0.06916588566073102,68539324,5428,470
0,8271,0.06213856446309105,0.0310407790626902,68539331,8819,548
1,161,0.22596153846153846,0.6170212765957447,69733566,208,47
0,3377,0.19210526315789472,0.36512455516014236,70532812,4180,803
0,216,0.22857142857142856,0.4329268292682927,71389143,280,64
0,2425,0.18459986550100874,0.3236884802595998,80116666,2974,549
1,2368,0.30291433617898145,0.7011294526498697,80118151,3397,1029
1,4053,0.2674859931321164,0.5973616853711361,80119293,5533,1480
0,3973,0.23859716366423916,0.4995700773860705,81976684,5218,1245
1,351,0.3641304347826087,0.8230088495575221,68384526,552,201
1,192,0.3943217665615142,0.8613636363636363,68511996,317,125
1,431183,0.36459074759317467,0.7845864514359597,329070,678591,247408
0,1043,0.15819209039548024,0.23235685752330226,68545540,1239,196
2,1125,0.537227478403949,0.9594137542277339,73503290,2431,1306
1,1172,0.28840315725561627,0.6510989010989011,80111353,1647,475
1,154,0.33905579399141633,0.8097686375321337,67553962,233,79
1,1319,0.4736632083000798,0.9092247301275761,69840750,2506,1187
0,3671,0.07039756900481134,0.13260160189854642,67837952,3949,278
0,1289,0.041635687732342004,0.047953216374269005,70001043,1345,56
0,2555,0.07326804497642365,0.1554730983302412,70001260,2757,202
1,312,0.2909090909090909,0.6899862825788752,68763765,440,128
1,372,0.30206378986866794,0.727177334732424,68763856,533,161
2,2245,0.5831786112142592,0.989247311827957,70178612,5386,3141
1,1170,0.39030745179781134,0.873117033603708,65984163,1919,749
1,2074,0.30332549546523346,0.7048442906574395,65984226,2977,903
1,1429,0.301564027370479,0.6793321819228555,80125350,2046,617
2,1006,0.5669393026259147,0.970242214532872,82041315,2323,1317
0,603,0.20866141732283464,0.4013709063214014,70841442,762,159
0,1157,0.19652777777777777,0.37320574162679426,68543706,1440,283
1,391,0.2759259259259259,0.6157480314960629,70800345,540,149
0,23119,0.24227327848972502,0.4930528375733855,68385996,30511,7392
0,624,0.1746031746031746,0.27853403141361255,68545561,756,132
0,553,0.16966966966966968,0.27376861397479957,68545575,666,113
1,54,0.39325842696629215,0.8487394957983193,64196055,89,35
1,1050,0.23802612481857766,0.5376513954713007,66930990,1378,328
1,1745,0.46912077882567693,0.9320754716981132,70070441,3287,1542
0,1397,0.16547192353643966,0.26820908311910885,70841596,1674,277
1,1592,0.22905569007263923,0.5186915887850467,80112032,2065,473
1,1109,0.33632555356074206,0.7106382978723405,65874683,1671,562
1,324,0.3002159827213823,0.6377025036818851,70110355,463,139
1,1341,0.4375,0.8813559322033898,70112056,2384,1043
1,12414,0.4181119340020624,0.8918738156281351,70607922,21334,8920
0,768,0.2090628218331617,0.47528981086028066,80118451,971,203
1,1870,0.26867422761048104,0.6205645161290323,80125506,2557,687
0,1740,0.23076923076923078,0.4746506986027944,69130243,2262,522
0,762,0.15521064301552107,0.21751216122307157,63277620,902,140
0,2970,0.10461260174856798,0.11119266055045872,65299696,3317,347
0,520,0.09722222222222222,0.1205298013245033,68539933,576,56
0,1235,0.08178438661710037,0.06534422403733955,69622056,1345,110
1,3027,0.3006007393715342,0.7261066398390342,80124643,4328,1301
1,924,0.3972602739726027,0.8680722891566265,72953706,1533,609
0,2595,0.22951306413301661,0.4759791122715405,82011772,3368,773
2,257,0.6380281690140845,0.9941747572815534,82018853,710,453
2,2152,0.7245616280558044,0.9926590538336052,62690390,7813,5661
1,406,0.24675324675324675,0.532133676092545,68533290,539,133
1,243,0.25,0.6130346232179226,68533661,324,81
0,231,0.1348314606741573,0.17307692307692307,68533892,267,36
1,622,0.3452631578947368,0.8145922746781116,69176800,950,328
1,1093,0.4357253484770263,0.9449591280653951,70643503,1937,844
1,3111,0.32251742160278746,0.7585673795413553,68945842,4592,1481
0,509,0.08944543828264759,0.07628128724672228,70071015,559,50
0,519,0.08947368421052632,0.0713436385255648,70071036,570,51
1,6776,0.31974701335207306,0.7349452554744526,69092226,9961,3185
1,413,0.43424657534246575,0.9097320169252469,80004015,730,317
1,1718,0.2536924413553432,0.6356435643564357,76500690,2302,584
0,112,0.23809523809523808,0.4163568773234201,80108693,147,35
1,1133,0.28697293895531784,0.615592609283461,80124124,1589,456
1,237,0.3247863247863248,0.7313664596273292,69177542,351,114
1,543,0.3378048780487805,0.8121263877028181,69180706,820,277
1,1629,0.23124115148655025,0.5868388171595169,63028686,2119,490
0,1542,0.19140010487676978,0.30368663594470047,67145862,1907,365
2,762,0.5071151358344114,0.9364575059571089,60984161,1546,784
1,1547,0.3966458658346334,0.8530915853091585,80153456,2564,1017
1,642,0.3305526590198123,0.8198198198198198,66425744,959,317
1,434,0.46878824969400246,0.9646739130434783,69091624,817,383
1,565,0.29197994987468673,0.7128205128205128,67555103,798,233
1,12686,0.25067926757235676,0.5436033133916245,80130304,16930,4244
1,2131,0.30245499181669394,0.6552399608227228,80180456,3055,924
0,537,0.16873065015479877,0.283657917019475,82058185,646,109
0,830,0.18065153010858837,0.30828025477707005,82058186,1013,183
0,3299,0.12120404901438465,0.22578490313961255,80116736,3754,455
0,4382,0.2026928675400291,0.45851272015655575,64929256,5496,1114
1,1594,0.26442085832948775,0.6308617234468938,69590535,2167,573
1,263,0.36930455635491605,0.7915966386554621,82106949,417,154
1,1163,0.2611181702668361,0.5734383792909398,80109393,1574,411
1,741,0.21587301587301588,0.5056374674761491,68541186,945,204
1,2528,0.3771864991377186,0.8559810233819044,67262041,4059,1531
1,1067,0.41598248494800216,0.8828883495145631,80153457,1827,760
1,2400,0.30313588850174217,0.5969191270860077,80127524,3444,1044
1,682,0.2546448087431694,0.5957910014513788,80125286,915,233
1,2870,0.3213525656183495,0.7451323015476785,67865371,4229,1359
1,1010,0.2518518518518518,0.5893060295790671,71783733,1350,340
0,7832,0.04951456310679612,0.025477707006369428,67706485,8240,408
1,1346,0.30403309203722856,0.6625891946992865,67706835,1934,588
1,67363,0.32147785533697965,0.7236692375774434,70484316,99279,31916
0,2910,0.22688629117959616,0.4961453744493392,80130311,3764,854
0,3085,0.19430660746931314,0.30618602581219406,68954711,3829,744
1,149,0.3686440677966102,0.8894009216589862,70618485,236,87
1,294,0.3033175355450237,0.7155688622754491,70618492,422,128
0,3515,0.07157950343370312,0.056830215319449345,67706401,3786,271
1,339,0.37105751391465674,0.8448500651890483,65847901,539,200
1,273,0.3,0.5924006908462867,82021923,390,117
1,18373,0.3024677296886864,0.6791725105189341,80121874,26340,7967
1,1459,0.3923365264473136,0.8483389504092441,67199265,2401,942
0,4754,0.07886068591358264,0.07352128247650636,67706583,5161,407
1,1107,0.34613112817483754,0.781888459414688,67994976,1693,586
1,1175,0.37994722955145116,0.7985690698954321,70632492,1895,720
0,95,0.20833333333333334,0.3768844221105528,695520,120,25
1,353,0.28830645161290325,0.7332535885167464,64369655,496,143
1,23926,0.2703040653877825,0.6585206375153249,70691145,32789,8863
1,424,0.38011695906432746,0.8877419354838709,70626822,684,260
2,2017,0.6044322416160032,0.9929863418235512,80109365,5099,3082
1,870,0.39625260235947257,0.8910675381263616,68131784,1441,571
1,156,0.2909090909090909,0.6078431372549019,70179543,220,64
1,311,0.2850574712643678,0.5526838966202783,70179585,435,124
1,144,0.2835820895522388,0.608,81956120,201,57
0,113,0.16911764705882354,0.22727272727272727,81956121,136,23
0,135,0.21511627906976744,0.3864734299516908,81956123,172,37
2,38,0.6237623762376238,0.98,69585691,101,63
1,796,0.17255717255717257,0.5361356932153393,80165693,962,166
0,3528,0.16477272727272727,0.2789135514018692,60579022,4224,696
0,5178,0.15681485100146556,0.22101090188305253,67706660,6141,963
1,8208,0.24042198778456414,0.5945531914893617,70691236,10806,2598
1,1860,0.4214618973561431,0.8912495498739648,82152820,3215,1355
0,390,0.21686746987951808,0.43047034764826175,68237813,498,108
0,2652,0.11036564911103657,0.115736885928393,67706702,2981,329
1,5091,0.25959860383944156,0.5264019647973802,67706905,6876,1785
0,1394,0.11492063492063492,0.1485371342835709,68563866,1575,181
1,467,0.28810975609756095,0.7512254901960784,78921444,656,189
0,746,0.1891304347826087,0.3822784810126582,68538176,920,174
1,2155,0.3592030924769551,0.8162042875157629,60508882,3363,1208
1,424,0.3116883116883117,0.6922357343311506,82008906,616,192
0,362,0.24583333333333332,0.4622356495468278,82116582,480,118
1,25163,0.43793696531081777,0.8907433380084151,64506022,44769,19606
1,170,0.27350427350427353,0.588477366255144,69724116,234,64
0,9623,0.19046016656852024,0.33978618896272755,69600951,11887,2264
1,1349,0.29186351706036745,0.6622114216281896,80130306,1905,556
1,374,0.35517241379310344,0.8111979166666666,70252924,580,206
0,1093,0.21928571428571428,0.47739602169981915,78235661,1400,307
0,1679,0.1650919940328195,0.2884415133634155,80119391,2011,332
1,1199,0.29883040935672517,0.6753794266441822,68211710,1710,511
0,880,0.21777777777777776,0.3654618473895582,70729484,1125,245
1,1811,0.2945072068562524,0.6659101225601453,80111304,2567,756
1,506,0.27089337175792505,0.5644768856447688,80111311,694,188
1,1298,0.3564700049578582,0.8375394321766562,80125496,2017,719
1,3050,0.35789473684210527,0.8312363238512035,75893020,4750,1700
0,68,0.23595505617977527,0.4350282485875706,80109484,89,21
0,924,0.1348314606741573,0.3768939393939394,69638821,1068,144
1,4969,0.49244126659856996,0.9431426602343211,70818986,9790,4821
0,1170,0.11963882618510158,0.140625,82009374,1329,159
0,1036,0.10380622837370242,0.137664697864607,82009376,1156,120
1,84,0.4166666666666667,0.9047619047619048,69603485,144,60
0,4380,0.17962165199475558,0.2877184912603496,80130325,5339,959
0,9464,0.07197489703863502,0.047814569536423844,68539303,10198,734
0,672,0.20190023752969122,0.4151103565365025,68540514,842,170
0,8377,0.08816806356808533,0.08128449573507275,80138986,9187,810
1,3366,0.23638838475499094,0.5304286052569264,70627816,4408,1042
1,1970,0.41543026706231456,0.9259259259259259,68532471,3370,1400
1,934,0.3946856772521063,0.901685393258427,68532485,1543,609
0,1718,0.17641418983700863,0.4069335534461411,63503601,2086,368
1,6600,0.34046167682622164,0.7439824945295405,69681486,10007,3407
1,2936,0.3064020789038507,0.7270959902794654,80120442,4233,1297
1,8657,0.28282660922873004,0.6345342812387035,70841715,12071,3414
0,1745,0.0844700944386149,0.05824811027123166,67554760,1906,161
0,1762,0.06920232435287903,0.035607035607035604,67554774,1893,131
1,904,0.2644426362896664,0.6182432432432432,69056533,1229,325
0,1930,0.22271445831655257,0.4989130434782609,70643531,2483,553
0,697,0.22898230088495575,0.4843875100080064,80109820,904,207
2,392,0.5062972292191436,0.9549330085261876,69708625,794,402
0,1430,0.19977616116396194,0.4251554280248685,68534144,1787,357
0,55028,0.21491753695143526,0.4057598702001082,70484330,70092,15064
1,3053,0.27395957193816883,0.5912707981673498,80132195,4205,1152
1,707,0.32538167938931295,0.7396928051738076,67994675,1048,341
0,1386,0.20253164556962025,0.3852380952380952,68540962,1738,352
0,1074,0.2032640949554896,0.4049079754601227,81979983,1348,274
1,768,0.30997304582210244,0.6884955752212389,68191662,1113,345
1,3433,0.24299889746416758,0.501627150162715,68533073,4535,1102
1,103,0.32679738562091504,0.7781569965870307,70828492,153,50
0,912,0.15633672525439407,0.20965189873417722,70653772,1081,169
1,1112,0.33373277411623725,0.7497630331753554,63141491,1669,557
1,3187,0.2687012391005048,0.5216682958618443,70644840,4358,1171
1,861,0.3827956989247312,0.8296795952782462,67662546,1395,534
1,876,0.2946859903381642,0.6704834605597965,80180152,1242,366
0,4098,0.14088050314465408,0.2055032226078334,65291590,4770,672
0,7116,0.05044035228182546,0.020358020358020357,68534613,7494,378
1,1734,0.24967546516659456,0.5772669220945083,80121303,2311,577
0,1401,0.18213660245183888,0.3231441048034934,10120481,1713,312
1,965,0.32752613240418116,0.7747559274755927,68531890,1435,470
1,3171,0.29782993799822854,0.6928909952606636,65808330,4516,1345
1,2209,0.41140420996536103,0.897931775449906,69574631,3753,1544
1,822,0.350197628458498,0.8010362694300518,80118401,1265,443
1,2016,0.3662370323797548,0.8448023426061494,68563432,3181,1165
0,315,0.1532258064516129,0.3396648044692737,66058811,372,57
1,783,0.48790058862001306,0.9345670852610707,82104029,1529,746
0,1012,0.1298366294067068,0.15063649222065065,73818444,1163,151
1,1701,0.4437540876389797,0.9162401116798511,70120071,3058,1357
1,562,0.46116970278044106,0.9602510460251046,65360932,1043,481
1,2388,0.3648936170212766,0.8357763975155279,69608910,3760,1372
1,2728,0.23947588514078616,0.5132810523652922,72900324,3587,859
1,1981,0.4834419817470665,0.9445758702264279,80127853,3835,1854
0,8039,0.08104709647919524,0.07749447902027705,67706576,8748,709
1,506,0.31989247311827956,0.6885245901639344,67994500,744,238
1,4580,0.39225053078556266,0.8765460375629868,80110765,7536,2956
1,206,0.31788079470198677,0.6785714285714286,80111444,302,96
1,997,0.4392575928008999,0.935969868173258,70627361,1778,781
1,95,0.42424242424242425,0.875,82152819,165,70
1,188,0.4106583072100313,0.9358288770053476,69154470,319,131
1,3461,0.36773839970770916,0.8475263584752636,80110856,5474,2013
1,235,0.3543956043956044,0.7751196172248804,80109155,364,129
2,345,0.6039035591274398,0.9864130434782609,61460826,871,526
0,867,0.15249266862170088,0.2,70644903,1023,156
0,547,0.07288135593220339,0.03986710963455149,66423644,590,43
1,416,0.34072900158478603,0.8136729222520107,67159624,631,215
1,758,0.4511223750905141,0.9075757575757576,80174678,1381,623
1,6673,0.4285347263852017,0.9053966189856957,66765384,11677,5004
0,1040,0.2055003819709702,0.3821451509312781,70870912,1309,269
1,296,0.3593073593073593,0.8553345388788427,66423021,462,166
2,708,0.5664421310471525,0.9780918727915194,70178675,1633,925
1,1662,0.48751156336725254,0.9261425959780621,82036043,3243,1581
0,1501,0.20455749867514572,0.4175691937424789,66931753,1887,386
1,3284,0.28092839938690606,0.6760204081632653,69037794,4567,1283
1,4002,0.269974461875228,0.6124078624078624,80125449,5482,1480
1,2693,0.29613173026659695,0.6393040921342809,80130277,3826,1133
1,2581,0.27275288813750354,0.5667170953101361,74478334,3549,968
1,6624,0.4536456614978555,0.9081614665961573,80153449,12124,5500
0,1525,0.06096059113300493,0.10554245283018868,60542804,1624,99
0,755,0.06674907292954264,0.1621160409556314,61704083,809,54
1,8298,0.3393312101910828,0.8029141104294478,63947716,12560,4262
0,140,0.11949685534591195,0.2977941176470588,68530105,159,19
2,1,0.5,0.8571428571428571,69007890,2,1
0,295,0.07523510971786834,0.15594541910331383,69139112,319,24
0,193,0.05392156862745098,0.14457831325301204,69143333,204,11
0,402,0.0945945945945946,0.20621931260229132,69158313,444,42
0,245,0.17785234899328858,0.4028436018957346,69160105,298,53
0,46,0.11538461538461539,0.4152542372881356,70721105,52,6
1,177,0.2891566265060241,0.7294372294372294,68536412,249,72
1,230,0.31343283582089554,0.775894538606403,68536426,335,105
1,187,0.33687943262411346,0.8103975535168195,81967327,282,95
2,524,0.5375110326566638,0.972338642078793,67414592,1133,609
0,21974,0.20828679517204107,0.3732268058046633,72748872,27755,5781
0,5557,0.22604456824512534,0.44101633393829404,72895473,7180,1623
1,2003,0.441594647337608,0.9091551785083068,82125454,3587,1584
0,1755,0.2265315116791538,0.44078014184397163,74445812,2269,514
1,333,0.3076923076923077,0.6298405466970387,80137166,481,148
1,1175,0.26699937616968183,0.6215116279069768,80112144,1603,428
1,449,0.3693820224719101,0.8646616541353384,68393430,712,263
2,438,0.5864022662889519,0.9820627802690582,70178654,1059,621
0,8728,0.21799121942478272,0.4127298954201226,64135176,11161,2433
1,370,0.3707482993197279,0.7848324514991182,70646884,588,218
0,804,0.1845841784989858,0.2707117852975496,80126979,986,182
1,151,0.3601694915254237,0.7701863354037267,70612682,236,85
0,5398,0.1892460198257735,0.3437726285300507,70669403,6658,1260
1,542,0.27925531914893614,0.5905631659056316,80145286,752,210
0,3747,0.2437941473259334,0.48882305413412336,70670971,4955,1208
0,3639,0.23389473684210527,0.48943901885078356,58862650,4750,1111
2,17,0.6964285714285714,0.967741935483871,80137993,56,39
1,159,0.3861003861003861,0.8081841432225064,74478026,259,100
1,1887,0.2759017651573292,0.6516393442622951,70626815,2606,719
1,903,0.29508196721311475,0.6939443535188216,70627774,1281,378
1,2000,0.40227136879856545,0.8849806542384805,74091493,3346,1346
1,3783,0.30612619222303744,0.6988614055751865,64411746,5452,1669
0,3787,0.15844444444444444,0.2638666239179224,65934505,4500,713
1,2147,0.36722664308871206,0.8069032888309997,66098060,3393,1246
1,2441,0.428872250818905,0.8953687821612349,66358222,4274,1833
0,1770,0.10920986411675894,0.1357808857808858,66359006,1987,217
0,2174,0.14476789929189615,0.21332670313276977,66808903,2542,368
1,3841,0.3615359042553192,0.8087431693989071,67994066,6016,2175
1,674,0.26258205689277897,0.5852036575228595,804720,914,240
1,714,0.3828867761452031,0.8247354497354498,70808283,1157,443
2,313,0.6443181818181818,0.9732888146911519,77319550,880,567
1,4481,0.27468436387180317,0.5966829268292683,62816425,6178,1697
0,132,0.21428571428571427,0.3646788990825688,67556216,168,36
1,98,0.4895833333333333,0.9504950495049505,70474656,192,94
2,3321,0.7787622410232496,0.99159891598916,69995296,15011,11690
1,7705,0.2022157796645268,0.5117567769956567,70691215,9658,1953
1,340,0.2608695652173913,0.5843793584379359,73514056,460,120
2,178,0.5669099756690997,0.9272727272727272,69972476,411,233
1,1775,0.18949771689497716,0.5792300805729633,63981995,2190,415
1,4146,0.184821077467558,0.552319842053307,63982002,5086,940
2,122,0.5196850393700787,0.8660287081339713,80045602,254,132
2,294,0.5905292479108635,0.9142857142857143,69732194,718,424
2,1257,0.6069418386491557,0.9306599832915622,69514200,3198,1941
1,3643,0.36994119681771015,0.7586007516623302,70720496,5782,2139
1,1337,0.386697247706422,0.8835117773019272,64400595,2180,843
1,100,0.453551912568306,0.8731707317073171,69944693,183,83
1,2842,0.3066601610148817,0.5929432013769363,70255325,4099,1257
2,333,0.6879100281162137,0.9069069069069069,70573804,1067,734
2,280,0.5971223021582733,0.9555555555555556,80124942,695,415
2,979,0.5390772128060264,0.9408376963350785,69706315,2124,1145
1,959,0.26287471176018445,0.5915145535273804,65312541,1301,342
1,962,0.2777777777777778,0.6180400890868597,68236266,1332,370
0,30286,0.23927459057570583,0.4948943243885063,80128891,39812,9526
0,1436,0.18640226628895185,0.2968949383241174,67291721,1765,329
0,3875,0.18711978183343822,0.3152741514360313,67556454,4767,892
0,1366,0.12379730596536241,0.12782294489611562,67963532,1559,193
2,147,0.5893854748603352,0.9811320754716981,56014581,358,211
0,182,0.23529411764705882,0.41739130434782606,69489266,238,56
0,2941,0.2221634488230627,0.37051282051282053,70641123,3781,840
2,732,0.6087653661143774,0.9882445141065831,70277452,1871,1139
1,5293,0.42304338347503817,0.9183250414593698,80110730,9174,3881
0,1625,0.07142857142857142,0.24258355238452872,66389351,1750,125
0,367,0.10922330097087378,0.4242709313264346,80128649,412,45
1,585,0.275092936802974,0.5956964892412231,80181373,807,222
0,675,0.20118343195266272,0.35266821345707655,80181387,845,170
0,820,0.10869565217391304,0.1353811149032992,80181392,920,100
0,1455,0.1297846889952153,0.1702002355712603,68478256,1672,217
1,5457,0.3402248821182445,0.76775956284153,68545764,8271,2814
1,1949,0.35909240381453467,0.8335771762984638,80125510,3041,1092
1,629,0.3722554890219561,0.8809746954076851,67557140,1002,373
0,3693,0.15083927339618303,0.20290205562273278,70871045,4349,656
1,1138,0.2751592356687898,0.5750463248919085,80111143,1570,432
0,9329,0.20428181508017743,0.3753063725490196,65291660,11724,2395
0,11233,0.15674498911493132,0.23472124206069162,65291940,13321,2088
1,1196,0.3325892857142857,0.7579445571331981,65808365,1792,596
0,4217,0.07804984696108438,0.06529209621993128,68539751,4574,357
0,941,0.11142587346553352,0.16644113667117727,70617232,1059,118
0,1814,0.012520413718018509,0.002936241610738255,70617386,1837,23
0,1358,0.058905058905058906,0.03544575725026853,70642586,1443,85
1,6969,0.35734046477314646,0.809135143619526,74130945,10844,3875
1,2951,0.3433466844681798,0.7890961262553802,81965579,4494,1543
0,759,0.23487903225806453,0.4651307596513076,70525420,992,233
0,3814,0.22274302017525982,0.4636324041811847,76032600,4907,1093
1,8973,0.4065083669554865,0.880939524838013,79515296,15119,6146
0,4296,0.23162225004471473,0.4746611053180396,80114104,5591,1295
0,2146,0.14365522745411013,0.2304270462633452,80116526,2506,360
0,2587,0.23143196672608438,0.4918300653594771,80117897,3366,779
0,1833,0.22788542544229148,0.4636042402826855,80117907,2374,541
0,2647,0.17487531172069826,0.2857142857142857,80119301,3208,561
0,1190,0.0916030534351145,0.10267034990791897,82036708,1310,120
0,2350,0.09823484267075978,0.23034154090548054,62413680,2606,256
0,1166,0.040329218106995884,0.051354401805869074,62413925,1215,49
1,608,0.3059360730593607,0.6044499381953028,62437634,876,268
1,461,0.3220588235294118,0.6048632218844985,63998256,680,219
1,386,0.2675521821631879,0.6859956236323851,70062636,527,141
1,4464,0.277436063450955,0.5716528369589594,74353174,6178,1714
0,167,0.01764705882352941,0.014336917562724014,68743570,170,3
0,750,0.02216427640156454,0.02040816326530612,68743584,767,17
0,1240,0.08621960206337509,0.08134805345729228,68743640,1357,117
1,1824,0.2674698795180723,0.5957142857142858,69586482,2490,666
1,2799,0.310930576070901,0.6588805641251653,69705160,4062,1263
1,449,0.4401496259351621,0.9100467289719626,80159812,802,353
0,973,0.2240829346092504,0.4505844845908608,82095521,1254,281
1,1667,0.26499118165784835,0.5475578406169666,71571675,2268,601
1,301,0.46536412078152756,0.9201807228915663,63716961,563,262
1,2735,0.3293281020107896,0.7543453070683661,66765223,4078,1343
1,1065,0.28714859437751006,0.6145905024088094,80111164,1494,429
0,634,0.09298998569384835,0.1617873651771957,71762285,699,65
0,2586,0.17930815614090764,0.31931993817619786,66404674,3151,565
1,2138,0.35172832019405703,0.8167994207096307,80108973,3298,1160
1,887,0.2800324675324675,0.6722257857601026,73816183,1232,345
0,8873,0.19570340826686006,0.38232899022801303,73818514,11032,2159
1,520,0.2737430167597765,0.5659068384539148,81980717,716,196
1,741,0.49385245901639346,0.9407051282051282,80096030,1464,723
0,464,0.16994633273703041,0.2849344978165939,70871066,559,95
0,528,0.22238586156111928,0.4070294784580499,67435956,679,151
0,2640,0.04933381346777098,0.026717557251908396,69167693,2777,137
1,1050,0.26367461430575034,0.596100278551532,69739355,1426,376
0,104,0.2,0.42700729927007297,80124520,130,26
1,2388,0.23091787439613526,0.502165944685105,79793504,3105,717
1,581,0.45394736842105265,0.9052901023890785,66364816,1064,483
0,2868,0.06243870545930043,0.11602209944751381,69575324,3059,191
1,842,0.254207263064659,0.662847790507365,70925421,1129,287
2,100,0.5391705069124424,0.9827586206896551,67993765,217,117
1,599,0.21801566579634465,0.5190697674418605,68537455,766,167
1,9517,0.24161287752012112,0.5229369554074833,80130309,12549,3032
0,737,0.14600231749710313,0.17486818980667837,67556825,863,126
0,2810,0.05195681511470985,0.015838926174496646,68539023,2964,154
0,1308,0.22465915826911678,0.489974293059126,68540395,1687,379
0,1078,0.08952702702702703,0.07482250136537412,70206906,1184,106
1,368,0.33574007220216606,0.7743300423131171,62461483,554,186
1,2222,0.36020731356176217,0.8111988513998565,80180319,3473,1251
1,973,0.3143058491895701,0.7734333154793787,68235965,1419,446
1,1900,0.4346920559357334,0.9176555195972672,80126583,3361,1461
1,607,0.4712543554006969,0.9159159159159159,65406495,1148,541
2,1609,0.5363112391930835,0.9698294709226061,82023513,3470,1861
0,2488,0.06641651031894934,0.10921766072811774,64165360,2665,177
1,2451,0.259963768115942,0.5963274198568316,80125466,3312,861
1,624,0.298876404494382,0.5758793969849246,69108676,890,266
2,311,0.5544412607449857,0.9796215429403202,70612500,698,387
1,510,0.3253968253968254,0.6865671641791045,73049340,756,246
1,3427,0.36619197336785647,0.779980420949584,80123757,5407,1980
1,2169,0.28978388998035365,0.5651286239281339,82020726,3054,885
1,3091,0.3592454394693201,0.764412997903564,81879159,4824,1733
0,1642,0.08777777777777777,0.09284818067754078,70617211,1800,158
1,302,0.396,0.8617021276595744,80180130,500,198
1,5384,0.37431725740848343,0.8372650202727607,69739110,8605,3221
1,159,0.3510204081632653,0.8292682926829268,67942406,245,86
0,502,0.2119309262166405,0.4140625,68533003,637,135
0,1556,0.12387387387387387,0.11389715257118573,68543986,1776,220
1,1479,0.2612387612387612,0.5449763282482903,80111332,2002,523
1,456,0.37103448275862067,0.8389830508474576,67922666,725,269
1,2566,0.38962892483349193,0.8613728129205922,69020560,4204,1638
1,1465,0.2808051055473736,0.6311576354679803,82008919,2037,572
0,5746,0.16965317919075146,0.35599078341013823,69638765,6920,1174
1,342,0.2597402597402597,0.5963302752293578,80111955,462,120
1,698,0.3537037037037037,0.8338607594936709,80111962,1080,382
1,238,0.25157232704402516,0.5445859872611465,80045630,318,80
1,1549,0.2920475319926874,0.6486895161290323,80110744,2188,639
0,4887,0.22796208530805687,0.4724537507623501,80125469,6330,1443
0,4332,0.20014771048744462,0.34865725989986346,68532933,5416,1084
0,1328,0.22202694786174576,0.46941549614861805,68543692,1707,379
1,11,0.47619047619047616,0.9230769230769231,81989170,21,10
1,4916,0.38023197175995965,0.8352309344790548,67641322,7932,3016
1,4726,0.32639680729760545,0.7150770712909441,69551160,7016,2290
2,313,0.5430656934306569,0.9666666666666667,70934185,685,372
0,830,0.1590678824721378,0.27913669064748203,73524745,987,157
0,944,0.17984361424847958,0.34203516249334043,69239814,1151,207
0,786,0.19467213114754098,0.4112676056338028,69240101,976,190
0,995,0.22688422688422688,0.45875542691751087,80108665,1287,292
1,164,0.3543307086614173,0.8735362997658079,69180300,254,90
1,280,0.2802056555269923,0.5790349417637272,80180151,389,109
1,5680,0.3132632088018377,0.6709183673469388,69705216,8271,2591
0,2444,0.0808574652124859,0.09157688540646425,69705300,2659,215
0,9503,0.10543161065612351,0.10585000763708569,70609322,10623,1120
0,963,0.21770917952883834,0.43724696356275305,80097626,1231,268
0,492,0.2202852614896989,0.35917312661498707,80132867,631,139
0,1227,0.18741721854304635,0.36332651670074984,67336703,1510,283
0,1548,0.185691741188848,0.3775454045129334,68171572,1901,353
1,415,0.25225225225225223,0.5617647058823529,68791114,555,140
0,2441,0.22261146496815287,0.38961474036850924,70653856,3140,699
1,2603,0.2704596412556054,0.586552217453505,67553353,3568,965
0,522,0.17795275590551182,0.3125512715340443,79520161,635,113
1,743,0.2842003853564547,0.6815988973121985,80121101,1038,295
1,790,0.2609915809167446,0.6204081632653061,80121112,1069,279
1,162,0.3360655737704918,0.8429752066115702,80133423,244,82
1,1228,0.3234159779614325,0.6264501160092807,68577705,1815,587
1,3919,0.41524917934944794,0.9235393123346959,67552611,6702,2783
1,891,0.28203062046736505,0.6026686434395849,69176583,1241,350
1,2869,0.4195832490390451,0.894120776802341,80126582,4943,2074
1,2807,0.45057741240947347,0.9252659574468085,82152821,5109,2302
0,520,0.1390728476821192,0.1952941176470588,63100534,604,84
1,25,0.40476190476190477,0.8552631578947368,67381020,42,17
0,58,0.17142857142857143,0.3359375,69622126,70,12
1,25,0.2647058823529412,0.6666666666666666,80154138,34,9
0,188,0.0,0.0,63141302,188,0
0,781,0.10946408209806158,0.1440536013400335,68743591,877,96
0,1904,0.07527926177756192,0.07016823963890029,68743661,2059,155
1,934,0.25990491283676703,0.5661157024793388,73914386,1262,328
0,740,0.0897908979089791,0.1609907120743034,66964296,813,73
1,3704,0.4655893810416967,0.9112452492734183,79154516,6931,3227
1,1092,0.2661290322580645,0.6323768272874932,80117914,1488,396
2,1285,0.5502275113755688,0.9670781893004116,80126952,2857,1572
1,267,0.2562674094707521,0.6529080675422139,68534312,359,92
1,16026,0.4028171113429721,0.8935197879535691,69579454,26836,10810
1,773,0.4498220640569395,0.9444032616753151,68531176,1405,632
0,2423,0.17864406779661016,0.33663366336633666,73816050,2950,527
1,1250,0.30128563443264395,0.6897009966777409,67145673,1789,539
0,275,0.23184357541899442,0.3460764587525151,70489643,358,83
1,624,0.4227567067530065,0.8789420142421159,57013642,1081,457
1,826,0.3047138047138047,0.546875,71752940,1188,362
1,4693,0.32793928111127024,0.6948365886675691,80125824,6983,2290
1,1151,0.3825107296137339,0.8386092371562014,68441303,1864,713
1,2658,0.284329563812601,0.6562417174662073,73703826,3714,1056
1,508,0.45435016111707843,0.9148717948717948,82152431,931,423
1,1328,0.36792003807710616,0.8108108108108109,66509415,2101,773
1,1198,0.3047011027278003,0.6160849772382397,66509436,1723,525
0,2494,0.06870799103808813,0.052571860816944024,70641193,2678,184
0,2481,0.07700892857142858,0.0671491757137113,70641501,2688,207
0,2684,0.17415384615384616,0.24934725848563968,70644973,3250,566
0,1238,0.26045400238948624,0.49744245524296676,81956101,1674,436
1,3167,0.39825194755842674,0.8397417082477253,78705284,5263,2096
1,6318,0.4601384260446039,0.930322408739675,65197174,11703,5385
1,1366,0.292594510616261,0.6613508442776735,64410311,1931,565
1,1076,0.255363321799308,0.565,66930801,1445,369
1,1056,0.23367198838896952,0.5010460251046025,66931872,1378,322
1,2003,0.27110625909752545,0.6523168908819134,69625192,2748,745
0,1017,0.10475352112676056,0.11081441922563418,68534452,1136,119
0,1074,0.12039312039312039,0.17814207650273223,68553590,1221,147
1,696,0.34277620396600567,0.7570356472795498,70110320,1059,363
0,1839,0.0954254795868175,0.1053911633563032,70615230,2033,194
1,413,0.2792321116928447,0.7004773269689738,80121269,573,160
0,3279,0.19985358711566617,0.36248654467169,80181298,4098,819
0,4736,0.1200297287253809,0.14790807307012374,69227466,5382,646
1,657,0.35525024533856725,0.7822765469824293,80117933,1019,362
1,1155,0.4169611307420495,0.8813953488372093,66106621,1981,826
1,940,0.40012763241863436,0.9289940828402367,67558134,1567,627
0,2416,0.19787516600265603,0.37422934648581996,80119299,3012,596
0,235,0.09615384615384616,0.4332425068119891,62834821,260,25
0,163,0.12365591397849462,0.43781094527363185,64240736,186,23
0,558,0.03626943005181347,0.12634920634920635,64984661,579,21
1,635,0.24224343675417662,0.5583468395461912,69198444,838,203
1,5645,0.27923901940755874,0.6127852290541718,70252273,7832,2187
0,1246,0.16150740242261102,0.3074558032282859,70252280,1486,240
0,11984,0.13603921851344533,0.17230113636363636,65291961,13871,1887
0,1517,0.1316542644533486,0.24419155998103367,81965606,1747,230
0,729,0.21359223300970873,0.45410628019323673,68543825,927,198
1,1633,0.27000447027268665,0.5254957507082153,81956112,2237,604
1,340,0.3738489871086556,0.8615611192930781,80109351,543,203
2,79,0.616504854368932,0.9875,82059493,206,127
2,155,0.6095717884130982,0.9853372434017595,61827290,397,242
0,505,0.14839797639123103,0.46331738437001596,69660024,593,88
1,1820,0.3296500920810313,0.8187113214415727,65463965,2715,895
1,3507,0.34177927927927926,0.8099253192001927,76958301,5328,1821
1,228,0.3522727272727273,0.8190709046454768,63051016,352,124
1,408,0.28169014084507044,0.6486880466472303,63051023,568,160
1,1321,0.27377680043980207,0.6615678776290631,80110562,1819,498
1,10135,0.36201687020017626,0.7992880613362541,67641294,15886,5751
0,12039,0.10643509240703629,0.1123956326268465,67706751,13473,1434
1,15341,0.27434842249657065,0.5838788870703764,64135113,21141,5800
1,4539,0.2666020358700921,0.5541950113378685,66906994,6189,1650
2,543,0.514745308310992,0.9292389853137517,70198191,1119,576
1,4738,0.21711830799735624,0.5020860077021823,61743101,6052,1314
0,959,0.06072477962781587,0.2310396785534907,62835262,1021,62
0,656,0.06685633001422475,0.30514705882352944,62837334,703,47
0,1495,0.20563230605738575,0.4766977363515313,80003413,1882,387
1,1199,0.3225988700564972,0.7294716740929345,80109120,1770,571
1,5836,0.2507382205674669,0.5467775467775468,73818080,7789,1953
1,527,0.33375474083438683,0.7910750507099391,67552464,791,264
1,1582,0.2523629489603025,0.5074786324786325,66808952,2116,534
0,278,0.09446254071661238,0.1505922165820643,70643174,307,29
0,2384,0.14613180515759314,0.18660287081339713,67554431,2792,408
1,2465,0.2794504530838936,0.6381431767337807,67168612,3421,956
0,2748,0.13666352497643733,0.2538614848031888,70841540,3183,435
1,1692,0.21666666666666667,0.5104498760184201,80180137,2160,468
0,6771,0.17123623011015912,0.27047781569965873,68645150,8170,1399
0,1732,0.22122302158273383,0.4071533561979422,64135155,2224,492
1,343,0.34790874524714827,0.7163120567375887,79787015,526,183
1,2451,0.35432033719704953,0.7455765710799268,80123779,3796,1345
1,1221,0.2986789201608271,0.601145038167939,81967949,1741,520
1,467,0.30402384500745155,0.7789598108747045,67556916,671,204
1,3347,0.2582003546099291,0.5680442221637273,68534095,4512,1165
1,649,0.36744639376218324,0.8620689655172413,65267076,1026,377
0,10167,0.09994688385269122,0.09771309771309772,67706730,11296,1129
2,720,0.5628415300546448,0.9668989547038328,82041317,1647,927
1,2024,0.2461824953445065,0.5113088616981831,67557280,2685,661
1,719,0.2781124497991968,0.6666666666666666,70215894,996,277
0,10269,0.14303596762079612,0.25248458925651024,61585524,11983,1714
0,3848,0.19497907949790794,0.43451195219123506,62507606,4780,932
0,1822,0.08257804632426989,0.11639549436795996,68312146,1986,164
1,881,0.38477653631284914,0.8876163206871869,68532506,1432,551
1,580,0.49122807017543857,0.9393939393939394,70317975,1140,560
1,938,0.26947040498442365,0.6422668240850059,68532905,1284,346
1,1040,0.3820558526440879,0.8779840848806366,69585950,1683,643
0,1898,0.13922902494331066,0.2053182214472537,74886245,2205,307
0,3486,0.07680084745762712,0.14852752880921896,60029095,3776,290
1,4030,0.269133115705477,0.6263711151736746,62507571,5514,1484
1,144,0.26153846153846155,0.6046511627906976,63051646,195,51
1,100,0.43820224719101125,0.9037800687285223,73131191,178,78
0,410,0.20233463035019456,0.49282296650717705,60592224,514,104
0,2951,0.13256907701352147,0.26961445133459155,69575093,3402,451
0,1647,0.1009825327510917,0.19321876451463074,69575415,1832,185
0,46,0.08,0.1206896551724138,262836,50,4
1,84,0.35384615384615387,0.8387096774193549,68158391,130,46
0,4089,0.16071428571428573,0.2609004739336493,69167406,4872,783
1,4001,0.321864406779661,0.7451796669588081,69628664,5900,1899
0,2086,0.1695859872611465,0.29048843187660667,70609406,2512,426
1,443,0.3680456490727532,0.7650085763293311,74290496,701,258
1,1912,0.29654157468727005,0.6669156086631814,80108140,2718,806
1,2852,0.32957216737188527,0.7798302546180729,69166041,4254,1402
0,1464,0.14585764294049008,0.18035796236805873,69240164,1714,250
1,543,0.3047375160051216,0.7179775280898877,68531260,781,238
0,1921,0.13194758246723903,0.15932914046121593,69240143,2213,292
1,446,0.31278890600924497,0.7647714604236343,80111920,649,203
1,877,0.3518107908351811,0.8360872438863186,742574,1353,476
1,211,0.2596491228070175,0.6068601583113457,75662713,285,74
1,1579,0.26558139534883723,0.5958733546780505,63283276,2150,571
1,460,0.36022253129346316,0.8448275862068966,68534781,719,259
1,2968,0.27468230694037143,0.585357624831309,70283052,4092,1124
1,301,0.4566787003610108,0.9366053169734151,64191911,554,253
1,1676,0.3200811359026369,0.7842291094546882,68158335,2465,789
0,89,0.14423076923076922,0.2647058823529412,80180391,104,15
1,1763,0.2815810920945395,0.6416093170989942,80180457,2454,691
1,626,0.458477508650519,0.9112769485903814,63241976,1156,530
0,49,0.10909090909090909,0.0975609756097561,63779681,55,6
0,5734,0.04924556458298789,0.01694915254237288,68539044,6031,297
1,1454,0.2528263103802672,0.6020008699434537,80125285,1946,492
1,6978,0.3326958018552166,0.7809598741148702,80125456,10457,3479
1,383,0.2718631178707224,0.6476190476190476,66931081,526,143
0,614,0.228643216080402,0.44136291600633915,67551813,796,182
1,255,0.38405797101449274,0.883629191321499,67555936,414,159
0,972,0.17135549872122763,0.2756981580510992,68545323,1173,201
1,2020,0.2504638218923933,0.5763411279229711,68545596,2695,675
1,322,0.3148936170212766,0.7347611202635914,69607685,470,148
1,6591,0.267992003553976,0.5711145996860283,67136776,9004,2413
1,3385,0.4433481335306693,0.9255084538103406,67145953,6081,2696
0,2319,0.052308949734368615,0.029552715654952075,68018160,2447,128
1,11718,0.26620326883336465,0.5769946371894495,69836095,15969,4251
1,98,0.4269005847953216,0.8349056603773585,68185453,171,73
0,873,0.1474609375,0.25109855618330196,68538050,1024,151
0,676,0.23702031602708803,0.4862466725820763,80135737,886,210
1,620,0.3057110862262038,0.7090545938748336,80120444,893,273
1,50,0.39759036144578314,0.8785046728971962,65919056,83,33
0,24140,0.14521440458907262,0.24555129842486165,70219583,28241,4101
0,4352,0.0808870116156283,0.17054986020503263,80140145,4735,383
0,541,0.2170767004341534,0.46965699208443273,66931354,691,150
0,747,0.18892508143322476,0.4045901639344262,67160604,921,174
0,5083,0.21413110698824986,0.41071743345672485,80125468,6468,1385
0,2902,0.22798616653365256,0.48220218319886093,80130310,3759,857
1,1829,0.3213358070500928,0.7168508287292817,80111073,2695,866
1,1751,0.34761549925484353,0.7929366231253023,80111101,2684,933
0,2698,0.2476296709425544,0.488,69974401,3586,888
0,248,0.17880794701986755,0.3,70240954,302,54
0,3599,0.15137939165291206,0.20328343795267986,69489301,4241,642
1,1405,0.26246719160104987,0.5671806167400881,67555824,1905,500
1,122,0.3107344632768362,0.7435897435897436,82002691,177,55
1,2105,0.4913001449975834,0.9426321709786277,69589205,4138,2033
1,774,0.47203274215552526,0.9171023151605676,80131240,1466,692
0,18,0.28,0.3235294117647059,82017786,25,7
1,1704,0.43873517786561267,0.8074534161490683,69972455,3036,1332
2,265,0.6329639889196675,0.9395248380129589,69972490,722,457
1,52,0.2777777777777778,0.5733333333333334,80051580,72,20
0,83,0.26548672566371684,0.25,82061394,113,30
0,478,0.2589147286821705,0.4724770642201835,66957562,645,167
0,813,0.1687116564417178,0.268630849220104,68995444,978,165
0,5582,0.1970655926352129,0.3414832925835371,69705146,6952,1370
0,1496,0.18783930510314875,0.3046808510638298,69705195,1842,346
0,585,0.23728813559322035,0.4383720930232558,69705321,767,182
0,1285,0.21789409616555083,0.4724284199363733,80121266,1643,358
1,353,0.3389513108614232,0.8527918781725888,68236105,534,181
1,1589,0.28552158273381295,0.5844051446945338,80089982,2224,635
1,7148,0.4373425692695214,0.8573421695151726,80090031,12704,5556
2,708,0.5591531755915318,0.8727015558698727,151473,1606,898
0,4094,0.06551015749828806,0.03647798742138365,54130272,4381,287
0,4873,0.1390459363957597,0.17881136950904392,60003265,5660,787
1,1479,0.24386503067484663,0.5447641886490807,67703293,1956,477
0,965,0.06943105110896818,0.05445935280189424,69603366,1037,72
2,437,0.7134426229508197,0.9005376344086021,62819932,1525,1088
1,4160,0.49969933854479853,0.9311440677966102,68613342,8315,4155
1,918,0.3784698713608666,0.877642536835362,63445893,1477,559
0,449,0.1982142857142857,0.45925925925925926,67555166,560,111
0,1051,0.13212221304706853,0.14218566392479437,70207872,1211,160
1,3003,0.4668915320433162,0.9172638436482085,69585516,5633,2630
2,445,0.6798561151079137,0.8694444444444445,70121723,1390,945
0,1214,0.1954937044400265,0.36310223266745006,80140117,1509,295
0,833,0.18172888015717092,0.3614457831325301,80140124,1018,185
1,556,0.2788586251621271,0.5627802690582959,80141442,771,215
0,397,0.160676532769556,0.25,80141499,473,76
0,18679,0.2214163644700096,0.47809698451507743,69638716,23991,5312
1,680,0.33980582524271846,0.807563025210084,80107650,1030,350
0,681,0.1684981684981685,0.2921615201900237,67428403,819,138
2,1157,0.5116082735331363,0.923633969716919,68282403,2369,1212
1,2253,0.3421897810218978,0.7651458489154824,80180315,3425,1172
0,23826,0.10192235205427817,0.13207756232686982,66203396,26530,2704
0,10358,0.07194695815787115,0.07948578671012131,66203403,11161,803
0,991,0.2209119496855346,0.42613065326633165,69475294,1272,281
1,689,0.31714568880079286,0.5300668151447662,80090024,1009,320
0,1033,0.16152597402597402,0.2599009900990099,66202213,1232,199
0,832,0.13423517169614985,0.19017763845350052,66405164,961,129
1,1050,0.23076923076923078,0.5444630872483222,66408580,1365,315
0,4935,0.08134772896500372,0.15228426395939088,67837945,5372,437
1,4883,0.4441661923733637,0.8931229532598988,80125004,8785,3902
1,607,0.36967808930425755,0.7523427041499331,80134978,963,356
1,22768,0.39395229982964225,0.8500377500943752,70690725,37568,14800
2,421,0.7426650366748166,0.9550898203592815,62482252,1636,1215
0,8940,0.17436276320650165,0.3125404705374487,65915962,10828,1888
0,3258,0.150013044612575,0.23676880222841226,68535292,3833,575
0,1197,0.16235129461161651,0.2688792688792689,67554585,1429,232
1,2557,0.45584166844009366,0.9189765458422174,70119994,4699,2142
1,549,0.33695652173913043,0.7373737373737373,67414620,828,279
1,1719,0.28135451505016723,0.5805168986083499,80127928,2392,673
1,15728,0.2959083176649655,0.675018819227874,70690732,22338,6610
2,826,0.7041547277936963,0.9810682893847193,80181548,2792,1966
1,18049,0.458313325330132,0.9262822999922402,67513061,33320,15271
0,1612,0.06658946149392009,0.06950067476383266,69167665,1727,115
1,2044,0.48500881834215165,0.8480463096960926,65547230,3969,1925
1,2268,0.2590656648154198,0.6263104497801826,68015472,3061,793
1,918,0.30349013657056145,0.7439812096300646,69587882,1318,400
1,719,0.49437412095639943,0.9048964218455744,73428985,1422,703
1,1150,0.27581863979848864,0.5757938885560215,70628803,1588,438
2,928,0.7604543107898812,0.955595026642984,62237056,3874,2946
2,86,0.6518218623481782,0.9037037037037037,79373301,247,161
0,300,0.21465968586387435,0.3955431754874652,69489273,382,82
0,1471,0.23465140478668053,0.45386969829470925,69586433,1922,451
0,429,0.17341040462427745,0.3081896551724138,67555873,519,90
0,725,0.10714285714285714,0.15134099616858238,73255056,812,87
0,62,0.17333333333333334,0.45454545454545453,82011818,75,13
0,307,0.05828220858895705,0.048,82011820,326,19
1,2241,0.44405854626643515,0.8933500627352572,80127260,4031,1790
0,1224,0.1690427698574338,0.3119143239625167,69601973,1473,249
0,1381,0.14170292106898694,0.2386780905752754,70281421,1609,228
0,1077,0.13215149073327961,0.21505376344086022,80118319,1241,164
0,1591,0.0380894800483676,0.03534031413612566,82007799,1654,63
0,1472,0.04539559014267185,0.041379310344827586,82007803,1542,70
0,87,0.1553398058252427,0.42777777777777776,82007809,103,16
1,19,0.4722222222222222,0.9215686274509803,72803094,36,17
1,11164,0.26499440384488776,0.5944348682590495,80125477,15189,4025
1,985,0.33803763440860213,0.7695051270619706,82019416,1488,503
0,258,0.1513157894736842,0.4917431192660551,70654773,304,46
1,6,0.25,0.7692307692307693,70694365,8,2
0,1,0.0,0.0,70704732,1,0
0,50,0.20634920634920634,0.48214285714285715,70535136,63,13
0,448,0.0743801652892562,0.19219653179190752,80124285,484,36
0,1634,0.11723392760669908,0.23096286972938956,80124412,1851,217
1,687,0.48921933085501856,0.9489389920424404,70925652,1345,658
1,2974,0.27481102170202387,0.5907417148869016,72999080,4101,1127
0,3,0.0,0.0,75124364,3,0
0,963,0.1804255319148936,0.2838801711840228,69489350,1175,212
2,38,0.867595818815331,0.98,74092235,287,249
2,55,0.8651960784313726,0.9894736842105263,72457091,408,353
2,29,0.5538461538461539,0.9917355371900827,54909323,65,36
0,1481,0.13086854460093897,0.16375,80140093,1704,223
0,2556,0.12555593568251797,0.18800292611558156,80140121,2923,367
0,1480,0.12374185908821789,0.13917525773195877,80141461,1689,209
2,8,0.75,0.9333333333333333,69667213,32,24
2,13,0.7291666666666666,0.9047619047619048,80128790,48,35
0,293,0.2506393861892583,0.4904632152588556,80051916,391,98
1,333,0.4168126094570928,0.838495575221239,80135407,571,238
2,323,0.5463483146067416,0.8703703703703703,80018582,712,389
1,359,0.38632478632478634,0.6799065420560748,80174470,585,226
2,14,0.8426966292134831,0.95,69424061,89,75
1,513,0.4020979020979021,0.8437843784378438,72322152,858,345
1,274,0.4897579143389199,0.8809034907597536,79682484,537,263
2,389,0.5290556900726392,0.9125364431486881,79682491,826,437
2,51,0.6194029850746269,0.96875,69226493,134,83
2,50,0.5495495495495496,0.9081632653061225,80128756,111,61
1,2404,0.3045993636100665,0.6683976261127597,80130372,3457,1053
2,1054,0.5411406181976491,0.9572773352643013,80181481,2297,1243
2,154,0.631578947368421,0.9698275862068966,67588045,418,264
1,1544,0.37082314588427057,0.6388235294117647,80176074,2454,910
0,415,0.15306122448979592,0.16551724137931034,80178940,490,75
1,3761,0.27714779934653083,0.5109402720283855,80176746,5203,1442
0,3201,0.18962025316455697,0.27879213483146065,80176748,3950,749
1,198,0.3944954128440367,0.7368421052631579,80180281,327,129
0,247,0.13937282229965156,0.2823741007194245,68120115,287,40
0,263,0.08996539792387544,0.20064205457463885,68120346,289,26
1,429,0.22980251346499103,0.645748987854251,73366300,557,128
1,10239,0.40633153591929033,0.8592925026399155,80119131,17247,7008
1,1238,0.3667519181585678,0.8331616889804325,80125277,1955,717
0,1440,0.1859807801017524,0.4693548387096774,73194954,1769,329
1,1075,0.4804253262445626,0.9496221662468514,82018892,2069,994
0,3655,0.04369440083725798,0.017740174672489083,69601063,3822,167
0,3137,0.11208604585338239,0.133617247804099,69094396,3533,396
1,3990,0.3955461293743372,0.8666383520917392,67706114,6601,2611
0,1036,0.2187028657616893,0.4908350305498982,68543503,1326,290
0,3854,0.07110147023379128,0.05647130647130647,69600944,4149,295
0,1105,0.22073342736248236,0.37322515212981744,70644532,1418,313
1,4184,0.4347473655768711,0.9149006622516557,67638725,7402,3218
0,607,0.02254428341384863,0.020608439646712464,60028696,621,14
0,1205,0.0504334121355398,0.08665749656121045,60028773,1269,64
0,387,0.08293838862559241,0.15485996705107083,60312840,422,35
0,579,0.047697368421052634,0.09321058688147296,60509533,608,29
0,267,0.07931034482758621,0.2962328767123288,60541761,290,23
0,2124,0.20300187617260787,0.48487972508591065,62514676,2665,541
0,707,0.08062418725617686,0.1650339110776187,63773654,769,62
0,397,0.08944954128440367,0.29707112970711297,65509892,436,39
0,258,0.08833922261484099,0.2106537530266344,66349962,283,25
0,840,0.14979757085020243,0.3779481132075472,67225942,988,148
2,838,0.5352190793122573,0.9610545236668664,69588876,1803,965
1,891,0.46422128683102826,0.9226841721371262,65444694,1663,772
1,1087,0.332719459791283,0.688135593220339,79787435,1629,542
0,4963,0.15666949872557348,0.2970559047304003,70841484,5885,922
1,379,0.37766830870279144,0.8583815028901735,65290491,609,230
1,387,0.3962558502340094,0.8874643874643875,65290512,641,254
1,654,0.45271966527196655,0.9464131374243734,65290526,1195,541
1,416,0.38095238095238093,0.8554033485540334,65355703,672,256
0,713,0.2233115468409586,0.46875,66930822,918,205
1,306,0.27315914489311166,0.6506666666666666,66930766,421,115
1,451,0.3611898016997167,0.8359469240048251,65268301,706,255
1,1117,0.2727864583333333,0.5897435897435898,80107566,1536,419
1,1250,0.26857811585722646,0.6321564885496184,80109764,1709,459
1,1141,0.28909657320872273,0.6524943310657596,80110842,1605,464
1,625,0.27409988385598144,0.6295566502463055,80111976,861,236
1,877,0.2703826955074875,0.669971671388102,80111983,1202,325
1,335,0.38191881918819187,0.7874564459930313,68579343,542,207
1,230,0.42786069651741293,0.8128654970760234,68579350,402,172
1,584,0.3333333333333333,0.6983240223463687,74326840,876,292
1,211,0.25704225352112675,0.5583756345177665,63681555,284,73
1,3796,0.4035197988686361,0.8654777630999559,72512160,6364,2568
1,38671,0.3867294669901835,0.8369462212745795,72474514,63057,24386
2,450,0.5081967213114754,0.9639953542392566,73016335,915,465
1,1198,0.3134670487106017,0.7610273590173088,70631904,1745,547
1,4035,0.23230593607305935,0.5000918948722661,80130757,5256,1221
1,428,0.2504378283712785,0.5740740740740741,80121271,571,143
0,2020,0.09090909090909091,0.07011980267794221,68539051,2222,202
0,982,0.2144,0.4599686028257457,68541802,1250,268
2,1227,0.6280691118520764,0.9787590832867524,68615372,3299,2072
1,1105,0.36784897025171626,0.8177083333333334,69550530,1748,643
0,2567,0.08288674526616649,0.2447833065810594,62835290,2799,232
0,6050,0.22276464542651592,0.44446529080675423,66409154,7784,1734
1,3228,0.2538141470180305,0.5556930693069307,67246466,4326,1098
0,4847,0.15143557422969187,0.18354831888348488,67554606,5712,865
0,441,0.23170731707317074,0.48982785602503914,67815762,574,133
1,229,0.4771689497716895,0.9312796208530806,69617541,438,209
1,1597,0.3744614179396788,0.8457841852337266,69668795,2553,956
1,260,0.453781512605042,0.9030303030303031,73321521,476,216
0,5636,0.2316291751874574,0.47857393747804705,80125464,7335,1699
1,6869,0.25506994902938945,0.5670229007633588,80125476,9221,2352
1,3698,0.24898456539398864,0.5541954150901403,66409840,4924,1226
0,661,0.20743405275779375,0.3264840182648402,67553304,834,173
0,345,0.13316582914572864,0.10398230088495575,67553346,398,53
0,972,0.1251125112511251,0.13404825737265416,67554900,1111,139
1,4153,0.30633038249540673,0.7282850779510023,67626944,5987,1834
0,3140,0.14160743575724438,0.17714613838644847,82107799,3658,518
0,1856,0.1306791569086651,0.1438994730441832,82107800,2135,279
0,1655,0.1411520498183705,0.19116360454943132,82107801,1927,272
0,3592,0.20266370699223085,0.3733381243262666,80180382,4505,913
1,2765,0.36972874401641215,0.7979060913705583,70676900,4387,1622
1,386,0.289134438305709,0.569954128440367,73049564,543,157
0,257,0.17891373801916932,0.3233644859813084,67160023,313,56
1,2287,0.27900378310214374,0.659236641221374,69531581,3172,885
0,3929,0.18671082591595942,0.3201939291736931,67154563,4831,902
1,1537,0.2589199614271938,0.5972064930162325,67246396,2074,537
1,7966,0.24147781374976196,0.5201938610662359,66409245,10502,2536
0,3804,0.1981450252951096,0.34859876965140124,70870905,4744,940
0,1053,0.24190064794816415,0.47881087919038584,74320260,1389,336
0,1020,0.0941385435168739,0.08300132802124834,69622210,1126,106
1,233,0.24838709677419354,0.5614457831325301,68533850,310,77
0,159,0.17616580310880828,0.3159509202453988,68533871,193,34
1,1045,0.3037974683544304,0.7510224948875256,69608105,1501,456
0,5403,0.1838368580060423,0.286477925163334,70871164,6620,1217
0,3147,0.12704576976421636,0.2167909417288042,70219604,3605,458
0,24737,0.10454298642533937,0.1542652817980589,70219730,27625,2888
1,2285,0.34602175157412707,0.8043193717277487,70748440,3494,1209
0,1158,0.21224489795918366,0.4279091330551692,70539784,1470,312
0,1836,0.19367588932806323,0.3595397890699904,70539805,2277,441
1,5516,0.23938223938223938,0.5116830342025059,80130318,7252,1736
0,2036,0.20530835284933646,0.396541443053071,82000096,2562,526
0,116,0.008547008547008548,0.013574660633484163,69508845,117,1
0,195,0.04411764705882353,0.04028436018957346,69508901,204,9
0,247,0.05363984674329502,0.04435483870967742,69508971,261,14
1,1440,0.22870915907873593,0.5067969413763806,67246095,1867,427
0,1368,0.08617234468937876,0.1427038626609442,81965824,1497,129
1,1842,0.26142742582197276,0.5885714285714285,65940616,2494,652
0,995,0.15102389078498293,0.32587228439763,74026204,1172,177
1,1152,0.2610647851186658,0.6479679450486548,68312300,1559,407
1,1842,0.30068337129840544,0.6969298245614035,80181378,2634,792
1,751,0.25347912524850896,0.5391969407265774,80181381,1006,255
1,5707,0.3979322713366389,0.8925678055653399,69072794,9479,3772
1,2366,0.47398843930635837,0.9580378250591016,68531015,4498,2132
0,1463,0.21973333333333334,0.4652567975830816,68543713,1875,412
1,2565,0.2395493625852357,0.5143259746359793,80137637,3373,808
0,677,0.1473551637279597,0.2795869737887212,70614796,794,117
0,2260,0.1954432182271271,0.3598848368522073,67555131,2809,549
1,1281,0.2543655413271246,0.6181613085166384,80112193,1718,437
1,420,0.3850658857979502,0.8648339060710195,68534760,683,263
0,5602,0.19442047742306587,0.3465599455040872,69652681,6954,1352
1,2280,0.4957983193277311,0.9532467532467532,68040245,4522,2242
1,1334,0.307012987012987,0.6703721604639923,67994654,1925,591
1,3204,0.24380457871135236,0.5033517350157729,68563502,4237,1033
0,1085,0.23537702607470048,0.4885912698412698,70599326,1419,334
0,1025,0.1401006711409396,0.242600679281902,67268635,1192,167
0,5290,0.08808826064471643,0.09404659188955997,70500045,5801,511
0,628,0.2169576059850374,0.4797047970479705,80097514,802,174
0,953,0.06385068762278978,0.2182468694096601,62839665,1018,65
0,360,0.05013192612137203,0.20392491467576793,62840246,379,19
0,2908,0.06555269922879177,0.19334215167548502,68130930,3112,204
0,5184,0.21561507035860192,0.40598073998986317,69602925,6609,1425
0,311,0.051829268292682924,0.23023715415019763,80128643,328,17
1,393,0.23689320388349513,0.5170399221032133,68236056,515,122
1,795,0.35365853658536583,0.8079937304075235,69165194,1230,435
1,191,0.25390625,0.5246913580246914,73709230,256,65
0,1884,0.18687958567112645,0.3424212917883804,67556195,2317,433
1,150,0.23076923076923078,0.5350140056022409,67428284,195,45
0,2435,0.20632333767926989,0.39661106698437915,67428333,3068,633
1,806,0.3027681660899654,0.7329059829059829,80124670,1156,350
0,809,0.19821605550049554,0.38190184049079756,80125483,1009,200
1,1311,0.29326145552560645,0.7385586533403472,80125486,1855,544
0,1853,0.16191768430574402,0.1976682564917859,70644854,2211,358
0,1536,0.07913669064748201,0.05518617021276596,70644861,1668,132
0,491,0.1857379767827529,0.3698630136986301,80117906,603,112
0,405,0.14736842105263157,0.28194993412384717,70617666,475,70
0,3799,0.14820627802690584,0.2730128809299403,63109466,4460,661
0,1931,0.05574572127139364,0.0638646288209607,66345531,2045,114
0,664,0.10991957104557641,0.14333333333333334,72762704,746,82
0,774,0.2093973442288049,0.4759188846641318,81979695,979,205
0,712,0.13592233009708737,0.22821576763485477,82039208,824,112
0,143,0.1488095238095238,0.3166023166023166,66657185,168,25
0,1486,0.15664018161180476,0.23738626964433415,68151342,1762,276
0,1671,0.16198595787362086,0.2364784840110541,68161394,1994,323
0,1394,0.22598556357579122,0.40336134453781514,69073424,1801,407
1,5539,0.40568669527896994,0.8789769182782283,64239014,9320,3781
1,2611,0.276330376940133,0.5766746004760286,74942980,3608,997
1,1920,0.3812439574605221,0.8821818181818182,80125273,3103,1183
1,1554,0.300944669365722,0.727468736524364,73816204,2223,669
0,148,0.032679738562091505,0.05263157894736842,70001071,153,5
0,954,0.05731225296442688,0.11935953420669577,70001323,1012,58
0,435,0.046052631578947366,0.08119079837618404,70001715,456,21
0,359,0.11576354679802955,0.3788732394366197,60541586,406,47
1,338,0.24721603563474387,0.5512265512265512,75765032,449,111
1,2328,0.280370942812983,0.6753284671532847,76116642,3235,907
0,7923,0.06799200094106576,0.11059992638940007,67837014,8501,578
0,279,0.05102040816326531,0.13665594855305466,70001274,294,15
1,343,0.25272331154684097,0.5041186161449753,67995571,459,116
0,1628,0.16341212744090441,0.2767795438838977,54578846,1946,318
1,3809,0.35582614578048366,0.8009082217973231,70673526,5913,2104
1,4787,0.34612757819969947,0.8047232992597815,70729554,7321,2534
0,2154,0.23779193205944799,0.4991137894363701,70215880,2826,672
0,723,0.2316684378320935,0.46907993966817496,63278530,941,218
0,161,0.15706806282722513,0.32463768115942027,82129398,191,30
2,1864,0.5787570621468927,0.9739747634069401,81995501,4425,2561
1,649,0.32466181061394384,0.7723642172523961,68956244,961,312
0,2852,0.21324137931034481,0.4895995032598572,70690795,3625,773
1,1184,0.2927120669056153,0.6663361427863164,65766414,1674,490
1,7390,0.2800077942322681,0.632280701754386,67439155,10264,2874
1,499,0.32476319350473615,0.7532051282051282,69608210,739,240
0,9198,0.19794209975584234,0.38435007544729466,65916004,11468,2270
0,2397,0.07878554957724827,0.06221279604100389,68539744,2602,205
1,1104,0.23333333333333334,0.5376737381126554,68540682,1440,336
0,6730,0.20552473143666627,0.36878634402551114,70601601,8471,1741
1,1201,0.24560301507537688,0.5324118207816969,74990223,1592,391
1,628,0.4412811387900356,0.9041850220264317,65000600,1124,496
1,1497,0.3186162949476559,0.7488708220415538,68112576,2197,700
0,1542,0.15041322314049588,0.2907290729072907,70398874,1815,273
0,2315,0.14544112218530822,0.2963488124778447,81965660,2709,394
0,248,0.16216216216216217,0.18345323741007194,69155835,296,48
0,5130,0.21258633921719108,0.3781763826606876,68480636,6515,1385
0,2102,0.13032685146876294,0.137624466571835,68530595,2417,315
1,1823,0.37504285224545764,0.8531881804043546,70661024,2917,1094
0,782,0.2077001013171226,0.45867460908414,68540493,987,205
1,688,0.2570194384449244,0.5760188087774295,80109953,926,238
1,494,0.2972972972972973,0.6538060479666319,69056491,703,209
0,750,0.16851441241685144,0.25182186234817816,70646044,902,152
0,871,0.05735930735930736,0.0305532617671346,70646086,924,53
2,317,0.5182370820668692,0.8381294964028777,66280991,658,341
1,4345,0.23463096706006695,0.5322419644639649,80135434,5677,1332
0,1947,0.18261964735516373,0.29225780299959464,67556972,2382,435
0,708,0.21158129175946547,0.47298494242692646,68538162,898,190
0,11982,0.15661293728443726,0.3581539193529202,70700973,14207,2225
1,941,0.39602053915276,0.8873473917869035,77095676,1558,617
1,551,0.27212681638044917,0.6101949025487257,79145486,757,206
1,1948,0.3819796954314721,0.8481640754217664,70627032,3152,1204
1,4054,0.3634793531166588,0.8306826523122094,80110814,6369,2315
1,397,0.2807971014492754,0.7096296296296296,68539121,552,155
0,4748,0.22696190166069685,0.47412982126058323,70841505,6142,1394
0,2548,0.23299217338952438,0.44273194318525233,67552625,3322,774
1,642,0.398876404494382,0.859392575928009,80124976,1068,426
0,187,0.17256637168141592,0.33195020746887965,68538491,226,39
2,2268,0.5114174924601465,0.9675405742821473,69657392,4642,2374
2,381,0.5342298288508558,0.9615384615384616,82059911,818,437
1,1549,0.2727699530516432,0.6404136833731106,75892964,2130,581
0,1608,0.10117384013415316,0.10509407985314365,66423413,1789,181
0,64,0.2,0.40804597701149425,67553136,80,16
1,478,0.32390381895332393,0.7666277712952159,69606936,707,229
1,591,0.38308977035490605,0.8996101364522417,69607006,958,367
0,429,0.16536964980544747,0.2598984771573604,70207900,514,85
0,2632,0.1705011030570438,0.250945434900054,68535733,3173,541
1,613,0.3002283105022831,0.7473884140550807,80125442,876,263
1,577,0.27875,0.7062937062937062,80121123,800,223
1,2892,0.3858568698237418,0.8330152671755725,80153453,4709,1817
1,2144,0.2759202971968929,0.6432160804020101,70686903,2961,817
0,255,0.2006269592476489,0.27964601769911507,69499150,319,64
0,1319,0.1688720856962823,0.2912898619704902,63264593,1587,268
1,3470,0.33140655105973027,0.7668405041286397,80125458,5190,1720
1,3576,0.2877912766381199,0.6519230769230769,69092233,5021,1445
0,3482,0.23824108510172828,0.45526663728514766,69617954,4571,1089
0,2648,0.15507338864071474,0.21979665071770335,68544063,3134,486
0,1926,0.13086642599277978,0.14629888268156424,70207613,2216,290
1,1724,0.23817940786566505,0.5019565990750623,80121043,2263,539
1,481,0.26564885496183205,0.6190900981266726,68236413,655,174
1,207,0.2837370242214533,0.6003016591251885,79989700,289,82
0,893,0.13803088803088803,0.19371428571428573,70545881,1036,143
1,375,0.44933920704845814,0.9305389221556887,70612353,681,306
1,1831,0.27370091233637445,0.6178538673188627,70599312,2521,690
0,483,0.06395348837209303,0.04961832061068702,80119326,516,33
0,476,0.10694183864915573,0.1539961013645224,80119349,533,57
1,2298,0.407426508509541,0.8805803571428571,80180322,3878,1580
1,1825,0.3594243594243594,0.8572621035058431,506170,2849,1024
0,1440,0.23444976076555024,0.4639293937068304,64982652,1881,441
0,3476,0.14130434782608695,0.16883423977299597,70207410,4048,572
0,2081,0.1672669067627051,0.3248730964467005,69383615,2499,418
0,183,0.0663265306122449,0.21904761904761905,60029235,196,13
0,179,0.09595959595959595,0.37597911227154046,60070346,198,19
0,4835,0.04935116004718836,0.06355828220858896,67837882,5086,251
2,175,0.5138888888888888,0.9573770491803278,69978461,360,185
0,1209,0.03588516746411483,0.009854771784232365,70072030,1254,45
0,732,0.07924528301886792,0.08917197452229299,82045256,795,63
0,738,0.20559741657696448,0.3956043956043956,69130306,929,191
0,682,0.11428571428571428,0.17753623188405798,72900352,770,88
0,1819,0.1743077621425329,0.3089567259308957,82011770,2203,384
0,6269,0.15111712931618146,0.21404044257916827,80140116,7385,1116
1,1746,0.31015408929276966,0.7267736486486487,80125512,2531,785
1,1356,0.4776579352850539,0.9396984924623115,70830053,2596,1240
1,1752,0.27692942633099465,0.6397644613785937,66681692,2423,671
1,1318,0.2848616386326641,0.613588110403397,80180467,1843,525
1,1868,0.2551834130781499,0.5693587335658706,68563425,2508,640
0,2841,0.1875893623105519,0.3370754173862982,66404625,3497,656
0,2667,0.16812227074235808,0.2556818181818182,67556524,3206,539
0,782,0.12527964205816555,0.15243516761543327,69240304,894,112
1,810,0.32556203164029973,0.7572168763878608,80109274,1201,391
1,2539,0.3704438383337466,0.8276843467011643,81965580,4033,1494
1,2098,0.290736984448952,0.6824417009602195,70690746,2958,860
1,5381,0.30746460746460746,0.6619385342789598,70857262,7770,2389
1,504,0.27586206896551724,0.5974534769833496,80180150,696,192
1,755,0.233502538071066,0.5520833333333334,68642070,985,230
0,3372,0.09597855227882038,0.224016671008075,69575296,3730,358
0,893,0.16385767790262173,0.29365853658536584,70516670,1068,175
0,1537,0.16693766937669377,0.33422562141491396,80098522,1845,308
0,801,0.18098159509202455,0.27185185185185184,69635230,978,177
1,2254,0.40543392244790294,0.862378459237098,80153460,3791,1537
0,449,0.21228070175438596,0.49578820697954273,68538036,570,121
0,804,0.09966405375139978,0.1268323773103888,70641704,893,89
0,1054,0.07624890446976336,0.09153175591531756,70642614,1141,87
0,9308,0.12080853877396808,0.19368785127539992,70219590,10587,1279
0,1720,0.12955465587044535,0.25884732052578363,82028897,1976,256
1,196,0.23137254901960785,0.6340996168582376,70617995,255,59
1,3620,0.2970873786407767,0.7104954214604368,65007152,5150,1530
1,1951,0.38609188168659536,0.8800959232613909,67552576,3178,1227
1,1518,0.34765792866351525,0.8313953488372093,68532716,2327,809
0,804,0.21176470588235294,0.4284943335132218,70042336,1020,216
1,2221,0.28470209339774555,0.6321495327102804,67597971,3105,884
1,614,0.35368421052631577,0.8282265552460538,69073480,950,336
1,1726,0.2563550193881947,0.57209136331192,70614586,2321,595
1,981,0.41537544696066747,0.8996138996138996,63445676,1678,697
0,3984,0.15611099343359458,0.3305561341387211,64929151,4721,737
0,924,0.1830238726790451,0.33421750663129973,66833060,1131,207
0,1608,0.22168441432720232,0.4639546858908342,70605024,2066,458
0,2282,0.21634615384615385,0.4250691973111902,70605031,2912,630
1,1234,0.29202524383247275,0.608355091383812,80124971,1743,509
1,407,0.24489795918367346,0.5402124430955993,62657511,539,132
1,793,0.2836495031616983,0.6870026525198939,62657574,1107,314
1,543,0.2691790040376851,0.6374549819927972,62657812,743,200
0,975,0.1514360313315927,0.2308117062396466,63279062,1149,174
1,983,0.3477106834771068,0.8026936026936027,75892936,1507,524
1,1310,0.21697549312612074,0.518210197710718,67299666,1673,363
1,2401,0.3851472471190781,0.8899167437557817,68532135,3905,1504
1,3263,0.39461966604823745,0.8990575396825397,68532443,5390,2127
0,4922,0.18062260695854837,0.3235420240137221,69170080,6007,1085
1,2630,0.2661830357142857,0.5856212191717077,69704341,3584,954
0,10788,0.19534571492503916,0.3868520859671302,70178451,13407,2619
1,3279,0.38457207207207206,0.8071095571095571,73848691,5328,2049
1,1404,0.27253886010362693,0.6347013409183259,80122959,1930,526
0,154,0.08333333333333333,0.3707052441229656,80128670,168,14
0,697,0.21153846153846154,0.4192966636609558,68540640,884,187
1,2084,0.2421818181818182,0.5239313116550969,68543664,2750,666
2,675,0.5133381398702235,0.9545049063336307,64857191,1387,712
1,690,0.22991071428571427,0.5658217497955846,68537882,896,206
0,1736,0.14650934119960668,0.22808349146110057,80119294,2034,298
1,620,0.30101465614430667,0.6808988764044944,68212046,887,267
1,1644,0.22853120600656968,0.5164526484751204,80121142,2131,487
1,1566,0.2420135527589545,0.5756198347107438,80121151,2066,500
1,2268,0.2905849233656553,0.7121698346087386,70487900,3197,929
0,1187,0.2185648452929559,0.3437094682230869,70641305,1519,332
1,122,0.44545454545454544,0.9294605809128631,70701134,220,98
0,5456,0.21485105770614477,0.4581227989588118,73382421,6949,1493
0,2428,0.20783034257748775,0.45381740523224773,80140161,3065,637
0,413,0.16396761133603238,0.3127962085308057,60514062,494,81
0,1999,0.2320399538993469,0.45999195818254923,67706415,2603,604
0,6853,0.062003832466465916,0.051901458981105,67706506,7306,453
0,2310,0.2140183735964614,0.4590301003344482,68534844,2939,629
0,1691,0.20833333333333334,0.4444444444444444,68534851,2136,445
0,4121,0.20490063669689368,0.40072120802343925,74446183,5183,1062
1,366,0.3055028462998102,0.6947637292464879,54550916,527,161
1,1856,0.32582637123138397,0.7809485530546624,69652772,2753,897
1,4299,0.24711033274956218,0.5261680368959294,67168500,5710,1411
1,14,0.2631578947368421,0.574468085106383,80126970,19,5
0,1755,0.1702127659574468,0.278358497870693,67722004,2115,360
0,383,0.23552894211576847,0.44543429844098,69169562,501,118
0,5414,0.18155706727135298,0.3586744639376218,70219576,6615,1201
1,924,0.26198083067092653,0.6143601621308628,80117899,1252,328
2,568,0.538961038961039,0.9596577017114915,66259830,1232,664
0,717,0.20773480662983426,0.31390977443609025,70644686,905,188
1,557,0.2886334610472541,0.6772616136919315,80045623,783,226
0,323,0.2364066193853428,0.3971774193548387,81956115,423,100
1,18253,0.34745459745459745,0.8043511803733991,70072520,27972,9719
1,1216,0.20470896010464357,0.5031568722680914,73194961,1529,313
1,1576,0.3670682730923695,0.7625341841385597,79255421,2490,914
0,1994,0.13903281519861832,0.15807174887892378,70207501,2316,322
1,583,0.305952380952381,0.6949152542372882,70530810,840,257
1,447,0.38514442916093533,0.9156214367160775,67557630,727,280
2,2737,0.5507959954045626,0.9436232382261945,66280760,6093,3356
1,1381,0.2769633507853403,0.6346583296114336,68171306,1910,529
1,1443,0.23488865323435842,0.5156069364161849,80121066,1886,443
0,4169,0.22234657713113226,0.44630521247644966,80125455,5361,1192
1,20732,0.33031849602687513,0.7498282731144388,72748942,30958,10226
1,5412,0.3531731803513804,0.8134110787172012,68545631,8367,2955
1,759,0.3995253164556962,0.8800292611558157,80159808,1264,505
0,1198,0.20976253298153033,0.4080370942812983,67159323,1516,318
1,1808,0.2565789473684211,0.5820379965457686,70618450,2432,624
1,523,0.34869240348692404,0.8171334431630972,70618506,803,280
0,3886,0.2288152411192697,0.4760340162350213,68648832,5039,1153
0,2716,0.06473829201101929,0.1102257636122178,70001806,2904,188
1,1379,0.29606942317508933,0.7085875175973722,82116579,1959,580
1,2124,0.2731006160164271,0.6181818181818182,82116581,2922,798
1,3241,0.2693868349864743,0.5732142857142857,69078541,4436,1195
1,117,0.47767857142857145,0.9492957746478873,80127704,224,107
1,2191,0.4059110629067245,0.8895248998282771,73016363,3688,1497
0,1230,0.18704560475875742,0.49506903353057197,67364283,1513,283
2,1648,0.5878969742435609,0.9791586260131223,70830025,3999,2351
0,2036,0.1888446215139442,0.32632600258732214,80121010,2510,474
1,13539,0.24682910547396528,0.5155990016638935,80125462,17976,4437
1,2508,0.37673956262425445,0.8503937007874016,69600930,4024,1516
1,831,0.3057644110275689,0.7106508875739646,81967270,1197,366
1,1642,0.29648671808054844,0.6723356009070295,70229012,2334,692
2,217,0.5188470066518847,0.9875311720698254,69153105,451,234
2,51,0.5096153846153846,0.94,69256341,104,53
1,55,0.26666666666666666,0.5729166666666666,69467615,75,20
1,654,0.36007827788649704,0.7826784282277466,69998243,1022,368
1,3988,0.35133376707872477,0.7734877734877735,72748956,6148,2160
1,6803,0.37974106491611964,0.8456458935204292,72748963,10968,4165
0,1482,0.20663811563169165,0.3158307210031348,72749040,1868,386
0,1199,0.09097801364670205,0.061248527679623084,72749061,1319,120
1,1090,0.2999357739242132,0.684940138626339,80181374,1557,467
1,961,0.28176382660687593,0.6507580011229647,82140376,1338,377
0,3397,0.2283053157655611,0.4244296577946768,68751375,4402,1005
2,209,0.5777777777777777,0.9930875576036866,66632174,495,286
1,350,0.2708333333333333,0.6551204819277109,66423455,480,130
0,4906,0.05051287013741049,0.020087509944311854,68539065,5167,261
0,4399,0.0860170371909412,0.0660425101214575,68539765,4813,414
0,4227,0.07848266841072596,0.0651936715766503,69600923,4587,360
0,1689,0.12077043206663196,0.15921908893709327,70514822,1921,232
0,1383,0.23464305478693967,0.49412241588974465,63085953,1807,424
1,4166,0.29640263469008615,0.6776921631272317,67168556,5921,1755
0,1633,0.1655595298926929,0.2622618565058776,82107807,1957,324
0,1318,0.22516166960611406,0.4874161073825503,68535166,1701,383
0,1613,0.18658598083711547,0.3535853055457436,70545734,1983,370
1,2374,0.2670577338684779,0.6024382991376747,70545783,3239,865
1,1430,0.28713858424725824,0.6830902640914466,70545790,2006,576
0,3393,0.14705882352941177,0.20379260681709074,67555005,3978,585
2,1864,0.5443656807626497,0.8954732510288066,66280445,4091,2227
1,4134,0.4405196914332115,0.8920559514383742,80124827,7389,3255
0,969,0.1808960270498732,0.3361641896673744,68542943,1183,214
0,1891,0.18736570691877955,0.4036740461610928,81965592,2327,436
0,3480,0.12408759124087591,0.2315151515151515,82028896,3973,493
0,256,0.2706552706552707,0.4297994269340974,68383546,351,95
0,138,0.2620320855614973,0.45041322314049587,68383602,187,49
1,929,0.4867403314917127,0.9501133786848073,69626060,1810,881
1,4198,0.480895264003957,0.9428571428571428,80127846,8087,3889
1,2313,0.3109919571045576,0.7116898849182314,81999942,3357,1044
1,1378,0.37420526793823794,0.8502415458937198,69586265,2202,824
1,1146,0.2765151515151515,0.6341713699332991,80180162,1584,438
1,1441,0.3485533453887884,0.7995133819951338,80107636,2212,771
1,4248,0.3054283845650752,0.7315270935960592,64275680,6116,1868
0,4621,0.18009226401703335,0.29511093657961907,68544350,5636,1015
1,343,0.2559652928416486,0.5458937198067633,66892476,461,118
1,653,0.26297968397291194,0.5514705882352942,69165544,886,233
0,411,0.05517241379310345,0.06723891273247497,69509041,435,24
0,155,0.07738095238095238,0.10355987055016182,69509146,168,13
1,2395,0.3178581600683566,0.676410045286126,80118586,3511,1116
0,714,0.16686114352392065,0.4164859002169197,72866752,857,143
2,1019,0.6817613991255466,0.9967362924281984,64244215,3202,2183
1,2792,0.3885238720981165,0.7997758685095255,70576583,4566,1774
0,1272,0.15928618638466624,0.27283170591614014,80125276,1513,241
1,1136,0.3567383918459796,0.79957805907173,68434653,1766,630
0,4016,0.04380952380952381,0.021035058430717863,66404513,4200,184
0,4189,0.1881782945736434,0.3579920739762219,72748564,5160,971
1,40,0.3220338983050847,0.7837837837837838,73637802,59,19
0,2545,0.180090206185567,0.35373537353735374,73700473,3104,559
0,988,0.13409290096406662,0.21384928716904278,73700620,1141,153
0,4479,0.10150451354062187,0.13817619783616691,73808896,4985,506
0,7211,0.08767712550607287,0.09809203142536475,73808952,7904,693
0,283,0.17732558139534885,0.27978339350180503,68545365,344,61
0,771,0.13468013468013468,0.13616071428571427,70871094,891,120
1,317,0.2762557077625571,0.649079754601227,81967245,438,121
1,455,0.2673107890499195,0.5830815709969789,81967263,621,166
1,303,0.3355263157894737,0.8370044052863436,81967281,456,153
1,2200,0.2392807745504841,0.5213797035347777,68535040,2892,692
1,4811,0.24020846493998738,0.5158246510713583,69893432,6332,1521
2,1107,0.5863228699551569,0.977061376317421,77563451,2676,1569
1,724,0.3747841105354059,0.8222433460076045,74978680,1158,434
1,9345,0.33845391476709613,0.7864782276546982,66826025,14126,4781
1,1600,0.23444976076555024,0.5187353629976581,70841701,2090,490
0,1925,0.13249211356466878,0.24556462968177978,70841750,2219,294
0,1512,0.16510215350635007,0.34720908230842007,73195801,1811,299
0,332,0.19806763285024154,0.3640897755610973,73816155,414,82
1,542,0.4681059862610402,0.9523373052245646,73818185,1019,477
1,7379,0.2581682919473208,0.6543296089385475,80178118,9947,2568
0,3341,0.20866887730933206,0.4188135192625857,70669326,4222,881
0,4053,0.1894,0.33450413223140496,81989523,5000,947
1,1148,0.3543307086614173,0.8406296114117069,63378231,1778,630
2,5356,0.50389032975176,0.9596916653284085,80127851,10796,5440
1,100,0.24812030075187969,0.5966666666666667,70524412,133,33
0,727,0.11233211233211234,0.19801980198019803,73884251,819,92
0,250,0.1039426523297491,0.3921815889029004,69204821,279,29
0,280,0.08196721311475409,0.35537190082644626,69204912,305,25
1,1570,0.29848078641644327,0.7091775923718713,75892740,2238,668
1,2011,0.2899011299435028,0.6769832799715404,75892866,2832,821
1,3405,0.3086294416243655,0.72790813779331,75893006,4925,1520
0,1550,0.16351861845655694,0.2605877268798617,67554704,1853,303
1,777,0.4,0.9023689877961235,68532352,1295,518
1,1844,0.25585149313962874,0.5502549162418062,68544315,2478,634
1,1741,0.347695766204571,0.8314232902033272,69165691,2669,928
0,3389,0.23498871331828441,0.46173096976016686,69607671,4430,1041
1,971,0.3166783954961295,0.7091584158415841,70871024,1421,450
0,594,0.1863013698630137,0.37481371087928467,67160611,730,136
1,1228,0.2958715596330275,0.7049659201557936,80109323,1744,516
0,1465,0.11373260738052027,0.18909899888765294,80140153,1653,188
1,2269,0.28264306038570974,0.6467375682667433,69608112,3163,894
1,532,0.2849462365591398,0.7017001545595054,66883152,744,212
1,512,0.3191489361702128,0.775178026449644,68531484,752,240
0,764,0.20829015544041452,0.3923766816143498,68540444,965,201
1,951,0.2293354943273906,0.500709219858156,68540465,1234,283
0,1252,0.22428748451053285,0.4749232343909928,68543741,1614,362
1,1714,0.42942743009320905,0.901413982717989,70072555,3004,1290
0,4498,0.16316279069767442,0.31332855607309207,70841435,5375,877
1,2605,0.30865180467091297,0.6969987995198079,80137923,3768,1163
1,5383,0.3064038139415024,0.7204710144927536,72382275,7761,2378
0,2829,0.20174943566591422,0.39515498827819745,81978732,3544,715
0,912,0.16483516483516483,0.29228329809725156,81989095,1092,180
1,335,0.26373626373626374,0.5295315682281059,76756715,455,120
0,547,0.19558823529411765,0.4150731158605174,70215901,680,133
1,450,0.44987775061124696,0.9098837209302325,69170003,818,368
0,134,0.20238095238095238,0.40896358543417366,75327280,168,34
0,1277,0.21608348680171885,0.42593387720051523,76328882,1629,352
1,147,0.28292682926829266,0.7253731343283583,300090,205,58
1,445,0.31432973805855163,0.8073555166374781,68391946,649,204
1,690,0.26439232409381663,0.6071139854486661,80125353,938,248
1,561,0.29077117572692796,0.6792849631966351,80125355,791,230
0,496,0.20766773162939298,0.4450317124735729,68540605,626,130
0,4085,0.1437853699434081,0.20744186046511628,70615545,4771,686
1,1381,0.2486398258977149,0.5804997951659157,70627830,1838,457
0,252,0.21739130434782608,0.44416243654822335,70642005,322,70
1,809,0.3953662182361734,0.9079147640791476,80125384,1338,529
0,2696,0.2100791092880164,0.3334412431207511,70645071,3413,717
0,3262,0.13152289669861555,0.14248554913294798,70645176,3756,494
0,503,0.12216404886561955,0.18147590361445784,70073220,573,70
0,215,0.11885245901639344,0.2785571142284569,70633570,244,29
0,321,0.1618798955613577,0.3883495145631068,70633703,383,62
0,1111,0.2214435879467414,0.4789382573571841,68542103,1427,316
1,556,0.23415977961432508,0.5465711361310133,68542124,726,170
0,5703,0.1932380817654548,0.34831460674157305,70174986,7069,1366
1,188,0.250996015936255,0.545054945054945,74708711,251,63
2,14634,0.5246695033618085,0.9347966429954809,67271610,30787,16153
1,90,0.34782608695652173,0.7134146341463414,70822416,138,48
0,950,0.23263327948303716,0.41582830315224684,74320141,1238,288
1,115,0.3313953488372093,0.7905604719764012,82016320,172,57
0,3350,0.14014373716632444,0.16339410939691446,67554403,3896,546
0,4405,0.1844102943899278,0.2910344827586207,67556202,5401,996
1,2436,0.33040131940626716,0.780902348578492,80109001,3638,1202
1,3616,0.278963110667996,0.6316507503410641,68927656,5015,1399
1,3631,0.29344230395018484,0.6778846153846154,80119196,5139,1508
0,4457,0.12556405728860115,0.13894064413095555,67706513,5097,640
1,1847,0.3372802296376032,0.7334254143646409,67706793,2787,940
0,1818,0.2552232691519869,0.49473202015574896,67706800,2441,623
1,1254,0.2526817640047676,0.5171767645221736,67706814,1678,424
0,3892,0.11766039446837452,0.13724212812160694,70614705,4411,519
0,2103,0.11415332771693344,0.12838283828382838,70617092,2374,271
0,802,0.2206025267249757,0.47251389746757255,82011810,1029,227
2,13,0.6486486486486487,0.9166666666666666,69660703,37,24
1,793,0.3932670237184392,0.868013468013468,80119011,1307,514
1,106,0.4143646408839779,0.9103139013452914,69317990,181,75
0,2102,0.13104588673005374,0.14448979591836736,68539625,2419,317
0,474,0.21782178217821782,0.4971297359357061,68538022,606,132
1,4846,0.4083750457819558,0.860362350861688,70671090,8191,3345
0,3868,0.23798266351457842,0.49340706082518077,70178542,5076,1208
1,153,0.3076923076923077,0.6303030303030303,80125003,221,68
1,1348,0.27952966328166756,0.6264501160092807,65312450,1871,523
1,898,0.27522195318805487,0.6397228637413395,69165831,1239,341
1,470,0.44510035419126326,0.9408284023668639,65008636,847,377
1,2939,0.3207765195285417,0.7488440009734728,70642292,4327,1388
1,3713,0.41591945886424414,0.8691099476439791,68401361,6357,2644
1,1391,0.2863006670087224,0.6457819437592501,75892985,1949,558
0,3387,0.2115921787709497,0.42826754904277947,70642271,4296,909
1,2077,0.4137736381597516,0.8782258064516129,80153459,3543,1466
0,3597,0.1369961612284069,0.14877300613496933,63264446,4168,571
1,1369,0.27103301384451545,0.6281179138321995,67557602,1878,509
0,5135,0.06346890388473464,0.03434343434343434,68539296,5483,348
2,760,0.5835616438356165,0.987600291757841,68115565,1825,1065
2,253,0.863905325443787,0.9947916666666666,80118214,1859,1606
1,1235,0.3458686440677966,0.7603201347935973,73330642,1888,653
0,329,0.18564356435643564,0.4153846153846154,70627522,404,75
1,473,0.2432,0.5421348314606742,80172864,625,152
0,1652,0.16184677828513444,0.25996932515337423,72368912,1971,319
1,748,0.37037037037037035,0.8106936416184971,66812130,1188,440
1,2746,0.36169223616922364,0.8309153257715642,69668704,4302,1556
2,625,0.5124804992199687,0.9465530596436871,69967884,1282,657
0,3901,0.12690241718889883,0.1634637647603612,70615566,4468,567
1,784,0.2589792060491493,0.6208358570563295,70545776,1058,274
1,2593,0.24840579710144928,0.5429029671210907,65808442,3450,857
1,903,0.25556471558120364,0.5837676842889055,68173392,1213,310
0,2033,0.22904816078877513,0.4301536262951054,62510196,2637,604
1,958,0.32056737588652484,0.7532874139010645,68531456,1410,452
1,3168,0.24065196548418025,0.5399580963783298,70690802,4172,1004
0,3216,0.23355576739752146,0.4732412602503237,69585964,4196,980
1,327,0.36627906976744184,0.7287671232876712,80124983,516,189
1,659,0.39262672811059907,0.8017492711370262,70576604,1085,426
0,1208,0.19520319786808793,0.41017415215398717,82041093,1501,293
0,114,0.11627906976744186,0.2512690355329949,80135429,129,15
1,38,0.4647887323943662,0.9701492537313433,65293410,71,33
2,257,0.5123339658444023,0.9808795411089866,68532555,527,270
0,4124,0.21893939393939393,0.42140686061658705,68544364,5280,1156
1,1803,0.2449748743718593,0.5310277957336781,69836081,2388,585
0,2671,0.16374452097683156,0.27451487710219924,67291875,3194,523
0,1994,0.22981846272692158,0.45839064649243466,68544301,2589,595
0,808,0.18548387096774194,0.3771537970644544,69240213,992,184
0,8271,0.02968090098545284,0.01139713106700727,67706534,8524,253
1,467,0.41625,0.8827930174563591,70757036,800,333
1,1582,0.3073555166374781,0.7422608695652174,66387370,2284,702
1,136,0.26881720430107525,0.525096525096525,68531414,186,50
0,1021,0.09885260370697264,0.10106382978723404,68539520,1133,112
1,1430,0.24736842105263157,0.5831611570247934,80112305,1900,470
2,2098,0.5227479526842584,0.9620151939224311,70818965,4396,2298
0,2630,0.15051679586563307,0.19170075978959672,63278656,3096,466
0,1312,0.12649800266311584,0.14121589277166108,70207396,1502,190
1,3554,0.2935798052077122,0.6749165193478688,74946382,5031,1477
1,995,0.35094585779517284,0.7547068316299086,67655014,1533,538
0,1309,0.20425531914893616,0.39306885544915643,68543370,1645,336
2,168,0.5,0.927536231884058,80125418,336,168
1,1231,0.2690023752969121,0.559342665855143,80110786,1684,453
0,500,0.18433931484502447,0.36936936936936937,66931445,613,113
1,1096,0.2372999304105776,0.5086979441222984,70627676,1437,341
1,892,0.3175210405508799,0.7452093683463449,80111591,1307,415
1,667,0.24118316268486917,0.6152748037116346,80124668,879,212
2,941,0.572661217075386,0.9643861293345829,80141439,2202,1261
1,4017,0.2581717451523546,0.5630442354580285,80137636,5415,1398
1,1246,0.2884066247858367,0.737406216505895,80121172,1751,505
1,554,0.3505275498241501,0.7470270270270271,67994213,853,299
1,2263,0.3346074683916495,0.7606198236708522,67070731,3401,1138
2,1992,0.6533240515140968,0.990990990990991,67400634,5746,3754
0,2606,0.15169270833333334,0.291849935316947,70841764,3072,466
1,6397,0.41903550994460087,0.8939993908010966,74091486,11011,4614
0,2385,0.2133905013192612,0.4610980127989222,73816071,3032,647
1,1343,0.2484611080022384,0.5657841140529531,80118150,1787,444
1,430,0.49352179034157834,0.929364278506559,73321486,849,419
1,366,0.23109243697478993,0.5090180360721442,67556510,476,110
0,2257,0.2013446567586695,0.44660921693518174,73195836,2826,569
0,1132,0.11354737666405638,0.17192812044681885,73255105,1277,145
0,1900,0.13202375513933304,0.22162468157373338,54411056,2189,289
0,3486,0.1898675342784104,0.41088788075178223,70690690,4303,817
0,2760,0.17290979922085706,0.3226221079691517,73808945,3337,577
0,2900,0.2004411359250069,0.42366224840451644,73816393,3627,727
0,2020,0.22753346080305928,0.4717236708432103,73818164,2615,595
0,2113,0.16548183254344392,0.22837370242214533,69608245,2532,419
0,1592,0.0765661252900232,0.06785558938668987,82012513,1724,132
0,2391,0.08073817762399077,0.07376502002670227,82012542,2601,210
0,3574,0.11818406118924253,0.10354223433242507,68543881,4053,479
1,1301,0.43752702118460873,0.8978370915784629,69164802,2313,1012
1,2522,0.48739837398373986,0.9526029526029526,69660031,4920,2398
0,1501,0.19560557341907825,0.32576712904581756,70207641,1866,365
0,1823,0.21793221793221793,0.4387755102040816,68542390,2331,508
0,1407,0.20642978003384094,0.426879271070615,68542460,1773,366
1,862,0.36005939123979214,0.8120171673819743,70670355,1347,485
0,5276,0.18517374517374519,0.3367949501119935,69601035,6475,1199
1,428,0.47868453105968334,0.9288135593220339,57173956,821,393
0,1112,0.2085409252669039,0.36163175303197354,68533094,1405,293
1,3363,0.332870462209879,0.7759481037924152,69167595,5041,1678
1,960,0.377431906614786,0.8444022770398482,69637120,1542,582
1,1849,0.2577278201525492,0.5463483146067416,73818451,2491,642
1,1086,0.23087818696883852,0.5085078534031413,80121304,1412,326
0,552,0.1182108626198083,0.20166793025018953,69551832,626,74
0,597,0.14835948644793154,0.2696551724137931,72785902,701,104
1,938,0.27003891050583656,0.6535914416709119,80098445,1285,347
0,3242,0.12896292315959162,0.2292894818492088,299831,3722,480
0,2105,0.1828416149068323,0.3260509764978484,65355101,2576,471
0,6071,0.028484557529204674,0.01694915254237288,70001085,6249,178
0,1605,0.1122787610619469,0.09242957746478873,70215922,1808,203
0,6608,0.11716766867067469,0.18282866998850134,81965815,7485,877
2,239,0.6662011173184358,0.8072916666666666,70713804,716,477
2,39,0.6694915254237288,0.725,70855533,118,79
2,106,0.6293706293706294,0.7264150943396226,70855575,286,180
1,326,0.46991869918699186,0.9309941520467836,66919174,615,289
1,181,0.4065573770491803,0.8626609442060086,71020215,305,124
1,1179,0.29443447037701975,0.7279370432827431,80121178,1671,492
1,1418,0.34804597701149426,0.769283276450512,80180342,2175,757
0,1638,0.136986301369863,0.23519790644422636,70841526,1898,260
1,3319,0.42388474223225137,0.9296835760924159,68532450,5761,2442
1,2762,0.4229001253656498,0.9262865090403338,68532464,4786,2024
0,5218,0.22443519619500593,0.45006760672203977,73818374,6728,1510
0,17198,0.18054033449278126,0.2900414496758423,80125478,20987,3789
1,1007,0.399880810488677,0.8890128276631344,67994283,1678,671
0,1057,0.18879508825786645,0.37209302325581395,70642824,1303,246
1,1587,0.2713498622589532,0.6259645937358148,80110345,2178,591
1,295,0.2942583732057416,0.7210084033613445,80121184,418,123
0,4082,0.2328509678631836,0.49207029575653666,70573580,5321,1239
1,3088,0.2845227062094532,0.5725271811190665,69164935,4316,1228
1,721,0.43495297805642635,0.8576449912126538,69118322,1276,555
0,6083,0.24845564615764765,0.49475465313028766,70634354,8094,2011
1,2931,0.4392577004017601,0.8526894865525673,80090052,5227,2296
1,1370,0.4764998089415361,0.9295774647887324,80137142,2617,1247
1,3922,0.2771839292296351,0.5819024257290815,67145736,5426,1504
0,2302,0.16835260115606937,0.21156716417910448,70645190,2768,466
0,4896,0.17283324885960466,0.26387497495491885,67555586,5919,1023
0,3530,0.1648923586467944,0.23958820776789894,67555593,4227,697
0,364,0.13947990543735225,0.27664670658682633,70627074,423,59
1,2393,0.3268635724331927,0.7326332794830371,69998180,3555,1162
1,1168,0.32329084588644263,0.7489736070381232,68541900,1726,558
0,2618,0.0689900426742532,0.04088586030664395,68539142,2812,194
0,1071,0.13138686131386862,0.15650030807147258,80125431,1233,162
0,1539,0.14309576837416482,0.22150814053127676,80125434,1796,257
0,1424,0.17064647641234712,0.34405719392314565,80125437,1717,293
0,2336,0.1745583038869258,0.30269568041571937,80125438,2830,494
2,1395,0.566231343283582,0.9779862865391555,67118135,3216,1821
1,1270,0.3041095890410959,0.626425855513308,72749012,1825,555
1,4465,0.25990386209182825,0.5500987166831195,72749033,6033,1568
0,3326,0.21240824058726024,0.3869128427912028,72749201,4223,897
1,452,0.2836767036450079,0.6592592592592592,67557966,631,179
1,3182,0.45588235294117646,0.9248234106962664,70072541,5848,2666
0,1909,0.09910335063709297,0.08853211009174312,66471426,2119,210
1,839,0.2804459691252144,0.6213592233009708,67557224,1166,327
0,1962,0.19820187985288107,0.3784148397976391,63278810,2447,485
1,847,0.367910447761194,0.7868442964196503,66695454,1340,493
1,1546,0.36561345917111204,0.8511156186612576,69072745,2437,891
0,1392,0.09256844850065189,0.21630094043887146,65464763,1534,142
0,1461,0.17504234895539245,0.4182041820418204,65714614,1771,310
0,11340,0.15906562847608455,0.28378378378378377,65915766,13485,2145
1,387,0.26704545454545453,0.5642105263157895,68239640,528,141
2,589,0.7651515151515151,0.9921171171171171,70520583,2508,1919
1,2561,0.33943770956925456,0.7203504043126685,66808966,3877,1316
1,3418,0.2785985647952723,0.6620498614958449,80125280,4738,1320
1,260,0.3564356435643564,0.8446215139442231,69177430,404,144
1,1041,0.2800829875518672,0.6894132653061225,67942546,1446,405
1,635,0.29911699779249445,0.7072111207645526,80112123,906,271
1,2498,0.3568486096807415,0.7715867158671587,70688205,3884,1386
0,1639,0.16420193778684344,0.27451682176091624,70841351,1961,322
0,3690,0.14957363447799032,0.27624084621643613,70841533,4339,649
1,4942,0.37474696356275305,0.8228932870842686,74130966,7904,2962
1,2268,0.25394736842105264,0.5748520710059172,67865406,3040,772
0,2572,0.07912638739706408,0.06545209176788123,70617750,2793,221
0,2154,0.06672443674176777,0.053391537944929485,70641893,2308,154
1,242,0.23417721518987342,0.5759312320916905,70760823,316,74
0,7041,0.021675698207586493,0.008756174225415357,67706555,7197,156
1,21,0.36363636363636365,0.855072463768116,70509705,33,12
1,16,0.23809523809523808,0.5121951219512195,70669522,21,5
0,4967,0.1795507102741989,0.26951581027667987,67706744,6054,1087
1,1021,0.23976172747580043,0.5139318885448917,69165110,1343,322
0,6113,0.10405979774292833,0.10129310344827586,69165453,6823,710
1,4335,0.325186799501868,0.6864661654135338,70756693,6424,2089
1,686,0.2809224318658281,0.6755417956656347,68763541,954,268
1,247,0.2560240963855422,0.5446880269814502,70835751,332,85
1,1355,0.3578199052132701,0.7636074692093763,80135361,2110,755
1,1533,0.3765758438389589,0.8622497616777883,80107545,2459,926
0,1043,0.1656,0.2798651252408478,68535432,1250,207
0,8775,0.19723721525935414,0.348669623059867,69652723,10931,2156
1,1527,0.35786375105130364,0.8411978221415608,67993261,2378,851
1,86,0.47560975609756095,0.8290155440414507,76213963,164,78
1,2294,0.303793626707132,0.6847635726795096,80168170,3295,1001
0,682,0.05931034482758621,0.05767012687427912,74326322,725,43
0,1153,0.1681096681096681,0.2591362126245847,74326350,1386,233
0,1232,0.20516129032258065,0.4,81979709,1550,318
0,1589,0.1331151118385161,0.19951534733441034,82036713,1833,244
1,648,0.24563445867287545,0.6187050359712231,67160541,859,211
1,658,0.3804143126177024,0.8579234972677595,80110051,1062,404
1,356,0.3087378640776699,0.6992366412213741,80136828,515,159
0,2466,0.1009843237331389,0.17457375833951075,299866,2743,277
0,1349,0.04326241134751773,0.05736250739207569,60028605,1410,61
0,440,0.07368421052631578,0.155893536121673,61716921,475,35
1,1597,0.24384469696969696,0.5240036231884058,67721962,2112,515
0,1197,0.17448275862068965,0.27948990435706694,67721983,1450,253
1,307,0.4900332225913621,0.960328317373461,68405603,602,295
0,5547,0.09451518119490696,0.16492648625612616,68481063,6126,579
0,2584,0.06512301013024602,0.04760319573901465,68743675,2764,180
0,975,0.17232597623089982,0.26105651105651106,68750451,1178,203
1,1456,0.3354632587859425,0.7570456754130224,69572944,2191,735
0,4681,0.1654483865216616,0.3222195181309321,81965593,5609,928
0,8606,0.1530361184922744,0.2676246070947463,81965650,10161,1555
0,5291,0.11120443473878716,0.1709767044240222,81965821,5953,662
0,1528,0.054455445544554455,0.10140056022408964,60027905,1616,88
0,908,0.06198347107438017,0.15066469719350073,64251180,968,60
0,1593,0.15490716180371353,0.28703347441323585,73266361,1885,292
0,602,0.2099737532808399,0.4546839299314547,63279671,762,160
0,1398,0.2025099828864803,0.4158644589911436,82011773,1753,355
1,251,0.25958702064896755,0.608540925266904,80172863,339,88
0,1803,0.2251826385904598,0.4906215520411916,80121025,2327,524
0,1985,0.05790223065970574,0.03633975481611208,80121263,2107,122
1,301,0.26405867970660146,0.5844444444444444,68289172,409,108
1,50,0.32432432432432434,0.6847826086956522,82096242,74,24
2,928,0.7131375579598145,0.8984198645598194,65949373,3235,2307
2,1225,0.6944375155899227,0.9065420560747663,69581792,4009,2784
2,949,0.7339500981216709,0.9295352323838081,65966026,3567,2618
1,1350,0.3697478991596639,0.7678062678062678,80130150,2142,792
2,7,0.8108108108108109,0.8,63242963,37,30
2,90,0.6551724137931034,0.675,68618326,261,171
2,177,0.7820197044334976,0.9701492537313433,68959674,812,635
1,956,0.2944649446494465,0.6270588235294118,70660541,1355,399
0,1424,0.14934289127837516,0.23982398239823982,67429306,1674,250
2,223,0.7617521367521367,0.9527896995708155,62237084,936,713
2,16,0.627906976744186,0.4166666666666667,69406715,43,27
2,8770,0.503509963768116,0.9537612146307799,67905705,17664,8894
2,44,0.7777777777777778,0.9333333333333333,73447612,198,154
2,21,0.8333333333333334,0.9722222222222222,63684502,126,105
2,1552,0.6749738219895288,0.9054593874833555,80089842,4775,3223
1,3300,0.45490584737363726,0.8852459016393442,80124831,6054,2754
0,1478,0.19455040871934604,0.30973451327433627,68760755,1835,357
1,12178,0.32144648130606784,0.6991374936580416,67271680,17947,5769
0,266,0.12211221122112212,0.3352272727272727,299201,303,37
1,374,0.3380530973451327,0.7071524966261808,72390766,565,191
2,826,0.5416204217536071,0.9785561115082202,82095518,1802,976
1,141,0.4125,0.6770186335403726,72433571,240,99
1,615,0.2704626334519573,0.5736894164193868,62022345,843,228
2,49,0.689873417721519,0.9882352941176471,80125415,158,109
2,765,0.5158227848101266,0.8598265895953757,70544194,1580,815
0,518,0.075,0.0784313725490196,70657692,560,42
0,580,0.07051282051282051,0.07523939808481532,80130297,624,44
1,103,0.2746478873239437,0.6578073089700996,68257035,142,39
0,15,0.11764705882352941,0.21428571428571427,72909613,17,2
1,32,0.3191489361702128,0.6666666666666666,82002227,47,15
2,38,0.5869565217391305,0.9602649006622517,82052050,92,54
1,857,0.42560321715817695,0.8525469168900804,67216233,1492,635
0,218,0.28052805280528054,0.43043478260869567,68995535,303,85
1,307,0.3670103092783505,0.8088050314465409,70925561,485,178
1,351,0.43295638126009695,0.8967032967032967,70925785,619,268
0,1965,0.2254631454473788,0.413265306122449,71971256,2537,572
1,294,0.3146853146853147,0.6600660066006601,80114720,429,135
1,213,0.3238095238095238,0.6446280991735537,80124132,315,102
1,15,0.4827586206896552,0.9154929577464789,81971183,29,14
2,615,0.7299077733860343,0.9498607242339833,70542605,2277,1662
1,1530,0.4403803950256035,0.7962529274004684,80176069,2734,1204
0,5147,0.0721110510185686,0.0515331100231899,54130293,5547,400
0,6586,0.16165987780040733,0.23937646807601964,60003230,7856,1270
0,6691,0.1604767879548306,0.23370834217788156,60003251,7970,1279
0,2106,0.04403086699954607,0.020525451559934318,68018174,2203,97
2,36,0.5662650602409639,0.9642857142857143,70925673,83,47
2,20,0.869281045751634,0.9117647058823529,80176020,153,133
1,860,0.48533812088569717,0.9613583138173302,67506110,1671,811
1,1238,0.3741152679474216,0.7604166666666666,70576611,1978,740
2,56,0.7037037037037037,0.9805825242718447,70277333,189,133
1,393,0.3482587064676617,0.5743243243243243,80128016,603,210
0,1139,0.22305593451568895,0.3882646691635456,68018335,1466,327
1,394,0.3562091503267974,0.8437935843793585,68531470,612,218
1,784,0.32413793103448274,0.7772096420745069,68535971,1160,376
2,470,0.6194331983805668,0.9493670886075949,80119151,1235,765
2,461,0.712234706616729,0.9682377049180327,80045553,1602,1141
0,1200,0.17751884852638794,0.3424428332403793,80122953,1459,259
0,596,0.04180064308681672,0.06989247311827956,80124225,622,26
0,1237,0.009607686148919135,0.0248403122782115,80124279,1249,12
0,85,0.0,0.0,80124384,85,0
0,3498,0.019893527598767162,0.0533837746952501,80124392,3569,71
0,1946,0.06621880998080615,0.13657407407407407,80126906,2084,138
1,1761,0.28530844155844154,0.6383219954648526,80180458,2464,703
2,642,0.7038745387453874,0.9664310954063604,16764335,2168,1526
1,183,0.24691358024691357,0.5748502994011976,77065100,243,60
0,1304,0.21493076459963878,0.44565217391304346,68535026,1661,357
0,4987,0.136001386001386,0.163373395803626,69652660,5772,785
1,1757,0.30989787902592303,0.7701056051990252,80121176,2546,789
1,2972,0.4878511114940548,0.9108567464446757,64966342,5803,2831
2,69,0.603448275862069,0.974025974025974,70283724,174,105
0,453,0.21080139372822299,0.4415929203539823,82036703,574,121
1,1317,0.40862146385271664,0.8804627249357326,80130621,2227,910
1,1292,0.29205479452054794,0.6484420928865373,67552590,1825,533
0,505,0.2529585798816568,0.49373695198329853,67553381,676,171
0,1214,0.09131736526946108,0.05431502715751358,67556531,1336,122
1,155,0.3231441048034934,0.7110481586402266,67626930,229,74
1,170,0.44805194805194803,0.9408033826638478,63470512,308,138
0,2865,0.19994414967886065,0.46934329287270465,69151621,3581,716
1,2602,0.3473789816904941,0.7942536327608983,80180318,3987,1385
1,1445,0.36511423550087874,0.8127226463104326,80180320,2276,831
1,452,0.3496402877697842,0.7666174298375185,70110334,695,243
1,1387,0.3302752293577982,0.7755632582322357,65984114,2071,684
0,3133,0.06700416914830257,0.066557911908646,70641221,3358,225
0,1279,0.15016611295681062,0.19461827284105132,70641242,1505,226
1,1096,0.27752142386288725,0.6936026936026936,69531616,1517,421
0,388,0.12612612612612611,0.20992028343666963,69551776,444,56
1,75,0.21875,0.5112107623318386,72758784,96,21
1,107,0.49047619047619045,0.9230769230769231,75278903,210,103
1,2534,0.3833049403747871,0.8664383561643836,82011673,4109,1575
1,1162,0.24789644012944984,0.5957178841309824,80145616,1545,383
0,3077,0.1889826041117554,0.35449402891263354,65291625,3794,717
1,452,0.28253968253968254,0.7082616179001722,81980452,630,178
1,1380,0.24092409240924093,0.618426103646833,67809931,1818,438
1,1298,0.2633371169125993,0.5833333333333334,69145223,1762,464
0,2864,0.07791371538956858,0.05948940269749518,70642096,3106,242
1,1583,0.2411313518696069,0.5390266299357208,80112165,2086,503
0,736,0.13615023474178403,0.18828451882845187,68539093,852,116
0,284,0.18155619596541786,0.3742690058479532,68539471,347,63
0,764,0.1492204899777283,0.16211878009630817,67653005,898,134
0,613,0.2506112469437653,0.4871541501976285,67653026,818,205
0,593,0.18319559228650137,0.2536873156342183,67653033,726,133
0,2546,0.15834710743801653,0.27688079697698387,73346784,3025,479
1,452,0.3791208791208791,0.889920424403183,80125382,728,276
0,4775,0.06170170956966005,0.03254741158380318,54138770,5089,314
0,5145,0.04775124930594114,0.0242098184263618,68018153,5403,258
0,848,0.17025440313111545,0.27291666666666664,68545491,1022,174
0,324,0.2019704433497537,0.36379613356766255,68545505,406,82
0,2982,0.20964749536178107,0.3815005954743946,62409340,3773,791
1,2045,0.29214260989961927,0.6814159292035398,80181372,2889,844
0,926,0.20515021459227467,0.45166015625,69074782,1165,239
1,1791,0.3776928422515636,0.8031430934656741,79787421,2878,1087
2,321,0.510670731707317,0.96,80137020,656,335
2,197,0.54292343387471,0.9443207126948775,80137983,431,234
0,2985,0.19083762537272975,0.32980132450331123,68645115,3689,704
1,108,0.4065934065934066,0.8755980861244019,70655200,182,74
2,8283,0.7759716549914802,0.9986760227724083,66899266,36973,28690
1,2279,0.2833333333333333,0.6933066933066933,80111745,3180,901
0,521,0.1094017094017094,0.18760195758564438,80119311,585,64
0,1382,0.06177868295994569,0.04289428076256499,80119312,1473,91
0,1558,0.1291224147568474,0.209284332688588,80119346,1789,231
0,1403,0.0977491961414791,0.1288981288981289,80119360,1555,152
0,305,0.11849710982658959,0.20628930817610064,82011821,346,41
0,2571,0.174373795761079,0.33702127659574466,66202164,3114,543
1,1494,0.26331360946745563,0.5992970123022847,66408566,2028,534
0,977,0.22089314194577353,0.49837662337662336,70627795,1254,277
1,744,0.3841059602649007,0.8879935535858179,70632254,1208,464
1,1150,0.45754716981132076,0.912647374062165,82110023,2120,970
2,3189,0.7487789506853632,0.9850359712230216,72633505,12694,9505
1,2529,0.32216563923881,0.7788065843621399,70626661,3731,1202
0,2655,0.16823308270676693,0.24663245670301476,67554963,3192,537
1,1814,0.4486322188449848,0.9122994652406418,80127847,3290,1476
1,931,0.24308943089430896,0.5494437577255872,80111703,1230,299
0,1108,0.22300140252454417,0.4810126582278481,63278705,1426,318
1,1011,0.4313835770528684,0.8583732057416268,80174917,1778,767
0,1902,0.24102154828411812,0.45108695652173914,73747821,2506,604
1,2821,0.40093438097260564,0.8526108927568782,74356044,4709,1888
1,4452,0.2567612687813022,0.5120053357047577,74554480,5990,1538
1,146,0.3302752293577982,0.636094674556213,81976029,218,72
0,283,0.12654320987654322,0.23717948717948717,81979714,324,41
0,727,0.11878787878787879,0.19030079803560468,81989100,825,98
1,622,0.3678861788617886,0.7807283763277694,72555644,984,362
1,201,0.38153846153846155,0.803030303030303,80161886,325,124
1,62,0.45132743362831856,0.9320987654320988,80161888,113,51
0,7773,0.12848974100235452,0.1454146876141761,67706422,8919,1146
0,407,0.20662768031189083,0.38954468802698144,67813571,513,106
0,1450,0.10988336402701043,0.1245674740484429,68614952,1629,179
0,6725,0.11267977305713155,0.13073780341264118,70499954,7579,854
0,1265,0.12758620689655173,0.16478190630048464,75427646,1450,185
0,699,0.18436406067677946,0.2878625134264232,80130625,857,158
0,641,0.14533333333333334,0.30723606168446027,74789295,750,109
0,1610,0.14133333333333334,0.20722635494155153,68543153,1875,265
1,200,0.32432432432432434,0.7957559681697612,75327315,296,96
1,263,0.2967914438502674,0.7509363295880149,75327322,374,111
1,233,0.29607250755287007,0.7127496159754224,70049343,331,98
0,2799,0.21088243586129124,0.4273789649415693,66100846,3547,748
0,1860,0.21651221566975568,0.4172821270310192,70197484,2374,514
1,1335,0.3807977736549165,0.8850478967097043,70207704,2156,821
0,1592,0.16474291710388247,0.2603580562659846,60074315,1906,314
0,393,0.041463414634146344,0.14583333333333334,64182762,410,17
0,1462,0.0524951393389501,0.17879256965944273,66389344,1543,81
0,2369,0.029098360655737704,0.022615906520919715,70001666,2440,71
2,358,0.5513784461152882,0.9721854304635762,80178126,798,440
0,2892,0.2068019747668678,0.4784727863525589,80118450,3646,754
1,197,0.32764505119453924,0.773784355179704,82128650,293,96
1,931,0.45682613768961494,0.9178779069767442,65690044,1714,783
1,913,0.41586692258477287,0.8668683812405447,70628852,1563,650
1,578,0.3556298773690078,0.840034965034965,81967246,897,319
1,2287,0.37066593285635663,0.8372234010306153,70626864,3634,1347
1,1875,0.43267776096822996,0.9116508271735304,63445774,3305,1430
1,235,0.2610062893081761,0.645320197044335,68317795,318,83
2,333,0.5222381635581061,0.9492957746478873,74776576,697,364
0,1627,0.04068396226415094,0.013181019332161687,66930493,1696,69
1,550,0.30025445292620867,0.7518181818181818,66931340,786,236
0,1201,0.20093147039254824,0.4193877551020408,68536601,1503,302
0,1192,0.18856364874063988,0.36995401124169647,68536615,1469,277
0,2617,0.17910915934755334,0.3197375926982316,68544455,3188,571
1,1972,0.24270353302611367,0.5148101793909053,68545211,2604,632
1,2110,0.24857549857549857,0.5255243371586862,68545274,2808,698
1,3773,0.38859180035650626,0.858316733067729,66695545,6171,2398
1,4318,0.307679974346641,0.6871046228710462,70676361,6237,1919
1,383,0.47891156462585033,0.9254032258064516,67426891,735,352
1,690,0.3698630136986301,0.8789759503491078,80120448,1095,405
0,767,0.22210953346855983,0.4031510658016682,67652186,986,219
1,818,0.32172470978441126,0.773067331670823,80135176,1206,388
1,1136,0.2805573147561748,0.6678269517652909,72522863,1579,443
1,258,0.26704545454545453,0.6175040518638574,72522891,352,94
1,738,0.3345356176735798,0.7991239048811014,82016323,1109,371
0,55,0.16666666666666666,0.14423076923076922,69630274,66,11
1,28,0.46153846153846156,0.90625,63385021,52,24
0,709,0.19796380090497737,0.41429562803608605,77676452,884,175
0,577,0.23066666666666666,0.4740810556079171,79520063,750,173
1,1048,0.36638452237001207,0.789838337182448,80141440,1654,606
0,697,0.11994949494949494,0.1436077057793345,68542873,792,95
0,2440,0.17372163901117507,0.3181996086105675,68543146,2953,513
0,2438,0.15464632454923716,0.2701872031293657,70841456,2884,446
0,3444,0.15670910871694418,0.2703287197231834,70841603,4084,640
1,2635,0.260662177328844,0.6073352141574763,80125279,3564,929
1,2420,0.3331496279966933,0.774604160198696,66826235,3629,1209
0,435,0.17142857142857143,0.4224137931034483,81965688,525,90
1,2531,0.3965188364329995,0.8899332929047907,69092170,4194,1663
0,6615,0.04060913705583756,0.04032586558044807,63426160,6895,280
0,5492,0.0811443868161285,0.14498886414253898,63426244,5977,485
0,4509,0.08316388775925172,0.1761038961038961,63426412,4918,409
0,3930,0.021170610211706103,0.011805741883552455,70001414,4015,85
0,2676,0.04870245289726271,0.068,70001673,2813,137
1,1101,0.2723066754791804,0.6507537688442211,70627466,1513,412
1,1182,0.3022432113341204,0.6779533483822423,80180463,1694,512
0,1052,0.17683881064162754,0.28604382929642447,68541970,1278,226
0,973,0.19051580698835274,0.34454756380510443,68541984,1202,229
1,4880,0.2909038070328393,0.6702365728900256,69586195,6882,2002
1,324,0.273542600896861,0.6643454038997214,72382380,446,122
0,728,0.19735391400220506,0.3727206418672502,67554473,907,179
0,1770,0.22774869109947643,0.4381730412179725,68462695,2292,522
0,3722,0.2271594684385382,0.47075575027382255,60020310,4816,1094
0,509,0.21932515337423314,0.46559139784946235,80112263,652,143
1,1104,0.23598615916955018,0.5545297172533179,80112284,1445,341
0,804,0.09865470852017937,0.0880597014925373,68539506,892,88
1,3215,0.3208702999577524,0.7229786051681022,67286660,4734,1519
0,1544,0.21783181357649442,0.48012718600953896,68173406,1974,430
1,1505,0.34479756203744016,0.7786157941437445,69739166,2297,792
1,7676,0.3328118209474142,0.7867059318468658,66765181,11505,3829
1,1899,0.2945765230312036,0.6942765730536793,69590556,2692,793
0,1316,0.04499274310595065,0.06292749658002736,60028192,1378,62
0,2533,0.11680613668061367,0.23126801152737753,81965654,2868,335
0,4923,0.06085463563525372,0.051362683438155136,63336756,5242,319
0,1336,0.06508047585724283,0.0622524052065648,63336826,1429,93
0,2242,0.1390168970814132,0.1836734693877551,80125432,2604,362
0,4783,0.15390058376083496,0.2190376569037657,80125433,5653,870
1,64,0.42342342342342343,0.8692307692307693,70781473,111,47
1,117,0.2994011976047904,0.5492227979274611,70781515,167,50
0,2476,0.16829022505878402,0.26142595978062155,66907015,2977,501
0,466,0.1708185053380783,0.23954372623574144,69389670,562,96
1,9889,0.3257193508795854,0.7215573179524153,70250600,14666,4777
1,465,0.4245049504950495,0.9130952380952381,82095532,808,343
0,848,0.10736842105263159,0.08625730994152046,73307262,950,102
0,1718,0.19944082013047532,0.42169540229885055,69944735,2146,428
0,1044,0.14426229508196722,0.24289642529789185,72368842,1220,176
0,1456,0.14201532115497936,0.2319932998324958,73255035,1697,241
0,1588,0.04624624624624624,0.023228346456692913,80114391,1665,77
0,1973,0.05643232902917265,0.035553892215568865,80118152,2091,118
0,940,0.19658119658119658,0.39229910714285715,81979712,1170,230
0,859,0.09004237288135593,0.11407605070046697,82011822,944,85
0,1636,0.17953861584754263,0.3950679416205335,60308171,1994,358
1,1034,0.29850746268656714,0.6872948898265354,68212165,1474,440
1,529,0.23884892086330936,0.6708407871198568,60509631,695,166
0,4146,0.04930061912405412,0.12287975876366378,62838006,4361,215
0,306,0.02857142857142857,0.059375,62838181,315,9
0,199,0.11160714285714286,0.4102209944751381,69204772,224,25
1,1194,0.2692778457772338,0.6510234648027958,68536762,1634,440
1,714,0.41379310344827586,0.8634868421052632,80174679,1218,504
2,86,0.5742574257425742,0.9519230769230769,68631430,202,116
2,115,0.603448275862069,0.9635627530364372,80083752,290,175
0,742,0.13317757009345793,0.18402505873140174,68536902,856,114
0,4996,0.18658417453598178,0.3454724409448819,80119271,6142,1146
0,1254,0.1446111869031378,0.17370242214532872,69458571,1466,212
0,1471,0.2200424178154825,0.4619105199516324,68563565,1886,415
0,969,0.2179176755447942,0.4562300319488818,70207081,1239,270
1,3541,0.24321436204317162,0.5353188239786177,73637466,4679,1138
1,1845,0.39686171951618177,0.8537609774723177,80153451,3059,1214
1,3497,0.4742934455802766,0.942422491815906,80138010,6652,3155
1,3778,0.40107799619530754,0.8819943392118441,80119012,6308,2530
2,1565,0.5218454017720745,0.9646017699115044,60074231,3273,1708
2,276,0.5753846153846154,0.9681372549019608,67847570,650,374
1,510,0.2543859649122807,0.626360338573156,68540066,684,174
1,11916,0.3249107699280494,0.7426799511996747,74870530,17651,5735
0,407,0.2335216572504708,0.4975062344139651,68642266,531,124
0,6640,0.043503313166234514,0.014528850145288501,69601042,6942,302
0,1091,0.21623563218390804,0.464951768488746,80121306,1392,301
1,2591,0.38992229809277135,0.8602941176470589,74091472,4247,1656
2,1685,0.587717151945192,0.9854689564068693,78159263,4087,2402
0,1052,0.14122448979591837,0.16730453799890652,63277606,1225,173
1,450,0.24623115577889448,0.5850144092219021,69869471,597,147
1,767,0.4482014388489209,0.9493670886075949,74372865,1390,623
0,914,0.18899733806566105,0.34767236299351795,80121021,1127,213
1,1021,0.2585330428467683,0.5969176052163604,80121075,1377,356
0,1912,0.1901736552308344,0.34959349593495936,65290106,2361,449
1,1992,0.3382059800664452,0.7682250396196514,68545771,3010,1018
1,1103,0.3298906439854192,0.8117958913187542,67435893,1646,543
1,5935,0.3388659908655453,0.775158939370445,80089562,8977,3042
1,485,0.49320794148380354,0.9447077409162717,62599936,957,472
0,3339,0.13205094879126592,0.14156626506024098,67554844,3847,508
0,574,0.18696883852691218,0.46208530805687204,61939360,706,132
0,882,0.17647058823529413,0.40904198062432723,69638632,1071,189
0,1274,0.1791237113402062,0.3149667838999609,82000149,1552,278
0,1297,0.16214470284237725,0.3028571428571429,65291562,1548,251
1,999,0.3176229508196721,0.7712944332662642,80108546,1464,465
0,1245,0.221875,0.4109211252068395,67513124,1600,355
0,320,0.13279132791327913,0.22432432432432434,67706002,369,49
0,5116,0.127409176189664,0.15569114243635598,80130303,5863,747
1,1425,0.408958938199917,0.8911845730027548,67706093,2411,986
1,144,0.35714285714285715,0.846441947565543,80121281,224,80
0,671,0.16852540272614622,0.2757475083056478,67554186,807,136
0,1700,0.2140545538603791,0.4163848177376926,68543356,2163,463
1,2325,0.24781624069880298,0.5473421926910299,69602946,3091,766
0,997,0.20935765265662173,0.4592885375494071,68539891,1261,264
2,523,0.5778853914447135,0.9529411764705882,74120193,1239,716
1,1812,0.41130604288499023,0.8692307692307693,67411295,3078,1266
1,2745,0.2799055613850997,0.6541808550889141,68302010,3812,1067
1,1836,0.37444633730834753,0.7777777777777778,65390465,2935,1099
0,3868,0.18875838926174496,0.3302340493747996,65528925,4768,900
1,10459,0.3704327935953771,0.8053173241852487,79910796,16613,6154
0,1689,0.06633499170812604,0.14583333333333334,68242251,1809,120
1,6275,0.31149879306561334,0.671667965705378,62230105,9114,2839
0,2375,0.15809996455157746,0.22370088719898606,68543895,2821,446
1,51,0.23880597014925373,0.6065573770491803,66227021,67,16
2,6755,0.506357790119848,0.9456148946594807,80127292,13684,6929
1,1161,0.2766355140186916,0.6512667660208644,68645094,1605,444
0,1839,0.1505773672055427,0.2540743836188884,68537686,2165,326
0,2131,0.1046218487394958,0.12037519541427827,73808875,2380,249
1,2956,0.2800779347296639,0.6864211737629459,80121155,4106,1150
1,4828,0.36230352661471404,0.8050334501433578,80125005,7571,2743
1,1120,0.2558139534883721,0.5890489913544669,67942714,1505,385
1,922,0.48085585585585583,0.9594501718213059,69072836,1776,854
1,368,0.3069679849340866,0.7180451127819549,80121221,531,163
1,464,0.3573407202216066,0.6372712146422629,72320962,722,258
1,1414,0.2592980618124673,0.5746268656716418,62140624,1909,495
0,609,0.14825174825174825,0.23154848046309695,74792354,715,106
1,1168,0.24499030381383322,0.5050348567002324,80178631,1547,379
0,2534,0.11056511056511056,0.143796992481203,80178634,2849,315
1,294,0.3049645390070922,0.7627627627627628,80121256,423,129
1,3438,0.43295398317664524,0.8797890061077179,80135745,6063,2625
0,1208,0.2078688524590164,0.4152418172936004,68537966,1525,317
0,1442,0.21842818428184282,0.4675118858954041,80121305,1845,403
1,1110,0.2438692098092643,0.5411686586985391,68540332,1468,358
1,790,0.27121771217712176,0.6736577181208053,68540381,1084,294
0,1542,0.14806629834254142,0.23616376042456405,70742091,1810,268
0,676,0.16851168511685116,0.2897350993377483,68536531,813,137
0,2186,0.14004720692368214,0.20321694782267555,80125275,2542,356
2,4623,0.5099120110251245,0.9604549431321084,70213794,9433,4810
0,381,0.0475,0.1843100189035917,62839301,400,19
1,1363,0.3840939900587438,0.8651266766020864,63841435,2213,850
1,222,0.3105590062111801,0.727810650887574,65338735,322,100
0,559,0.16066066066066065,0.26532663316582916,70641956,666,107
1,1768,0.3504775900073475,0.7795275590551181,70657734,2722,954
1,1183,0.29119233073696826,0.7090103397341211,68536776,1669,486
1,263,0.34413965087281795,0.7770562770562771,69176681,401,138
1,218,0.3166144200626959,0.7676470588235295,69091673,319,101
1,2170,0.24495476687543494,0.5550387596899224,70628712,2874,704
1,1007,0.3121584699453552,0.73961895456766,68563411,1464,457
0,4276,0.16582130316035895,0.24502266903213088,65987446,5126,850
0,2313,0.17245080500894455,0.255977048135161,67291693,2795,482
0,844,0.13701431492842536,0.1875,67291952,978,134
1,251,0.48459958932238195,0.958,69056512,487,236
1,2830,0.2889447236180904,0.649560465668805,65312583,3980,1150
0,361,0.2587268993839836,0.4896449704142012,70641004,487,126
0,626,0.03245749613601236,0.018357487922705314,73245662,647,21
0,2111,0.14569000404694454,0.2010178117048346,65299703,2471,360
0,526,0.21375186846038863,0.4405829596412556,68538981,669,143
0,710,0.21978021978021978,0.48221670802315963,68544546,910,200
0,1018,0.21207430340557276,0.45485272815065186,68497373,1292,274
0,628,0.215,0.49483648881239245,68537805,800,172
0,1018,0.23285606631499622,0.46215139442231074,69092051,1327,309
0,303,0.21298701298701297,0.45454545454545453,82113163,385,82
2,330,0.6140350877192983,0.964963503649635,77693623,855,525
1,3737,0.47052989515443466,0.9359550561797753,78265922,7058,3321
1,1629,0.2658855340243353,0.5850073493385596,80135750,2219,590
1,474,0.27076923076923076,0.6154776299879081,69165726,650,176
1,808,0.33278282411230387,0.7914285714285715,68532702,1211,403
0,768,0.1855779427359491,0.3375594294770206,70186515,943,175
1,200,0.3079584775086505,0.7111597374179431,70649621,289,89
0,256,0.20987654320987653,0.34549356223175964,70835562,324,68
1,2966,0.2669303015323777,0.6221985058697972,80119272,4046,1080
1,2549,0.24541148608644167,0.5599523951204999,80121014,3378,829
1,2449,0.32885722115648125,0.7149171270718232,68436095,3649,1200
0,4359,0.15062353858144972,0.34309961608405737,69638793,5132,773
1,1687,0.33634933123524785,0.81016825164594,70626640,2542,855
0,232,0.18309859154929578,0.25510204081632654,67554221,284,52
1,283,0.30637254901960786,0.7098214285714286,69176772,408,125
0,505,0.1611295681063123,0.2952952952952953,70642544,602,97
1,213,0.36036036036036034,0.8665207877461707,69177640,333,120
1,5475,0.27029188324670134,0.6196566812521037,80135436,7503,2028
1,2052,0.30628803245436104,0.6854077253218884,80181369,2958,906
0,761,0.2210849539406346,0.47883597883597884,66409924,977,216
0,5735,0.06929568321973385,0.04706104706104706,68539345,6162,427
0,877,0.15347490347490347,0.25302325581395346,68543195,1036,159
1,275,0.26861702127659576,0.6620795107033639,69702962,376,101
1,479,0.2468553459119497,0.5933333333333334,80121242,636,157
1,609,0.2775800711743772,0.682664054848188,80125284,843,234
0,1005,0.1762295081967213,0.3326876513317191,70841680,1220,215
0,980,0.1729957805907173,0.3047759724273757,70841743,1185,205
1,182,0.2540983606557377,0.5463659147869674,74708893,244,62
1,2808,0.24576954069298954,0.5529168817759422,80125281,3723,915
1,3596,0.28423566878980894,0.6843127731908694,68158286,5024,1428
0,1298,0.24490983129726585,0.4749082007343941,80181310,1719,421
1,1238,0.3386752136752137,0.8007856341189674,80111633,1872,634
2,318,0.5364431486880467,0.9519572953736655,73850756,686,368
1,292,0.42063492063492064,0.8756302521008403,80118362,504,212
0,5254,0.16217509169191516,0.3934786281466464,69638653,6271,1017
0,10402,0.14919025028627514,0.19930488974113136,70909762,12226,1824
1,2860,0.48937689698268166,0.938700823421775,60261810,5601,2741
0,593,0.14057971014492754,0.20785219399538107,80125342,690,97
0,10433,0.22804291527931927,0.4832225143033864,66404233,13515,3082
0,4797,0.21153846153846154,0.44659206510681587,80180136,6084,1287
1,2387,0.2632716049382716,0.5435962951133823,74341134,3240,853
1,414,0.4509283819628647,0.9121951219512195,73850770,754,340
1,2176,0.3054580274497287,0.7204791785510554,66027451,3133,957
2,351,0.5151933701657458,0.9326599326599326,63176904,724,373
1,423,0.33069620253164556,0.8064516129032258,69621244,632,209
1,365,0.4278996865203762,0.9129353233830846,67766741,638,273
1,506,0.352112676056338,0.7950963222416813,69637001,781,275
1,1425,0.44746025591314464,0.8950975224037955,67092263,2579,1154
0,1368,0.23618090452261306,0.4475336322869955,72958256,1791,423
0,212,0.21481481481481482,0.4469914040114613,64158794,270,58
1,617,0.2503037667071689,0.5674362089914945,67479125,823,206
1,179,0.2782258064516129,0.6534216335540839,68600672,248,69
0,1309,0.19247378161628625,0.34805568891022565,68542404,1621,312
1,114,0.45454545454545453,0.9706959706959707,65251844,209,95
1,766,0.2445759368836292,0.6701954397394136,62909651,1014,248
1,214,0.44415584415584414,0.8647887323943662,66860010,385,171
0,51,0.1774193548387097,0.14754098360655737,66917102,62,11
1,427,0.29654036243822074,0.6854521625163827,66892483,607,180
0,1876,0.13388734995383195,0.23639921722113502,70398902,2166,290
0,7110,0.23810544363480496,0.4919624916275954,66409252,9332,2222
1,1085,0.47047340165934604,0.9587786259541985,80111213,2049,964
1,264,0.363855421686747,0.8174603174603174,80110072,415,151
1,527,0.32087628865979384,0.7338709677419355,80111220,776,249
1,1421,0.2598958333333333,0.5527675276752767,67555992,1920,499
1,405,0.32160804020100503,0.7578378378378379,69195371,597,192
0,318,0.22815533980582525,0.448566610455312,67030334,412,94
1,984,0.3147632311977716,0.6830801466736511,70677012,1436,452
1,27,0.35714285714285715,0.6438356164383562,70013251,42,15
1,1869,0.3449001051524711,0.7494284407864655,64135106,2853,984
1,246,0.43317972350230416,0.9111842105263158,68372150,434,188
1,2511,0.49303452453058755,0.9379900213827512,81989254,4953,2442
0,922,0.13345864661654136,0.1800981079187106,54436081,1064,142
1,85,0.42953020134228187,0.8848484848484849,66381994,149,64
0,1991,0.10153429602888087,0.09615384615384616,66423406,2216,225
0,5638,0.20141643059490086,0.34090392913922324,66906980,7060,1422
1,67,0.4806201550387597,0.946524064171123,67337256,129,62
1,1029,0.2809224318658281,0.6683831101956745,82016318,1431,402
0,317,0.20947630922693267,0.4282115869017632,82016319,401,84
1,2693,0.2568984547461369,0.5771694816540478,66409644,3624,931
1,144,0.4418604651162791,0.9278350515463918,67560010,258,114
2,641,0.5205684367988033,0.9365708622398414,453915,1337,696
1,254,0.32625994694960214,0.7890625,67305616,377,123
0,994,0.1576271186440678,0.2568956192536506,67963546,1180,186
1,3996,0.32896725440806046,0.7579174664107485,80125509,5955,1959
0,912,0.20140105078809106,0.42130365659777425,66409875,1142,230
0,5648,0.04707271806984984,0.017406610600430274,68534606,5927,279
1,2579,0.34576357179096906,0.7955423476968796,69628671,3942,1363
0,539,0.20618556701030927,0.4233511586452763,69621370,679,140
1,493,0.42939814814814814,0.8704402515723271,64193283,864,371
1,1396,0.3333333333333333,0.7911924789708066,68530931,2094,698
1,415,0.29780033840947545,0.7569866342648846,68542656,591,176
1,11471,0.25546829363276435,0.5375716728699326,68563495,15407,3936
1,5819,0.2502254864063909,0.5438333020461799,66409294,7761,1942
1,816,0.23880597014925373,0.5682730923694779,63279153,1072,256
0,495,0.16243654822335024,0.33666666666666667,70228970,591,96
0,1554,0.20875763747454176,0.40358565737051794,66931781,1964,410
0,2750,0.04314544189283229,0.011834319526627219,67554753,2874,124
1,3123,0.23437116940426575,0.5231044166453919,80111731,4079,956
0,797,0.15122470713525027,0.2429742388758782,82000079,939,142
0,982,0.17200674536256325,0.3233458177278402,68536650,1186,204
0,2169,0.15701515740380878,0.26216022889842633,69652716,2573,404
1,2218,0.33572926025756217,0.7734346724574738,80105760,3339,1121
0,1444,0.15058823529411763,0.19223826714801445,68151181,1700,256
0,399,0.1806981519507187,0.3138586956521739,67159183,487,88
0,542,0.14511041009463724,0.19238900634249473,67428410,634,92
1,765,0.3253968253968254,0.7305428384565075,69573616,1134,369
0,901,0.1809090909090909,0.3659751037344398,70641753,1100,199
1,1696,0.3474413235859946,0.8218045112781955,66471013,2599,903
0,3484,0.13612695264071412,0.14073899741115556,67553934,4033,549
1,378,0.23790322580645162,0.5387263339070568,63098595,496,118
0,7658,0.11334954266527729,0.13002241765821693,70609343,8637,979
1,1468,0.28180039138943247,0.6917328351237739,80110380,2044,576
0,1279,0.21437346437346438,0.4422062350119904,70614656,1628,349
1,4415,0.3139083139083139,0.747220703480955,70627494,6435,2020
1,31,0.3541666666666667,0.7701149425287356,60244121,48,17
1,130,0.47368421052631576,0.9552238805970149,64242955,247,117
1,509,0.24592592592592594,0.5125324114088159,65316384,675,166
0,4774,0.11461424332344214,0.19880546075085323,66742116,5392,618
0,475,0.20435510887772193,0.49956709956709955,67226033,597,122
0,395,0.1595744680851064,0.19954648526077098,69498835,470,75
0,770,0.18172157279489903,0.34263392857142855,70769762,941,171
1,2301,0.3320754716981132,0.7700359829898593,75892901,3445,1144
0,1944,0.20653061224489797,0.3609737542791936,69020742,2450,506
0,4200,0.10352187833511206,0.09593820084724645,67291336,4685,485
1,2112,0.47928994082840237,0.9330895795246801,70676991,4056,1944
1,984,0.2656716417910448,0.6175363098440022,70627263,1340,356
1,240,0.42992874109263657,0.8762135922330098,79838752,421,181
0,267,0.03260869565217391,0.08490566037735849,62839140,276,9
0,770,0.1118800461361015,0.38162344983089064,62839350,867,97
0,565,0.05042016806722689,0.16677966101694916,62839980,595,30
0,974,0.06794258373205742,0.2239292364990689,62840183,1045,71
1,2720,0.41227312013828865,0.9249257358898191,66471034,4628,1908
1,1997,0.2684981684981685,0.5403899721448467,69982752,2730,733
1,228,0.3372093023255814,0.640625,82047559,344,116
1,1506,0.29626168224299065,0.7228739002932552,80110576,2140,634
1,589,0.4438149197355996,0.8902439024390244,74779404,1059,470
1,239,0.3743455497382199,0.8253676470588235,80072104,382,143
0,933,0.22443890274314215,0.44661921708185054,54558791,1203,270
0,3638,0.15395348837209302,0.26993372163084955,70841400,4300,662
0,5711,0.14761194029850747,0.25362776025236594,70841414,6700,989
0,5570,0.155420773313116,0.2861207714195384,70841624,6595,1025
1,555,0.42066805845511485,0.8763136620856912,82036045,958,403
1,512,0.2414814814814815,0.5521472392638037,70617463,675,163
1,568,0.3530751708428246,0.8466453674121406,70618513,878,310
0,810,0.09698996655518395,0.10647803425167536,70642964,897,87
2,550,0.5873968492123031,0.9812775330396476,70057274,1333,783
1,172,0.33073929961089493,0.7657266811279827,54417986,257,85
1,3074,0.313379495197677,0.7658339641685592,69531574,4477,1403
1,104,0.3772455089820359,0.8202247191011236,67276293,167,63
0,455,0.1095890410958904,0.12231030577576443,68539513,511,56
0,1075,0.20429311621021465,0.416958654519972,68541795,1351,276
1,1154,0.23169107856191745,0.509594882729211,69198423,1502,348
2,554,0.5062388591800356,0.9471153846153846,80123435,1122,568
1,1190,0.27394752898108604,0.5138028169014085,81989273,1639,449
0,143,0.20994475138121546,0.45,80121163,181,38
1,24,0.4,0.855072463768116,70631372,40,16
2,320,0.564625850340136,0.9846827133479212,67540193,735,415
1,1565,0.3438155136268344,0.7566616390145802,68421255,2385,820
0,2936,0.04146261834802481,0.01054790506885438,67554732,3063,127
1,1197,0.24527112232030265,0.5182211241507103,67555726,1586,389
1,690,0.24008810572687225,0.5654574132492114,77676466,908,218
1,50,0.2537313432835821,0.6204819277108434,80121111,67,17
1,2434,0.2604071710726223,0.6131837307152875,608965,3291,857
0,965,0.19246861924686193,0.4715447154471545,82107518,1195,230
1,1516,0.23006602336211274,0.5097481722177092,82116578,1969,453
1,79,0.2882882882882883,0.84251968503937,73842566,111,32
1,3158,0.4704008049639443,0.9350115592088364,68026721,5963,2805
1,118,0.2804878048780488,0.6666666666666666,67138386,164,46
0,1507,0.10563798219584569,0.3254364089775561,68271602,1685,178
0,228,0.16483516483516483,0.47417840375586856,69001660,273,45
0,74,0.13953488372093023,0.30677290836653387,70063882,86,12
1,63,0.3,0.7008928571428571,70078393,90,27
1,544,0.41379310344827586,0.8953586497890296,70349174,928,384
0,111,0.06722689075630252,0.1414141414141414,70681660,119,8
1,696,0.4209650582362729,0.8709476309226932,80123783,1202,506
1,2429,0.434195201490799,0.9363333333333334,80107412,4293,1864
0,2136,0.11844820470491127,0.1281437125748503,54436074,2423,287
0,1053,0.096137339055794,0.06978367062107467,66423364,1165,112
0,1424,0.12044471896232242,0.11989664082687339,69622322,1619,195
0,15021,0.12183572054954692,0.18531430439045649,70219681,17105,2084
1,1388,0.3975694444444444,0.9035995035167563,65360946,2304,916
0,2024,0.19905025722200237,0.3836734693877551,80119367,2527,503
1,3365,0.447998687664042,0.8923674588665448,80132204,6096,2731
1,1219,0.28838295388207824,0.6346414073071719,80180455,1713,494
0,1272,0.11297071129707113,0.2510869565217391,62413771,1434,162
1,522,0.21621621621621623,0.6777691711851278,68631626,666,144
0,566,0.14242424242424243,0.1989795918367347,66931711,660,94
0,604,0.25339925834363414,0.4799618320610687,67994983,809,205
0,2791,0.219082260772244,0.4452777777777778,68993743,3574,783
1,2399,0.27082066869300914,0.6003622094778147,71777160,3290,891
1,975,0.28361498897869214,0.6104815864022662,80108336,1361,386
1,712,0.36257833482542523,0.8260038240917782,70215642,1117,405
1,5358,0.29183187946074546,0.6561224489795918,67556685,7566,2208
0,1489,0.2183727034120735,0.40163581575548857,69100983,1905,416
1,1500,0.4847131569907248,0.9342701722574795,70202384,2911,1411
1,1334,0.30157068062827225,0.7245045915901401,75892894,1910,576
1,953,0.2812971342383107,0.6819687647893989,70573153,1326,373
1,9105,0.2174473571121616,0.5386719343564808,70700994,11635,2530
1,231,0.384,0.8735119047619048,80180169,375,144
1,466,0.3940182054616385,0.8953626634958383,66470992,769,303
1,981,0.29067245119305857,0.6998754669987547,80110422,1383,402
1,586,0.4080808080808081,0.8932038834951457,69587896,990,404
0,1852,0.06559031281533804,0.04224738675958188,70617785,1982,130
0,649,0.14153439153439154,0.2615273775216138,70642166,756,107
0,2182,0.06911262798634812,0.06280875088214538,70642796,2344,162
0,842,0.08478260869565217,0.10187110187110188,70643181,920,78
0,931,0.027168234064785787,0.010561056105610561,70643545,957,26
0,955,0.09220532319391635,0.09813542688910697,70742126,1052,97
1,2425,0.29300291545189505,0.6910774410774411,67506810,3430,1005
1,621,0.25717703349282295,0.6246600181323663,68171376,836,215
0,1025,0.17205169628432956,0.36666666666666664,80135747,1238,213
1,880,0.36872309899569583,0.8431818181818181,80108224,1394,514
1,2374,0.30238025271818986,0.6062305295950156,82045548,3403,1029
1,2121,0.3097949886104784,0.7448119325551232,68532100,3073,952
1,3007,0.3584382334115639,0.8466872110939908,68532114,4687,1680
0,1036,0.24269005847953215,0.47164948453608246,80108966,1368,332
1,3502,0.32692677301556794,0.7714822771213748,73556735,5203,1701
2,947,0.5274451097804391,0.9621656881930855,73503276,2004,1057
1,11629,0.41196399676375406,0.882412672623883,69122963,19776,8147
1,2093,0.48688404020593284,0.912,80124815,4079,1986
1,726,0.48692579505300354,0.9378531073446328,70912926,1415,689
1,66,0.25842696629213485,0.5282051282051282,62976830,89,23
1,3122,0.2786506469500924,0.6137491141034727,73882984,4328,1206
1,1349,0.3803399173174093,0.8892718655751831,65268441,2177,828
1,1418,0.29382470119521914,0.6665014866204163,80107454,2008,590
1,545,0.2345505617977528,0.5058365758754864,80125370,712,167
1,1838,0.3539543057996485,0.7416723317471108,80127526,2845,1007
0,3020,0.12539820445988994,0.2123329283110571,81965603,3453,433
0,2059,0.18648755432635322,0.3048956083513319,68545414,2531,472
1,911,0.2532786885245902,0.5864928909952607,67555194,1220,309
0,575,0.18323863636363635,0.35958254269449713,68534263,704,129
1,493,0.251896813353566,0.5420765027322404,68542544,659,166
1,1129,0.2790549169859515,0.664,80109932,1566,437
1,1006,0.3161114887831407,0.7623400365630713,80109946,1471,465
0,2141,0.15442338072669826,0.21342456826327794,67554816,2532,391
0,2125,0.14452495974235105,0.19035153328347046,70870940,2484,359
0,1019,0.2155504234026174,0.44660194174757284,68543363,1299,280
1,777,0.23372781065088757,0.5299760191846523,68543475,1014,237
1,409,0.25636363636363635,0.5755208333333334,68530630,550,141
1,1305,0.3087923728813559,0.7387551113130395,68532093,1888,583
0,5592,0.21997489189566188,0.4426601171358398,73818150,7169,1577
0,1490,0.18356164383561643,0.2789598108747045,69608175,1825,335
0,1534,0.1743810548977395,0.25078793336334987,69608945,1858,324
1,2536,0.266415967601967,0.6093340325117986,82011768,3457,921
1,1051,0.4196576477084484,0.921760391198044,67557112,1811,760
1,2784,0.35135135135135137,0.7989889979185252,80180321,4292,1508
0,1796,0.12390243902439024,0.16674962667994028,80180387,2050,254
0,281,0.08469055374592833,0.08285714285714285,64158353,307,26
1,254,0.40792540792540793,0.8931159420289855,67995662,429,175
1,178,0.30196078431372547,0.7601476014760148,67173365,255,77
1,866,0.2540913006029285,0.5116459627329193,80111066,1161,295
1,264,0.4260869565217391,0.6403508771929824,68665653,460,196
0,1196,0.22938144329896906,0.49491682070240295,69198402,1552,356
0,1305,0.22597864768683273,0.4895991882293252,69198430,1686,381
0,4079,0.17861457913813936,0.29664103601780656,68535593,4966,887
0,694,0.1844888366627497,0.29790660225442833,68535684,851,157
0,102,0.15702479338842976,0.195906432748538,68648790,121,19
0,1193,0.24157660521296884,0.49563318777292575,70179522,1573,380
0,8076,0.22791586998087954,0.4420142421159715,70601615,10460,2384
1,3708,0.33524560774471135,0.7734277384423157,75441940,5578,1870
0,1280,0.15789473684210525,0.23531777956556718,82000069,1520,240
1,1774,0.4844521941296135,0.9076673866090713,80124835,3441,1667
2,843,0.6552147239263804,0.9820075757575758,80139984,2445,1602
0,1953,0.07440758293838863,0.2308673469387755,62835311,2110,157
0,731,0.05064935064935065,0.2005958291956306,62837152,770,39
0,478,0.036290322580645164,0.09482758620689655,62837810,496,18
0,1944,0.02556390977443609,0.04352941176470588,62838132,1995,51
0,628,0.0202808112324493,0.03922789539227895,62838265,641,13
0,1663,0.0414985590778098,0.0875696949819613,64248723,1735,72
0,452,0.24540901502504173,0.4925496688741722,65307473,599,147
0,1056,0.07205623901581722,0.18462897526501768,68138420,1138,82
0,1856,0.1182897862232779,0.2785693515556848,68138434,2105,249
1,2170,0.2715676401477006,0.6064109301103521,68763506,2979,809
0,354,0.035422343324250684,0.03879310344827586,73245403,367,13
0,1170,0.08949416342412451,0.1005464480874317,73245683,1285,115
0,58,0.18309859154929578,0.43577981651376146,73245830,71,13
1,53,0.24285714285714285,0.5903614457831325,73245844,70,17
0,429,0.17341040462427745,0.35409457900807384,62897121,519,90
1,1529,0.4110169491525424,0.9211128048780488,65268434,2596,1067
1,923,0.2732283464566929,0.634954193093728,80111486,1270,347
1,361,0.4420401854714065,0.9234449760765551,65008286,647,286
0,7955,0.2081425442962373,0.39690479912458965,69170115,10046,2091
0,1843,0.17502238137869292,0.2988705473501303,69170122,2234,391
1,3243,0.44278350515463916,0.9013426736719206,80153448,5820,2577
1,154,0.36885245901639346,0.8803827751196173,68112366,244,90
0,1438,0.09786700125470514,0.1184475806451613,68553660,1594,156
1,802,0.37490257209664846,0.8607142857142858,80111430,1283,481
1,205,0.16666666666666666,0.5034246575342466,68191256,246,41
1,239,0.22402597402597402,0.5415549597855228,73637564,308,69
1,748,0.38688524590163936,0.8397328881469115,80180307,1220,472
1,234,0.3776595744680851,0.8365384615384616,80180310,376,142
1,223,0.34411764705882353,0.8117359413202934,80180347,340,117
1,1543,0.3639736191261336,0.8327028163093737,70627396,2426,883
1,1077,0.2713125845737483,0.579954954954955,80107671,1478,401
1,550,0.2637215528781794,0.5725338491295938,80108854,747,197
1,5709,0.4258849557522124,0.8853064651553316,70758436,9944,4235
1,838,0.32473811442385175,0.7446675031367629,80124676,1241,403
1,590,0.20592193808882908,0.5034825870646766,64225126,743,153
2,1539,0.5423728813559322,0.9688654353562005,68285812,3363,1824
0,1752,0.12662013958125623,0.21689683184402925,80124512,2006,254
0,12737,0.11769188140759212,0.14958142473542885,66203263,14436,1699
1,1030,0.3232588699080158,0.7444839857651245,68039496,1522,492
1,327,0.234192037470726,0.5736137667304015,68538666,427,100
0,868,0.16054158607350097,0.28053333333333336,80040961,1034,166
1,2604,0.2687447346251053,0.6416732438831886,80118433,3561,957
1,229,0.336231884057971,0.8042226487523992,82113167,345,116
1,258,0.31746031746031744,0.6858316221765913,67994584,378,120
0,1858,0.22096436058700208,0.4669789227166276,72906701,2385,527
1,532,0.3856812933025404,0.8941717791411042,70620781,866,334
1,99,0.37735849056603776,0.8,67662490,159,60
0,1517,0.21683014971605577,0.3568818514007308,70565530,1937,420
1,31,0.32608695652173914,0.6612903225806451,66859954,46,15
1,1295,0.3905882352941176,0.8576406172224987,80153455,2125,830
0,4078,0.13766123916261366,0.15724381625441697,67963455,4729,651
0,2604,0.12996992983628466,0.14839609483960947,67964134,2993,389
1,265,0.2471590909090909,0.5848101265822785,68192390,352,87
0,39,0.23529411764705882,0.4583333333333333,68283040,51,12
1,720,0.3036750483558994,0.7021716649431231,69127520,1034,314
1,2521,0.324671845700509,0.784077892325315,80125282,3733,1212
1,3172,0.3736176935229068,0.7891440501043842,66915996,5064,1892
1,2536,0.24770097893800058,0.5292238901309486,68545085,3371,835
1,1704,0.26073752711496745,0.5822102425876011,68545204,2305,601
1,1595,0.28635346756152125,0.6852085967130215,80125491,2235,640
1,267,0.327455919395466,0.8128161888701517,64277052,397,130
1,3663,0.3920331950207469,0.8758723828514456,69072773,6025,2362
0,2674,0.2176711527208894,0.44223566695476807,80125465,3418,744
1,512,0.459915611814346,0.8933030646992054,61021940,948,436
0,782,0.10832383124287344,0.07574206755373593,74091514,877,95
1,2071,0.3594184967522425,0.7964880684376408,80118587,3233,1162
1,1850,0.42042606516290726,0.875717017208413,66907001,3192,1342
0,455,0.10609037328094302,0.095,70870954,509,54
0,858,0.1271617497456765,0.29327237099934683,81965666,983,125
0,2066,0.24515893313847278,0.49683544303797467,80135101,2737,671
1,3235,0.4731270358306189,0.8046722907203114,80090283,6140,2905
0,1474,0.13294117647058823,0.3101123595505618,70649082,1700,226
1,621,0.22375,0.5168539325842697,70649656,800,179
0,3562,0.06656184486373165,0.12313432835820895,80126909,3816,254
0,3390,0.17957405614714425,0.2993492407809111,69239905,4132,742
2,470,0.5042194092827004,0.945179584120983,67426905,948,478
0,2237,0.13294573643410854,0.1708171206225681,80125290,2580,343
2,462,0.5954465849387041,0.9826589595375722,80145284,1142,680
1,716,0.4239742558326629,0.8880597014925373,774032,1243,527
1,1066,0.24557678697806087,0.5156069364161849,80108994,1413,347
0,4234,0.20458388126996055,0.42047203694202157,68155843,5323,1089
0,638,0.1964735516372796,0.35732647814910024,68294646,794,156
0,903,0.19086021505376344,0.38927507447864945,70853125,1116,213
1,5,0.375,0.5714285714285714,70719033,8,3
1,17,0.2916666666666667,0.5227272727272727,70719152,24,7
1,2329,0.37627209426888053,0.8462101794214574,80111395,3734,1405
0,11,0.26666666666666666,0.4,80053883,15,4
1,10,0.375,0.7391304347826086,80054023,16,6
0,753,0.19032258064516128,0.480719794344473,67226103,930,177
0,822,0.17882117882117882,0.3412256267409471,68541844,1001,179
1,1457,0.2797825012357884,0.6694579109739973,80109750,2023,566
1,748,0.3893877551020408,0.8608433734939759,67306925,1225,477
1,474,0.3875968992248062,0.887991927346115,68531351,774,300
0,2871,0.2208955223880597,0.40166204986149584,70641095,3685,814
1,360,0.38879456706281834,0.8324225865209471,70245574,589,229
1,3442,0.30548829701372077,0.7083247262962198,68238093,4956,1514
0,1179,0.19467213114754098,0.3633603238866397,68151251,1464,285
0,3843,0.17708779443254818,0.2726220782226336,68151363,4670,827
0,1977,0.24107485604606527,0.4465587044534413,70641431,2605,628
0,2794,0.16919417187035385,0.23476297968397292,70641473,3363,569
1,162,0.2831858407079646,0.6709183673469388,67556391,226,64
1,414,0.24863883847549909,0.5468956406869221,70632212,551,137
2,229,0.5158562367864693,0.9613034623217923,74226166,473,244
0,961,0.11996336996336997,0.15824915824915825,80140089,1092,131
0,1899,0.1623290692545214,0.2662779397473275,80141453,2267,368
1,387,0.27932960893854747,0.6789862724392819,66930794,537,150
0,732,0.1893687707641196,0.3621943159286186,68537203,903,171
0,637,0.18333333333333332,0.2775073028237585,72393370,780,143
1,92,0.2868217054263566,0.6089743589743589,68131805,129,37
0,2163,0.16839677047289503,0.2350312779267203,70641361,2601,438
1,694,0.32490272373540857,0.8055555555555556,68535985,1028,334
1,106,0.2638888888888889,0.5042016806722689,68536006,144,38
0,3338,0.2091921345652689,0.3933832407631007,68544385,4221,883
0,448,0.2112676056338028,0.44811753902662993,70841771,568,120
0,96,0.15789473684210525,0.28,80070942,114,18
0,106,0.08620689655172414,0.05944055944055944,80070956,116,10
0,530,0.21364985163204747,0.45089666951323654,82011763,674,144
1,2026,0.2921034241788959,0.6779053084648493,68156312,2862,836
1,522,0.4657113613101331,0.8891170431211499,69585530,977,455
0,4786,0.08803353658536585,0.16233447768513978,67837063,5248,462
0,895,0.105,0.3150537634408602,69659996,1000,105
1,978,0.19039735099337748,0.5329639889196676,69729485,1208,230
1,690,0.3023255813953488,0.7330287206266318,73668581,989,299
0,702,0.1125158027812895,0.14947965941343425,68539464,791,89
1,2678,0.3484184914841849,0.7825603998889198,70658945,4110,1432
0,633,0.17792207792207793,0.32047986289631536,67160170,770,137
0,2306,0.13243039879608728,0.15778380006022283,67963315,2658,352
0,570,0.16176470588235295,0.2901439645625692,68539100,680,110
0,1395,0.1560798548094374,0.2250559284116331,60047092,1653,258
1,829,0.41371994342291374,0.8868184955141477,80167228,1414,585
1,134,0.30569948186528495,0.5910780669144982,67994892,193,59
1,346,0.46105919003115264,0.872,62510532,642,296
1,215,0.3086816720257235,0.6014492753623188,65804333,311,96
0,100,0.2647058823529412,0.4424778761061947,80178924,136,36
1,317,0.4074766355140187,0.7710526315789473,80178936,535,218
1,1162,0.2813852813852814,0.62,80180459,1617,455
0,835,0.215962441314554,0.4709531866892273,75765326,1065,230
1,1307,0.25186033199771035,0.5379136992040218,65909095,1747,440
0,1652,0.12731114632857898,0.13119789381307592,70870996,1893,241
0,780,0.1657754010695187,0.27172827172827174,80137328,935,155
0,919,0.09636184857423795,0.09840425531914894,80137332,1017,98
1,1668,0.2550245645377401,0.5825815405968078,69089643,2239,571
1,3093,0.24450415241817294,0.5137296720874434,70601643,4094,1001
0,3424,0.18631178707224336,0.32190040650406504,66404856,4208,784
0,3238,0.17229038854805726,0.2782348541510845,66422853,3912,674
0,748,0.17982456140350878,0.346969696969697,68537665,912,164
0,369,0.16515837104072398,0.3013698630136986,68543440,442,73
1,1298,0.2346698113207547,0.5572755417956656,73808903,1696,398
1,1017,0.2746077032810271,0.6458117890382626,709142,1402,385
0,46,0.11538461538461539,0.3560606060606061,62413841,52,6
0,205,0.055299539170506916,0.2863636363636364,62835080,217,12
0,1725,0.18708765315739867,0.4603718199608611,67364276,2122,397
1,1067,0.2780784844384303,0.6522029372496663,73195885,1478,411
0,728,0.1875,0.32954545454545453,68542376,896,168
1,1548,0.49576547231270357,0.956,80062500,3070,1522
1,706,0.40321217244294166,0.8438634713144517,68029521,1183,477
1,356,0.2764227642276423,0.6273364485981309,73816302,492,136
0,463,0.07952286282306163,0.3413597733711048,62835465,503,40
1,3774,0.23401664298761923,0.5916346736714487,80118411,4927,1153
1,1470,0.392310872261265,0.8540906722251173,80153464,2419,949
1,3558,0.3938671209540034,0.9002074210647615,66471146,5870,2312
0,6306,0.1784783741532048,0.28170594837261503,67554956,7676,1370
0,909,0.16143911439114392,0.2440260680666184,70871234,1084,175
2,1792,0.5245423189174847,0.9657894736842105,70612164,3769,1977
0,1054,0.21518987341772153,0.38238993710691827,65851072,1343,289
2,397,0.5128834355828221,0.9705535924617197,63577486,815,418
0,540,0.07216494845360824,0.13522355507088332,75283215,582,42
1,530,0.2923898531375167,0.7156767283349562,67552142,749,219
1,2350,0.3084167157151265,0.7062902426944032,70925442,3398,1048
0,707,0.12931034482758622,0.12976022566995768,67555565,812,105
0,2148,0.11202976436544027,0.12013455069678039,70283696,2419,271
1,818,0.40073260073260075,0.9073010664479081,80111521,1365,547
0,5037,0.17642249836494442,0.33408705483323914,65915934,6116,1079
1,1066,0.24664310954063604,0.602135231316726,63109592,1415,349
2,283,0.7138523761375126,0.907563025210084,62819813,989,706
1,5877,0.3237832240248533,0.710440251572327,77885640,8691,2814
2,2182,0.7072319871192808,0.9334637964774951,68179153,7453,5271
2,562,0.723152709359606,0.9392624728850325,69581813,2030,1468
1,1012,0.3162162162162162,0.7861244019138756,70627144,1480,468
1,2050,0.43495038588754137,0.8925831202046036,80125008,3628,1578
1,6858,0.3916437505544221,0.8367488711358111,65412606,11273,4415
2,61,0.7436974789915967,0.9305555555555556,69202371,238,177
1,3999,0.45776271186440676,0.8972003499562554,80124830,7375,3376
1,1475,0.3283242258652095,0.6556442417331813,69212101,2196,721
1,1730,0.45920600187558613,0.854982206405694,75417111,3199,1469
2,4505,0.5211522108843537,0.9030651340996169,66280970,9408,4903
2,45,0.6311475409836066,0.9245283018867925,68157173,122,77
2,27,0.7652173913043478,0.9696969696969697,68157194,115,88
1,1997,0.3922702373706634,0.5520446096654275,66826655,3286,1289
2,421,0.6207207207207207,0.9860950173812283,73321472,1110,689
1,1485,0.34868421052631576,0.8174831892411143,63445921,2280,795
1,245,0.2553191489361702,0.5016077170418006,65307333,329,84
0,471,0.23414634146341465,0.4,65312415,615,144
0,1265,0.20639899623588456,0.4035497431106959,68535803,1594,329
1,361,0.2587268993839836,0.5455607476635514,68763730,487,126
1,633,0.2707373271889401,0.5988329686360321,68763863,868,235
1,1181,0.2240473061760841,0.5227829495345419,69549494,1522,341
0,1517,0.12362796071634893,0.18832552194290583,70516642,1731,214
1,1641,0.24027777777777778,0.5439560439560439,70567602,2160,519
0,731,0.11070559610705596,0.15033222591362128,80119389,822,91
0,1337,0.12385321100917432,0.19218241042345277,70617862,1526,189
1,1276,0.2427299703264095,0.5659704533876719,80121241,1685,409
0,2266,0.1436130007558579,0.17534430634867315,63264453,2646,380
1,2207,0.27875816993464053,0.6614906832298136,70627704,3060,853
0,1205,0.1423487544483986,0.2608695652173913,73637536,1405,200
0,702,0.1808634772462077,0.37672176308539945,69625276,857,155
0,502,0.12237762237762238,0.1672384219554031,80116680,572,70
1,7306,0.2623927309439677,0.5772902122809517,80117894,9905,2599
0,846,0.05790645879732739,0.032339885859226376,80119392,898,52
0,639,0.07658959537572255,0.07206537890044576,80119401,692,53
0,670,0.09825033647375504,0.1080669710806697,80119403,743,73
0,494,0.15265866209262435,0.2511715089034677,81978735,583,89
0,1694,0.2135561745589601,0.45485090298194036,70115066,2154,460
1,421,0.4416445623342175,0.9351198871650211,80125366,754,333
0,908,0.149812734082397,0.3710691823899371,62548171,1068,160
0,2178,0.14251968503937007,0.17206982543640897,67554830,2540,362
0,1494,0.11754282339043119,0.1199825479930192,69239856,1693,199
1,759,0.25806451612903225,0.7183520599250937,69551090,1023,264
0,1869,0.06456456456456457,0.049586776859504134,67706471,1998,129
0,2353,0.04388459975619667,0.024789029535864978,67706520,2461,108
0,14965,0.1252119015607646,0.20102051663654724,66742025,17107,2142
0,133,0.125,0.31835205992509363,68155710,152,19
1,1253,0.2856328392246294,0.6636652542372882,75892845,1754,501
1,603,0.3380900109769484,0.7733439744612929,67668076,911,308
0,1070,0.21323529411764705,0.44697720515361744,70066990,1360,290
0,1005,0.19728434504792333,0.3915343915343915,81979715,1252,247
0,1204,0.1627260083449235,0.25015033072760073,68533976,1438,234
0,402,0.20866141732283464,0.431740614334471,68538645,508,106
0,3383,0.21398698884758363,0.44182825484764543,80121024,4304,921
2,2993,0.7735492169176061,0.9973828840617639,81996942,13217,10224
1,1304,0.25613234455219624,0.6205774705164702,80118417,1753,449
0,1437,0.17603211009174313,0.287596048298573,69166020,1744,307
0,1248,0.13333333333333333,0.17708333333333334,54609632,1440,192
0,2357,0.12281354670636398,0.22903963414634146,80116722,2687,330
0,5078,0.1652145323031399,0.2807209175314036,66404492,6083,1005
0,864,0.1676300578034682,0.2845528455284553,68535446,1038,174
0,3259,0.1119891008174387,0.12666469369635988,80121150,3670,411
0,376,0.1473922902494331,0.25463917525773194,72382352,441,65
0,780,0.15675675675675677,0.2222222222222222,67554802,925,145
1,1851,0.26518459706232633,0.5861123800822293,68545281,2519,668
0,2504,0.12078651685393259,0.14977711738484398,70614691,2848,344
0,2135,0.09801436417406,0.09926470588235294,70615181,2367,232
2,138,0.5157894736842106,0.9663865546218487,80166997,285,147
1,2887,0.36156567890314023,0.6738644825018615,80176791,4522,1635
1,100,0.3006993006993007,0.6095617529880478,67203962,143,43
0,1275,0.20212765957446807,0.41066520065970313,68541781,1598,323
0,1462,0.044444444444444446,0.01768070722828913,80114321,1530,68
0,2545,0.06364974245768948,0.04663840096910963,80114356,2718,173
1,744,0.38,0.8731435643564357,69161071,1200,456
0,2754,0.23669623059866962,0.4934246575342466,80117901,3608,854
0,919,0.2158703071672355,0.49123945489941595,68537861,1172,253
0,1253,0.20545339251743816,0.3878048780487805,80109715,1577,324
0,493,0.06095238095238095,0.051470588235294115,68743416,525,32
1,1404,0.3272640153330139,0.7975432211101001,80121210,2087,683
1,987,0.297008547008547,0.6067726330338632,80161895,1404,417
0,3039,0.08187311178247735,0.24089960584280085,62835430,3310,271
0,1219,0.2338152105593966,0.4991717283268912,68545176,1591,372
1,1822,0.2572360375050958,0.5714899098325461,68545183,2453,631
1,590,0.3572984749455338,0.735658042744657,79726801,918,328
0,6766,0.21188118811881188,0.40932069510268565,70060116,8585,1819
1,520,0.3229166666666667,0.6823338735818476,74049045,768,248
1,295,0.4111776447105788,0.8474226804123711,68254452,501,206
1,910,0.2766295707472178,0.6557583385777218,66930703,1258,348
0,635,0.193138500635324,0.4166054371785452,70532896,787,152
0,2508,0.22400990099009901,0.47851634226955564,72906715,3232,724
1,595,0.42678227360308285,0.8962655601659751,80004043,1038,443
1,1091,0.24913971094287682,0.5497435897435897,67553255,1453,362
1,893,0.29850746268656714,0.7550890585241731,68543762,1273,380
1,1301,0.47771979124849456,0.9390337423312883,68615463,2491,1190
0,2001,0.18658536585365854,0.31057563587684067,62140484,2460,459
1,301,0.25495049504950495,0.5529595015576324,70221200,404,103
1,1200,0.34959349593495936,0.8277194919933738,69551916,1845,645
0,816,0.1815446339017051,0.35708566853482787,68538960,997,181
0,701,0.13776137761377613,0.19022687609075042,68542726,813,112
1,312,0.22772277227722773,0.5384615384615384,69622504,404,92
2,5913,0.7977562677429285,0.9988573605027614,60504913,29237,23324
1,33,0.32653061224489793,0.75,79976680,49,16
1,43,0.4027777777777778,0.9230769230769231,79976694,72,29
2,708,0.5798219584569733,0.9846153846153847,73321465,1685,977
1,713,0.25806451612903225,0.5988620199146515,80121116,961,248
1,1544,0.4010861132660978,0.9044776119402985,67552653,2578,1034
1,874,0.332824427480916,0.8137254901960784,68532492,1310,436
1,594,0.31724137931034485,0.7533206831119544,68532520,870,276
1,711,0.3763157894736842,0.843558282208589,68532695,1140,429
1,631,0.35348360655737704,0.8256227758007118,69184150,976,345
1,3439,0.334816247582205,0.7886661717396684,68545645,5170,1731
0,2318,0.15060461707585196,0.3172652804032766,67299561,2729,411
0,4,0.3333333333333333,0.16666666666666666,65899624,6,2
1,2685,0.28112449799196787,0.6515580736543909,69586412,3735,1050
1,363,0.3826530612244898,0.883551673944687,69607321,588,225
0,1263,0.18463524854744998,0.3451367099955177,70040866,1549,286
0,737,0.1625,0.2648963730569948,68535516,880,143
1,400,0.29328621908127206,0.5980392156862745,80127537,566,166
0,7936,0.13485228387659434,0.19245434477222556,65915906,9173,1237
0,626,0.15519568151147098,0.20309477756286268,68645024,741,115
0,1029,0.16409423233143786,0.262916939175932,68539940,1231,202
0,925,0.1935483870967742,0.3671625929861849,67154640,1147,222
0,573,0.2225237449118046,0.4105960264900662,74708760,737,164
0,1172,0.14763636363636365,0.20440251572327045,68544105,1375,203
1,912,0.2990007686395081,0.6406533575317604,67995256,1301,389
0,5124,0.12185089974293059,0.1420534458509142,67706562,5835,711
0,3205,0.20412217531661286,0.359518754423213,67706653,4027,822
1,1401,0.2684073107049608,0.6061439706556625,78045842,1915,514
1,251,0.3693467336683417,0.856929955290611,70760921,398,147
0,2858,0.22798487304159915,0.3953565505804312,70641235,3702,844
0,790,0.16046758767268862,0.23619371282922685,68533955,941,151
1,766,0.3203194321206744,0.7750449910017997,82016324,1127,361
1,452,0.26742301458670986,0.6057585825027686,67551722,617,165
0,929,0.18580192813321647,0.329319686935581,67556496,1141,212
2,2273,0.5922869955156951,0.977982385908727,70110152,5575,3302
1,1585,0.27954545454545454,0.5392670157068062,80127527,2200,615
0,386,0.12669683257918551,0.19101123595505617,68018020,442,56
1,86,0.3064516129032258,0.7475728155339806,70420462,124,38
0,2623,0.0851063829787234,0.09479305740987984,70617855,2867,244
0,666,0.06853146853146853,0.06205250596658711,70643195,715,49
1,561,0.4505386875612145,0.9186652763295099,68258351,1021,460
1,1645,0.26758682101513803,0.6448129579637486,70614530,2246,601
0,1201,0.17058011049723756,0.33120476798637716,67717580,1448,247
1,11036,0.3522713933560277,0.7895543353339293,67755345,17038,6002
1,6914,0.40662547202197047,0.8813897194930941,71255604,11652,4738
1,2111,0.29562896229562896,0.7078413563427187,70626983,2997,886
0,4855,0.1878554700568752,0.2862490641377589,70641375,5978,1123
0,538,0.24649859943977592,0.46685472496473907,70644805,714,176
1,672,0.34757281553398056,0.82109375,63445382,1030,358
0,1371,0.09683794466403162,0.11150175791059769,68553653,1518,147
0,1196,0.1021021021021021,0.13933547695605572,70617680,1332,136
1,1707,0.2925818483215914,0.6924947880472551,64410290,2413,706
1,949,0.3464187327823691,0.8107928047968022,63445305,1452,503
1,951,0.343232044198895,0.8097165991902834,63445326,1448,497
0,3060,0.13559322033898305,0.242451967063129,68155892,3540,480
1,3633,0.24922504649721017,0.5207715133531158,82204815,4839,1206
1,508,0.30506155950752395,0.715261958997722,72439563,731,223
1,1396,0.44974379188017344,0.9100817438692098,70677054,2537,1141
1,3052,0.29709811146936893,0.6775732788002726,74946375,4342,1290
1,2162,0.4387331256490135,0.9280597014925374,66005583,3852,1690
0,25,0.1935483870967742,0.22950819672131148,68401970,31,6
1,26,0.2777777777777778,0.5254237288135594,68401984,36,10
1,132,0.3465346534653465,0.7364620938628159,68401991,202,70
0,1401,0.11553030303030302,0.12039417309340189,80121135,1584,183
1,369,0.45089285714285715,0.9308510638297872,68036374,672,303
1,883,0.3058176100628931,0.6026443980514962,69458431,1272,389
1,338,0.471875,0.9415692821368948,73538563,640,302
0,1716,0.2568211346903421,0.47989556135770234,80130622,2309,593
1,1155,0.25961538461538464,0.5594675826534994,65308796,1560,405
1,1001,0.27093954843408596,0.6010587102983638,65312835,1373,372
0,620,0.1809775429326288,0.24776119402985075,69606950,757,137
0,1574,0.11223914269599548,0.16555343511450382,68156046,1773,199
0,749,0.17420066152149946,0.32961309523809523,68538085,907,158
0,2779,0.15966132446325976,0.29904458598726114,70252574,3307,528
0,1555,0.13273842721695484,0.24794188861985472,70252581,1793,238
0,1485,0.12285883047844064,0.18859649122807018,70252672,1693,208
1,794,0.49232736572890023,0.952156862745098,70202146,1564,770
0,3987,0.1066547165583688,0.12268102932375823,68333951,4463,476
1,759,0.26808100289296044,0.5231910946196661,70604800,1037,278
0,4112,0.10218340611353711,0.0961910910264687,73399592,4580,468
1,1117,0.29079365079365077,0.6820779220779221,80109295,1575,458
1,459,0.27716535433070866,0.6462646264626463,66883166,635,176
1,2082,0.2288888888888889,0.510652688535678,68543482,2700,618
0,3240,0.15756630265210608,0.2564167725540025,80130322,3846,606
1,1291,0.25202780996523755,0.5844789356984479,80118544,1726,435
0,598,0.13956834532374102,0.21308576480990274,60512711,695,97
1,1446,0.40931372549019607,0.8791684711996536,70183071,2448,1002
1,1271,0.306979280261723,0.697503671071953,68989515,1834,563
2,294,0.6765676567656765,0.9860869565217392,80181567,909,615
1,3818,0.2574873590042785,0.5766406608536025,80125439,5142,1324
0,2072,0.2166351606805293,0.437807679684936,60900833,2645,573
0,4254,0.22640480087288598,0.4302418283284613,64179850,5499,1245
0,427,0.16926070038910507,0.2962962962962963,68497023,514,87
0,1248,0.04294478527607362,0.05305191100969766,70001365,1304,56
0,1217,0.15013966480446927,0.2458307597282273,68537693,1432,215
1,721,0.2775551102204409,0.7078651685393258,80121183,998,277
0,12161,0.07203357497138496,0.05049769361495508,68539310,13105,944
2,107,0.6007462686567164,0.9747474747474747,61500565,268,161
0,2672,0.1164021164021164,0.12547528517110265,68538946,3024,352
1,2173,0.24757617728531855,0.5348900352973119,70179480,2888,715
1,892,0.3985165205664194,0.8635097493036211,80153463,1483,591
1,6627,0.3193303204601479,0.7349680448676145,72474521,9736,3109
0,1201,0.14519572953736654,0.3129210042865891,63092771,1405,204
2,1047,0.5044959772834832,0.9611992945326279,70676886,2113,1066
1,896,0.3925423728813559,0.9002732240437158,68210765,1475,579
0,945,0.19299743808710504,0.3436095054592164,68545484,1171,226
1,531,0.30223390275952694,0.7776717557251909,70618226,761,230
0,3389,0.12406306539157405,0.11432637571157495,68544280,3869,480
0,3122,0.24698504582730343,0.4879864636209814,64135141,4146,1024
1,2550,0.35344827586206895,0.757262996941896,69630155,3944,1394
1,219,0.344311377245509,0.8529411764705882,65249142,334,115
1,154,0.45195729537366547,0.9816272965879265,66379621,281,127
0,19,0.17391304347826086,0.19718309859154928,69183863,23,4
1,2182,0.3088375039594552,0.7223001402524544,80181384,3157,975
1,559,0.24663072776280323,0.608499095840868,80121170,742,183
1,635,0.23860911270983212,0.510654490106545,69869485,834,199
0,489,0.1092896174863388,0.23129251700680273,60312903,549,60
0,273,0.1875,0.352,69601700,336,63
1,299,0.2981220657276995,0.7203791469194313,79520042,426,127
1,818,0.231924882629108,0.5292535305985205,66931543,1065,247
1,837,0.31054365733113676,0.7073897497020262,54045873,1214,377
1,201,0.2690909090909091,0.5601577909270217,54045880,275,74
1,5082,0.27264920566766854,0.5608391608391609,69616834,6987,1905
2,2,0.7777777777777778,0.75,80127025,9,7
1,3098,0.2657027731689974,0.6201423097974822,68531001,4219,1121
0,3619,0.2016324729759541,0.44372023063424415,307496,4533,914
0,3931,0.049334945586457075,0.06063100137174211,67837056,4135,204
0,2046,0.18421052631578946,0.4099462365591398,68312195,2508,462
0,1795,0.05026455026455026,0.07453416149068323,70001190,1890,95
1,866,0.42228152101400934,0.9295180722891566,65278472,1499,633
0,1450,0.15795586527293845,0.24390243902439024,80119369,1722,272
0,678,0.12062256809338522,0.19704433497536947,80140146,771,93
2,208,0.5657620041753654,0.9162303664921466,80137989,479,271
1,868,0.24521739130434783,0.5524625267665952,67154584,1150,282
0,213,0.13414634146341464,0.24242424242424243,70627333,246,33
0,2417,0.15959666203059805,0.2558014031300594,69094046,2876,459
1,1316,0.32199896960329727,0.7679343128781331,73148376,1941,625
0,1165,0.21443020903573837,0.3779411764705882,69607930,1483,318
1,7426,0.3497942386831276,0.7826825127334465,80159820,11421,3995
2,249,0.5088757396449705,0.9314775160599572,69662873,507,258
0,2629,0.14197127937336815,0.19925313416911175,68535243,3064,435
0,5655,0.04444068942210206,0.022838499184339316,80122725,5918,263
1,774,0.23214285714285715,0.5277777777777778,10402,1008,234
0,914,0.21612349914236706,0.46364242828552366,67291931,1166,252
0,3856,0.23734177215189872,0.482610254571531,70178801,5056,1200
0,1078,0.11202635914332784,0.13613013698630136,82009375,1214,136
0,470,0.18118466898954705,0.33043478260869563,73637634,574,104
1,246,0.27218934911242604,0.6366559485530546,69621300,338,92
1,701,0.29120323559150657,0.6802919708029197,80108322,989,288
1,346,0.26849894291754756,0.6204379562043796,66912076,473,127
1,1731,0.31336771122570406,0.7352816603134266,69092184,2521,790
1,2911,0.330188679245283,0.7492780257285376,69573574,4346,1435
1,6843,0.2968557336621455,0.6424488567990373,67755324,9732,2889
0,7896,0.15324396782841823,0.20641738251642244,67886350,9325,1429
1,975,0.3929016189290162,0.832046332046332,68189716,1606,631
1,191,0.34812286689419797,0.6983372921615202,69150823,293,102
0,109,0.2158273381294964,0.4602272727272727,70078260,139,30
0,272,0.14195583596214512,0.3447488584474886,70078442,317,45
1,919,0.3913907284768212,0.8349514563106796,70925806,1510,591
0,96,0.010309278350515464,0.004807692307692308,72545914,97,1
0,44,0.18518518518518517,0.3680555555555556,72546250,54,10
0,211,0.06637168141592921,0.16752577319587628,72669261,226,15
0,1133,0.2037947997189037,0.41354115927910373,73266375,1423,290
0,578,0.08832807570977919,0.24720244150559512,80116953,634,56
0,6512,0.19694166974966087,0.36682674547469524,80172715,8109,1597
2,431,0.5157303370786517,0.961646398503274,82050118,890,459
1,1178,0.3690412426352437,0.8068599428338097,73002062,1867,689
1,2108,0.2476802284082798,0.5183089214380826,74554473,2802,694
2,320,0.5084485407066052,0.9510939510939511,80123458,651,331
0,6626,0.0950559956296094,0.10738892848657638,80127894,7322,696
1,235,0.35082872928176795,0.7389473684210527,81989269,362,127
0,4,0.2,0.38461538461538464,82010289,5,1
0,1032,0.135678391959799,0.19474835886214442,82011998,1194,162
0,77,0.06097560975609756,0.12987012987012986,82019471,82,5
0,107,0.036036036036036036,0.07106598984771574,82022516,111,4
1,913,0.3276877761413844,0.7025920873124147,80096254,1358,445
0,1517,0.08171912832929783,0.2058636073932441,80096324,1652,135
0,2203,0.25017018379850237,0.48925848925848925,80137922,2938,735
1,56,0.3563218390804598,0.7305699481865285,82002264,87,31
2,10,0.5238095238095238,0.8947368421052632,80094882,21,11
1,85,0.3656716417910448,0.7555555555555555,82007146,134,49
0,1232,0.20974983964079538,0.4597285067873303,80098382,1559,327
0,414,0.09606986899563319,0.11876988335100742,82012540,458,44
1,220,0.29260450160771706,0.6719817767653758,72417114,311,91
0,1960,0.15626345243219975,0.20875576036866358,68689033,2323,363
0,1692,0.24933451641526175,0.4725330620549339,68689054,2254,562
2,1,0.9166666666666666,0.5,75264343,12,11
0,37,0.3728813559322034,0.35714285714285715,80118325,59,22
0,835,0.24021838034576887,0.48281786941580757,70729456,1099,264
0,2297,0.24341238471673254,0.4918032786885246,70729505,3036,739
0,2426,0.21792392005157962,0.388909426987061,70729533,3102,676
1,122,0.4429223744292237,0.8598484848484849,69108711,219,97
1,147,0.27941176470588236,0.5382716049382716,65172331,204,57
0,2,0.0,0.0,80126960,2,0
2,530,0.5470085470085471,0.9744463373083475,81989263,1170,640
1,892,0.3536231884057971,0.7489768076398363,54293841,1380,488
0,1336,0.13133940182054615,0.14084507042253522,70645085,1538,202
0,703,0.2607781282860147,0.4777542372881356,70646583,951,248
1,940,0.46772366930917325,0.9094908862350722,70758023,1766,826
1,1362,0.4964879852125693,0.9535759096612296,64292522,2705,1343
0,1221,0.1903183023872679,0.4729559748427673,70649222,1508,287
1,246,0.27647058823529413,0.7564575645756457,68538610,340,94
1,1912,0.24813212740857254,0.6483142592019796,63499884,2543,631
1,314,0.40304182509505704,0.8189102564102564,70576744,526,212
1,1224,0.2411655300681959,0.5315358690418873,80121082,1613,389
0,1669,0.1574962140333165,0.23045871559633027,80139717,1981,312
1,2007,0.48259860788863107,0.937842190016103,67230541,3879,1872
1,9184,0.23872679045092837,0.6263866877971473,70691152,12064,2880
1,53,0.47,0.9421487603305785,80150945,100,47
1,40,0.2857142857142857,0.7785714285714286,64000713,56,16
0,925,0.1537053979871912,0.41150195421552205,69660010,1093,168
0,703,0.235038084874864,0.4504792332268371,67557511,919,216
1,845,0.2475512021371327,0.5014409221902018,67557532,1123,278
0,1699,0.2384580905423577,0.48005698005698005,69608063,2231,532
0,560,0.21678321678321677,0.48814814814814816,80116603,715,155
1,628,0.2620446533490012,0.6145833333333334,81976685,851,223
1,4875,0.24195303996268078,0.5168416447944006,66409273,6431,1556
1,1727,0.2584800343495062,0.5900443880786304,80137638,2329,602
1,395,0.3045774647887324,0.7675606641123882,70627564,568,173
1,265,0.36754176610978523,0.7866108786610879,72512636,419,154
1,65,0.3010752688172043,0.6578947368421053,66857203,93,28
1,1079,0.4002223457476376,0.8807556080283353,67994395,1799,720
0,3230,0.1375166889185581,0.15592814371257485,67553941,3745,515
0,315,0.012539184952978056,0.020833333333333332,62839315,319,4
0,434,0.029082774049217,0.07446808510638298,62839455,447,13
1,1714,0.3805565594506686,0.8676855895196507,80110821,2767,1053
0,6574,0.16763737655102556,0.25858455586006773,60047022,7898,1324
1,14852,0.3462452680693723,0.7948369565217391,69586321,22718,7866
0,3115,0.2145738779626828,0.4543534381600563,70219702,3966,851
1,5041,0.40244191559981035,0.8766700924974307,69187006,8436,3395
1,760,0.23154701718907988,0.5974702380952381,69395375,989,229
1,419,0.3453125,0.7948717948717948,66856965,640,221
1,402,0.3547351524879615,0.7311320754716981,70489636,623,221
0,796,0.255378858746492,0.4988235294117647,69150844,1069,273
1,667,0.4718923198733175,0.9201651754989677,69588995,1263,596
1,1988,0.44854368932038835,0.9132631578947369,64292550,3605,1617
1,3387,0.46669815777042983,0.9269810869044769,70795095,6351,2964
2,363,0.5744431418522861,0.976,72315390,853,490
2,2037,0.5793929382614083,0.9845535990114304,70178626,4843,2806
0,136,0.12258064516129032,0.33136094674556216,69886355,155,19
0,145,0.10493827160493827,0.37402597402597404,69886502,162,17
0,188,0.10900473933649289,0.33642691415313225,69886810,211,23
1,103,0.14166666666666666,0.5054545454545455,69887405,120,17
0,142,0.10126582278481013,0.33519553072625696,70597800,158,16
0,458,0.17625899280575538,0.276510067114094,66471391,556,98
0,4183,0.14247642476424766,0.16798767062967856,68544322,4878,695
1,7464,0.3113755881538887,0.7227117847491482,70599256,10839,3375
1,1021,0.2753726046841732,0.6380487804878049,71444583,1409,388
1,1946,0.4741961631991354,0.9346801346801347,79145976,3701,1755
1,731,0.33180987202925044,0.726517571884984,69617926,1094,363
1,584,0.3105076741440378,0.7236598890942699,62945421,847,263
1,457,0.3117469879518072,0.7637795275590551,70070742,664,207
1,1591,0.2409351145038168,0.5484029484029485,68538792,2096,505
1,3665,0.22483079526226735,0.5665045464157327,69638625,4728,1063
1,621,0.3308189655172414,0.7839285714285714,82008909,928,307
1,650,0.31650893796004204,0.6924242424242424,61022724,951,301
0,6589,0.23472706155632986,0.42025316455696204,70641186,8610,2021
1,1252,0.27671865973425763,0.5854341736694678,70676333,1731,479
0,611,0.16186556927297668,0.26802621995630005,82000146,729,118
1,1219,0.35365853658536583,0.777,70924224,1886,667
0,1493,0.0610062893081761,0.11599099099099099,69625710,1590,97
1,115,0.2721518987341772,0.5850144092219021,72932286,158,43
0,332,0.07520891364902507,0.08986615678776291,80124166,359,27
1,1775,0.2542016806722689,0.5155024280911468,65330412,2380,605
0,514,0.23168908819133036,0.4349442379182156,68191144,669,155
0,4394,0.1412937267930428,0.2924390243902439,66741885,5117,723
1,2536,0.3078602620087336,0.6757377049180328,67706891,3664,1128
0,1835,0.1905602117335686,0.31016679904686256,70645645,2267,432
1,416,0.4074074074074074,0.8388017118402282,80174680,702,286
1,1405,0.26937077483099325,0.6719963453631795,80111815,1923,518
0,808,0.053864168618266976,0.1870066788099575,62835521,854,46
0,196,0.034482758620689655,0.0944206008583691,66389176,203,7
0,543,0.2352112676056338,0.4719424460431655,80181376,710,167
1,495,0.1804635761589404,0.5816593886462882,82049141,604,109
0,43,0.21818181818181817,0.3707865168539326,69056743,55,12
1,1543,0.28031716417910446,0.6530343007915568,69668753,2144,601
1,1329,0.42912371134020616,0.9367789570835257,66471160,2328,999
1,1000,0.27325581395348836,0.6368098159509202,70278334,1376,376
1,1787,0.3223359878649981,0.7490414778668526,80132300,2637,850
0,1800,0.1662806855025475,0.2539918306721129,80139719,2159,359
1,3006,0.3378854625550661,0.806993006993007,67553066,4540,1534
1,1223,0.27889150943396224,0.6097672295755363,65474836,1696,473
0,2029,0.24572490706319702,0.4782487451199108,67557525,2690,661
2,99,0.5875,0.9806763285024155,69622714,240,141
2,808,0.7117374241883696,0.99528672427337,69588960,2803,1995
0,899,0.18346957311534967,0.3142361111111111,68534732,1101,202
1,318,0.26558891454965355,0.609167671893848,73226475,433,115
1,948,0.373015873015873,0.8515376458112407,64331344,1512,564
1,1485,0.44130925507900676,0.9456771231828616,80125349,2658,1173
1,1190,0.26633785450061653,0.609995537706381,63282940,1622,432
0,3419,0.21994067989961213,0.437255859375,80125474,4383,964
0,1442,0.13859020310633213,0.1423455684870188,63264313,1674,232
2,1040,0.510818438381938,0.9542211652794292,64244236,2126,1086
1,575,0.49249779346866723,0.9303991811668373,64244271,1133,558
1,1272,0.25220458553791886,0.6376288659793814,80121168,1701,429
0,2952,0.06345177664974619,0.1214221150949081,69575114,3152,200
0,3141,0.06933333333333333,0.13492489270386265,69575541,3375,234
0,1202,0.09419743782969103,0.1151947339550192,70642712,1327,125
0,566,0.22145804676753783,0.4427402862985685,66622556,727,161
0,263,0.27146814404432135,0.37398373983739835,62168400,361,98
0,3826,0.1465536471113094,0.17432273262661954,69705083,4483,657
1,175,0.24892703862660945,0.5272108843537415,66471216,233,58
1,1576,0.38389366692728694,0.8801668562760713,67557945,2558,982
1,11111,0.2597601598934044,0.5729255513585964,80130316,15010,3899
0,4598,0.2021516571230262,0.42772533777531,70219632,5763,1165
1,4544,0.4011597258829731,0.8711958851264466,66695552,7588,3044
1,350,0.3230174081237911,0.688135593220339,69177234,517,167
2,174,0.5112359550561798,0.9566473988439307,70748314,356,182
0,820,0.20925747348119575,0.42671394799054374,66409910,1037,217
0,360,0.2087912087912088,0.34774436090225563,67705911,455,95
1,148,0.4008097165991903,0.8705357142857143,80127934,247,99
1,1916,0.42167220042257775,0.8996809641970932,67145960,3313,1397
1,1760,0.2657488527325824,0.6184006211180124,80121063,2397,637
1,922,0.22845188284518828,0.5433021806853583,73194996,1195,273
1,1369,0.34497607655502394,0.7365937365937366,70201831,2090,721
2,529,0.5268336314847942,0.9756637168141593,70215670,1118,589
0,628,0.1736842105263158,0.30656934306569344,62768104,760,132
1,2150,0.25321292115317817,0.5624821275378896,80119387,2879,729
1,300,0.1780821917808219,0.5482093663911846,70113526,365,65
1,382,0.4289985052316891,0.8825214899713467,80165226,669,287
0,3171,0.1575451647183847,0.20502851218247797,67555600,3764,593
2,417,0.5005988023952096,0.96,69056526,835,418
0,1491,0.18435448577680524,0.2809168443496802,70601454,1828,337
1,1938,0.31784582893347413,0.68573832562053,67706765,2841,903
1,214,0.30293159609120524,0.694980694980695,80180104,307,93
0,2032,0.2,0.3702664796633941,70614614,2540,508
0,501,0.09892086330935251,0.09047619047619047,72749173,556,55
0,1649,0.11105121293800539,0.25844346549192365,62413736,1855,206
2,223,0.5392561983471075,0.9680851063829787,80154145,484,261
2,526,0.5231187669990934,0.975609756097561,67683903,1103,577
0,2574,0.17684681803645666,0.2865766024719747,67555124,3127,553
1,434,0.4319371727748691,0.908008658008658,67981991,764,330
0,624,0.2141057934508816,0.40458015267175573,70841652,794,170
0,2777,0.10621177985194721,0.25156610616551267,62413666,3107,330
1,1469,0.3031309297912713,0.726270185112249,66575971,2108,639
0,936,0.08055009823182711,0.18740031897926634,67343241,1018,82
1,966,0.39511584220413276,0.8880484114977307,80125492,1597,631
1,1632,0.2440944881889764,0.5738897396630934,70638211,2159,527
1,4542,0.39294306335204493,0.8473840530043408,64292396,7482,2940
1,593,0.36373390557939916,0.7600827300930714,70598913,932,339
1,825,0.24588665447897623,0.5905621096460791,68537854,1094,269
1,314,0.25943396226415094,0.5987525987525988,74708816,424,110
1,235,0.3128654970760234,0.7037773359840954,69553442,342,107
0,1448,0.17020057306590258,0.2836710369487485,72749180,1745,297
1,3899,0.34668230563002683,0.7802099620281439,67760833,5968,2069
0,465,0.15145985401459855,0.19594594594594594,63279636,548,83
0,2343,0.12769918093819807,0.1374469474371531,67555012,2686,343
1,1651,0.3417065390749601,0.7486222975837219,70628943,2508,857
1,1117,0.3617142857142857,0.8198391420911528,69998194,1750,633
1,1010,0.40094899169632264,0.8610149942329873,80123748,1686,676
0,824,0.06681766704416761,0.28613396004700353,82134980,883,59
0,209,0.18359375,0.3450413223140496,68538505,256,47
1,4896,0.25057400887800396,0.6681759379042691,70691222,6533,1637
0,610,0.06153846153846154,0.03642987249544627,69101431,650,40
1,1679,0.35248746625530275,0.80859375,69669026,2593,914
1,1319,0.29615795090715047,0.72021484375,66425205,1874,555
0,877,0.08263598326359832,0.07323026851098453,68628532,956,79
1,968,0.2329635499207607,0.6390328151986183,64000916,1262,294
1,81,0.2831858407079646,0.6190476190476191,80109281,113,32
1,3998,0.2520112254443405,0.6270742358078603,66531402,5345,1347
1,56,0.3253012048192771,0.8164556962025317,82143807,83,27
1,933,0.35876288659793815,0.8349397590361446,70670726,1455,522
0,1289,0.1558611656843484,0.19510926118626432,70729414,1527,238
0,1612,0.217095677513356,0.38939321548017203,70729470,2059,447
0,6306,0.2247356774034915,0.447463768115942,72387441,8134,1828
1,560,0.3094944512946979,0.7092138630600169,65384431,811,251
0,1810,0.224174882126018,0.46950976484655244,69551741,2333,523
0,807,0.07876712328767123,0.06056236481614996,80114132,876,69
0,762,0.16721311475409836,0.2757201646090535,80117911,915,153
0,629,0.20979899497487436,0.3862238622386224,63286783,796,167
0,3050,0.14181204276871132,0.16804489072652096,67554711,3554,504
0,1701,0.17627118644067796,0.3022181146025878,67554725,2065,364
0,2075,0.0993923611111111,0.07395833333333333,67554746,2304,229
0,1628,0.08333333333333333,0.06124234470691164,67555663,1776,148
0,1005,0.11219081272084806,0.08945497630331753,70207935,1132,127
0,4295,0.14747915839618897,0.1870157068062827,82154412,5038,743
1,490,0.3920595533498759,0.8655804480651731,67994360,806,316
1,272,0.3832199546485261,0.8686131386861314,66471104,441,169
1,191,0.35906040268456374,0.7759562841530054,68210891,298,107
0,1689,0.15338345864661654,0.19755501222493888,70645155,1995,306
0,2334,0.15800865800865802,0.22876949740034663,60003195,2772,438
0,3231,0.06672443674176777,0.0520904729266621,62956740,3462,231
0,1021,0.19795758051846032,0.39760410724472334,68535614,1273,252
1,2476,0.2448917352851479,0.5271573604060914,67554165,3279,803
1,2739,0.31729810568295114,0.7474009553245293,77065065,4012,1273
0,2469,0.22039785285759395,0.39528487229862475,70511686,3167,698
1,17237,0.32113741089362374,0.7087388282025819,67286681,25391,8154
0,98,0.19008264462809918,0.45528455284552843,68530812,121,23
1,2050,0.25939306358381503,0.5870445344129555,69652800,2768,718
1,835,0.4039971448965025,0.9232440260680667,68531512,1401,566
0,333,0.06460674157303371,0.26582278481012656,64248562,356,23
1,8269,0.33694170475503166,0.7890002570033411,70225351,12471,4202
1,653,0.2671156004489338,0.5922330097087378,67942812,891,238
1,2907,0.3053763440860215,0.6940258342303552,70638225,4185,1278
0,8578,0.15060897118526587,0.20620033867396118,70909755,10099,1521
1,4139,0.28067431352102884,0.6297938951213149,73818094,5754,1615
1,1131,0.40816326530612246,0.9076644538322269,80110044,1911,780
1,1179,0.36612903225806454,0.845670053217223,65268406,1860,681
1,5610,0.3503184713375796,0.7559733646690169,65830212,8635,3025
1,316,0.39579349904397704,0.9047619047619048,70014070,523,207
0,293,0.2544529262086514,0.4654300168634064,80109162,393,100
1,153,0.2644230769230769,0.5362318840579711,80109190,208,55
1,159,0.22058823529411764,0.5459317585301837,68533780,204,45
1,649,0.30064655172413796,0.6538461538461539,81975576,928,279
0,5456,0.09051508584764127,0.07442078165223497,70206276,5999,543
2,420,0.501779359430605,0.9495798319327731,68191466,843,423
1,84,0.3333333333333333,0.7342342342342343,68616786,126,42
1,6055,0.26801257253384914,0.589751273599041,70395192,8272,2217
0,1136,0.23553162853297444,0.43284290460370195,70649600,1486,350
0,3287,0.1881946159545567,0.3214833759590793,80114125,4049,762
1,2769,0.23381294964028776,0.5003684598378777,82000087,3614,845
1,813,0.26624548736462095,0.6085080147965475,71389220,1108,295
1,1265,0.3492798353909465,0.8213333333333334,65268392,1944,679
0,370,0.05128205128205128,0.23300970873786409,62835136,390,20
0,81,0.012195121951219513,0.014962593516209476,62836333,82,1
0,1615,0.043246445497630334,0.12042788129744651,68255145,1688,73
1,3122,0.2608901515151515,0.5920349684312773,60499782,4224,1102
1,581,0.22013422818791947,0.6373720136518771,66534846,745,164
0,629,0.2282208588957055,0.4818423383525244,68530651,815,186
1,1011,0.2311787072243346,0.5271238485158649,70532854,1315,304
0,1320,0.14396887159533073,0.24538824538824539,72899806,1542,222
0,221,0.10887096774193548,0.20795660036166366,72900520,248,27
0,442,0.08108108108108109,0.10714285714285714,72900534,481,39
0,362,0.14420803782505912,0.2914572864321608,72900562,423,61
0,3340,0.21430251705481063,0.4164319248826291,82011769,4251,911
1,134,0.22093023255813954,0.6449511400651465,65592611,172,38
0,506,0.13504273504273503,0.321285140562249,67343402,585,79
0,581,0.13541666666666666,0.1600407747196738,67555075,672,91
1,237,0.22549019607843138,0.5217391304347826,68538995,306,69
1,377,0.2593320235756385,0.6263736263736264,68539002,509,132
0,1206,0.07444359171143515,0.059164253206454284,68539135,1303,97
0,1243,0.20371556694426649,0.4140992167101828,68541025,1561,318
0,1591,0.16875653082549635,0.3107014388489209,68541865,1914,323
1,1370,0.18257756563245822,0.5602432535157734,69256383,1676,306
1,356,0.24735729386892177,0.5964125560538116,70618443,473,117
1,305,0.254278728606357,0.6341107871720116,80112424,409,104
1,1024,0.3690696241528035,0.8164910105393677,82113165,1623,599
1,652,0.33059548254620125,0.7771639042357275,66470803,974,322
1,898,0.2627257799671593,0.6020463112547119,68237995,1218,320
0,400,0.2263056092843327,0.4926052332195677,70066983,517,117
0,1410,0.14803625377643503,0.4316326530612245,68725566,1655,245
1,562,0.18313953488372092,0.5426587301587301,68725580,688,126
1,191,0.17672413793103448,0.5766871165644172,69887370,232,41
0,1804,0.06480041472265423,0.1683673469387755,73366216,1929,125
0,1866,0.0771513353115727,0.19559003674969375,73366223,2022,156
0,114,0.21379310344827587,0.40594059405940597,64594285,145,31
1,1093,0.2818659658344284,0.6498599439775911,65335991,1522,429
0,91,0.10784313725490197,0.08796296296296297,66459603,102,11
0,125,0.10714285714285714,0.15,66459631,140,15
1,606,0.3333333333333333,0.7313633310946944,68437572,909,303
1,1022,0.3406451612903226,0.8114313629702002,81989528,1550,528
0,1097,0.19868517165814464,0.3834808259587021,80121095,1369,272
0,4295,0.159655644687928,0.22598627787307032,67554592,5111,816
1,804,0.28214285714285714,0.6568446899938613,71358826,1120,316
1,134,0.42735042735042733,0.9227272727272727,69091750,234,100
0,1934,0.09031044214487301,0.11360294117647059,70642572,2126,192
0,857,0.21806569343065693,0.4561186650185414,68537210,1096,239
0,144,0.05263157894736842,0.061946902654867256,69509006,152,8
0,114,0.0,0.0,69509195,114,0
0,3448,0.23784261715296198,0.4867294520547945,69586020,4524,1076
1,117,0.31976744186046513,0.6237113402061856,80111276,172,55
1,2463,0.2938646788990826,0.5867276887871854,65439913,3488,1025
1,835,0.39754689754689754,0.8190546528803545,68185474,1386,551
0,546,0.060240963855421686,0.25337118523775726,62834142,581,35
0,925,0.027339642481598318,0.05851297844258689,62838083,951,26
0,738,0.046511627906976744,0.15831295843520782,64182944,774,36
0,900,0.06444906444906445,0.2420591456736035,66389386,962,62
0,2980,0.05004781638508129,0.12037937743190662,66389414,3137,157
0,2783,0.13972179289026276,0.3320574162679426,80128805,3235,452
1,2421,0.2949912638322656,0.6080649840440964,69546561,3434,1013
0,5024,0.07220683287165282,0.06658809664113141,80122955,5415,391
1,5703,0.3386292473617071,0.7202472952086554,80145307,8623,2920
1,175,0.37050359712230213,0.7563025210084033,81956126,278,103
1,1365,0.23785594639865998,0.5068171133051246,66409651,1791,426
2,13,0.59375,0.9565217391304348,63158410,32,19
2,889,0.5607707509881423,0.9811726734803657,65816716,2024,1135
1,631,0.28295454545454546,0.6454062262718299,68211976,880,249
1,1077,0.2876984126984127,0.6758869512928443,66425135,1512,435
0,709,0.148859543817527,0.20149812734082398,67554641,833,124
0,755,0.12918108419838523,0.14370811615785556,67554655,867,112
1,2870,0.2790756091434313,0.6352788023432415,80130300,3981,1111
0,1779,0.1779112754158965,0.31215900233826965,82107804,2164,385
1,926,0.25622489959839356,0.5888563049853373,69159916,1245,319
0,272,0.10819672131147541,0.33053691275167785,62413785,305,33
0,978,0.05140640155189137,0.1065891472868217,62413932,1031,53
0,874,0.19669117647058823,0.36733333333333335,63264243,1088,214
0,1571,0.043239951278928136,0.07289066400399401,73366132,1642,71
0,1575,0.04603270745003028,0.07708014293006636,73366174,1651,76
0,1215,0.05959752321981424,0.10396323951751867,73366195,1292,77
0,545,0.0946843853820598,0.19950433705080545,73366251,602,57
0,1632,0.09933774834437085,0.21315677061085006,73366293,1812,180
0,857,0.1679611650485437,0.48263642806520196,68725524,1030,173
1,984,0.3050847457627119,0.6928792569659443,81967310,1416,432
1,219,0.2980769230769231,0.7188081936685289,81967361,312,93
0,797,0.0775462962962963,0.31543624161073824,82116591,864,67
0,653,0.06446991404011461,0.28184281842818426,82134987,698,45
1,207,0.23616236162361623,0.6223958333333334,68537126,271,64
1,466,0.28417818740399386,0.6708074534161491,67305735,651,185
1,682,0.3811252268602541,0.8551307847082495,76988121,1102,420
1,361,0.420545746388443,0.9400630914826499,66470852,623,262
2,1743,0.5591805766312595,0.9838649155722327,65831171,3954,2211
1,426,0.37168141592920356,0.8827238335435057,66471041,678,252
1,3506,0.4062658763759526,0.8750897343862168,72748970,5905,2399
0,1875,0.055415617128463476,0.09307553956834533,70001232,1985,110
2,797,0.5542505592841164,0.9749455337690632,79326121,1788,991
0,363,0.22929936305732485,0.4498567335243553,69625416,471,108
1,454,0.4983425414364641,0.9489144316730523,67556034,905,451
1,2150,0.3960674157303371,0.8689320388349514,69573560,3560,1410
0,685,0.10222804718217562,0.09984276729559749,80119307,763,78
0,1327,0.03279883381924198,0.04788909892879647,62413904,1372,45
0,140,0.07894736842105263,0.3131578947368421,62414163,152,12
1,414,0.23616236162361623,0.6997690531177829,67809791,542,128
1,2716,0.29178617992177314,0.6409128402529557,67994941,3835,1119
1,1013,0.37738168408113093,0.8545232273838631,67995011,1627,614
1,1264,0.26125073056691994,0.5472614840989399,80180143,1711,447
1,144,0.15789473684210525,0.5478723404255319,60552786,171,27
0,1356,0.07059629883481837,0.2089238845144357,69575485,1459,103
0,149,0.04487179487179487,0.22718446601941747,80149932,156,7
1,215,0.27364864864864863,0.5883620689655172,80107622,296,81
0,2023,0.10248447204968944,0.0946812523576009,65906421,2254,231
0,428,0.21467889908256882,0.38516405135520687,67666130,545,117
1,147,0.27941176470588236,0.6313131313131313,70912695,204,57
1,1908,0.4100185528756957,0.88296488946684,66695636,3234,1326
1,352,0.2917505030181087,0.6651376146788991,62722506,497,145
0,248,0.1895424836601307,0.2727272727272727,62722520,306,58
1,128,0.2808988764044944,0.5982142857142857,65918965,178,50
1,1803,0.2577192260189378,0.50917626973965,66426773,2429,626
1,817,0.41010830324909747,0.9155844155844156,65268364,1385,568
1,24,0.3684210526315789,0.8260869565217391,65279816,38,14
1,1407,0.2435483870967742,0.550682261208577,80110366,1860,453
1,2092,0.27637495676236595,0.62709188506473,69092023,2891,799
2,139,0.718052738336714,0.9901639344262295,70073864,493,354
1,550,0.1887905604719764,0.5854077253218885,64001154,678,128
0,596,0.1617440225035162,0.3146687697160883,80070774,711,115
0,315,0.14402173913043478,0.20207253886010362,66087280,368,53
1,668,0.2602436323366556,0.5708920187793427,67557105,903,235
0,1990,0.2340261739799846,0.4752306115476597,68462681,2598,608
0,5485,0.11489430369533646,0.1208348590259978,69032740,6197,712
1,1540,0.2380009896091044,0.5616169544740973,70638204,2021,481
0,1812,0.19107142857142856,0.37471264367816093,68621672,2240,428
0,368,0.18584070796460178,0.2965964343598055,73884531,452,84
1,230,0.4221105527638191,0.9148073022312373,67995865,398,168
1,451,0.3638928067700987,0.8052147239263804,80118402,709,258
1,779,0.4634986225895317,0.9163468917881811,70795130,1452,673
0,207,0.2247191011235955,0.4072727272727273,69168554,267,60
1,2498,0.27468060394889665,0.6180010465724751,69585985,3444,946
0,1150,0.07704654895666131,0.1585932315859323,73366335,1246,96
0,1156,0.0759392486011191,0.1511627906976744,73366370,1251,95
0,4491,0.19299191374663072,0.46137667304015295,69638772,5565,1074
1,4469,0.34986907186499855,0.7867184609692934,70864731,6874,2405
0,3105,0.12805391743892164,0.14750251424740193,67706674,3561,456
1,2207,0.2744904667981591,0.5619291194738765,67706772,3042,835
1,218,0.47721822541966424,0.9548532731376975,63099162,417,199
0,693,0.09530026109660575,0.2518043303929431,62413750,766,73
0,1033,0.04085422469823584,0.05034612964128383,64252272,1077,44
1,1542,0.34355044699872284,0.8256842105263158,68531400,2349,807
1,2827,0.33088757396449703,0.7854088050314465,70642782,4225,1398
1,774,0.4853723404255319,0.9469387755102041,67290720,1504,730
1,13,0.3157894736842105,0.62,73590041,19,6
1,2978,0.3193142857142857,0.7650955414012739,80118421,4375,1397
1,2914,0.2237613212573255,0.5167973124300111,68211381,3754,840
0,2530,0.2046526249607042,0.37339479749753046,69073445,3181,651
1,86,0.24561403508771928,0.5374449339207048,77676396,114,28
1,85,0.23423423423423423,0.5042016806722689,82143796,111,26
1,181,0.3822525597269625,0.77,69150802,293,112
0,1987,0.035904900533721494,0.026651216685979143,80137163,2061,74
1,224,0.36363636363636365,0.8271334792122538,80109603,352,128
1,513,0.3781818181818182,0.7875399361022364,73331020,825,312
1,2269,0.30717557251908395,0.6219956300072833,80131113,3275,1006
0,331,0.15776081424936386,0.4641350210970464,70649131,393,62
0,601,0.20921052631578949,0.35255570117955437,80114664,760,159
0,502,0.03275529865125241,0.04005340453938585,80124210,519,17
0,118,0.06349206349206349,0.19850187265917604,80124306,126,8
0,359,0.01643835616438356,0.021352313167259787,80124383,365,6
0,104,0.06306306306306306,0.22167487684729065,80124440,111,7
0,64,0.1794871794871795,0.26282051282051283,70566741,78,14
1,1782,0.26211180124223604,0.5747085835393854,68211934,2415,633
0,887,0.20944741532976827,0.43593130779392336,68542495,1122,235
1,952,0.22664500406173843,0.5272151898734178,68543496,1231,279
1,1094,0.2274011299435028,0.5231560891938251,80110373,1416,322
0,74,0.25252525252525254,0.475,68333804,99,25
1,98,0.3,0.5664335664335665,73459673,140,42
1,284,0.37719298245614036,0.7972768532526475,82059495,456,172
1,408,0.37327188940092165,0.7602179836512262,82059497,651,243
1,12,0.45454545454545453,0.9024390243902439,66616130,22,10
1,433,0.25215889464594127,0.6053082191780822,72760436,579,146
0,1413,0.23248234655078762,0.49802839116719244,81988948,1841,428
1,3966,0.3068857042991961,0.7025825571549534,80180161,5722,1756
1,231,0.3565459610027855,0.8083491461100569,66471020,359,128
1,1851,0.30674157303370786,0.6790859413810233,66426752,2670,819
0,1273,0.17551813471502592,0.3296492071119654,68534900,1544,271
1,1227,0.2731042654028436,0.620876415558838,70597716,1688,461
1,520,0.2757660167130919,0.70298769771529,66931921,718,198
2,380,0.5749440715883669,0.973724884080371,68383700,894,514
2,1526,0.5183080808080808,0.9639573372563442,64507100,3168,1642
2,91,0.5973451327433629,0.985781990521327,68280982,226,135
0,242,0.15087719298245614,0.4228456913827655,70629440,285,43
0,1816,0.15964831096714485,0.3162258191867351,81965676,2161,345
0,5982,0.034538411878631374,0.027829660067239446,80145379,6196,214
0,676,0.23615819209039549,0.4720670391061452,68163760,885,209
0,880,0.13043478260869565,0.16855524079320114,68645031,1012,132
0,3698,0.18203937182039373,0.2962268572767753,70601636,4521,823
0,147,0.09815950920245399,0.13479623824451412,82011788,163,16
0,140,0.07894736842105263,0.05847953216374269,82011789,152,12
0,3025,0.07123119435062941,0.060804769001490316,82012543,3257,232
1,1020,0.3359375,0.7881650919940328,68810560,1536,516
1,207,0.4152542372881356,0.9055690072639225,67555845,354,147
0,6669,0.1977625405990617,0.31686810299527063,67286765,8313,1644
1,755,0.28026692087702576,0.6107954545454546,68112464,1049,294
1,723,0.37294015611448394,0.8312267657992565,69573546,1153,430
0,2596,0.04698972099853157,0.022647403358063256,64163722,2724,128
0,5743,0.1402694610778443,0.14435033339340422,67553920,6680,937
0,4593,0.12397482357428953,0.12188593782170064,67555040,5243,650
0,4077,0.08402606155920019,0.07365023474178403,70206311,4451,374
0,4983,0.1571380243572395,0.21170809943865276,82154400,5912,929
1,818,0.313758389261745,0.7235072619688004,70543592,1192,374
0,1090,0.18838421444527179,0.3763157894736842,66931550,1343,253
0,640,0.1478029294274301,0.21068938807126258,76932261,751,111
1,146,0.4362934362934363,0.960431654676259,68210793,259,113
0,2785,0.20086083213773315,0.343001971275697,68532940,3485,700
0,251,0.11929824561403508,0.3126801152737752,78763461,285,34
0,169,0.22119815668202766,0.4765432098765432,67159694,217,48
1,698,0.30685203574975173,0.7487644151565074,80121280,1007,309
0,668,0.20665083135391923,0.30640083945435465,81956103,842,174
0,1187,0.1768377253814147,0.229375,81956106,1442,255
1,82,0.47435897435897434,0.9366197183098591,75330976,156,74
1,4787,0.2370098820529168,0.5881706647134225,68162311,6274,1487
2,256,0.6179104477611941,0.9787878787878788,70185661,670,414
0,814,0.19723865877712032,0.364762560220234,67721892,1014,200
0,960,0.2026578073089701,0.3650904033379694,67721913,1204,244
0,1125,0.19122933141624732,0.3277066356228172,67721934,1391,266
2,97,0.5125628140703518,0.9585062240663901,75330983,199,102
1,366,0.2606060606060606,0.5911330049261084,68536041,495,129
1,629,0.3515463917525773,0.8481797056545314,68536076,970,341
1,1067,0.31382636655948554,0.747677261613692,80120443,1555,488
1,3253,0.3359869361094101,0.7803893637226971,80132193,4899,1646
0,986,0.17489539748953975,0.34806629834254144,70642803,1195,209
0,899,0.222318339100346,0.42089771891096395,66471223,1156,257
0,595,0.14511494252873564,0.1750255885363357,66471286,696,101
1,601,0.36469344608879495,0.8643092105263158,67553213,946,345
0,704,0.2314410480349345,0.4965034965034965,68541991,916,212
0,1338,0.1606022584692597,0.2449459332393042,68542040,1594,256
1,84,0.22935779816513763,0.5413223140495868,68785143,109,25
0,1827,0.1074743527112848,0.08266666666666667,70870933,2047,220
0,555,0.112,0.15087719298245614,67703286,625,70
1,522,0.4,0.8398533007334963,64999865,870,348
1,579,0.3057553956834532,0.7740384615384616,68536384,834,255
0,3229,0.05942324497524031,0.035843472541927,54138735,3433,204
0,5685,0.13206106870229006,0.15651604453176163,68018013,6550,865
0,3186,0.18244803695150116,0.3263131813676908,68537945,3897,711
1,282,0.4050632911392405,0.8773424190800682,67627210,474,192
0,270,0.09698996655518395,0.15327380952380953,70617540,299,29
1,2765,0.24059324361439166,0.5010666666666667,67554151,3641,876
1,1073,0.34890776699029125,0.8265460030165912,80180172,1648,575
1,864,0.3328185328185328,0.7329450915141431,67286793,1295,431
0,1364,0.2115606936416185,0.4133118625872249,68545260,1730,366
0,1799,0.11422944362383063,0.1446917808219178,70615244,2031,232
0,713,0.08706786171574904,0.08120204603580562,70627501,781,68
0,1728,0.18104265402843603,0.33692307692307694,70642775,2110,382
0,3716,0.1107920555156736,0.1192390139335477,80125289,4179,463
1,1059,0.4228882833787466,0.9314320388349514,78921374,1835,776
1,1788,0.33826794966691337,0.7303953337653921,80130348,2702,914
1,1647,0.47329708986248803,0.9107455372768638,80136352,3127,1480
1,2043,0.4424126637554585,0.9007004532344458,65830282,3664,1621
1,316,0.2702078521939954,0.6027164685908319,69636882,433,117
1,1524,0.24554455445544554,0.5396825396825397,70599284,2020,496
1,1404,0.4819188191881919,0.951272100043122,80169868,2710,1306
1,1014,0.23587038432554636,0.5607649599012955,68541466,1327,313
1,1181,0.24343369634849454,0.5288659793814433,68544252,1561,380
0,2903,0.08191018342820999,0.06958849113415858,68628574,3162,259
0,1160,0.16305916305916307,0.25956144824069355,69240220,1386,226
0,1583,0.08655510675129832,0.07836822329575953,68534564,1733,150
0,790,0.1787941787941788,0.32946001367054,68542082,962,172
0,1332,0.17574257425742573,0.2952430196483971,68545533,1616,284
0,2589,0.20460829493087557,0.4179415855354659,69601021,3255,666
0,2756,0.13577924114142365,0.2618392911701803,68311803,3189,433
1,112,0.22758620689655173,0.5756302521008403,70351120,145,33
1,1404,0.26913066111400313,0.5155688622754491,80127930,1921,517
0,65,0.13333333333333333,0.24102564102564103,72522954,75,10
1,90,0.4857142857142857,0.9438943894389439,77994210,175,85
1,1171,0.3976337448559671,0.9030674846625767,67554270,1944,773
0,2138,0.24372125928546162,0.43654114365411434,70676984,2827,689
0,1378,0.20576368876080692,0.3523809523809524,67287584,1735,357
1,453,0.2854889589905363,0.6188212927756654,68211703,634,181
1,276,0.3117206982543641,0.6786296900489397,67994563,401,125
0,943,0.07729941291585127,0.31185270425776757,62834051,1022,79
1,2407,0.48917657045840407,0.9549304295220811,80119015,4712,2305
1,226,0.3505747126436782,0.8180242634315424,69540751,348,122
0,592,0.21066666666666667,0.45327446651949965,72760380,750,158
1,996,0.23969465648854962,0.5510606808090774,80095435,1310,314
0,499,0.1925566343042071,0.35348837209302325,68533514,618,119
0,806,0.17922606924643583,0.30279898218829515,68545554,982,176
2,999,0.5721627408993576,0.9823059360730594,62017214,2335,1336
1,1013,0.2921034241788959,0.6741935483870968,80111374,1431,418
1,1079,0.32052896725440805,0.7300053676865271,69574400,1588,509
1,1161,0.3758064516129032,0.8863035430988895,78863743,1860,699
1,933,0.3691683569979716,0.8770053475935828,78863750,1479,546
0,3907,0.2086287218958882,0.3342453260373917,72749054,4937,1030
0,702,0.21388577827547592,0.4705438066465257,63264523,893,191
1,360,0.3594306049822064,0.7538461538461538,64331113,562,202
0,994,0.2085987261146497,0.358718487394958,71358756,1256,262
1,991,0.31936813186813184,0.7792521109770808,80125507,1456,465
0,1218,0.22469764481222151,0.3855140186915888,81956102,1571,353
1,478,0.33611111111111114,0.8035902851108765,68200531,720,242
0,1491,0.22945736434108527,0.4932754880694143,80119298,1935,444
0,807,0.16373056994818652,0.2735229759299781,70870842,965,158
0,54,0.19402985074626866,0.2746478873239437,67557546,67,13
0,2925,0.060995184590690206,0.0373900293255132,54138756,3115,190
1,1340,0.2584394023242944,0.5664240218380345,66409693,1807,467
1,120,0.38461538461538464,0.8958333333333334,69165530,195,75
0,277,0.1924198250728863,0.38653001464128844,80111822,343,66
0,1300,0.07604832977967306,0.05320366132723112,68534522,1407,107
0,1779,0.07440166493236212,0.06258442143178748,68534536,1922,143
0,2081,0.1996153846153846,0.41593848304788533,68537973,2600,519
1,5956,0.22629254351779682,0.6178665053438194,64399720,7698,1742
1,2406,0.3338870431893688,0.7771720613287905,70748391,3612,1206
0,512,0.15650741350906094,0.2577565632458234,81979800,607,95
0,246,0.15753424657534246,0.25034387895460797,81979804,292,46
1,455,0.234006734006734,0.5126676602086438,82166803,594,139
1,610,0.3398268398268398,0.7386990077177509,68191424,924,314
1,222,0.3867403314917127,0.8333333333333334,68191921,362,140
1,406,0.3333333333333333,0.7971014492753623,67557196,609,203
1,891,0.3060747663551402,0.7015873015873015,80111605,1284,393
0,1700,0.16297390448055146,0.2715453194650817,67963413,2031,331
1,1224,0.31620111731843575,0.7601965601965602,68203555,1790,566
1,393,0.4271137026239067,0.9290030211480362,63099204,686,293
0,1022,0.22926093514328807,0.4849279161205767,80110352,1326,304
1,101,0.26811594202898553,0.6727272727272727,77677012,138,37
0,1020,0.13924050632911392,0.20474406991260924,68536223,1185,165
1,1045,0.2822802197802198,0.653370786516854,70842205,1456,411
1,528,0.2552891396332863,0.603648424543947,80056963,709,181
0,963,0.19883527454242927,0.3746819338422392,80097675,1202,239
1,4351,0.36360977036712006,0.833102355969115,69836074,6837,2486
0,675,0.18674698795180722,0.38717339667458434,70252945,830,155
0,658,0.18057285180572852,0.35650446871896724,80155258,803,145
1,807,0.32298657718120805,0.8099579242636746,67819332,1192,385
1,282,0.20786516853932585,0.6081771720613288,67884201,356,74
0,164,0.15025906735751296,0.47804878048780486,70687575,193,29
0,195,0.15584415584415584,0.21445221445221446,72597721,231,36
1,1231,0.36151452282157676,0.8483045806067817,63445333,1928,697
0,280,0.18840579710144928,0.39603960396039606,67150720,345,65
0,267,0.20771513353115728,0.4034090909090909,68741722,337,70
1,302,0.22564102564102564,0.5377574370709383,69383580,390,88
0,26,0.1875,0.32038834951456313,82103794,32,6
1,214,0.345565749235474,0.8618556701030928,66188276,327,113
1,2169,0.3074712643678161,0.7555416796753044,69531595,3132,963
1,545,0.48438978240302744,0.9182194616977226,70202545,1057,512
0,359,0.18961625282167044,0.298989898989899,67630633,443,84
0,295,0.05448717948717949,0.02195121951219512,67630724,312,17
1,345,0.3575418994413408,0.8529014844804319,67552352,537,192
0,266,0.19637462235649547,0.28685897435897434,67555495,331,65
1,455,0.43196004993757803,0.9312977099236641,67555502,801,346
1,1416,0.33081285444234404,0.8065339458907606,80121185,2116,700
0,1232,0.2236925015752993,0.39408866995073893,74320225,1587,355
1,2729,0.36930899006239887,0.8504509746872272,80110863,4327,1598
1,189,0.48641304347826086,0.9022869022869023,67307310,368,179
1,433,0.3191823899371069,0.6963824289405685,80124672,636,203
1,251,0.25297619047619047,0.5343642611683849,67029620,336,85
1,730,0.27218344965104685,0.6572890025575447,80112102,1003,273
0,6168,0.21396712119281253,0.4122734076168302,80130323,7847,1679
1,76,0.2962962962962963,0.6341463414634146,80110093,108,32
1,1028,0.3534591194968553,0.8513870541611624,80111612,1590,562
1,2716,0.4288117770767613,0.9020979020979021,79790634,4755,2039
1,1007,0.2638888888888889,0.572584997301673,64238853,1368,361
0,1209,0.16907216494845362,0.2650666666666667,68543923,1455,246
1,1004,0.3350993377483444,0.7844671884406984,68531463,1510,506
1,236,0.1945392491467577,0.5101088646967341,63999593,293,57
0,1669,0.06707657909446618,0.12993262752646775,73366244,1789,120
0,2512,0.057057057057057055,0.09554551323434474,73366286,2664,152
1,809,0.27960819234194123,0.6519193233571894,63100016,1123,314
0,743,0.2628968253968254,0.46238532110091746,70644700,1008,265
1,525,0.2895805142083897,0.6934763181411975,71358840,739,214
1,402,0.31399317406143346,0.7463479415670651,80103093,586,184
1,1240,0.2811594202898551,0.6372745490981964,80103100,1725,485
1,1628,0.3081172970675733,0.7303299492385786,80120439,2353,725
1,444,0.37640449438202245,0.8349900596421471,70628705,712,268
0,469,0.2496,0.4668587896253602,73709202,625,156
1,323,0.32142857142857145,0.6572769953051644,70645274,476,153
0,5369,0.23102262961902034,0.47617341454675743,68918115,6982,1613
0,378,0.1782608695652174,0.35501066098081024,80097332,460,82
1,744,0.3291253381424707,0.7243650047036688,66028886,1109,365
1,149,0.25870646766169153,0.7016574585635359,66188290,201,52
0,1825,0.21268334771354616,0.3478476001979218,70653702,2318,493
1,1204,0.2232258064516129,0.5112485939257593,68537812,1550,346
1,2714,0.3594524427661081,0.790424857324033,66695531,4237,1523
1,1460,0.33726736268724467,0.7933785400877543,68236231,2203,743
1,860,0.381294964028777,0.8562628336755647,67994472,1390,530
1,162,0.25,0.5406698564593302,70207550,216,54
2,1216,0.5292295780100658,0.956875,73503304,2583,1367
1,1940,0.2535590611773759,0.5783569778950841,69110650,2599,659
0,1180,0.17482517482517482,0.3300423131170663,70524524,1430,250
1,61,0.21794871794871795,0.5704697986577181,80097430,78,17
0,5704,0.12273146724084896,0.15386078356789654,80119351,6502,798
0,302,0.08761329305135952,0.42099898063200814,69639122,331,29
1,278,0.3835920177383592,0.8836363636363637,65268105,451,173
1,527,0.23401162790697674,0.5016611295681063,69178984,688,161
1,1567,0.4457021577644146,0.936851601262968,63445620,2827,1260
2,358,0.5027777777777778,0.9484029484029484,64399013,720,362
1,2713,0.3392596200681929,0.7554521663274207,67994052,4106,1393
1,2196,0.40744738262277386,0.8753648569760654,70613445,3706,1510
1,273,0.3275862068965517,0.6788830715532286,80180304,406,133
1,832,0.2597864768683274,0.6087231352718079,69603772,1124,292
1,695,0.3658759124087591,0.8239043824701195,67994171,1096,401
0,1607,0.19890329012961117,0.35093167701863354,68545064,2006,399
1,1683,0.24155024785939613,0.5316780821917808,68545071,2219,536
1,1276,0.2507339988256019,0.5402010050251256,68545092,1703,427
1,1943,0.4725841476655809,0.9397513547975773,66364774,3684,1741
0,1251,0.1693227091633466,0.2555685814771395,70645204,1506,255
0,1110,0.12183544303797468,0.23293172690763053,80117999,1264,154
0,7247,0.1398219584569733,0.17007452703993886,70641144,8425,1178
1,3386,0.36245528149124456,0.8366170110523786,69739173,5311,1925
0,426,0.20670391061452514,0.34354194407456723,80097661,537,111
0,2448,0.13589834098129192,0.14446529080675422,70207844,2833,385
1,2660,0.26963207029104885,0.5794277257030094,65312625,3642,982
1,343,0.312625250501002,0.7417302798982188,70207221,499,156
2,894,0.5074380165289256,0.951188986232791,66592834,1815,921
1,964,0.382051282051282,0.8198757763975155,70628922,1560,596
0,2697,0.20932277924362358,0.43017701601573477,73816106,3411,714
0,4000,0.15254237288135594,0.23151706986208456,75893013,4720,720
1,360,0.22077922077922077,0.5370370370370371,68543272,462,102
1,100,0.2753623188405797,0.5762081784386617,68947123,138,38
1,1549,0.34751474304970514,0.7796373779637378,69164732,2374,825
1,272,0.2898172323759791,0.599388379204893,69617933,383,111
1,583,0.345679012345679,0.7617617617617618,70657643,891,308
1,156,0.36065573770491804,0.8070175438596491,80124130,244,88
1,1372,0.36007462686567165,0.7663065226090436,81895988,2144,772
1,1416,0.3034923757993114,0.6948748510131109,80111283,2033,617
2,38,0.62,0.9868421052631579,68290803,100,62
0,1033,0.09781659388646288,0.2778139232270657,62413701,1145,112
2,136,0.8631790744466801,0.9947916666666666,80127841,994,858
0,2385,0.22915319974143503,0.3878466557911909,70644784,3094,709
0,3441,0.16884057971014493,0.22013546798029557,70644833,4140,699
1,2270,0.2468480424684804,0.5423400129282482,69869394,3014,744
0,2392,0.21030042918454936,0.4264448336252189,80121017,3029,637
1,1192,0.3418001104362231,0.6795977011494253,80176753,1811,619
1,711,0.39847715736040606,0.8445807770961146,70628873,1182,471
1,1621,0.47743391360412635,0.9234411996842936,70852663,3102,1481
1,6538,0.4368162632440348,0.9037719037719038,67755331,11609,5071
0,373,0.22129436325678498,0.34394124847001223,70645960,479,106
0,2623,0.1683576410906785,0.3319521178637201,69625724,3154,531
0,1073,0.11248966087675766,0.177938808373591,80124180,1209,136
1,1499,0.2965743782261849,0.7112890922959573,70643160,2131,632
1,2557,0.2768665158371041,0.6543810848400556,70686882,3536,979
0,1755,0.15867689357622244,0.2711864406779661,72368856,2086,331
1,1089,0.30636942675159234,0.6782504493708807,70179011,1570,481
1,487,0.33104395604395603,0.7983293556085919,68532415,728,241
1,391,0.3361629881154499,0.7642956764295676,80109330,589,198
1,217,0.2593856655290102,0.5698198198198198,70197435,293,76
0,1136,0.16224188790560473,0.29958197863446356,70841365,1356,220
1,570,0.1703056768558952,0.5558608058608059,64001966,687,117
1,958,0.3783257624918884,0.807372175980975,68953892,1541,583
1,278,0.41841004184100417,0.8940609951845907,67199363,478,200
1,1224,0.3285792649478881,0.7938894277400582,80121206,1823,599
2,881,0.6542386185243328,0.991899852724595,64244201,2548,1667
1,859,0.2751054852320675,0.5881513204853676,80108105,1185,326
0,448,0.10220440881763528,0.32762312633832974,70908152,499,51
0,159,0.08092485549132948,0.2961876832844575,70908894,173,14
0,543,0.13946117274167988,0.16888193901485535,76932254,631,88
1,288,0.26153846153846155,0.5952080706179067,76932233,390,102
1,7184,0.3766053453661923,0.8444936358605424,947544,11524,4340
1,134,0.3197969543147208,0.7763157894736842,80107944,197,63
1,683,0.40505226480836237,0.8640287769784173,82012002,1148,465
0,915,0.20641803989592367,0.338475499092559,67555250,1153,238
1,449,0.2940251572327044,0.5466472303206997,80176764,636,187
1,216,0.3394495412844037,0.7514910536779325,69637085,327,111
0,1200,0.05660377358490566,0.034375,70617330,1272,72
1,1676,0.2504472271914132,0.5988023952095808,68158251,2236,560
1,252,0.36683417085427134,0.8779342723004695,61408060,398,146
0,1071,0.15602836879432624,0.21222527472527472,66383296,1269,198
1,186,0.3961038961038961,0.8312342569269522,73321535,308,122
1,652,0.4315605928509154,0.8932926829268293,69458515,1147,495
1,1138,0.3115547489413188,0.7520964360587002,80109981,1653,515
1,269,0.3207070707070707,0.6223091976516634,69108704,396,127
0,839,0.2316849816849817,0.47166521360069746,63681625,1092,253
1,666,0.37406015037593987,0.8465499485066942,69154001,1064,398
0,2283,0.19978969505783387,0.33944307366936904,69586426,2853,570
1,1058,0.3329129886506936,0.7952468007312614,69165054,1586,528
0,1727,0.18576143328618577,0.23961661341853036,69705090,2121,394
1,207,0.2935153583617747,0.6187845303867403,76756673,293,86
1,2848,0.48057632682837864,0.9291002277904328,82060767,5483,2635
0,1298,0.11700680272108843,0.1577789994502474,68534396,1470,172
1,77,0.35294117647058826,0.7272727272727273,66272031,119,42
1,976,0.2045639771801141,0.62778730703259,65922493,1227,251
0,783,0.056626506024096385,0.25444096133751304,80149835,830,47
1,499,0.4023952095808383,0.8526682134570766,70192486,835,336
2,157,0.718132854578097,0.9965156794425087,72818711,557,400
0,3691,0.09645042839657282,0.0932475884244373,70609371,4085,394
0,1845,0.15250344510794672,0.19382022471910113,72393272,2177,332
1,585,0.28832116788321166,0.8003875968992248,60909436,822,237
1,541,0.40484048404840484,0.9181890389197777,69066361,909,368
1,37,0.4393939393939394,0.9344262295081968,80180107,66,29
1,925,0.3646978021978022,0.8394415357766143,65268413,1456,531
1,3061,0.2992216117216117,0.6837874050915588,65312695,4368,1307
1,172,0.312,0.6717171717171717,67556062,250,78
1,527,0.38362573099415204,0.9037536092396535,67556146,855,328
1,122,0.3612565445026178,0.7964285714285714,67556153,191,69
1,1410,0.2857142857142857,0.6669569003047453,68532891,1974,564
0,671,0.19253910950661854,0.36659108087679515,68542005,831,160
0,2435,0.12347012239020878,0.11425061425061425,70207865,2778,343
0,512,0.17017828200972449,0.2302771855010661,70644945,617,105
0,453,0.22696245733788395,0.39226519337016574,70645050,586,133
1,819,0.2694023193577163,0.5793103448275863,80108112,1121,302
1,293,0.3056872037914692,0.6450304259634888,80108350,422,129
1,187,0.3392226148409894,0.7911832946635731,80109785,283,96
0,1774,0.07844155844155844,0.07474639615589963,66653531,1925,151
1,100,0.2125984251968504,0.57421875,64000503,127,27
0,663,0.13671875,0.4228007181328546,80165692,768,105
1,1648,0.3201320132013201,0.6887897378694925,70644574,2424,776
0,659,0.193390452876377,0.24481327800829875,70644672,817,158
1,1447,0.37305025996533797,0.8761301989150091,78863771,2308,861
0,2145,0.13228155339805825,0.14166967835200578,67554991,2472,327
0,1048,0.22023809523809523,0.4427750773309766,67168822,1344,296
0,907,0.17168949771689498,0.3969248291571754,81965689,1095,188
0,1107,0.1836283185840708,0.3229107447413303,68542012,1356,249
0,3429,0.2095435684647303,0.40185676392572944,80130324,4338,909
0,2833,0.14745711706289497,0.2227453821079319,67895044,3323,490
1,1058,0.44139387539598735,0.9252124645892351,63445795,1894,836
1,4456,0.3116020392399197,0.7386609071274298,66973074,6473,2017
1,248,0.31301939058171746,0.7722772277227723,69704656,361,113
1,5785,0.3891235480464625,0.8628554051999392,70077350,9470,3685
1,217,0.27906976744186046,0.7270992366412213,80154136,301,84
0,1252,0.23518631643249846,0.46663321625689913,80103114,1637,385
0,4365,0.051705409515533346,0.01824892351855649,68539030,4603,238
0,3869,0.14967032967032967,0.195898312326426,68544336,4550,681
1,255,0.26512968299711814,0.6475849731663685,80135826,347,92
1,1002,0.496735308890005,0.9515951595159516,66592855,1991,989
1,523,0.42716319824753557,0.891286307053942,73321031,913,390
1,1067,0.33972772277227725,0.8322281167108754,80121258,1616,549
1,855,0.3203497615262321,0.7684887459807074,80109554,1258,403
1,1080,0.3220338983050847,0.7566628041714948,80109925,1593,513
0,3670,0.11672683513838748,0.13883299798792756,65291534,4155,485
0,1029,0.1992217898832685,0.38636363636363635,68536846,1285,256
0,878,0.18853974121996303,0.378561736770692,68536881,1082,204
0,217,0.16216216216216217,0.30976430976430974,69417054,259,42
1,2018,0.25972120322817316,0.6101116625310173,70627753,2726,708
2,262,0.6325385694249649,0.9894459102902374,61460812,713,451
0,1282,0.11707988980716254,0.21754385964912282,66226986,1452,170
1,953,0.2697318007662835,0.6412776412776413,68203975,1305,352
2,469,0.6594045025417574,0.986013986013986,65866024,1377,908
0,3429,0.05977515766383329,0.04681084040514646,63336763,3647,218
0,652,0.21256038647342995,0.42093287827076226,66206406,828,176
1,944,0.424039048200122,0.8946015424164524,80159807,1639,695
1,1050,0.27785419532324623,0.6422885572139303,82095519,1454,404
1,2473,0.440624293146347,0.9188658057271196,70070462,4421,1948
1,2212,0.3463356973995272,0.7642956764295676,70628880,3384,1172
1,1531,0.4879598662207358,0.9465478841870824,70677026,2990,1459
2,1661,0.5001504664459826,0.9589538685070832,82151293,3323,1662
1,507,0.33638743455497383,0.7456037514654161,69458725,764,257
0,2614,0.22594018359490672,0.4491662183969876,67480042,3377,763
0,955,0.10580524344569288,0.1162514827995255,68022381,1068,113
0,1137,0.07785888077858881,0.06931246506428172,68022395,1233,96
0,1004,0.08810172570390554,0.0816917728852839,68022402,1101,97
0,701,0.15846338535414164,0.2852919438285292,69633270,833,132
0,398,0.13478260869565217,0.19675675675675675,70524615,460,62
0,609,0.20078740157480315,0.3543859649122807,72411493,762,153
1,742,0.22627737226277372,0.524547803617571,80122393,959,217
1,1127,0.28716002530044277,0.7138350608382155,80176491,1581,454
0,4042,0.12624297449200172,0.15741360089186177,70615615,4626,584
0,1877,0.13222376329172444,0.17972350230414746,70617106,2163,286
1,1334,0.2896698615548456,0.695038494439692,70092904,1878,544
1,3287,0.2581809975174904,0.5275890187550965,80122954,4431,1144
1,770,0.26666666666666666,0.5305841924398625,67640461,1050,280
1,503,0.25920471281296026,0.5452151009657594,73019611,679,176
1,220,0.32926829268292684,0.7936746987951807,65277744,328,108
1,985,0.3523997370151216,0.8280516431924883,73148362,1521,536
0,400,0.18200408997955012,0.30969267139479906,69705132,489,89
1,1966,0.27826725403817915,0.6606145251396648,80125493,2724,758
1,756,0.36894824707846413,0.8784440842787682,70631981,1198,442
0,409,0.15320910973084886,0.2862595419847328,62940605,483,74
0,463,0.074,0.07368421052631578,70200361,500,37
0,2864,0.16208308952603862,0.262586115527292,72368870,3418,554
1,268,0.4933837429111531,0.9580536912751678,73251395,529,261
1,577,0.3022974607013301,0.7142857142857143,69184311,827,250
0,1078,0.1424025457438345,0.19970341077607515,70572523,1257,179
1,1509,0.34731833910034604,0.8052990766760337,70613501,2312,803
0,1312,0.07410021171489062,0.06927710843373494,80118144,1417,105
0,2795,0.06365159128978225,0.05390113162596784,80118149,2985,190
0,102,0.23880597014925373,0.40816326530612246,66857042,134,32
1,1421,0.2489429175475687,0.5064935064935064,80105725,1892,471
1,3932,0.28625884915592664,0.6493850520340586,69707925,5509,1577
1,2397,0.24670018856065368,0.532932235592147,66100916,3182,785
0,2002,0.11845002201673271,0.15973435861586857,70524622,2271,269
1,1674,0.27782571182053495,0.6435643564356436,70545825,2318,644
0,1124,0.10722795869737888,0.14653865588681153,82036712,1259,135
0,317,0.20151133501259447,0.4469135802469136,69701002,397,80
0,309,0.23703703703703705,0.3400900900900901,71288770,405,96
1,189,0.31272727272727274,0.6365979381443299,78118026,275,86
0,235,0.18118466898954705,0.26003824091778205,82046833,287,52
0,3599,0.15595684803001877,0.25393966681674923,68535264,4264,665
0,2376,0.06896551724137931,0.05917721518987342,70617190,2552,176
0,4645,0.07819011708672356,0.07210031347962383,70617841,5039,394
0,3949,0.21615720524017468,0.41424914675767915,58862671,5038,1089
1,998,0.38922888616891066,0.8893617021276595,68531162,1634,636
0,1316,0.20722891566265061,0.46317512274959083,68533136,1660,344
1,963,0.36769533814839134,0.8426501035196687,80107664,1523,560
1,198,0.35081967213114756,0.8103448275862069,80107741,305,107
2,102,0.5887096774193549,0.9818181818181818,70612486,248,146
0,1682,0.1959847036328872,0.3164969450101833,69586041,2092,410
0,2096,0.20425208807896736,0.3573048266925818,69586153,2634,538
1,811,0.3109600679694138,0.6980108499095841,80111024,1177,366
1,1873,0.2555643879173291,0.5905432595573441,70618464,2516,643
0,219,0.18888888888888888,0.4527027027027027,68538575,270,51
0,1908,0.08048192771084338,0.06804849432929214,68539163,2075,167
0,2870,0.2084942084942085,0.40993132593766507,80121026,3626,756
1,738,0.28,0.6676792223572297,68629764,1025,287
1,2865,0.237017310252996,0.5093497069494837,66100853,3755,890
1,1476,0.27611574301128006,0.6389548693586699,66930633,2039,563
0,981,0.22327790973871733,0.49527186761229314,66930885,1263,282
0,884,0.21700620017714792,0.4750608272506083,66931655,1129,245
1,492,0.27002967359050445,0.5958668197474167,77676872,674,182
1,1399,0.24663435648896068,0.5807952622673435,80130320,1857,458
1,55,0.3956043956043956,0.7475728155339806,69047461,91,36
1,193,0.33676975945017185,0.6596194503171248,69546554,291,98
1,1976,0.3310765064319567,0.7093023255813954,80123740,2954,978
1,512,0.33506493506493507,0.7276908923643054,82145096,770,258
1,215,0.31962025316455694,0.7102137767220903,67557490,316,101
1,152,0.3153153153153153,0.7530864197530864,70207074,222,70
1,884,0.34177215189873417,0.7179034157832744,70658560,1343,459
0,607,0.2542997542997543,0.47543461829176115,72936045,814,207
0,1349,0.17188459177409454,0.2742932862190813,63278572,1629,280
1,1404,0.34909596662030595,0.7274211099020674,70576695,2157,753
1,746,0.33747779751332146,0.7503566333808844,80123745,1126,380
1,1856,0.32262773722627736,0.6953372566772296,68285826,2740,884
1,21,0.3,0.5901639344262295,70912786,30,9
1,894,0.319634703196347,0.7525252525252525,81989524,1314,420
1,239,0.30523255813953487,0.7057728119180633,80109344,344,105
0,1369,0.07437457741717377,0.04472178887155486,68539436,1479,110
1,377,0.387987012987013,0.8408862034239678,80156292,616,239
2,257,0.5029013539651838,0.9313572542901716,70206493,517,260
1,1264,0.2376357056694813,0.5400593471810089,68530980,1658,394
1,853,0.2550218340611354,0.6129707112970711,68540563,1145,292
1,797,0.3855050115651503,0.885430463576159,65278430,1297,500
1,6644,0.30451167172615934,0.6824047366023986,67716691,9553,2909
1,1896,0.38917525773195877,0.8432323232323232,70657706,3104,1208
0,2587,0.19683328158956845,0.2973901098901099,67136790,3221,634
0,38,0.11627906976744186,0.140625,69680730,43,5
1,739,0.45055762081784384,0.9189944134078212,69164823,1345,606
2,305,0.6695557963163596,0.968476357267951,80137970,923,618
1,3174,0.37334649555774924,0.8401431553832389,80110884,5065,1891
1,313,0.354639175257732,0.796078431372549,80110926,485,172
0,521,0.1795275590551181,0.3457286432160804,68553625,635,114
1,39,0.22,0.5607476635514018,80121128,50,11
0,1944,0.14997813729777001,0.21294658648744252,68544070,2287,343
1,518,0.3620689655172414,0.7575030012004802,63767571,812,294
1,1657,0.3189478010686395,0.6949956859361519,66695573,2433,776
0,2228,0.2011473646468268,0.3754183145725586,66931774,2789,561
1,1058,0.3403990024937656,0.8184049079754602,68112583,1604,546
0,972,0.11475409836065574,0.16011730205278593,67478740,1098,126
0,186,0.16964285714285715,0.23195876288659795,72293830,224,38
0,1525,0.2077922077922078,0.41099916036943746,80119333,1925,400
0,595,0.21296296296296297,0.42167654530059273,80119371,756,161
1,359,0.29469548133595286,0.6204301075268818,71559005,509,150
1,3252,0.3674382415872398,0.8594515181194907,68532121,5141,1889
0,263,0.18575851393188855,0.4023136246786632,80040975,323,60
1,611,0.24287484510532836,0.5189035916824196,77676886,807,196
1,902,0.3283693224125093,0.7484162895927602,68531526,1343,441
1,520,0.3220338983050847,0.7564625850340136,68531533,767,247
1,3994,0.3199387025370339,0.696969696969697,69467601,5873,1879
2,221,0.5216450216450217,0.9681908548707754,70612514,462,241
0,1201,0.1961178045515395,0.37231869254341166,67159232,1494,293
0,904,0.06514994829369183,0.030322173089071383,68539282,967,63
1,275,0.34834123222748814,0.7729941291585127,80107552,422,147
1,2023,0.3436080467229072,0.7974211062097047,66471125,3082,1059
1,2834,0.24204332709280557,0.5446623093681917,80121023,3739,905
0,1545,0.15803814713896458,0.22596388482186433,67554935,1835,290
0,1942,0.12719101123595505,0.1372772089495639,70871213,2225,283
1,566,0.3072215422276622,0.6280737704918032,70924245,817,251
0,437,0.13806706114398423,0.1889168765743073,65290141,507,70
0,897,0.1875,0.3822829964328181,69239884,1104,207
1,978,0.32411886662059436,0.7619047619047619,80109596,1447,469
1,431,0.4298941798941799,0.920392584514722,66423973,756,325
0,1572,0.23354461238420282,0.4562841530054645,68545106,2051,479
1,1051,0.25195729537366546,0.5759416767922235,68545113,1405,354
1,724,0.24504692387904067,0.6037344398340249,68534753,959,235
0,2283,0.15003723008190617,0.2315822194591234,68535215,2686,403
1,890,0.34268833087149186,0.7575539568345324,67993940,1354,464
1,885,0.3380703066566941,0.7441713925645873,67993975,1337,452
0,4457,0.14731203367132198,0.20115665074176514,68018034,5227,770
0,1787,0.13336566440349176,0.1575875486381323,68018055,2062,275
0,1875,0.06390414378432352,0.04740608228980322,68018195,2003,128
0,3562,0.07021665361524407,0.05726215329555622,68628581,3831,269
0,730,0.014844804318488529,0.001669449081803005,80121031,741,11
1,105,0.304635761589404,0.74,70871171,151,46
0,813,0.20215897939156036,0.3217477656405164,67705995,1019,206
1,6534,0.2684729064039409,0.5517883755588674,72748914,8932,2398
0,527,0.21225710014947682,0.43807574206755373,68536566,669,142
1,1097,0.27350993377483446,0.5918253079507279,80108154,1510,413
2,3471,0.5118829981718465,0.9566253574833175,80126577,7111,3640
0,1152,0.14981549815498155,0.2011104256631709,74320253,1355,203
0,869,0.2199281867145422,0.38057948316366486,74320274,1114,245
0,154,0.12994350282485875,0.1198044009779951,69621195,177,23
1,317,0.4172794117647059,0.9287974683544303,69621412,544,227
1,568,0.34936998854524626,0.7693522906793049,70676963,873,305
1,174,0.3894736842105263,0.8892128279883382,69607132,285,111
1,514,0.33762886597938147,0.7740336967294351,69607363,776,262
1,498,0.44419642857142855,0.9215885947046843,65385670,896,398
0,612,0.15,0.23569277108433734,73914393,720,108
1,3022,0.38739103993513074,0.8734513274336283,80108945,4933,1911
0,1495,0.164804469273743,0.2598870056497175,68535600,1790,295
0,4387,0.15062923523717328,0.20320747056435243,80130314,5165,778
0,3166,0.13473626673954633,0.20579633076309492,70627354,3659,493
0,312,0.1875,0.3592592592592593,82000148,384,72
2,829,0.6287505597850426,0.9799029799029799,80137985,2233,1404
2,376,0.593952483801296,0.9572519083969465,80137988,926,550
0,68,0.09333333333333334,0.22941176470588234,67568711,75,7
0,119,0.13138686131386862,0.2719298245614035,67568725,137,18
2,60,0.5384615384615384,0.9719626168224299,69468945,130,70
1,5612,0.4926776351473513,0.9534995977473854,80119009,11062,5450
0,65,0.25287356321839083,0.42105263157894735,80108035,87,22
1,409,0.3497615262321145,0.7900466562986003,80110905,629,220
0,723,0.05366492146596859,0.028782287822878228,69101501,764,41
0,1294,0.0988857938718663,0.11522633744855967,69101515,1436,142
0,1519,0.07490864799025579,0.05747126436781609,70532791,1642,123
1,1073,0.3528347406513872,0.7625797306874557,65383360,1658,585
2,13,0.6285714285714286,0.9354838709677419,71080380,35,22
0,400,0.23224568138195778,0.4524336283185841,62141576,521,121
1,288,0.34545454545454546,0.786046511627907,65277954,440,152
1,745,0.41887675507020283,0.9299552906110283,65278486,1282,537
1,20,0.375,0.9016393442622951,66305015,32,12
1,607,0.39601990049751246,0.9076773566569485,67552072,1005,398
1,205,0.27816901408450706,0.6417233560090703,68533640,284,79
1,608,0.31376975169300225,0.7583834909716252,68535915,886,278
1,349,0.32233009708737864,0.7588652482269503,80110296,515,166
1,537,0.3016905071521456,0.7130681818181818,80102932,769,232
1,334,0.47401574803149604,0.9158415841584159,68040322,635,301
1,1191,0.3079604880883207,0.7495899398578458,66425093,1721,530
1,567,0.2947761194029851,0.7037444933920705,66425156,804,237
1,361,0.23839662447257384,0.5414012738853503,68538596,474,113
0,228,0.15555555555555556,0.2928416485900217,68538603,270,42
1,2668,0.3412345679012346,0.7867723045125732,80110982,4050,1382
0,733,0.23566214807090718,0.4352651048088779,65312422,959,226
1,377,0.4480234260614934,0.898876404494382,72135245,683,306
0,1003,0.09312839059674503,0.09009628610729023,68539611,1106,103
1,1179,0.2897590361445783,0.703125,80125489,1660,481
1,387,0.3837579617834395,0.8732057416267942,66147312,628,241
1,1485,0.24581005586592178,0.5538277511961722,70573650,1969,484
1,1113,0.3217550274223035,0.7510373443983402,78045863,1641,528
0,1359,0.19538188277087035,0.4138335287221571,80119353,1689,330
0,863,0.18661639962299717,0.3660949868073879,68541893,1061,198
2,259,0.5290909090909091,0.9636608344549125,80161883,550,291
1,2359,0.29116586538461536,0.6802575107296137,70599515,3328,969
1,555,0.453740157480315,0.9005847953216374,70279321,1016,461
1,703,0.32727272727272727,0.8111620795107034,66410246,1045,342
1,347,0.3365200764818356,0.7882165605095541,69183303,523,176
0,6604,0.14665977516474996,0.2420413521496554,70219625,7739,1135
2,579,0.5126262626262627,0.9690721649484536,75933613,1188,609
1,780,0.32525951557093424,0.6711891460494812,72390773,1156,376
1,441,0.34859675036927623,0.7922077922077922,81967251,677,236
1,508,0.2914923291492329,0.6673095467695275,81967277,717,209
1,1046,0.40770101925254815,0.8439838802533103,82110022,1766,720
2,368,0.5832389580973952,0.9815864022662889,67993786,883,515
2,29,0.546875,0.9365079365079365,80151017,64,35
0,343,0.16341463414634147,0.3469387755102041,80125479,410,67
1,102,0.3625,0.8246445497630331,70064204,160,58
0,1463,0.1577432354634427,0.26844444444444443,67478873,1737,274
1,2121,0.2688728024819028,0.6222156222156222,67480056,2901,780
0,75,0.2268041237113402,0.23809523809523808,66826270,97,22
0,61,0.2823529411764706,0.3493975903614458,66826312,85,24
0,681,0.1519302615193026,0.2624113475177305,62940584,803,122
0,1358,0.23622047244094488,0.475238922675934,68212221,1778,420
1,1081,0.3452453058752271,0.7475,81975575,1651,570
0,1501,0.19732620320855615,0.367722602739726,67154682,1870,369
1,1017,0.3352941176470588,0.8121000581733566,80103065,1530,513
1,1723,0.26178234790059984,0.5373924553275976,67556720,2334,611
0,1291,0.16870573084352866,0.27986348122866894,60003181,1553,262
0,962,0.1546572934973638,0.3027932960893855,80098774,1138,176
0,1342,0.2063867534003548,0.4189485213581599,80112130,1691,349
0,980,0.19008264462809918,0.37969924812030076,68536874,1210,230
1,326,0.41889483065953653,0.8697749196141479,80125399,561,235
0,1747,0.09152366094643785,0.13549618320610687,66358992,1923,176
2,4,0.5555555555555556,0.9333333333333333,72802016,9,5
1,156,0.4983922829581994,0.9480812641083521,70757995,311,155
1,658,0.36302032913843174,0.7357894736842105,81975743,1033,375
0,356,0.12098765432098765,0.15789473684210525,80114650,405,49
0,463,0.04338842975206612,0.06788079470198675,80124335,484,21
0,410,0.053117782909930716,0.09980806142034548,80124425,433,23
0,30,0.1891891891891892,0.34831460674157305,70078141,37,7
0,1596,0.08747855917667238,0.22242535039609995,70600635,1749,153
0,3125,0.02556906766448394,0.03479636219849743,80124227,3207,82
0,870,0.02027027027027027,0.028116213683223992,80124386,888,18
0,4,0.2,0.41935483870967744,80133900,5,1
0,422,0.09247311827956989,0.20959147424511546,70612465,465,43
2,221,0.5347368421052632,0.9649122807017544,72271052,475,254
1,44,0.4942528735632184,0.9305555555555556,70048601,87,43
1,1088,0.28421052631578947,0.5909310178485288,70280581,1520,432
1,734,0.3699570815450644,0.7931292008961912,72932692,1165,431
1,1412,0.35788994997726237,0.7941403238242097,73002055,2199,787
2,172,0.5195530726256983,0.966804979253112,73131233,358,186
0,423,0.03644646924829157,0.045454545454545456,80114594,439,16
0,7980,0.13402061855670103,0.232397075798384,80116701,9215,1235
0,1031,0.07450628366247755,0.12204351939451277,80117744,1114,83
2,646,0.5332369942196532,0.9632843791722296,77600355,1384,738
1,722,0.48757984386089426,0.9421052631578948,67290741,1409,687
1,894,0.42765685019206146,0.8933884297520661,69267835,1562,668
0,167,0.1256544502617801,0.21341463414634146,67747274,191,24
0,3989,0.06711880261927035,0.12215909090909091,69625675,4276,287
1,371,0.3785594639865997,0.7708006279434851,69932401,597,226
1,266,0.35436893203883496,0.7276341948310139,69932415,412,146
1,846,0.3556740289413557,0.824442943956786,67384681,1313,467
0,854,0.2136279926335175,0.43349455864570735,67154703,1086,232
1,674,0.23496027241770714,0.5753646677471637,68534270,881,207
1,384,0.2163265306122449,0.5179233621755254,68534284,490,106
0,1208,0.1697594501718213,0.3217649975210709,68536643,1455,247
0,1840,0.12087912087912088,0.14930300807043287,80125287,2093,253
1,716,0.37302977232924694,0.8314424635332253,67994311,1142,426
0,503,0.20031796502384738,0.35730858468677495,69165516,629,126
0,208,0.20306513409961685,0.24691358024691357,60449515,261,53
1,1013,0.3108843537414966,0.7054973821989529,80110002,1470,457
1,796,0.32996632996632996,0.7979502196193266,67556762,1188,392
0,2461,0.15863247863247865,0.2221105527638191,68543860,2925,464
0,2230,0.14852997327224132,0.23915816326530612,70641662,2619,389
1,322,0.31634819532908703,0.7157894736842105,75354356,471,149
0,1751,0.08849557522123894,0.0788829005389515,80121156,1921,170
0,1879,0.1983788395904437,0.4089810017271157,68534893,2344,465
1,1219,0.42769953051643195,0.8938961779806047,69267842,2130,911
2,2080,0.5967429236138038,0.9822207312982221,70217000,5158,3078
1,221,0.3556851311953353,0.7847222222222222,68884431,343,122
2,1053,0.5459249676584734,0.9570592062459337,67214224,2319,1266
1,266,0.37850467289719625,0.8821218074656189,67942343,428,162
1,52,0.3333333333333333,0.708029197080292,70051212,78,26
0,988,0.1834710743801653,0.36847946725860153,67160212,1210,222
0,1227,0.22586750788643534,0.4558223833257816,80121081,1585,358
1,1108,0.328077622801698,0.6836158192090396,70673470,1649,541
1,89,0.32575757575757575,0.7435897435897436,66856531,132,43
0,86,0.14,0.15384615384615385,69184360,100,14
1,2540,0.35679918966827046,0.819084213896894,70207326,3949,1409
1,474,0.27522935779816515,0.609375,67940453,654,180
0,487,0.20941558441558442,0.4315403422982885,68533150,616,129
0,455,0.20454545454545456,0.4419889502762431,68542152,572,117
1,437,0.2306338028169014,0.5928297055057619,68542222,568,131
1,225,0.27419354838709675,0.7302752293577982,68542236,310,85
0,1662,0.1928120446818844,0.35585585585585583,68542474,2059,397
0,2702,0.16912669126691268,0.24062877871825877,68545456,3252,550
0,1717,0.23484848484848486,0.42510793756227166,67557504,2244,527
1,579,0.2490272373540856,0.555765595463138,80121223,771,192
1,3270,0.25546448087431695,0.5831240582621798,80125470,4392,1122
0,591,0.10454545454545454,0.14545454545454545,80097213,660,69
1,443,0.3099688473520249,0.6779661016949152,80152458,642,199
0,650,0.21968787515006002,0.40102389078498296,70581343,833,183
1,1527,0.3440721649484536,0.7866952789699571,72088394,2328,801
2,163,0.5,0.9728915662650602,63099190,326,163
0,1872,0.21575198994553832,0.4318555008210181,68163956,2387,515
0,1630,0.11987041036717062,0.169236700077101,68341392,1852,222
0,1467,0.062020460358056265,0.047165729121592385,68341413,1564,97
1,149,0.255,0.6042654028436019,68497254,200,51
1,2730,0.23764311644791958,0.5100515463917525,67291882,3581,851
0,1848,0.1225071225071225,0.10882956878850103,67555026,2106,258
1,456,0.3761969904240766,0.8926615553121577,68200342,731,275
1,420,0.2446043165467626,0.5575575575575575,68236350,556,136
0,2930,0.21088068946943173,0.4294855387765549,80121015,3713,783
1,358,0.39932885906040266,0.896124031007752,62497176,596,238
0,1139,0.19047619047619047,0.3367596671561429,68534746,1407,268
0,320,0.21182266009852216,0.3246753246753247,69180160,406,86
0,170,0.19047619047619047,0.2769857433808554,80118953,210,40
0,103,0.11965811965811966,0.11186440677966102,80118954,117,14
1,1029,0.3487341772151899,0.7541928721174004,80123741,1580,551
1,682,0.2698072805139186,0.5779591836734694,70654276,934,252
2,146,0.5408805031446541,0.978125,67552233,318,172
1,872,0.41397849462365593,0.8857518056467498,80127854,1488,616
0,493,0.17281879194630873,0.3086627417998318,72368940,596,103
1,959,0.31840796019900497,0.7112922002328289,67995004,1407,448
0,244,0.14084507042253522,0.24735449735449735,80098613,284,40
1,745,0.25125628140703515,0.5985639686684073,81965339,995,250
1,2089,0.2641775272983445,0.6188101175632348,67556986,2839,750
1,7795,0.3450130241156205,0.7711570096874428,70016975,11901,4106
1,2175,0.29770745883112687,0.6904328846853401,70748475,3097,922
1,1877,0.2410028305701577,0.5354179961710275,73746876,2473,596
0,857,0.1481113320079523,0.2322661644695543,82011855,1006,149
1,140,0.2708333333333333,0.59846547314578,67566492,192,52
1,592,0.4115308151093439,0.9191542288557214,68531575,1006,414
0,690,0.13533834586466165,0.15849673202614378,68545043,798,108
1,1237,0.2438875305623472,0.52685546875,68544266,1636,399
1,55,0.3125,0.7425149700598802,80121119,80,25
2,256,0.6121212121212121,0.994535519125683,63099113,660,404
1,547,0.33047735618115054,0.8063200815494393,68542670,817,270
1,266,0.2810810810810811,0.6049586776859505,68018363,370,104
0,1591,0.01668726823238566,0.0013623978201634877,72748921,1618,27
0,3105,0.034815045073049423,0.00667779632721202,72748935,3217,112
0,1281,0.25,0.49785867237687365,70631281,1708,427
1,385,0.30755395683453235,0.7082748948106592,81967252,556,171
1,3112,0.25514600287218764,0.5585918266863614,70614621,4178,1066
1,1627,0.3192468619246862,0.72314453125,80107342,2390,763
1,989,0.2558314522197141,0.59375,70642460,1329,340
0,3417,0.13208026416052832,0.1379994332672145,70641326,3937,520
0,314,0.16266666666666665,0.2670375521557719,67555145,375,61
0,392,0.19008264462809918,0.3853727144866385,68530735,484,92
0,303,0.13675213675213677,0.17117117117117117,68512024,351,48
1,453,0.24750830564784054,0.5137931034482759,70581350,602,149
1,927,0.2785992217898833,0.7128446536650975,67557616,1285,358
1,998,0.3425559947299078,0.8195652173913044,68516224,1518,520
1,524,0.2524964336661912,0.5671641791044776,80125443,701,177
0,443,0.21314387211367672,0.39344262295081966,80125482,563,120
1,1729,0.31170382165605093,0.6655112651646448,70463841,2512,783
0,890,0.055201698513800426,0.03088042049934297,68539870,942,52
0,1967,0.06997635933806147,0.047261815453863466,68539884,2115,148
1,4074,0.24541581774402668,0.5585854282062207,80130302,5399,1325
1,768,0.48247978436657685,0.9438502673796791,65787316,1484,716
1,425,0.35015290519877673,0.826625386996904,67159414,654,229
1,1180,0.32992617830777965,0.7641402714932126,80108462,1761,581
0,3018,0.11883211678832117,0.11995577667219458,72749082,3425,407
2,64,0.5151515151515151,0.966824644549763,68189590,132,68
1,313,0.3297644539614561,0.7254601226993865,82126793,467,154
1,1334,0.3650642551166111,0.8427607680332122,80107713,2101,767
1,870,0.33990895295902884,0.7730287398673544,80107720,1318,448
1,213,0.3564954682779456,0.9017857142857143,67557133,331,118
0,1356,0.1756838905775076,0.29417040358744395,67291896,1645,289
1,375,0.2603550295857988,0.5520421607378129,67553514,507,132
1,161,0.2747747747747748,0.6269430051813472,69177185,222,61
1,1082,0.30818414322250637,0.7392875580795044,69586440,1564,482
1,213,0.4350132625994695,0.9337231968810916,67995851,377,164
1,1187,0.35418933623503807,0.737652922519257,81896493,1838,651
0,661,0.16010165184243966,0.256198347107438,68497352,787,126
0,414,0.15163934426229508,0.18159203980099503,68533402,488,74
1,981,0.33626522327469555,0.783359497645212,68151216,1478,497
0,4451,0.1333722741433022,0.15222857142857144,82107797,5136,685
1,1797,0.27715205148833466,0.5982975273611674,67706842,2486,689
1,1575,0.24096385542168675,0.5174983797796501,73914470,2075,500
0,2606,0.22301729278473464,0.43231976459048554,69607216,3354,748
0,3639,0.2189311010946555,0.4054920825816797,69607706,4659,1020
1,448,0.3253012048192771,0.7540628385698809,70599452,664,216
0,1367,0.22593431483578708,0.48580610605249064,80112333,1766,399
1,771,0.28677150786308975,0.6512950094756791,80120425,1081,310
1,40,0.3333333333333333,0.6956521739130435,80108315,60,20
1,1334,0.3775081661222585,0.8385736196319018,69925765,2143,809
0,2508,0.21231155778894473,0.4212548015364917,68538771,3184,676
0,2076,0.1947245927075252,0.3610283159463487,68538785,2578,502
0,52,0.037037037037037035,0.03125,69108424,54,2
1,286,0.2832080200501253,0.7105643994211288,70072254,399,113
2,630,0.5089633671083398,0.9710144927536232,72941204,1283,653
1,2220,0.31417979610750696,0.6955767562879445,70254856,3237,1017
1,318,0.2789115646258503,0.6088560885608856,69177353,441,123
1,1501,0.3687973086627418,0.8148575827559661,63975394,2378,877
1,1352,0.37781868384721584,0.8602620087336245,69574666,2173,821
0,42,0.20754716981132076,0.44594594594594594,72801365,53,11
1,340,0.29606625258799174,0.5514834205933682,82023774,483,143
1,878,0.3261703760552571,0.8135593220338984,70631960,1303,425
0,1228,0.1352112676056338,0.14528207688467298,67555684,1420,192
0,69,0.24175824175824176,0.49760765550239233,80121165,91,22
0,688,0.08632138114209828,0.09725315515961395,72522905,753,65
0,1267,0.07043286867204696,0.05619668840943302,72522912,1363,96
0,883,0.07150368033648791,0.058823529411764705,72522926,951,68
1,5857,0.3320027372262774,0.7863528009535161,70627270,8768,2911
1,813,0.2561756633119854,0.5903465346534653,82011814,1093,280
1,542,0.33821733821733824,0.7912395153774464,66087196,819,277
0,1333,0.20560190703218117,0.3933035714285714,68535033,1678,345
1,902,0.24074074074074073,0.5851905104241553,68541613,1188,286
1,721,0.2238966630785791,0.5130890052356021,68541641,929,208
0,1151,0.15305371596762327,0.22732491389207807,70615363,1359,208
0,879,0.15642994241842612,0.2575558475689882,70615384,1042,163
2,397,0.5534308211473565,0.9849812265331664,82095527,889,492
2,193,0.6497277676950998,0.9863013698630136,80127700,551,358
1,338,0.3549618320610687,0.8392036753445635,68541921,524,186
0,525,0.1809672386895476,0.36617405582922824,67555173,641,116
1,156,0.23902439024390243,0.5605536332179931,68530896,205,49
1,310,0.329004329004329,0.7452667814113597,80108042,462,152
0,1402,0.21058558558558557,0.43361270401411556,80121069,1776,374
1,1071,0.34774665042630937,0.8261980830670926,69586300,1642,571
0,3145,0.19749936208216382,0.36011366571945236,67154661,3919,774
1,226,0.37047353760445684,0.8432539682539683,68200412,359,133
1,3642,0.2623050435487138,0.5821405682546464,70544880,4937,1295
1,3628,0.2791575601033181,0.6564540431943747,69037731,5033,1405
1,2795,0.27364864864864863,0.6468564279011574,69652961,3848,1053
1,385,0.23306772908366533,0.5012755102040817,69031291,502,117
1,969,0.28854625550660795,0.7351535836177474,80121252,1362,393
0,127,0.22085889570552147,0.4772727272727273,70524580,163,36
0,968,0.1619047619047619,0.2804610318331504,80056970,1155,187
1,508,0.23493975903614459,0.5801024140453548,80168506,664,156
1,148,0.3392857142857143,0.8268156424581006,69607615,224,76
0,922,0.18623124448367168,0.32727272727272727,68161380,1133,211
0,585,0.14970930232558138,0.19071729957805908,68645045,688,103
1,747,0.46870554765291605,0.9418604651162791,81997132,1406,659
1,760,0.3915132105684548,0.8673237300985596,66737545,1249,489
1,1153,0.24640522875816995,0.5611735330836455,80121011,1530,377
2,492,0.5166994106090373,0.9572649572649573,63159733,1018,526
0,253,0.15384615384615385,0.3824228028503563,66226811,299,46
0,883,0.08212058212058213,0.08230842005676443,67598006,962,79
1,1020,0.34990439770554493,0.7728852838933952,67994080,1569,549
1,1451,0.2766699900299103,0.5339539978094195,80131114,2006,555
0,1219,0.21405544809800128,0.39481865284974094,69097945,1551,332
1,815,0.48612862547288777,0.946164199192463,80159813,1586,771
1,2180,0.4978115641557245,0.9638474295190713,69165761,4341,2161
1,136,0.28421052631578947,0.6156351791530945,80107783,190,54
1,216,0.40166204986149584,0.9023861171366594,80120472,361,145
2,218,0.5144766146993318,0.968978102189781,67902394,449,231
1,3322,0.2541535698248765,0.5567951318458418,66100881,4454,1132
0,763,0.17155266015200868,0.3050969131371141,71783712,921,158
1,2053,0.4317741489067257,0.9038461538461539,80126579,3613,1560
0,190,0.12844036697247707,0.2028397565922921,72523024,218,28
0,106,0.18461538461538463,0.3633217993079585,80071222,130,24
0,237,0.052,0.016363636363636365,80121879,250,13
1,526,0.31953428201811124,0.7730414746543779,65290414,773,247
0,869,0.16361886429258904,0.2821357943309163,68544000,1039,170
1,2042,0.2877572375305197,0.6487330787920861,69585922,2867,825
1,1196,0.34573304157549234,0.7522546419098143,64932826,1828,632
1,686,0.3403846153846154,0.7583479789103691,70865396,1040,354
0,1013,0.18438003220611915,0.34153158188932364,69240052,1242,229
1,612,0.2783018867924528,0.6225218080888184,80108196,848,236
1,2020,0.32912653603454,0.7667692307692308,69944826,3011,991
1,3816,0.3732961077352603,0.837069922308546,82039213,6089,2273
0,2028,0.19491861849940453,0.29325259515570934,70641480,2519,491
1,510,0.43458980044345896,0.901077375122429,69089713,902,392
1,195,0.25287356321839083,0.5509708737864077,67748905,261,66
0,272,0.21159420289855072,0.3407534246575342,69056680,345,73
0,137,0.16463414634146342,0.3277777777777778,72523066,164,27
0,1954,0.15411255411255412,0.21063189568706117,63278782,2310,356
1,1402,0.2574152542372881,0.5699248120300752,67721955,1888,486
0,2100,0.20993227990970656,0.33407671721677074,70641466,2658,558
1,90,0.3283582089552239,0.7813953488372093,80110114,134,44
0,174,0.20909090909090908,0.3282051282051282,80136838,220,46
1,578,0.2765957446808511,0.6140350877192983,71257935,799,221
0,916,0.23857024106400665,0.37990580847723704,66471545,1203,287
1,1470,0.2708333333333333,0.5161854768153981,69705342,2016,546
0,480,0.19327731092436976,0.3628158844765343,19915140,595,115
1,1408,0.30089374379344586,0.7144736842105263,64275883,2014,606
0,1251,0.16877076411960132,0.27902134305049453,68543916,1505,254
0,300,0.025974025974025976,0.013888888888888888,73245445,308,8
0,1353,0.0998003992015968,0.1270935960591133,73245613,1503,150
0,970,0.06098741529525654,0.046153846153846156,73245634,1033,63
1,483,0.29591836734693877,0.7709437963944857,80121114,686,203
1,1480,0.336322869955157,0.8064155165982843,70627851,2230,750
0,2557,0.16492488569562377,0.23855799373040754,68151335,3062,505
1,159,0.38132295719844356,0.8966480446927374,66930836,257,98
0,706,0.1742690058479532,0.3291316526610644,69549095,855,149
1,332,0.4704944178628389,0.9385714285714286,82151296,627,295
1,915,0.3041825095057034,0.6212319790301442,70600446,1315,400
1,1686,0.28010247651579845,0.5395110858442297,77312823,2342,656
0,882,0.23636363636363636,0.4694767441860465,80105802,1155,273
0,679,0.12160413971539456,0.17130620985010706,80114384,773,94
1,440,0.25549915397631134,0.5891690009337068,82000006,591,151
0,1519,0.13397947548460662,0.19298952457695406,68163872,1754,235
0,400,0.1836734693877551,0.34808853118712274,70583471,490,90
0,2436,0.12625538020086083,0.1773049645390071,80119347,2788,352
0,1449,0.16387766878245816,0.2688853671421025,67556811,1733,284
0,2247,0.1738970588235294,0.277634011090573,67556881,2720,473
0,631,0.09728183118741059,0.07102272727272728,67557371,699,68
1,113,0.29375,0.5683890577507599,70686490,160,47
1,1675,0.3597094801223242,0.8451737451737452,68112604,2616,941
0,586,0.16997167138810199,0.29283018867924526,63141603,706,120
0,3301,0.21554182509505704,0.40220700152207,70617141,4208,907
0,2578,0.17976455615653833,0.31427000274951883,69994176,3143,565
1,838,0.38563049853372433,0.8817354793561931,80125278,1364,526
0,1472,0.05398457583547558,0.01805372082782915,68538904,1556,84
0,927,0.20292347377472056,0.3772336201191264,68540423,1163,236
2,472,0.5669724770642202,0.9918509895227008,69091610,1090,618
2,308,0.5423476968796433,0.9515347334410339,74575095,673,365
1,524,0.35547355473554737,0.8202247191011236,80110723,813,289
1,111,0.26,0.5111821086261981,82126779,150,39
0,729,0.22198505869797225,0.4226231783483692,80105753,937,208
2,81,0.5235294117647059,0.918552036199095,82059494,170,89
1,1658,0.35234375,0.7733017377567141,80123752,2560,902
1,189,0.3883495145631068,0.8369098712446352,67414634,309,120
1,517,0.2946793997271487,0.6368932038834951,69183674,733,216
0,86,0.2711864406779661,0.46551724137931033,69184465,118,32
0,1110,0.23711340206185566,0.44150499706055263,70207011,1455,345
1,1427,0.3155875299760192,0.7027439024390244,80125337,2085,658
0,3608,0.15463917525773196,0.21999549650979508,67964113,4268,660
0,812,0.11159737417943107,0.10860927152317881,67964141,914,102
0,879,0.16205910390848427,0.2521172638436482,68530805,1049,170
1,615,0.3812877263581489,0.8692857142857143,82009552,994,379
1,523,0.3190104166666667,0.7206703910614525,70832202,768,245
1,850,0.35703479576399394,0.7850340136054422,69998215,1322,472
1,374,0.23517382413087934,0.5479302832244008,68019784,489,115
0,119,0.18493150684931506,0.3740648379052369,80119329,146,27
1,158,0.41263940520446096,0.8466076696165191,69898206,269,111
1,1421,0.27573904179408765,0.5761851015801355,80111290,1962,541
0,452,0.04842105263157895,0.0223463687150838,80121721,475,23
0,94,0.12962962962962962,0.15873015873015872,80121722,108,14
1,2514,0.35272914521112253,0.7611827141774071,65383346,3884,1370
0,1068,0.09028960817717206,0.08015087223008015,69240283,1174,106
1,101,0.3803680981595092,0.8871595330739299,82011841,163,62
1,99,0.4342857142857143,0.9541284403669725,67552030,175,76
1,436,0.2495697074010327,0.5728155339805825,82011766,581,145
0,881,0.2126899016979446,0.43722943722943725,82011767,1119,238
1,561,0.2549800796812749,0.5357142857142857,74708886,753,192
1,283,0.3080684596577017,0.7186629526462396,54046622,409,126
0,1095,0.21505376344086022,0.4034446764091858,80180145,1395,300
1,2490,0.24362089914945323,0.5263486124103524,69397426,3292,802
1,622,0.34318901795142553,0.8142329020332717,78863764,947,325
1,2051,0.30380176510522744,0.7425386551600144,60499761,2946,895
0,375,0.2268041237113402,0.46733668341708545,69993364,485,110
0,2443,0.057848052448900886,0.036564625850340135,70641515,2593,150
0,3,0.25,0.3333333333333333,80165343,4,1
0,47,0.1896551724137931,0.23728813559322035,80168687,58,11
2,1,0.95,0.5,80135034,20,19
1,788,0.3253424657534247,0.6930946291560103,82039900,1168,380
1,6557,0.49154776674937967,0.9298690325306295,69133015,12896,6339
0,183,0.07575757575757576,0.14766839378238342,70678321,198,15
0,1490,0.07338308457711443,0.17308948399738733,72660021,1608,118
0,746,0.04725415070242656,0.12421711899791232,80116841,783,37
0,1162,0.09782608695652174,0.267680608365019,80116932,1288,126
0,30,0.09090909090909091,0.2076923076923077,80126768,33,3
0,230,0.10852713178294573,0.32158590308370044,69625731,258,28
0,55,0.11290322580645161,0.3088235294117647,80124199,62,7
1,83,0.461038961038961,0.9240506329113924,62173713,154,71
1,25,0.2857142857142857,0.6,66801273,35,10
1,238,0.3687002652519894,0.8152777777777778,70197785,377,139
0,2137,0.01701931922723091,0.029994340690435765,80124228,2174,37
0,2866,0.011383235598482234,0.03487358326068003,80124281,2899,33
0,407,0.06004618937644342,0.13016845329249618,80126898,433,26
0,426,0.19318181818181818,0.31059506531204645,54550881,528,102
1,543,0.3626760563380282,0.8147029204431017,64928864,852,309
2,659,0.5470790378006873,0.9518161601186064,80181549,1455,796
2,6,0.8181818181818182,0.9,69538833,33,27
1,100,0.34210526315789475,0.7735849056603774,67846534,152,52
1,905,0.3316100443131462,0.6899462778204144,70720391,1354,449
1,966,0.3981308411214953,0.7838948233360723,73869306,1605,639
0,136,0.07482993197278912,0.04390243902439024,70741615,147,11
0,482,0.15289982425307558,0.2359882005899705,70810852,569,87
0,114,0.2597402597402597,0.3695652173913043,80176768,154,40
1,149,0.3037383177570093,0.5616438356164384,80176771,214,65
0,662,0.15019255455712452,0.1431980906921241,80178947,779,117
1,356,0.48703170028818443,0.9226869455006337,72322131,694,338
2,294,0.5296,0.9547511312217195,80181005,625,331
0,1044,0.08979947689625109,0.20921052631578949,70001155,1147,103
0,1925,0.04561229548834903,0.061419472247497726,70001183,2017,92
0,1992,0.08371665133394664,0.17105263157894737,70001351,2174,182
0,2327,0.07290836653386454,0.15411626999609832,70001442,2510,183
0,751,0.0785276073619632,0.21710526315789475,70001484,815,64
0,2972,0.03694102397926118,0.03180574555403557,70001512,3086,114
0,3178,0.06994439566871524,0.1258853831294269,70001694,3417,239
0,213,0.19622641509433963,0.3733075435203095,67428270,265,52
1,2720,0.33087330873308735,0.7482332155477032,67760826,4065,1345
0,1179,0.17146872803935348,0.25336927223719674,68645073,1423,244
1,302,0.24310776942355888,0.543859649122807,68496953,399,97
1,351,0.285132382892057,0.6394101876675603,73215926,491,140
1,468,0.36065573770491804,0.8305785123966942,69152475,732,264
1,391,0.27052238805970147,0.5941358024691358,69154491,536,145
1,3379,0.27876200640341514,0.6229879845839945,80180139,4685,1306
1,944,0.36686787391012743,0.872816212438854,69586244,1491,547
2,1109,0.7764563596049183,0.9987878787878788,73975265,4961,3852
1,1114,0.3885839736553238,0.8980477223427332,67552681,1822,708
1,227,0.3303834808259587,0.7026378896882494,69498842,339,112
1,1819,0.26236820762368207,0.5469593378913278,70207543,2466,647
1,448,0.36633663366336633,0.8144171779141104,74045615,707,259
1,997,0.3604874919820398,0.7247838616714697,80126934,1559,562
0,3569,0.23230802323080232,0.451831750339213,70634326,4649,1080
0,2212,0.2306086956521739,0.4769372693726937,68535726,2875,663
1,1918,0.3615179760319574,0.8296650717703349,69333271,3004,1086
1,72,0.47058823529411764,0.9518716577540107,71387974,136,64
1,541,0.37093023255813956,0.811284046692607,73036915,860,319
0,2641,0.18462488422352577,0.34833538840937117,66404653,3239,598
0,2058,0.1708299758259468,0.30693912303107707,70642656,2482,424
1,1736,0.4019979331725801,0.9009942004971002,63445802,2903,1167
1,581,0.48945518453427067,0.9578059071729957,65008314,1138,557
0,3681,0.13510338345864661,0.18856382978723404,69739152,4256,575
1,1273,0.3612644254892122,0.8257907542579075,69967261,1993,720
1,7381,0.4047100572626825,0.8452205882352941,80119132,12399,5018
0,2265,0.14237031427489588,0.16887608069164264,67555544,2641,376
0,4269,0.19710362986646604,0.33819241982507287,62510210,5317,1048
1,576,0.4122448979591837,0.8544600938967136,69986035,980,404
0,953,0.21499176276771004,0.3981191222570533,70545811,1214,261
1,495,0.3153526970954357,0.7659372026641293,70615370,723,228
0,1737,0.1685016754427956,0.37746681019016864,68149851,2089,352
0,635,0.11805555555555555,0.15283842794759825,72900415,720,85
0,1095,0.19426048565121412,0.4057672502574665,69549536,1359,264
0,1253,0.12986111111111112,0.1971326164874552,73255042,1440,187
1,280,0.2857142857142857,0.627147766323024,80135250,392,112
1,219,0.28431372549019607,0.6680761099365751,80135251,306,87
1,52,0.2876712328767123,0.6078431372549019,80162173,73,21
2,134,0.6968325791855203,0.9495412844036697,80137964,442,308
1,871,0.27597672485453034,0.5568513119533528,65983946,1203,332
1,205,0.34294871794871795,0.8259187620889749,67159554,312,107
1,651,0.4249116607773852,0.8884585592563904,69574694,1132,481
1,238,0.44907407407407407,0.885593220338983,70280042,432,194
1,678,0.24916943521594684,0.5596612779060816,80111843,903,225
1,3378,0.4363423994660437,0.9089861751152074,68276733,5993,2615
1,131,0.2598870056497175,0.6676737160120846,80103485,177,46
1,741,0.401453957996769,0.8585766423357665,70628936,1238,497
1,2268,0.3166616450738174,0.7629541393686718,70627025,3319,1051
1,223,0.347953216374269,0.8326359832635983,69586370,342,119
1,305,0.30205949656750575,0.6736842105263158,69606803,437,132
1,3037,0.36344581848669044,0.8279686232080065,69668746,4771,1734
0,3047,0.07834240774349667,0.07782212086659065,70617281,3306,259
1,1134,0.30215384615384616,0.6081081081081081,80127291,1625,491
1,401,0.33166666666666667,0.7576642335766424,80135249,600,199
0,1836,0.2533550223668158,0.48851224105461394,67553402,2459,623
1,412,0.34810126582278483,0.8229166666666666,69195392,632,220
0,646,0.11019283746556474,0.14364207221350078,54609744,726,80
1,3551,0.3541287740996726,0.8181581007044091,67685863,5498,1947
1,853,0.2504393673110721,0.5318404478656403,69586076,1138,285
1,182,0.4185303514376997,0.8941504178272981,64857205,313,131
0,3499,0.12851805728518056,0.1641123882503193,81999980,4015,516
1,783,0.30338078291814946,0.6750509857239972,68112450,1124,341
1,898,0.2687296416938111,0.5829863176680548,78111103,1228,330
0,4834,0.16439066551426101,0.2316995544239338,68545442,5785,951
1,840,0.33014354066985646,0.7514546965918537,69586202,1254,414
1,546,0.3665893271461717,0.83991462113127,69607762,862,316
0,675,0.1423125794155019,0.22073921971252566,68536314,787,112
0,2860,0.05982905982905983,0.03044189852700491,68539912,3042,182
0,753,0.11515863689776733,0.15342465753424658,68561682,851,98
0,542,0.19584569732937684,0.36795774647887325,68666934,674,132
1,1922,0.3150392017106201,0.7255334805003679,70642236,2806,884
1,2840,0.3293978748524203,0.7708451503119682,70643440,4235,1395
1,6482,0.41519307109346804,0.8872100122100122,80159819,11084,4602
1,29,0.30952380952380953,0.717948717948718,67557070,42,13
1,680,0.2916666666666667,0.6777210884353742,68536062,960,280
1,428,0.2620689655172414,0.6014851485148515,69227361,580,152
0,727,0.23473684210526316,0.48911070780399274,80108651,950,223
0,2545,0.20269423558897243,0.41813031161473085,73700480,3192,647
0,4043,0.20444706808343172,0.3807035175879397,80125473,5082,1039
1,3301,0.26201654370668453,0.5443204202232436,67557952,4473,1172
0,1771,0.14485755673587639,0.19475240206947525,68544273,2071,300
1,210,0.33753943217665616,0.7944862155388471,81967309,317,107
1,1180,0.26111458985597996,0.5988700564971752,80121083,1597,417
0,1742,0.23293703214442976,0.48164464023494863,69586090,2271,529
0,1093,0.21928571428571428,0.47287735849056606,67555943,1400,307
0,2911,0.24487678339818417,0.47546161321671526,67556706,3855,944
0,2507,0.1553234501347709,0.21743625086147483,70645554,2968,461
0,1854,0.22035323801513879,0.41062992125984255,70645792,2378,524
0,1312,0.22274881516587677,0.46561108362196935,71783726,1688,376
1,1118,0.2906091370558376,0.6663025669033316,80180163,1576,458
2,423,0.5753012048192772,0.9753566796368353,69458522,996,573
0,1375,0.15953545232273839,0.21560452650387135,70609224,1636,261
0,513,0.19085173501577288,0.3861551292743953,82011825,634,121
1,6738,0.3288176113158681,0.7460358056265984,70466172,10039,3301
1,5969,0.3241621376811594,0.7785492417321396,67556902,8832,2863
0,370,0.15331807780320367,0.22397476340694006,70850703,437,67
1,239,0.37922077922077924,0.8846153846153846,66892833,385,146
0,209,0.19615384615384615,0.3171912832929782,73215933,260,51
1,1001,0.31344307270233196,0.7021414665801428,65336012,1458,457
0,2343,0.1237845923709798,0.1361292540391887,68645122,2674,331
0,3608,0.0902672718103883,0.10043881033642126,80119381,3966,358
0,146,0.0641025641025641,0.03598971722365039,82011786,156,10
1,56,0.2727272727272727,0.7606382978723404,69321525,77,21
1,265,0.2659279778393352,0.6728016359918201,68540094,361,96
1,199,0.23461538461538461,0.5376344086021505,68540122,260,61
1,285,0.22764227642276422,0.514336917562724,70641935,369,84
0,1876,0.1822144725370532,0.32793522267206476,70641991,2294,418
0,1297,0.19089207735495944,0.39978034047226796,70642334,1603,306
0,1435,0.1371016235718581,0.15552805280528054,67554564,1663,228
1,7078,0.2403134056026618,0.5170896785109983,66409224,9317,2239
1,1108,0.4211076280041797,0.9351851851851852,67557763,1914,806
0,2173,0.1554605518849592,0.20437230871149387,68530686,2573,400
0,1456,0.10344827586206896,0.07880184331797235,68533220,1624,168
0,1565,0.23695758166747927,0.47890295358649787,68542334,2051,486
0,814,0.07709750566893424,0.0781448538754765,72785734,882,68
0,698,0.09702457956015524,0.12525808671713695,72785741,773,75
2,83,0.5808080808080808,0.966183574879227,70395311,198,115
1,986,0.2685459940652819,0.5871505056513979,65766246,1348,362
0,173,0.22072072072072071,0.4412532637075718,70064183,222,49
1,921,0.24259868421052633,0.5310701956271576,66900743,1216,295
1,1874,0.2713841368584759,0.6025118805159538,66900785,2572,698
1,344,0.29938900203665986,0.6442831215970962,80135254,491,147
1,1745,0.273219491878384,0.6290650406504065,70626612,2401,656
1,645,0.23122765196662692,0.543572044866264,68536671,839,194
0,637,0.16294349540078842,0.3000898472596586,68536692,761,124
1,1019,0.3607277289836888,0.7943874797625472,65783830,1594,575
1,765,0.23115577889447236,0.52,68540451,995,230
1,2790,0.29313402584241194,0.7043707973102786,70618471,3947,1157
1,1466,0.43658724058416604,0.9061313076505697,66695643,2602,1136
1,1834,0.298124760811328,0.63756252842201,70676403,2613,779
1,481,0.37532467532467534,0.8923220973782772,65353456,770,289
1,194,0.3378839590443686,0.8329113924050633,68171453,293,99
1,862,0.3694220921726408,0.8666666666666667,63774753,1367,505
1,5177,0.2615889316787905,0.5734030001685488,67168563,7011,1834
0,3847,0.21200327734535027,0.38558909444985395,69586335,4882,1035
1,1466,0.3318140382862352,0.7873076923076923,81965578,2194,728
1,3104,0.37153269892690827,0.8509068552105749,80111360,4939,1835
0,876,0.16332378223495703,0.25744800449690836,70582561,1047,171
1,1212,0.2582619339045288,0.577732170343766,70842191,1634,422
1,203,0.3024054982817869,0.7195121951219512,68763905,291,88
1,678,0.35181644359464626,0.7816780821917808,73036901,1046,368
1,249,0.28653295128939826,0.6546052631578947,68210604,349,100
1,393,0.33049403747870526,0.7478005865102639,68210905,587,194
0,906,0.21148825065274152,0.3983193277310924,70197470,1149,243
1,5376,0.3308439133681852,0.7357766886852759,69164921,8034,2658
0,2514,0.16032064128256512,0.2668569389939351,69600993,2994,480
0,505,0.18810289389067525,0.36143308746048475,70615391,622,117
0,415,0.2003853564547206,0.45,70626794,519,104
0,544,0.13513513513513514,0.2268976897689769,70627571,629,85
0,4138,0.07613306541638759,0.07168701944821348,70641795,4479,341
0,684,0.1952941176470588,0.4426546391752577,80098921,850,166
0,1803,0.08708860759493671,0.07675438596491228,68538925,1975,172
0,2238,0.19525350593311758,0.3495962314939435,69165306,2781,543
1,646,0.2814238042269188,0.7071290944123314,68540311,899,253
1,1230,0.2617046818727491,0.5601156069364162,80109372,1666,436
1,1092,0.27345309381237526,0.600997506234414,80181386,1503,411
0,2738,0.23391158365976497,0.43494809688581315,74320134,3574,836
1,1408,0.27942681678607983,0.6783216783216783,80112291,1954,546
1,2568,0.308562197092084,0.6881458966565349,73703805,3714,1146
1,4100,0.23834293145086383,0.510504578919016,73818465,5383,1283
0,2737,0.07062818336162988,0.14484895429899303,80140151,2945,208
1,1332,0.32795156407669024,0.795850622406639,80120437,1982,650
1,1147,0.2302013422818792,0.5321477428180574,68540710,1490,343
1,3311,0.24268069533394326,0.5168941597672857,80118140,4372,1061
1,719,0.28599801390268126,0.7140902872777017,66931284,1007,288
0,1712,0.1216008209338122,0.17320922703358965,70627662,1949,237
2,5,0.5,0.8888888888888888,66324384,10,5
1,180,0.40594059405940597,0.8685897435897436,73501365,303,123
1,193,0.31560283687943264,0.8042895442359249,67276300,282,89
0,1380,0.19439579684763572,0.40988711560918645,80124518,1713,333
1,2300,0.49024822695035464,0.9488399762046401,69097875,4512,2212
0,624,0.13573407202216067,0.19827586206896552,81999928,722,98
1,850,0.24377224199288255,0.5729833546734955,67349905,1124,274
0,495,0.11921708185053381,0.15081652257444764,70627613,562,67
2,970,0.5640449438202247,0.9807247494217425,69056834,2225,1255
1,677,0.3661048689138577,0.8488664987405542,67154395,1068,391
0,2325,0.17318634423897583,0.24473147518694766,70645092,2812,487
1,437,0.34087481146304677,0.7545787545787546,69982661,663,226
1,1586,0.3763271726307511,0.8223277909738718,80180316,2543,957
1,1171,0.34507829977628635,0.7809069212410501,69573581,1788,617
1,2406,0.3038194444444444,0.7471790179932907,80125300,3456,1050
1,1750,0.2768595041322314,0.6354888375673595,65852101,2420,670
0,2230,0.1369969040247678,0.1758368603308965,68645143,2584,354
1,61,0.19736842105263158,0.5986842105263158,82008951,76,15
0,1324,0.13123359580052493,0.12964728312678742,72749124,1524,200
0,1157,0.14296296296296296,0.16600790513833993,72749194,1350,193
1,3359,0.23572241183162684,0.5152603231597845,80125472,4395,1036
1,482,0.3581890812250333,0.8467220683287165,70207305,751,269
0,6973,0.111493374108053,0.1048401500267905,68543874,7848,875
0,2029,0.1521103217718345,0.20652551197500868,68543902,2393,364
1,4844,0.3005054151624549,0.7135687732342008,80119273,6925,2081
1,1199,0.36426299045599153,0.8071278825995807,80180341,1886,687
0,458,0.22765598650927488,0.3837920489296636,69478122,593,135
1,1015,0.3476863753213368,0.7748466257668711,80180160,1556,541
0,1268,0.15410273515677117,0.2796833773087071,68534704,1499,231
1,1207,0.35523504273504275,0.7988001845869867,69573623,1872,665
1,672,0.2574585635359116,0.5131938125568699,69607181,905,233
0,1407,0.04220558202859088,0.05332496863237139,80124224,1469,62
0,642,0.20935960591133004,0.3981308411214953,67557056,812,170
0,180,0.21052631578947367,0.4413793103448276,72368905,228,48
0,357,0.20489977728285078,0.42905788876276957,72368975,449,92
0,201,0.22988505747126436,0.3495702005730659,74708753,261,60
1,1111,0.2946031746031746,0.6930975470621791,80103121,1575,464
1,2418,0.2801428996725216,0.6922152088969041,61717775,3359,941
1,1439,0.26356192425793246,0.6144834930777423,80110653,1954,515
1,469,0.24719101123595505,0.5823095823095823,71358630,623,154
1,6637,0.28217607614103396,0.6614281354897772,69553414,9246,2609
0,411,0.20038910505836577,0.4304147465437788,81979734,514,103
2,203,0.5311778290993071,0.9331683168316832,80160399,433,230
1,2614,0.3046022878425113,0.7268531871935391,67879266,3759,1145
0,87,0.12121212121212122,0.34,82008950,99,12
1,1743,0.40389876880984954,0.8751505419510237,80156784,2924,1181
1,1800,0.34545454545454546,0.8131661442006269,70242732,2750,950
1,1158,0.31842260153031193,0.7755102040816326,80103023,1699,541
0,530,0.21013412816691504,0.365813377374071,80118968,671,141
1,1132,0.33529066353493836,0.7442129629629629,67994045,1703,571
1,1043,0.2806896551724138,0.6477832512315271,80109526,1450,407
1,644,0.36047666335650447,0.8079295154185022,81963804,1007,363
1,1275,0.28047404063205417,0.6589242053789731,70543585,1772,497
1,244,0.39303482587064675,0.8271186440677966,67627672,402,158
1,600,0.27007299270072993,0.6944237918215613,68019805,822,222
1,150,0.40476190476190477,0.8482758620689655,70611926,252,102
0,781,0.2274975272007913,0.4078164825828377,69608196,1011,230
1,321,0.3284518828451883,0.7139959432048681,80135256,478,157
2,3230,0.5394267788392985,0.9772483365529083,80138011,7013,3783
2,1777,0.6234371688917143,0.9838411819021238,60805101,4719,2942
0,3314,0.17705487956295007,0.29625,66422874,4027,713
2,694,0.5516795865633075,0.9726526891522334,70202433,1548,854
1,1923,0.47024793388429753,0.9406713505074161,67803596,3630,1707
1,270,0.24157303370786518,0.6209677419354839,70240751,356,86
0,206,0.21374045801526717,0.4574712643678161,66423833,262,56
0,1184,0.1945578231292517,0.37108301264431004,66423903,1470,286
0,617,0.14661134163208853,0.20052770448548812,67291791,723,106
0,1070,0.15213946117274169,0.21961325966850828,69621454,1262,192
0,450,0.20353982300884957,0.4195519348268839,69622413,565,115
0,850,0.15590863952333664,0.2422907488986784,65290120,1007,157
0,747,0.1242672919109027,0.14228617106314947,65290183,853,106
0,738,0.18091009988901222,0.3134822167080232,68543951,901,163
1,347,0.27405857740585776,0.6442417331812998,69836102,478,131
1,391,0.4561891515994437,0.9054415700267618,70586544,719,328
0,2216,0.12202852614896989,0.11530470914127423,67963392,2524,308
0,2683,0.13058976020738822,0.14817999426769848,69239821,3086,403
1,169,0.4271186440677966,0.8657142857142858,67568620,295,126
0,3654,0.17311608961303462,0.270906949352179,60047043,4419,765
0,2548,0.13889827644474484,0.2440944881889764,70841610,2959,411
0,1103,0.21494661921708186,0.42651986596457636,63767340,1405,302
1,577,0.42927794263105834,0.8482613277133825,70766311,1011,434
1,1196,0.26670754138565295,0.5798994974874372,80180146,1631,435
0,887,0.06729758149316509,0.059192200557103065,70642831,951,64
0,1593,0.2042957042957043,0.35046728971962615,69606922,2002,409
1,1829,0.25010250102501025,0.5442329227323628,80125446,2439,610
0,2975,0.13992483376698467,0.14868189806678384,70641445,3459,484
1,447,0.26721311475409837,0.6709006928406467,69395760,610,163
0,306,0.11560693641618497,0.1983663943990665,80119300,346,40
1,968,0.2954876273653566,0.6947236180904522,80128480,1374,406
1,1133,0.366331096196868,0.8246392896781354,80128481,1788,655
1,371,0.38166666666666665,0.8710601719197708,69176765,600,229
1,281,0.34953703703703703,0.8015037593984963,69177570,432,151
0,1856,0.19618882633174534,0.3484251968503937,65987502,2309,453
0,3558,0.11558538404175989,0.13808245913637474,80125288,4023,465
0,604,0.20526315789473684,0.35,69739264,760,156
1,60,0.3103448275862069,0.6585365853658537,67551785,87,27
1,33,0.26666666666666666,0.5,67551925,45,12
0,140,0.23497267759562843,0.41904761904761906,67551932,183,43
1,208,0.2852233676975945,0.608,67551946,291,83
0,1499,0.1727373068432671,0.3688320908768193,68150516,1812,313
1,1552,0.34097664543524414,0.8004728132387707,69153945,2355,803
0,1281,0.08890469416785206,0.10697399527186761,80123747,1406,125
0,452,0.23905723905723905,0.4837310195227766,80123751,594,142
1,1045,0.243849493487699,0.5039018952062431,80130382,1382,337
1,370,0.35986159169550175,0.8156862745098039,65923795,578,208
1,781,0.26597744360902253,0.6401062416998672,70059745,1064,283
0,1382,0.17443249701314217,0.3218116805721097,72368863,1674,292
1,1368,0.2544959128065395,0.5266009852216749,74320190,1835,467
1,879,0.31435257410296413,0.7229064039408867,69608301,1282,403
1,36,0.4375,0.8783783783783784,75933606,64,28
0,472,0.05788423153692615,0.0375,80176489,501,29
0,1796,0.18252162039144287,0.32130649449297377,68993736,2197,401
0,3088,0.21444924955482067,0.45325563719280465,68993750,3931,843
1,290,0.36681222707423583,0.6926229508196722,72320955,458,168
1,306,0.476027397260274,0.9347826086956522,72548616,584,278
1,257,0.351010101010101,0.8537859007832899,62141884,396,139
1,215,0.3601190476190476,0.8731563421828908,62141933,336,121
2,413,0.5406006674082313,0.9924906132665833,69603226,899,486
1,862,0.23581560283687944,0.5265486725663717,63278726,1128,266
1,999,0.2589020771513353,0.5503035559410234,65448292,1348,349
1,318,0.273972602739726,0.632420091324201,65450322,438,120
0,3440,0.13762847831536726,0.16257594167679223,67963462,3989,549
0,1143,0.23237071860308933,0.4621492853361567,80109442,1489,346
1,962,0.3143264433357092,0.7418952618453866,80109463,1403,441
0,452,0.24161073825503357,0.4880546075085324,80157072,596,144
1,568,0.3778751369112815,0.8679435483870968,66471181,913,345
1,305,0.35654008438818563,0.7990196078431373,68241523,474,169
0,619,0.20129032258064516,0.4403747870528109,68540500,775,156
2,6,0.6666666666666666,0.9285714285714286,80136951,18,12
0,1966,0.17706153202176642,0.2445308701993194,70644882,2389,423
1,589,0.41625371655104065,0.8641304347826086,69626053,1009,420
0,292,0.20218579234972678,0.34186471663619744,72413915,366,74
0,102,0.07272727272727272,0.04522613065326633,73865295,110,8
0,1985,0.2279268767016725,0.4914407988587732,73816225,2571,586
1,2834,0.3031718711581018,0.7030950424541221,80124681,4067,1233
1,248,0.24620060790273557,0.5234215885947047,54860666,329,81
0,1037,0.15827922077922077,0.25734710087370927,67705946,1232,195
1,518,0.27247191011235955,0.5914285714285714,67994626,712,194
0,162,0.18592964824120603,0.36681222707423583,69582933,199,37
0,404,0.16872427983539096,0.3633004926108374,80122952,486,82
1,1097,0.3481877599524658,0.8001063264221159,80178194,1683,586
1,686,0.4235294117647059,0.8754098360655738,70613732,1190,504
0,2276,0.12863705972434916,0.13569576490924806,70653660,2612,336
0,1557,0.1899063475546306,0.2728337236533958,70653681,1922,365
1,123,0.36923076923076925,0.8982300884955752,80098466,195,72
0,2270,0.1589477584290478,0.2591843613077182,67554690,2699,429
0,1007,0.21389539422326306,0.38453159041394336,71358742,1281,274
0,1647,0.10972972972972973,0.14824304538799415,68163900,1850,203
0,2165,0.1595496894409938,0.23826481061832308,67963364,2576,411
0,1596,0.21262950172668968,0.4293410692084542,68535894,2027,431
0,4121,0.1746445023032245,0.276568772448764,70601622,4993,872
0,537,0.19004524886877827,0.4623287671232877,80097353,663,126
0,1205,0.10475482912332838,0.13894849785407726,80119317,1346,141
2,169,0.5331491712707183,0.982646420824295,72776494,362,193
0,1377,0.18617021276595744,0.2853075170842825,72413880,1692,315
0,736,0.2170212765957447,0.4731113956466069,81976686,940,204
0,345,0.20323325635103925,0.445859872611465,69736352,433,88
0,1122,0.22460262612301313,0.44353518821603927,69607083,1447,325
1,196,0.3422818791946309,0.7714285714285715,69183233,298,102
1,302,0.3747412008281574,0.8006329113924051,70965860,483,181
0,1254,0.22160148975791433,0.4394014962593516,67435844,1611,357
0,551,0.19208211143695014,0.4301994301994302,82036699,682,131
0,1591,0.05128205128205128,0.11503623188405797,73366125,1677,86
0,2516,0.21693121693121692,0.4338768115942029,70660191,3213,697
0,464,0.21621621621621623,0.4608208955223881,80137640,592,128
0,1003,0.21271585557299844,0.4201349831271091,68535131,1274,271
2,587,0.5,0.9575045207956601,80130156,1174,587
1,1384,0.3248780487804878,0.7053984575835476,80127290,2050,666
0,320,0.07514450867052024,0.04864864864864865,70207263,346,26
0,999,0.1878048780487805,0.28892589508742716,70644924,1230,231
1,750,0.44649446494464945,0.8900364520048603,69627964,1355,605
0,1140,0.17391304347826086,0.2847025495750708,70565516,1380,240
1,1010,0.3962940824865511,0.781625441696113,70720342,1673,663
1,258,0.2892561983471074,0.5704697986577181,80018393,363,105
2,340,0.5853658536585366,0.9831365935919055,72315404,820,480
1,94,0.3472222222222222,0.6886792452830188,81989143,144,50
0,725,0.03204272363150868,0.007228915662650603,69167714,749,24
0,1297,0.05946337926033358,0.045878136200716846,69167812,1379,82
0,2311,0.0458298926507019,0.020427553444180523,69167854,2422,111
0,552,0.09359605911330049,0.13896457765667575,69625045,609,57
0,680,0.09694555112881806,0.11923847695390781,69699035,753,73
0,999,0.06460674157303371,0.054817275747508304,73026002,1068,69
1,448,0.41818181818181815,0.8849449204406364,82088785,770,322
0,3160,0.0645352279455299,0.04691601049868766,70641263,3378,218
1,339,0.49251497005988026,0.9463087248322147,80096016,668,329
1,1161,0.44289827255278313,0.8900299529311082,72801071,2084,923
2,43,0.5168539325842697,0.9210526315789473,80128692,89,46
0,4,0.0,0.0,70678461,4,0
0,2,0.0,0.0,80126799,2,0
0,155,0.14835164835164835,0.36254980079681276,72392796,182,27
1,328,0.22641509433962265,0.5267295597484277,66930570,424,96
1,117,0.4292682926829268,0.9123222748815166,82011709,205,88
1,18,0.35714285714285715,0.8596491228070176,70568015,28,10
2,590,0.5291300877893057,0.9566724436741768,72322110,1253,663
1,1564,0.28191000918273645,0.5826330532212886,67657485,2178,614
0,12,0.0,0.0,70704543,12,0
0,2,0.0,0.0,70707490,2,0
1,744,0.31047265987025024,0.6785361028684471,80004036,1079,335
2,0,1.0,1.0,80091004,1,1
1,639,0.3076923076923077,0.6383587786259542,69150921,923,284
2,768,0.5707098937954165,0.9692307692307692,70830046,1789,1021
0,1654,0.3050420168067227,0.4660493827160494,73941700,2380,726
1,961,0.26585179526355995,0.5190839694656488,80124968,1309,348
1,147,0.421259842519685,0.6910112359550562,70179823,254,107
1,1130,0.49281867145421904,0.8717948717948718,70614152,2228,1098
1,870,0.44337811900191937,0.8538083538083538,70120792,1563,693
1,397,0.473474801061008,0.8356713426853707,69585684,754,357
1,275,0.4532803180914513,0.8458498023715415,73410624,503,228
1,32,0.4576271186440678,0.717391304347826,80133196,59,27
1,305,0.45729537366548045,0.8215102974828375,69585705,562,257
1,857,0.45169545745361483,0.7303149606299213,66280844,1563,706
1,774,0.33676092544987146,0.5382775119617225,73941714,1167,393
1,1446,0.3192090395480226,0.7071678321678322,70182602,2124,678
0,6954,0.21147522394829346,0.44013396595032095,70178521,8819,1865
1,2283,0.25,0.5161290322580645,70178514,3044,761
1,967,0.4354932866316404,0.8908045977011494,80124979,1713,746
1,1989,0.27803992740471867,0.5221339387060159,80118615,2755,766
0,4006,0.21650694308625074,0.44897045658012535,80125001,5113,1107
0,643,0.18813131313131312,0.33590308370044053,70850745,792,149
1,168,0.4146341463414634,0.901840490797546,64191904,287,119
0,2869,0.1904627539503386,0.3785766691122524,67266213,3544,675
1,167,0.24774774774774774,0.5284810126582279,80130626,222,55
0,1280,0.07780979827089338,0.19371069182389938,69383671,1388,108
0,317,0.15013404825737264,0.4072948328267477,69383685,373,56
0,3075,0.11663315139327779,0.20537897310513448,69383692,3481,406
0,1688,0.13877551020408163,0.17105263157894737,80117757,1960,272
0,466,0.1089866156787763,0.12283044058744993,80123744,523,57
1,731,0.3044719314938154,0.6551264980026631,80130381,1051,320
0,388,0.08056872037914692,0.0812807881773399,80110030,422,34
0,455,0.10609037328094302,0.1037593984962406,80112774,509,54
1,200,0.38080495356037153,0.8771929824561403,68396013,323,123
1,329,0.40398550724637683,0.8669871794871795,74226152,552,223
0,4537,0.21164205039096437,0.3968066232998226,68544371,5755,1218
1,2009,0.3560897435897436,0.8158112582781457,80111150,3120,1111
1,393,0.25,0.6513888888888889,66931382,524,131
0,607,0.2127107652399481,0.4792243767313019,67833752,771,164
0,1800,0.13378248315688163,0.15228426395939088,67963434,2078,278
1,1982,0.27611395178962744,0.720694171578258,82008926,2738,756
0,618,0.23514851485148514,0.44787322768974147,67556552,808,190
1,1015,0.25858290723155586,0.5504225352112676,67557924,1369,354
2,101,0.6813880126182965,0.9911894273127754,71053402,317,216
0,1616,0.1924037981009495,0.3575029081039163,68534830,2001,385
1,3763,0.31743152548521675,0.736304347826087,70638246,5513,1750
0,463,0.18485915492957747,0.3474025974025974,68545162,568,105
1,1118,0.2659225213394616,0.6132442960489705,80121086,1523,405
0,1829,0.2230246389124894,0.44104948522085685,80125475,2354,525
1,74,0.408,0.8811188811188811,80158089,125,51
1,695,0.3761220825852783,0.8047619047619048,80168012,1114,419
1,336,0.3359683794466403,0.7900641025641025,69177731,506,170
1,777,0.3347602739726027,0.7387120651369357,70179151,1168,391
1,742,0.26968503937007876,0.5305936073059361,70654115,1016,274
0,1181,0.20148749154834347,0.2995805871779509,70654185,1479,298
0,502,0.06343283582089553,0.10187667560321716,80124264,536,34
2,259,0.5282331511839709,0.9771986970684039,82018852,549,290
0,569,0.06105610561056106,0.1401766004415011,61589430,606,37
0,1455,0.09851301115241635,0.23494302767227346,63775544,1614,159
1,679,0.25055187637969095,0.6229271809661139,81965679,906,227
0,1292,0.21363359707851493,0.48169456066945604,82028909,1643,351
1,121,0.18243243243243243,0.5134099616858238,327705,148,27
0,1946,0.16229014205768402,0.2608478802992519,82095667,2323,377
0,5189,0.04049556213017751,0.04052802223251505,63426293,5408,219
0,454,0.02575107296137339,0.01705237515225335,70001036,466,12
0,1798,0.06742738589211618,0.1442163244867301,70001330,1928,130
0,62,0.10144927536231885,0.4110169491525424,70862456,69,7
0,1983,0.0548141086749285,0.1046559538524928,73366230,2098,115
1,857,0.23070017953321365,0.5030712530712531,67291924,1114,257
1,872,0.22695035460992907,0.5014705882352941,68541172,1128,256
0,2051,0.22398789254634885,0.45125348189415043,70184940,2643,592
0,4252,0.12420185375901133,0.15336028297119758,80121154,4855,603
2,218,0.5112107623318386,0.9646569646569647,69056610,446,228
0,1005,0.18159609120521172,0.2979830839297333,65299850,1228,223
1,1860,0.45422535211267606,0.9272326350606395,66152191,3408,1548
2,912,0.5382278481012658,0.9594501718213059,78265712,1975,1063
0,1118,0.16254681647940075,0.2997393570807993,69975255,1335,217
0,3763,0.18496859432531948,0.31399468556244464,68544343,4617,854
0,6459,0.07411123853211009,0.05514458641560188,54130230,6976,517
0,2316,0.16570605187319884,0.260339573356552,60003202,2776,460
0,1320,0.0794979079497908,0.07236431690580163,70206220,1434,114
1,757,0.3029465930018416,0.6992323796231682,70472934,1086,329
1,685,0.25865800865800864,0.5604483586869495,80108980,924,239
0,467,0.19064124783362218,0.35798319327731093,80116533,577,110
1,593,0.29988193624557263,0.6960882647943831,67557700,847,254
0,6050,0.1519484160358845,0.19844357976653695,67963476,7134,1084
0,894,0.2088495575221239,0.39988590986879635,70613550,1130,236
1,409,0.23977695167286245,0.5848341232227489,72382282,538,129
1,141,0.22950819672131148,0.5307692307692308,72382303,183,42
0,1015,0.08558558558558559,0.09781021897810219,68628553,1110,95
0,753,0.23397761953204477,0.4327217125382263,74341603,983,230
1,841,0.4622762148337596,0.918141592920354,68741351,1564,723
0,3209,0.11230982019363762,0.14299900695134063,74691666,3615,406
0,3263,0.22475647422190545,0.439385150812065,80124133,4209,946
0,2974,0.03722887665911298,0.019401330376940133,82036280,3089,115
1,241,0.36910994764397903,0.7668269230769231,76756680,382,141
1,173,0.2938775510204082,0.5552699228791774,80180203,245,72
0,740,0.13551401869158877,0.1896551724137931,70609364,856,116
0,430,0.1746641074856046,0.26549865229110514,74549146,521,91
0,342,0.09762532981530343,0.0959409594095941,74549181,379,37
1,337,0.310838445807771,0.6958762886597938,67995634,489,152
1,100,0.34210526315789475,0.8153846153846154,80163486,152,52
0,251,0.2204968944099379,0.4687975646879756,67554214,322,71
1,617,0.30045351473922904,0.7042971595047341,67533606,882,265
1,530,0.3089960886571056,0.7537037037037037,70626710,767,237
0,1876,0.14376996805111822,0.29436860068259385,67246690,2191,315
0,2825,0.1171875,0.14555145551455514,80145613,3200,375
0,3079,0.1531903190319032,0.34320323014804843,65463601,3636,557
0,2439,0.23374175306314798,0.4884702825592725,69397454,3183,744
1,648,0.4873417721518987,0.9550763701707098,67922876,1264,616
1,676,0.31648129423660265,0.7297077922077922,66087161,989,313
0,2304,0.06265256305939788,0.11023622047244094,70001344,2458,154
0,354,0.18433179723502305,0.44080604534005036,70618240,434,80
0,9,0.1,0.14814814814814814,67291861,10,1
0,938,0.0989433237271854,0.20168067226890757,73366342,1041,103
0,1295,0.09567039106145252,0.1883812746756909,73366384,1432,137
1,885,0.40842245989304815,0.9005281690140845,62751444,1496,611
0,1278,0.056129985228951254,0.1811320754716981,62834282,1354,76
0,1539,0.20874035989717224,0.3583815028901734,70252245,1945,406
0,2565,0.1805111821086262,0.38155668358714045,80180132,3130,565
1,214,0.407202216066482,0.9338624338624338,66931046,361,147
0,1260,0.09156452775775054,0.055237102657634186,65290162,1387,127
0,1727,0.09486373165618449,0.19827586206896552,70001785,1908,181
0,874,0.2040072859744991,0.29310344827586204,66838800,1098,224
0,859,0.17004830917874397,0.30428571428571427,67862466,1035,176
1,229,0.3018292682926829,0.7225130890052356,67558001,328,99
0,1010,0.20970266040688576,0.43606036536934073,70612843,1278,268
1,749,0.2539840637450199,0.6111111111111112,73850840,1004,255
1,2387,0.32930598482719864,0.7598730606488011,80181370,3559,1172
0,625,0.0849194729136164,0.07305194805194805,70871192,683,58
1,334,0.463884430176565,0.9387755102040817,66906973,623,289
1,905,0.26661264181523503,0.6490412550842534,80121018,1234,329
0,699,0.1776470588235294,0.3993435448577681,63306726,850,151
1,758,0.2495049504950495,0.5476190476190477,63283402,1010,252
1,2040,0.27090779127948533,0.6207744314689613,66202185,2798,758
0,3490,0.14355828220858896,0.20516214427531437,80145612,4075,585
2,1642,0.5069069069069069,0.9641407307171854,70612045,3330,1688
1,1708,0.25382262996941896,0.5882658359293873,70690823,2289,581
0,3128,0.2438965433889292,0.4832311575910566,69415080,4137,1009
0,616,0.09144542772861357,0.0941402497598463,69978356,678,62
1,436,0.18352059925093633,0.5454545454545454,68607000,534,98
0,902,0.21015761821366025,0.4762184380504991,73194933,1142,240
1,687,0.4148211243611584,0.7967391304347826,72320983,1174,487
0,1668,0.1424164524421594,0.20931422722620266,65291541,1945,277
0,542,0.11147540983606558,0.15147453083109919,68534571,610,68
1,2117,0.25536405205768553,0.5652509652509653,68545190,2843,726
0,744,0.18865866957470012,0.37789799072642966,67291735,917,173
0,464,0.1609403254972875,0.36515748031496065,72907835,553,89
0,2561,0.17066062176165803,0.33145615446500404,70251846,3088,527
1,628,0.37387836490528414,0.8505550811272417,80121211,1003,375
0,93,0.12264150943396226,0.2918287937743191,65059225,106,13
0,14,0.06666666666666667,0.10526315789473684,66157882,15,1
1,156,0.2777777777777778,0.6705202312138728,69101795,216,60
0,2669,0.16042780748663102,0.264,68170893,3179,510
2,150,0.5614035087719298,0.981549815498155,68290824,342,192
1,79,0.25471698113207547,0.6962616822429907,69416235,106,27
0,664,0.12169312169312169,0.1752738654147105,70614782,756,92
0,5206,0.11462585034013606,0.11126927639383155,68017992,5880,674
0,751,0.10488676996424315,0.15215801024140455,70617561,839,88
0,504,0.1936,0.3507779349363508,80145622,625,121
0,1994,0.14051724137931035,0.20858662613981763,69960373,2320,326
0,393,0.09237875288683603,0.08448928121059268,82128639,433,40
1,1676,0.2616740088105727,0.5356622998544396,80108931,2270,594
1,2187,0.396523178807947,0.9010705057216685,80110772,3624,1437
1,732,0.30219256434699715,0.6453313253012049,67995116,1049,317
0,963,0.17054263565891473,0.284941388638413,68658765,1161,198
1,714,0.3526745240253853,0.7863741339491916,80180113,1103,389
1,1037,0.2833448514167243,0.6952978056426332,80125283,1447,410
1,1256,0.34549244398124024,0.7710976282404853,67994451,1919,663
1,1644,0.401964350672972,0.8848653667595172,80107426,2749,1105
1,858,0.23324396782841822,0.5366311834690044,70626591,1119,261
0,1207,0.165860400829302,0.2799208704253215,68538932,1447,240
0,3550,0.16509877704609596,0.29177877428998505,68173952,4252,702
0,827,0.22128060263653485,0.4925373134328358,70612892,1062,235
0,4925,0.11595763776700772,0.1476179300633654,70514115,5571,646
0,2795,0.06864378540486504,0.041387705416920266,68539072,3001,206
1,14,0.4166666666666667,0.8387096774193549,61694094,24,10
1,30,0.3877551020408163,0.9204545454545454,65278703,49,19
1,2500,0.31091510474090406,0.7320224719101124,80119023,3628,1128
1,1220,0.3270821842250414,0.7676724137931035,68266982,1813,593
0,3007,0.07191358024691358,0.0539993250084374,69601091,3240,233
0,311,0.20460358056265984,0.4327390599675851,68534256,391,80
0,1180,0.09090909090909091,0.17554125219426564,73366160,1298,118
0,1316,0.17440401505646172,0.32299270072992703,80145620,1594,278
0,1131,0.1572280178837556,0.2613318410744264,66816596,1342,211
2,325,0.500768049155146,0.9404332129963899,68741281,651,326
1,833,0.25625,0.5454035874439462,65312443,1120,287
1,659,0.30042462845010615,0.7037845705967977,68763681,942,283
0,1013,0.20361635220125787,0.4443765281173594,82109204,1272,259
0,365,0.1531322505800464,0.29130434782608694,68534466,431,66
0,3332,0.05955405023990968,0.033067611455565395,68534620,3543,211
0,348,0.12562814070351758,0.1371841155234657,68741092,398,50
2,181,0.5041095890410959,0.9569160997732427,72966075,365,184
1,30,0.3877551020408163,0.8651685393258427,70713993,49,19
0,3401,0.17870079690895918,0.34122995932041156,73346931,4141,740
0,724,0.12242424242424242,0.1680887372013652,82009771,825,101
1,484,0.30758226037195996,0.7478474784747847,80125344,699,215
1,330,0.28104575163398693,0.6788432267884322,80125378,459,129
0,1028,0.07136404697380307,0.25461919783686343,62839182,1107,79
1,378,0.4939759036144578,0.9588888888888889,70058912,747,369
0,559,0.06365159128978225,0.06650544135429262,79788142,597,38
1,2077,0.38713484803776926,0.8672086720867209,80107510,3389,1312
1,570,0.3238434163701068,0.7352941176470589,80108882,843,273
1,646,0.27740492170022374,0.7119565217391305,64363082,894,248
0,1144,0.1746031746031746,0.36722689075630255,75333223,1386,242
1,512,0.3236459709379128,0.8080985915492958,80121169,757,245
1,673,0.2945492662473795,0.6198347107438017,79787043,954,281
1,504,0.35218508997429304,0.7834008097165992,67414564,778,274
1,787,0.28906955736224027,0.6438356164383562,80107762,1107,320
2,644,0.5818181818181818,0.9846278317152104,63375200,1540,896
1,273,0.1702127659574468,0.578042328042328,80128656,329,56
0,328,0.10869565217391304,0.18417945690672963,69416515,368,40
1,712,0.4036850921273032,0.8919308357348703,80121717,1194,482
1,438,0.2946859903381642,0.7045143638850889,67985995,621,183
0,649,0.1133879781420765,0.1842346471127406,70609315,732,83
1,2990,0.2543640897755611,0.5712527688899828,75892796,4010,1020
1,441,0.45080946450809467,0.8697142857142857,61104715,803,362
1,1878,0.3787628183923255,0.8788788788788788,65278206,3023,1145
0,1060,0.1975775927327782,0.4205020920502092,80112060,1321,261
1,782,0.3229437229437229,0.7779947916666666,67215785,1155,373
1,1239,0.26512455516014233,0.5406859448554135,67706051,1686,447
2,558,0.6017130620985011,0.9787610619469026,69627831,1401,843
0,1408,0.17900874635568514,0.3041792330891857,68543685,1715,307
0,303,0.1652892561983471,0.2697201017811705,80121064,363,60
0,9361,0.1886808805685561,0.32373845060412226,82000090,11538,2177
1,1308,0.3353658536585366,0.7682672233820459,80119025,1968,660
0,4492,0.18445896877269427,0.396508279337653,65295510,5508,1016
0,1292,0.21601941747572814,0.43478260869565216,70615342,1648,356
1,192,0.2558139534883721,0.6233062330623306,70638904,258,66
1,1249,0.23748473748473747,0.5196560196560197,80121147,1638,389
0,249,0.15593220338983052,0.28970331588132636,54609842,295,46
1,245,0.40097799511002447,0.8070588235294117,67154220,409,164
0,2214,0.22151898734177214,0.4071058475203553,68192040,2844,630
1,633,0.2715765247410817,0.6283422459893048,70643230,869,236
1,1299,0.3105095541401274,0.7401402278702892,70643496,1884,585
0,1889,0.2036256323777403,0.4052539404553415,73003665,2372,483
1,207,0.38392857142857145,0.8949671772428884,69165866,336,129
1,648,0.2376470588235294,0.5716625716625716,66931396,850,202
0,1433,0.20033482142857142,0.4040485829959514,80180134,1792,359
1,51,0.1774193548387097,0.6354679802955665,75456626,62,11
0,622,0.14794520547945206,0.19112207151664612,70853132,730,108
1,249,0.35989717223650386,0.8217391304347826,80180006,389,140
1,335,0.27331887201735355,0.5981308411214953,70673582,461,126
1,1034,0.3484562066792691,0.7749406175771971,80122541,1587,553
1,2335,0.22962718574727814,0.5448907265209687,67810162,3031,696
1,1767,0.2932,0.6961731735601082,69628286,2500,733
0,1789,0.21050308914386584,0.4213219616204691,80112151,2266,477
1,766,0.47534246575342465,0.9324127906976745,70202202,1460,694
1,1974,0.28992805755395684,0.6923076923076923,70627844,2780,806
0,4084,0.2191204588910134,0.4411272987819441,66409182,5230,1146
1,258,0.31926121372031663,0.768,80121260,379,121
0,4663,0.19339214668742433,0.36149584487534625,69893474,5781,1118
1,763,0.3301141352063213,0.7385670731707317,80180159,1139,376
1,1306,0.4167038856632425,0.8891610532761788,68254396,2239,933
1,2833,0.29192701824543865,0.6282631395753567,69630141,4001,1168
1,2007,0.22629144178874325,0.572972972972973,70701022,2594,587
1,149,0.2731707317073171,0.6217765042979942,73200064,205,56
1,369,0.2634730538922156,0.5492957746478874,74351263,501,132
0,296,0.09480122324159021,0.08282828282828283,74549160,327,31
1,241,0.34688346883468835,0.7993079584775087,66054254,369,128
0,1543,0.06428138265615524,0.1245916938870742,68242286,1649,106
0,1293,0.027819548872180452,0.03567508232711306,68242384,1330,37
0,1043,0.21872659176029963,0.36503856041131105,70645421,1335,292
2,88,0.5665024630541872,0.954248366013072,79789731,203,115
1,302,0.3628691983122363,0.8517298187808896,67552926,474,172
1,498,0.215748031496063,0.50187265917603,68537343,635,137
0,1727,0.16730954676952747,0.31733145075891284,68535271,2074,347
0,3516,0.07885774168194917,0.08295254833040422,80149478,3817,301
0,805,0.14634146341463414,0.41787003610108303,63227024,943,138
1,928,0.3074626865671642,0.7670807453416149,80121173,1340,412
1,467,0.282642089093702,0.6121883656509696,74345726,651,184
0,700,0.15764139590854392,0.30101694915254235,80119345,831,131
0,1458,0.07954545454545454,0.08617511520737327,80119361,1584,126
0,1420,0.04825737265415549,0.024245423057892134,80119386,1492,72
1,1488,0.3871499176276771,0.8544529262086514,80125502,2428,940
1,450,0.3108728943338438,0.7739872068230277,70626871,653,203
0,1181,0.1277695716395864,0.14044350580781415,70871073,1354,173
2,392,0.5355450236966824,0.9754189944134078,64398992,844,452
1,2778,0.277315296566077,0.6285916156382477,73914400,3844,1066
0,1006,0.2084972462627852,0.38483824239497827,73914414,1271,265
1,1498,0.30999539382772917,0.7206385404789054,65913526,2171,673
2,1000,0.51338199513382,0.9459459459459459,74776562,2055,1055
0,614,0.046583850931677016,0.0158311345646438,70072093,644,30
0,335,0.20616113744075829,0.43005181347150256,70545853,422,87
2,931,0.6012847965738758,0.9775280898876404,82007006,2335,1404
1,3466,0.26082320324162933,0.569691829233814,66817191,4689,1223
0,3701,0.22002107481559535,0.4480737018425461,66817212,4745,1044
0,3022,0.19154628143392188,0.34417256922086287,68171691,3738,716
0,455,0.13988657844990549,0.25695216907675195,82009774,529,74
0,213,0.12345679012345678,0.17810760667903525,82011785,243,30
1,644,0.4925137903861308,0.9383561643835616,68741365,1269,625
0,1101,0.22464788732394367,0.46860189573459715,75522993,1420,319
1,636,0.2956810631229236,0.6849925705794948,69177066,903,267
2,267,0.5232142857142857,0.9618441971383148,65067646,560,293
1,1748,0.252991452991453,0.5600981193785772,68540955,2340,592
0,648,0.19801980198019803,0.36651982378854625,68541816,808,160
1,634,0.26450116009280744,0.6263636363636363,68543594,862,228
1,1327,0.3371628371628372,0.7393139841688654,68190983,2002,675
1,1129,0.22245179063360881,0.5358166189111748,82109663,1452,323
0,762,0.12814645308924486,0.13806706114398423,69165495,874,112
1,4566,0.23066554338668913,0.5103714423540762,70690760,5935,1369
0,124,0.07462686567164178,0.1685082872928177,67811961,134,10
0,449,0.18065693430656934,0.47577092511013214,67812850,548,99
1,451,0.3218045112781955,0.7730061349693251,68383000,665,214
1,2742,0.31329827197595794,0.7467197750702905,68236364,3993,1251
1,162,0.4151624548736462,0.8032128514056225,80174911,277,115
1,662,0.2717271727172717,0.596514745308311,69705174,909,247
1,845,0.28329092451229854,0.5824175824175825,69705335,1179,334
0,3927,0.020453978548266402,0.01305293691080493,73864056,4009,82
0,1278,0.16851008458035133,0.21827057182705717,80114524,1537,259
0,6556,0.06061040263648087,0.04958469670274352,80114734,6979,423
0,277,0.18529411764705883,0.40039447731755423,68539541,340,63
0,995,0.15749364944961897,0.21397379912663755,70748426,1181,186
0,796,0.06132075471698113,0.046275395033860044,79815876,848,52
0,1916,0.16112084063047286,0.22788496541681835,63264460,2284,368
0,647,0.15645371577574968,0.21739130434782608,69165873,767,120
1,871,0.3857545839210155,0.8553100498930862,69621510,1418,547
0,134,0.16770186335403728,0.4267515923566879,70850801,161,27
1,84,0.25663716814159293,0.5560747663551402,70623861,113,29
0,1290,0.24561403508771928,0.4902758932609679,74446141,1710,420
0,1293,0.21398176291793314,0.4305633017289459,70605073,1645,352
1,1153,0.3104066985645933,0.7278724573941726,69092212,1672,519
0,524,0.055855855855855854,0.14728682170542637,70001050,555,31
0,345,0.20871559633027523,0.3996415770609319,70110306,436,91
1,2244,0.37890949349570996,0.7637113402061856,72676555,3613,1369
1,378,0.32379248658318427,0.7247557003257329,80055360,559,181
0,271,0.20058997050147492,0.4646271510516252,68171460,339,68
1,389,0.37859424920127793,0.8380281690140845,57209523,626,237
0,142,0.12345679012345678,0.20080321285140562,68499620,162,20
0,88,0.10204081632653061,0.15384615384615385,68499676,98,10
0,128,0.1292517006802721,0.30278884462151395,68500040,147,19
0,55,0.08333333333333333,0.2328042328042328,69139133,60,5
0,26,0.10344827586206896,0.2916666666666667,70801381,29,3
1,2874,0.4552691432903715,0.9205246913580247,82138822,5276,2402
0,302,0.15406162464985995,0.4471830985915493,61897136,357,55
0,255,0.18789808917197454,0.39851485148514854,68543293,314,59
0,452,0.15828677839851024,0.28419654714475434,73113572,537,85
1,251,0.4149184149184149,0.9416195856873822,70632023,429,178
1,1715,0.37225475841874084,0.8270058708414872,68254522,2732,1017
0,489,0.19306930693069307,0.33835341365461846,67159155,606,117
1,560,0.3533487297921478,0.8421985815602837,68536356,866,306
0,996,0.16791979949874686,0.2511764705882353,68536461,1197,201
0,540,0.23728813559322035,0.403680981595092,80132866,708,168
0,5507,0.06071976803684121,0.09286347517730496,67837000,5863,356
0,3275,0.13199045852107077,0.22005649717514125,81965604,3773,498
1,211,0.39714285714285713,0.8737864077669902,67160401,350,139
1,12,0.3684210526315789,0.6,80055185,19,7
1,144,0.4725274725274725,0.9409448818897638,69739103,273,129
0,537,0.11677631578947369,0.13733905579399142,69739145,608,71
0,2865,0.08816040738383195,0.1480304955527319,81965823,3142,277
0,1831,0.15970628728774666,0.24409763905562226,67554942,2179,348
1,108,0.4489795918367347,0.8861209964412812,73848656,196,88
1,999,0.26381724392041267,0.594559585492228,69165075,1357,358
0,6087,0.03273478468139202,0.0274032187907786,60074245,6293,206
0,6525,0.029306753942279083,0.023028326879967392,63426391,6722,197
0,4210,0.0652753108348135,0.111170071637039,67837875,4504,294
0,4975,0.06273549359457423,0.10118908836558638,70001596,5308,333
1,2300,0.3548387096774194,0.8133906964237698,70658994,3565,1265
1,1617,0.25069508804448565,0.6071290197597831,73706563,2158,541
0,2789,0.20223112128146453,0.4381015599070694,70690634,3496,707
0,1997,0.019636720667648502,0.007228915662650603,70617393,2037,40
0,1399,0.057912457912457915,0.031067961165048542,70643384,1485,86
1,600,0.2998833138856476,0.7354651162790697,80125368,857,257
0,705,0.06992084432717678,0.05131004366812227,80180394,758,53
1,333,0.28846153846153844,0.7643835616438356,80118437,468,135
1,1527,0.306854289605084,0.6873684210526316,80181377,2203,676
0,1516,0.05309181761399125,0.167507204610951,62834996,1601,85
0,391,0.05783132530120482,0.15898617511520738,64241275,415,24
0,209,0.20229007633587787,0.483402489626556,67225991,262,53
0,192,0.06341463414634146,0.25161290322580643,69204856,205,13
0,619,0.03582554517133956,0.10740531373657433,80128640,642,23
1,475,0.3572395128552097,0.8312101910828026,69180391,739,264
1,61,0.39,0.9158415841584159,82128644,100,39
0,378,0.136986301369863,0.20610687022900764,68173931,438,60
0,119,0.0703125,0.008888888888888889,73346882,128,9
0,1911,0.13918918918918918,0.18086642599277977,67963441,2220,309
1,1844,0.24457189676362145,0.5653038046564453,65410212,2441,597
1,1021,0.38567990373044525,0.8212074303405573,69389446,1662,641
1,178,0.45896656534954405,0.8650519031141869,80118580,329,151
1,762,0.35423728813559324,0.78860103626943,80178611,1180,418
1,518,0.29905277401894453,0.681917211328976,64276051,739,221
0,966,0.135183527305282,0.17839506172839506,68541886,1117,151
1,1306,0.4047402005469462,0.9120347994200096,69607573,2194,888
1,1744,0.35550628233555065,0.8002382843526609,80118366,2706,962
1,909,0.37824897400820795,0.7878787878787878,74555033,1462,553
1,2333,0.4346983280833535,0.8968565815324165,70795116,4127,1794
1,438,0.3282208588957055,0.7898305084745763,69073515,652,214
1,126,0.27167630057803466,0.5371428571428571,80180473,173,47
1,630,0.2857142857142857,0.6445623342175066,68212130,882,252
0,810,0.18674698795180722,0.39415584415584415,68543384,996,186
0,1096,0.14774494556765164,0.2087912087912088,70207354,1286,190
1,282,0.4149377593360996,0.7751004016064257,80019590,482,200
0,216,0.25,0.4797979797979798,80176783,288,72
1,957,0.35943775100401604,0.807919621749409,69573651,1494,537
1,882,0.2370242214532872,0.546949965729952,68538750,1156,274
0,1819,0.20393873085339168,0.4120388349514563,68538764,2285,466
0,1658,0.18525798525798526,0.3361581920903955,81979699,2035,377
0,2292,0.19465917076598735,0.3744192402295709,81979700,2846,554
1,1583,0.3974114960030453,0.8651901781415503,80180323,2627,1044
0,470,0.09090909090909091,0.3402061855670103,62842465,517,47
1,350,0.23580786026200873,0.5559796437659033,68534991,458,108
1,1159,0.4800358905338717,0.9307479224376731,72801092,2229,1070
1,751,0.36677908937605397,0.8418674698795181,70748363,1186,435
0,756,0.1553072625698324,0.2767962308598351,66766231,895,139
1,3549,0.38181501480578295,0.8109332527937179,68372045,5741,2192
0,525,0.2009132420091324,0.2920353982300885,80176760,657,132
0,1647,0.06260671599317018,0.21703853955375255,62835444,1757,110
1,1893,0.24158653846153846,0.532286995515695,66817184,2496,603
1,335,0.21728971962616822,0.5112443778110944,67350990,428,93
1,248,0.22012578616352202,0.5388198757763976,69895014,318,70
1,760,0.24752475247524752,0.5497572815533981,65316580,1010,250
1,2033,0.27132616487455197,0.6179126038280968,80135435,2790,757
2,389,0.6137040714995035,0.9463687150837988,82023568,1007,618
1,1389,0.3058470764617691,0.7161234991423671,68151503,2001,612
1,280,0.3533487297921478,0.733983286908078,82023507,433,153
0,2451,0.1103448275862069,0.23699421965317918,60029256,2755,304
1,171,0.26609442060085836,0.5072992700729927,82062249,233,62
2,2236,0.5108291402318967,0.9665605095541401,69657406,4571,2335
1,3090,0.28372739916550765,0.5966555183946488,80096163,4314,1224
1,114,0.2919254658385093,0.6857142857142857,68531841,161,47
1,569,0.30609756097560975,0.7671111111111111,80121179,820,251
1,334,0.3709981167608286,0.8489010989010989,67668055,531,197
0,246,0.08208955223880597,0.058524173027989825,62792730,268,22
0,72,0.13253012048192772,0.18243243243243243,69621321,83,11
1,375,0.3339253996447602,0.6845528455284553,69955851,563,188
1,250,0.3224932249322493,0.6797235023041475,70485744,369,119
1,281,0.33569739952718675,0.7042553191489361,70485751,423,142
0,424,0.14688128772635814,0.1680960548885077,70524083,497,73
0,2603,0.1786052382455033,0.34351503759398494,73700466,3169,566
0,861,0.19607843137254902,0.37365743357829284,66423203,1071,210
0,1529,0.1524390243902439,0.20042735042735044,66423910,1804,275
1,222,0.47641509433962265,0.9152215799614644,67306974,424,202
0,1141,0.1683673469387755,0.286673058485139,67963490,1372,231
0,453,0.2038664323374341,0.44103547459252157,67555852,569,116
0,556,0.20229555236728838,0.3795811518324607,67556160,697,141
0,1170,0.22259136212624583,0.4220272904483431,67552121,1505,335
1,796,0.4851228978007762,0.9438596491228071,70612080,1546,750
1,341,0.318,0.782051282051282,63609420,500,159
1,108,0.4,0.9090909090909091,67346965,180,72
1,48,0.22580645161290322,0.5681818181818182,70490343,62,14
1,2023,0.31562922868741544,0.7371794871794872,70642243,2956,933
0,583,0.23790849673202613,0.494949494949495,69165705,765,182
0,750,0.2113564668769716,0.3509496284062758,69586055,951,201
1,483,0.22347266881028938,0.5071428571428571,70281666,622,139
1,2866,0.24499473129610116,0.5343886462882096,75892971,3796,930
0,1188,0.1829436038514443,0.3437935843793584,70609301,1454,266
0,1360,0.15,0.24788334901222953,73346910,1600,240
0,933,0.14167433302667892,0.2298181818181818,82009761,1087,154
2,968,0.5627822944896116,0.9774480712166173,70598493,2214,1246
0,1436,0.14217443249701314,0.20015760441292357,54460476,1674,238
1,1019,0.23898431665421957,0.5200764818355641,80108623,1339,320
2,2045,0.7968206656731247,0.9984928409947249,70599081,10065,8020
0,714,0.05305039787798409,0.033308099924299776,70617344,754,40
1,45,0.296875,0.6938775510204082,80053463,64,19
0,1080,0.21511627906976744,0.42396061269146607,68542026,1376,296
1,1115,0.31426814268142683,0.7498852684717761,73245893,1626,511
0,4819,0.15381913959613697,0.23753612716763006,69094382,5695,876
1,300,0.2555831265508685,0.5423514538558787,69606852,403,103
0,998,0.13593073593073593,0.22356495468277945,73255070,1155,157
0,192,0.06796116504854369,0.032362459546925564,67435872,206,14
0,240,0.14590747330960854,0.17256637168141592,68545120,281,41
0,1532,0.2155657962109575,0.4591733870967742,80112354,1953,421
0,119,0.032520325203252036,0.04050632911392405,63780423,123,4
0,289,0.049342105263157895,0.10766721044045677,63780955,304,15
0,1162,0.055284552845528454,0.10326086956521739,64251243,1230,68
0,733,0.0984009840098401,0.20899470899470898,69383440,813,80
0,558,0.057432432432432436,0.18045112781954886,69383573,592,34
1,130,0.16666666666666666,0.5422535211267606,80150437,156,26
1,1015,0.4852941176470588,0.941783345615328,70058940,1972,957
0,556,0.18832116788321168,0.3489235337787676,70524440,685,129
1,175,0.36363636363636365,0.8346055979643766,70642810,275,100
0,686,0.14463840399002495,0.24076281287246723,72523171,802,116
0,465,0.08102766798418973,0.08370044052863436,72523185,506,41
0,463,0.152014652014652,0.26343612334801764,81979726,546,83
0,490,0.13427561837455831,0.21540762902019447,82041094,566,76
1,1405,0.2757731958762887,0.6618247843849296,80121214,1940,535
1,826,0.4112615823235923,0.8008474576271186,82047557,1403,577
0,378,0.19915254237288135,0.42155525238744884,68538113,472,94
0,1346,0.2183507549361208,0.4399303540336622,66833004,1722,376
0,1226,0.22208121827411167,0.45354523227383864,66833074,1576,350
0,1,0.0,0.0,71879416,1,0
1,148,0.33031674208144796,0.6475903614457831,79792034,221,73
1,1526,0.3035143769968051,0.694468085106383,73818171,2191,665
0,1404,0.045547246770904146,0.013539651837524178,517804,1471,67
1,1888,0.25049622866216753,0.5588637919233401,69549382,2519,631
1,432,0.2894736842105263,0.6084583901773534,70179025,608,176
0,1659,0.11472785485592316,0.1463220675944334,80119313,1874,215
0,935,0.10182516810758886,0.12198221092757307,80119359,1041,106
0,2319,0.07572738142686329,0.06170780520346898,80119382,2509,190
0,1575,0.2029352226720648,0.4158523344191097,81979697,1976,401
1,194,0.40307692307692305,0.8460207612456747,70587601,325,131
0,263,0.0673758865248227,0.21608832807570977,67796526,282,19
0,4659,0.17787188988883007,0.29225670382645375,82116361,5667,1008
1,514,0.2900552486187845,0.6998904709748083,63774942,724,210
1,4227,0.21533320957861518,0.5113743184809174,67809952,5387,1160
0,613,0.15448275862068966,0.2444253859348199,67905453,725,112
1,92,0.4491017964071856,0.8756218905472637,82047588,167,75
1,184,0.4006514657980456,0.9093333333333333,75293162,307,123
1,300,0.3576017130620985,0.8043184885290149,67995641,467,167
0,2016,0.18082080455099553,0.2548262548262548,70653835,2461,445
0,2881,0.12298325722983257,0.13455562461155998,70653863,3285,404
1,252,0.26099706744868034,0.6652777777777777,70062643,341,89
0,3575,0.19644864014385255,0.3893094746501491,73266340,4449,874
1,749,0.3032558139534884,0.7410832232496698,80121208,1075,326
0,1315,0.15759128763613067,0.27346278317152106,67215631,1561,246
1,4611,0.45477119545938277,0.9222754740570952,67656183,8457,3846
1,6481,0.2761894125530489,0.6404427161232426,80135437,8954,2473
1,2078,0.2752005580746425,0.571062271062271,70645001,2867,789
1,3374,0.26476356504685117,0.6329308452250274,80118436,4589,1215
1,417,0.24043715846994534,0.6122860020140987,69895042,549,132
1,3445,0.31728101466508124,0.7626938602082005,70072534,5046,1601
1,1471,0.28033268101761255,0.5861594867094408,73747835,2044,573
1,467,0.26224328593996843,0.5362865221489161,74555481,633,166
1,2097,0.2723802914642609,0.6140664048554088,73816281,2882,785
1,164,0.451505016722408,0.908,70925743,299,135
0,5654,0.22907008453776928,0.4820952380952381,66409210,7334,1680
1,303,0.2518518518518518,0.5375335120643432,70048020,405,102
2,655,0.5218978102189781,0.9490445859872612,69986084,1370,715
0,243,0.17627118644067796,0.32798573975044565,70573853,295,52
0,3357,0.14296655603778402,0.17056145675265555,70641116,3917,560
0,135,0.08163265306122448,0.3323353293413174,60541705,147,12
0,1786,0.1450454763044519,0.18337408312958436,68544294,2089,303
1,1523,0.27476190476190476,0.6517857142857143,80121040,2100,577
1,2483,0.33627372360331464,0.7946454001708915,80109071,3741,1258
1,85,0.39285714285714285,0.8389261744966443,73501372,140,55
2,270,0.5454545454545454,0.9626334519572953,74572442,594,324
1,2007,0.4593211206896552,0.8921143847487002,80181004,3712,1705
1,1592,0.26330402591392876,0.5172964342735498,80181306,2161,569
1,599,0.49706129303106633,0.9479371316306483,80126585,1191,592
1,813,0.31334459459459457,0.7703045685279187,70614565,1184,371
1,450,0.3202416918429003,0.7711640211640212,66911656,662,212
1,1436,0.48214929679047963,0.9290928050052137,65690030,2773,1337
0,271,0.2554945054945055,0.47268408551068886,70800380,364,93
0,1623,0.09177392277560156,0.10062111801242236,73346770,1787,164
2,1050,0.5895230648944488,0.9793233082706767,82041316,2558,1508
0,934,0.09320388349514563,0.10032102728731943,68171586,1030,96
0,1189,0.13274981765134938,0.1766990291262136,68171684,1371,182
0,2191,0.2238753099539497,0.44662379421221865,73816162,2823,632
1,715,0.44530643910007756,0.9386343993085566,66633903,1289,574
0,1216,0.08157099697885196,0.16063596491228072,68242314,1324,108
1,1567,0.2708236389018148,0.6213853396099529,67813851,2149,582
0,931,0.14508723599632692,0.22722400857449088,54460483,1089,158
0,833,0.1577350859453994,0.263561320754717,68497135,989,156
0,9320,0.14212076583210603,0.22508983992159426,65915626,10864,1544
0,1416,0.15513126491646778,0.25660569105691056,73808931,1676,260
1,77,0.2376237623762376,0.50187265917603,70760634,101,24
0,876,0.11425682507583418,0.20277920741121977,73884230,989,113
0,799,0.17628865979381445,0.3843843843843844,80136482,970,171
0,862,0.10208333333333333,0.13290113452188007,80176412,960,98
2,125,0.5860927152317881,0.9566666666666667,73347456,302,177
1,257,0.44731182795698926,0.90625,67346825,465,208
2,630,0.590110605074821,0.9547413793103449,71165654,1537,907
1,5928,0.3006134969325153,0.6647757489806772,64506001,8476,2548
1,447,0.3080495356037152,0.62890625,68741540,646,199
1,343,0.29132231404958675,0.6434210526315789,69177262,484,141
2,428,0.6123188405797102,0.9847009735744089,82039899,1104,676
1,398,0.41384388807069217,0.8777777777777778,70179200,679,281
1,875,0.49009324009324007,0.9434502505368647,70202160,1716,841
2,171,0.5626598465473146,0.940959409594096,70254933,391,220
0,596,0.21164021164021163,0.4633920296570899,68541074,756,160
0,545,0.1497659906396256,0.2539349422875131,69214873,641,96
1,1047,0.3236434108527132,0.7507246376811594,80159816,1548,501
1,282,0.3869565217391304,0.7841726618705036,69157935,460,178
0,208,0.1969111969111969,0.2617283950617284,70575442,259,51
1,1449,0.3057019645424054,0.6333190210390726,70628733,2087,638
0,1261,0.22590546347452425,0.45002368545712934,70660142,1629,368
1,286,0.36160714285714285,0.8208955223880597,70852586,448,162
0,52,0.2,0.3045977011494253,72759491,65,13
0,19,0.0,0.0,72759743,19,0
1,110,0.3956043956043956,0.8388278388278388,73034472,182,72
2,457,0.5112299465240642,0.960730593607306,82043163,935,478
1,715,0.4361198738170347,0.8917525773195877,70628761,1268,553
1,250,0.23780487804878048,0.50814332247557,73818500,328,78
1,339,0.4368770764119601,0.8887096774193548,72271010,602,263
0,76,0.012987012987012988,0.02358490566037736,80124220,77,1
2,144,0.6974789915966386,0.9859154929577465,69171081,476,332
1,195,0.4786096256684492,0.8883720930232558,75550356,374,179
1,113,0.481651376146789,0.9457142857142857,82043164,218,105
2,228,0.6,0.9634146341463414,67719120,570,342
1,441,0.4661016949152542,0.9153605015673981,67216240,826,385
2,55,0.8291925465838509,0.9703703703703703,82007810,322,267
1,176,0.3736654804270463,0.7857142857142857,70998291,281,105
0,2,0.0,0.0,70843703,2,0
1,1360,0.28608923884514437,0.6415250725238293,74351256,1905,545
0,593,0.22076215505913271,0.4064039408866995,74445392,761,168
1,61,0.3645833333333333,0.842911877394636,80117931,96,35
0,993,0.1274165202108963,0.2668674698795181,80118000,1138,145
0,19,0.13636363636363635,0.328,80123780,22,3
0,215,0.07725321888412018,0.1822125813449024,80124245,233,18
0,166,0.05142857142857143,0.12472160356347439,80124388,175,9
0,2147,0.03069977426636569,0.02180339985218034,80137164,2215,68
0,4398,0.08736252334509234,0.18369793227449804,80096303,4819,421
1,1898,0.4437280187573271,0.8833441348023331,81989261,3412,1514
1,66,0.35294117647058826,0.7409326424870466,81997887,102,36
1,159,0.3715415019762846,0.8037735849056604,74511710,253,94
0,2206,0.05524625267665953,0.0767397521448999,80124222,2335,129
0,2572,0.04386617100371747,0.0922279792746114,80124280,2690,118
0,80,0.16666666666666666,0.39915966386554624,72773295,96,16
0,916,0.19860017497812774,0.39363817097415504,80140104,1143,227
1,1215,0.4167066730676908,0.8059887710542732,69511316,2083,868
1,405,0.30412371134020616,0.6682188591385332,69208181,582,177
0,194,0.0673076923076923,0.15604395604395604,69208244,208,14
2,17,0.7017543859649122,0.9516129032258065,80126501,57,40
1,654,0.29449838187702265,0.5995717344753747,80090255,927,273
2,666,0.5568862275449101,0.9636992221261884,70760242,1503,837
1,317,0.3078602620087336,0.6446540880503144,69150753,458,141
1,270,0.3023255813953488,0.6139630390143738,81997883,387,117
1,177,0.27755102040816326,0.5521235521235521,54412596,245,68
0,199,0.15319148936170213,0.18928571428571428,60501791,235,36
0,200,0.0430622009569378,0.16895604395604397,62841471,209,9
0,1589,0.24369347929557353,0.47781721384205855,64448860,2101,512
0,42,0.14285714285714285,0.4725274725274725,67862844,49,7
1,435,0.29383116883116883,0.650887573964497,68546114,616,181
0,687,0.12260536398467432,0.26956521739130435,69628734,783,96
1,234,0.21739130434782608,0.5762483130904184,70233786,299,65
0,2869,0.19590807174887892,0.3668596237337192,63755650,3568,699
2,544,0.5405405405405406,0.9646302250803859,70202580,1184,640
1,1670,0.3728877206158468,0.697950377562028,70112371,2663,993
0,373,0.27431906614785995,0.397887323943662,80128010,514,141
0,347,0.2288888888888889,0.42225859247135844,67666165,450,103
1,150,0.42748091603053434,0.8811881188118812,73026380,262,112
1,1893,0.26456876456876455,0.5504107542942495,74554445,2574,681
2,1460,0.7754537065518302,0.9963920625375827,80117626,6502,5042
1,533,0.2883845126835781,0.6758544652701213,80103030,749,216
1,304,0.3770491803278688,0.8111888111888111,80136856,488,184
0,738,0.14583333333333334,0.25208175624526874,74445406,864,126
0,164,0.15897435897435896,0.296875,80177439,195,31
1,16,0.30434782608695654,0.8493150684931506,69400541,23,7
0,1342,0.1554436752674638,0.2237017310252996,68240410,1589,247
0,318,0.012422360248447204,0.002911208151382824,73245424,322,4
1,2204,0.2960715426381348,0.6962445995347292,80181383,3131,927
0,939,0.1448087431693989,0.20118694362017805,82011410,1098,159
0,258,0.1103448275862069,0.176,82011862,290,32
0,874,0.17469310670443816,0.3322324966974901,68534914,1059,185
1,713,0.225,0.5180630284396618,68535110,920,207
1,751,0.32281334535617673,0.7498228206945429,65766526,1109,358
1,413,0.458005249343832,0.9270729270729271,69028022,762,349
0,3121,0.16304639313488872,0.30303030303030304,73808924,3729,608
1,1375,0.3069556451612903,0.736949846468782,80125514,1984,609
2,44,0.580952380952381,0.9795918367346939,68039951,105,61
2,652,0.5534246575342465,0.9842300556586271,68039972,1460,808
1,659,0.40036396724294815,0.8758389261744967,68258015,1099,440
1,1961,0.45798783858485353,0.8987839771101573,70760172,3618,1657
0,1921,0.13312274368231047,0.16217116217116218,67964120,2216,295
0,1462,0.19626168224299065,0.36875262494750105,68535810,1819,357
1,1211,0.38930912758446795,0.8883720930232558,68531491,1983,772
1,1336,0.343811394891945,0.8075601374570447,80109092,2036,700
1,5693,0.32451352634076885,0.73977232301672,70658966,8428,2735
1,1215,0.4301125703564728,0.9022329511164756,64996281,2132,917
0,52,0.23529411764705882,0.3238095238095238,82126762,68,16
1,1897,0.31466763005780346,0.6988457502623295,80125007,2768,871
1,454,0.24834437086092714,0.509142053445851,69152244,604,150
1,136,0.24444444444444444,0.5105740181268882,70207620,180,44
0,1295,0.15248691099476439,0.3542692939244663,73194884,1528,233
1,988,0.2411674347158218,0.5115055884286653,62141282,1302,314
0,981,0.19656019656019655,0.33622291021671824,62142031,1221,240
0,503,0.17540983606557378,0.30462020360219266,70769853,610,107
1,1527,0.4623239436619718,0.9118190212373037,70202321,2840,1313
0,615,0.08208955223880597,0.08017492711370262,70646142,670,55
0,455,0.21006944444444445,0.4351648351648352,68542355,576,121
0,1451,0.11953883495145631,0.14149043303121853,68539632,1648,197
1,225,0.2598684210526316,0.5197889182058048,69091715,304,79
0,1471,0.23064853556485357,0.4611494252873563,62142024,1912,441
0,1015,0.2351168048229088,0.4896341463414634,68535320,1327,312
1,127,0.47950819672131145,0.8706624605678234,82059490,244,117
1,445,0.4018817204301075,0.9094159713945172,68531330,744,299
0,525,0.19969512195121952,0.42344244984160506,68537462,656,131
0,99,0.08333333333333333,0.09414758269720101,80097451,108,9
1,393,0.34717607973421927,0.8160095579450418,82126698,602,209
1,515,0.3780193236714976,0.8804232804232804,70642124,828,313
1,582,0.3136792452830189,0.7226202661207779,80109624,848,266
1,363,0.274,0.6735751295336787,70670495,500,137
0,734,0.15144508670520232,0.22688172043010751,68294681,865,131
1,1614,0.37514518002322883,0.8262265016047684,80180317,2583,969
1,531,0.22707423580786026,0.515495867768595,68642105,687,156
2,427,0.5218365061590146,0.9445048966267682,70853986,893,466
0,8185,0.09387800287833499,0.1468889255652748,81965820,9033,848
1,504,0.30193905817174516,0.6821621621621622,81967255,722,218
1,602,0.30243337195828507,0.7281879194630873,69586083,863,261
0,595,0.19047619047619047,0.26140155728587317,70653653,735,140
1,622,0.4319634703196347,0.9266521423384169,69219024,1095,473
0,4997,0.2345281862745098,0.48251883330113965,80125452,6528,1531
1,816,0.32894736842105265,0.8042553191489362,69585971,1216,400
0,1366,0.2149425287356322,0.43385707045108973,80108581,1740,374
1,1025,0.4257703081232493,0.7450462351387054,68285413,1785,760
0,153,0.20725388601036268,0.4107142857142857,67344585,193,40
0,1840,0.13002364066193853,0.23054635761589404,81965602,2115,275
0,555,0.05128205128205128,0.01646090534979424,68539583,585,30
0,2006,0.12706701479547433,0.17722395292488752,67703335,2298,292
0,1781,0.06753926701570681,0.04955680902497985,67703356,1910,129
2,119,0.5688405797101449,0.9836065573770492,67160352,276,157
0,1542,0.14333333333333334,0.19984802431610943,70176274,1800,258
0,385,0.15384615384615385,0.242,70500052,455,70
1,107,0.3184713375796178,0.6407185628742516,54291153,157,50
1,305,0.2632850241545894,0.5638629283489096,67551743,414,109
0,205,0.2084942084942085,0.38823529411764707,68533353,259,54
2,450,0.5108695652173914,0.9592696629213483,62512240,920,470
0,1816,0.19929453262786595,0.3438291711907347,69586405,2268,452
0,1335,0.2156286721504113,0.405080831408776,69607993,1702,367
0,898,0.20881057268722467,0.36950732356857524,69608021,1135,237
1,224,0.2679738562091503,0.6462715105162524,73215961,306,82
1,951,0.34004163775156143,0.7075098814229249,80089954,1441,490
2,96,0.7467018469656992,0.9803921568627451,62624534,379,283
0,461,0.20379965457685664,0.3697334479793637,80160713,579,118
1,182,0.2571428571428571,0.5798969072164949,80135828,245,63
1,3816,0.31007051166154403,0.7426353048641242,80125445,5531,1715
0,1786,0.19075668328047124,0.3560460652591171,80141449,2207,421
1,536,0.37383177570093457,0.8213228035538006,65278416,856,320
0,873,0.2085222121486854,0.469429347826087,66423742,1103,230
2,35,0.5625,0.9454545454545454,66909934,80,45
0,2348,0.20568335588633288,0.44934776575076324,80140160,2956,608
1,302,0.4645390070921986,0.9330484330484331,61698581,564,262
1,1092,0.2591587516960651,0.584070796460177,68540990,1474,382
0,742,0.19435396308360478,0.32298136645962733,65360470,921,179
1,1324,0.29686670207116306,0.7144578313253012,67775022,1883,559
1,1935,0.28013392857142855,0.6121659634317862,67557973,2688,753
1,243,0.22115384615384615,0.5400313971742543,65006256,312,69
0,226,0.20422535211267606,0.40437158469945356,70654486,284,58
0,6854,0.15036568736829056,0.28530573335149123,70841736,8067,1213
1,2589,0.27499299915989917,0.5695407994714239,70641382,3571,982
0,871,0.08315789473684211,0.0805892547660312,79788135,950,79
0,51,0.203125,0.3793103448275862,72208584,64,13
1,216,0.15953307392996108,0.6338383838383839,64182356,257,41
0,587,0.0532258064516129,0.20075997466751108,67868780,620,33
2,53,0.7150537634408602,0.9765625,80126935,186,133
0,2042,0.1362098138747885,0.2112614578786556,73808910,2364,322
0,1802,0.19083969465648856,0.3799221116399827,80112172,2227,425
1,928,0.3033033033033033,0.650804289544236,70720433,1332,404
1,713,0.400336417157275,0.8794740686632578,80137616,1189,476
1,248,0.26409495548961426,0.6434108527131783,67552114,337,89
1,72,0.3949579831932773,0.8475609756097561,71164072,119,47
1,2479,0.29070100143061517,0.6830282861896838,76043394,3495,1016
1,1124,0.4482081492390771,0.8487084870848709,80174918,2037,913
0,995,0.09791477787851315,0.19755877034358046,70330575,1103,108
0,1694,0.1286008230452675,0.2523931078493937,80140168,1944,250
0,597,0.09954751131221719,0.3408408408408408,62835192,663,66
0,359,0.05526315789473684,0.24177949709864605,62835206,380,21
0,175,0.05913978494623656,0.30132450331125826,62836844,186,11
0,1863,0.13988919667590027,0.1874786178583647,67963343,2166,303
1,1473,0.17801339285714285,0.5326739667961851,68221664,1792,319
1,1990,0.26022304832713755,0.601123595505618,68530952,2690,700
0,280,0.0967741935483871,0.42048780487804877,68798366,310,30
0,155,0.06060606060606061,0.36768802228412256,68798373,165,10
0,266,0.18404907975460122,0.44112769485903813,70756420,326,60
1,504,0.288135593220339,0.6777668952007836,68253983,708,204
1,234,0.2887537993920973,0.6471861471861472,67627231,329,95
0,696,0.1460122699386503,0.23484848484848486,70073192,815,119
0,418,0.1787819253438114,0.35777777777777775,82011824,509,91
1,986,0.4343086632243259,0.9159609120521173,65984065,1743,757
1,26,0.3333333333333333,0.7924528301886793,69037906,39,13
1,1631,0.37557427258805515,0.8602099236641222,67993324,2612,981
1,1425,0.22131147540983606,0.5158311345646438,73194926,1830,405
1,2316,0.4301181102362205,0.919737663960025,69668802,4064,1748
1,1371,0.28482003129890454,0.6621325142606407,70729540,1917,546
1,208,0.2517985611510791,0.633245382585752,68538652,278,70
0,549,0.2300140252454418,0.49077181208053694,66930815,713,164
0,230,0.1872791519434629,0.3813868613138686,77676606,283,53
0,248,0.14186851211072665,0.1693548387096774,79520133,289,41
1,547,0.2263083451202263,0.5298969072164949,68543510,707,160
0,1240,0.1286015460295151,0.18244703847816687,70626892,1423,183
0,1250,0.16387959866220736,0.2436428149024246,70215873,1495,245
1,729,0.2606490872210953,0.5202702702702703,81956110,986,257
0,296,0.2064343163538874,0.4658703071672355,67159176,373,77
1,1074,0.334984520123839,0.6811168258633358,68401403,1615,541
2,485,0.5115810674723061,0.9685990338164251,63958272,993,508
0,1346,0.1382842509603073,0.17161520190023752,70653814,1562,216
0,418,0.17391304347826086,0.3228346456692913,82000022,506,88
0,598,0.19298245614035087,0.37196391394864675,70769783,741,143
1,177,0.3655913978494624,0.812987012987013,82007149,279,102
0,835,0.09041394335511982,0.09532710280373832,80119402,918,83
0,1257,0.08181154127100074,0.10125991600559962,82036694,1369,112
1,557,0.4191866527632951,0.8676358071920428,70925813,959,402
2,59,0.6193548387096774,0.9943502824858758,79816520,155,96
1,1280,0.39565627950897075,0.8429251406317612,73330656,2118,838
1,299,0.2372448979591837,0.5450381679389313,68533374,392,93
0,89,0.20535714285714285,0.4293785310734463,68533423,112,23
1,125,0.25149700598802394,0.5022222222222222,67291581,167,42
0,1338,0.2016706443914081,0.27689243027888444,69482175,1676,338
0,1687,0.23734177215189872,0.4480069324090121,70645106,2212,525
0,1314,0.16624365482233502,0.22650321074138938,70719985,1576,262
1,73,0.3706896551724138,0.8666666666666667,71741334,116,43
1,1037,0.29837618403247634,0.7390046296296297,68536741,1478,441
2,1646,0.5255116748342462,0.9676576282260699,65815631,3469,1823
1,742,0.3775167785234899,0.8333333333333334,69573826,1192,450
0,854,0.19736842105263158,0.37281067556296915,70642530,1064,210
0,68,0.2,0.3496932515337423,67555376,85,17
1,91,0.2601626016260163,0.6297709923664122,82096029,123,32
1,376,0.32737030411449014,0.7877551020408163,80120446,559,183
1,552,0.3825503355704698,0.8851791530944625,80120449,894,342
0,101,0.2518518518518518,0.4845814977973568,80120471,135,34
1,1427,0.3240170535291331,0.7503836317135549,69153952,2111,684
1,587,0.3061465721040189,0.7559414990859232,80125354,846,259
0,864,0.11566018423746162,0.2063157894736842,74789246,977,113
1,260,0.2837465564738292,0.657258064516129,76043415,363,103
1,1209,0.26992753623188404,0.5788986580286904,80130380,1656,447
0,1648,0.1294241944004226,0.26903890921183904,80140166,1893,245
0,490,0.02584493041749503,0.044072948328267476,62838090,503,13
1,384,0.31793960923623443,0.7235772357723578,80111241,563,179
1,426,0.35843373493975905,0.7544529262086515,65924033,664,238
1,282,0.3155339805825243,0.7227272727272728,64332121,412,130
0,1472,0.12847838957963292,0.14296784192173576,67963280,1689,217
0,2073,0.16208569118835894,0.34739707383463764,262766,2474,401
0,1648,0.1312598840274117,0.3505346350534635,62413673,1897,249
0,113,0.096,0.2056338028169014,70633710,125,12
0,210,0.14285714285714285,0.3339920948616601,72866766,245,35
0,171,0.03932584269662921,0.08664259927797834,80124781,178,7
0,1428,0.17504332755632582,0.4131614654002714,80180487,1731,303
1,1266,0.25791324736225085,0.644847972972973,80118418,1706,440
1,1703,0.2602085143353606,0.6021747281589801,80121136,2302,599
1,86,0.3435114503816794,0.8043478260869565,80135824,131,45
0,285,0.18803418803418803,0.2745762711864407,987574,351,66
1,837,0.31673469387755104,0.6868442292171105,69499276,1225,388
0,2276,0.10075069142631371,0.12254901960784313,70071043,2531,255
0,2342,0.09784283513097072,0.10446659283868587,70071050,2596,254
1,150,0.45652173913043476,0.9297658862876255,69007295,276,126
1,181,0.33455882352941174,0.7890625,66931032,272,91
1,255,0.22727272727272727,0.5172932330827068,67160513,330,75
1,1392,0.23178807947019867,0.5154880187025132,63709821,1812,420
1,363,0.4776978417266187,0.9419889502762431,64653015,695,332
1,1385,0.3695949021392808,0.7954033348355115,74555236,2197,812
2,821,0.5503833515881709,0.9657483246463142,70202440,1826,1005
0,733,0.16228571428571428,0.22709551656920077,70207774,875,142
1,1556,0.29941467807294014,0.6405529953917051,80127897,2221,665
1,200,0.35275080906148865,0.8413461538461539,80135823,309,109
0,649,0.18055555555555555,0.3948497854077253,68120423,792,143
0,4431,0.1537433155080214,0.2121068810593521,82107796,5236,805
1,1352,0.486517280668439,0.9484159220146222,80163508,2633,1281
1,563,0.2772785622593068,0.6823529411764706,80121093,779,216
2,838,0.5621734587251829,0.9798657718120806,63176883,1914,1076
1,271,0.44123711340206184,0.9498956158663883,67558204,485,214
1,337,0.26258205689277897,0.6258278145695364,68533941,457,120
1,981,0.45950413223140496,0.9047619047619048,70637994,1815,834
0,611,0.1875,0.28823981552651806,70841792,752,141
1,3049,0.243424317617866,0.5900541919030922,61626173,4030,981
1,462,0.3790322580645161,0.8524762908324552,65029944,744,282
0,1131,0.13266871165644173,0.2904918032786885,69697873,1304,173
1,2631,0.3281409601634321,0.7485561972456686,80125006,3916,1285
1,1525,0.2575462512171373,0.6111875286565795,68539961,2054,529
0,101,0.09821428571428571,0.14682539682539683,80131452,112,11
0,751,0.20360551431601273,0.44524380495603516,68540003,943,192
1,211,0.3775811209439528,0.8110047846889952,65931054,339,128
0,1197,0.10202550637659415,0.07086614173228346,70871255,1333,136
1,302,0.32286995515695066,0.6227045075125208,81975746,446,144
0,286,0.1437125748502994,0.18696883852691218,78863246,334,48
1,419,0.24640287769784172,0.5756410256410256,68534725,556,137
1,418,0.367624810892587,0.8297619047619048,67993555,661,243
2,3,0.9,0.8,74858070,30,27
1,1293,0.46125,0.9222520107238605,69668872,2400,1107
1,141,0.3788546255506608,0.8743169398907104,82126724,227,86
2,328,0.6484458735262594,0.9892280071813285,81968063,933,605
1,529,0.28125,0.6122448979591837,70644721,736,207
1,705,0.2531779661016949,0.6160520607375272,68391911,944,239
0,1606,0.10777777777777778,0.11636873466526464,69239996,1800,194
0,55,0.2361111111111111,0.4911242603550296,70064134,72,17
0,521,0.15146579804560262,0.2895927601809955,70642131,614,93
1,2923,0.3740899357601713,0.8425337064360213,70627172,4670,1747
1,1965,0.23570595099183198,0.5650069156293223,68158244,2571,606
0,2108,0.14064410925397472,0.3570852379671955,69638814,2453,345
2,424,0.6412859560067682,0.9782923299565847,70246673,1182,758
0,22,0.15384615384615385,0.3333333333333333,80135042,26,4
0,3436,0.12791878172588833,0.1212733703890854,63278754,3940,504
1,647,0.4913522012578616,0.9562314540059347,79884224,1272,625
0,2109,0.1292320396366639,0.2651150347779561,70330540,2422,313
0,7796,0.19579121105838662,0.37943322586119127,73818381,9694,1898
0,1335,0.11764705882352941,0.19941348973607037,80140152,1513,178
1,112,0.28205128205128205,0.7191358024691358,80118664,156,44
0,175,0.18981481481481483,0.39827586206896554,80118665,216,41
0,320,0.20987654320987653,0.44950055493895674,80118667,405,85
1,165,0.28879310344827586,0.6811926605504587,80118668,232,67
1,188,0.248,0.5953654188948306,80119002,250,62
0,182,0.17647058823529413,0.3037475345167653,80119004,221,39
1,757,0.4127230411171451,0.9165202108963093,80107916,1289,532
1,987,0.3393574297188755,0.7281733746130031,66098095,1494,507
0,747,0.2559760956175299,0.47396386822529224,80127931,1004,257
0,1106,0.05952380952380952,0.03484937979917307,80114251,1176,70
0,1170,0.10344827586206896,0.14540682414698164,80118147,1305,135
1,530,0.2789115646258503,0.6764184397163121,63283416,735,205
0,971,0.1322609472743521,0.16853146853146853,68536293,1119,148
1,95,0.31654676258992803,0.6554054054054054,68040182,139,44
1,1726,0.2505427702996092,0.5720133978414589,70626836,2303,577
1,866,0.3132434575733545,0.6804364770070148,78989953,1261,395
1,1008,0.47717842323651455,0.9098484848484848,63814296,1928,920
2,650,0.5217071376011774,0.95,70512232,1359,709
0,2088,0.21177802944507362,0.38593648736228126,65905105,2649,561
1,199,0.4059701492537313,0.9287257019438445,81967293,335,136
0,709,0.16978922716627634,0.2797494780793319,80137329,854,145
1,517,0.44047619047619047,0.9422180801491147,69154813,924,407
2,6,0.5,0.9411764705882353,70527324,12,6
0,1321,0.22476525821596244,0.4886521537748958,68543391,1704,383
0,588,0.20540540540540542,0.41852487135506006,68543426,740,152
0,2432,0.23809523809523808,0.48610007942811756,80118625,3192,760
1,743,0.27013752455795675,0.6113681427627231,70641725,1018,275
1,980,0.2637114951164538,0.5801232665639445,63098553,1331,351
0,800,0.19678714859437751,0.348993288590604,63098574,996,196
0,695,0.18138987043580684,0.26202812731310143,58862706,849,154
1,1213,0.34467855213398163,0.7630989699955217,80136854,1851,638
0,1430,0.14114114114114115,0.16704086214638528,68544084,1665,235
1,162,0.45454545454545453,0.9074550128534704,70720335,297,135
1,2215,0.40037899296155927,0.8065998329156224,70720363,3694,1479
1,614,0.3468085106382979,0.8228252194732641,63463533,940,326
1,198,0.28,0.6118143459915611,68434492,275,77
1,607,0.28250591016548465,0.6715195632393085,67557203,846,239
1,444,0.28038897893030795,0.5949535192563081,68741645,617,173
0,1388,0.1447935921133703,0.180235822571589,80181308,1623,235
1,1098,0.2837573385518591,0.6798029556650246,68289046,1533,435
0,1233,0.2284105131414268,0.47703329119258325,63282933,1598,365
0,944,0.19108826049700087,0.4740466101694915,72907891,1167,223
2,192,0.5565819861431871,0.9811320754716981,68290782,433,241
0,653,0.05499276410998553,0.026262626262626262,68741050,691,38
0,199,0.024509803921568627,0.006153846153846154,69226472,204,5
1,180,0.3258426966292135,0.6793893129770993,70324961,267,87
1,493,0.3143254520166898,0.6534422403733956,74675510,719,226
0,751,0.03346203346203346,0.012915129151291513,80181305,777,26
0,894,0.15421002838221382,0.23780487804878048,80181307,1057,163
1,388,0.14725274725274726,0.51,80128668,455,67
0,300,0.1452991452991453,0.48747390396659707,80128669,351,51
2,602,0.6595022624434389,0.9890643985419199,61331830,1768,1166
0,2058,0.12425531914893617,0.15448986160283232,70545860,2350,292
1,220,0.34718100890207715,0.7878787878787878,80108063,337,117
1,2122,0.3010540184453228,0.6396761133603239,69482210,3036,914
1,638,0.27085714285714285,0.5888324873096447,80107573,875,237
1,29,0.48214285714285715,0.9661016949152542,80180008,56,27
1,292,0.3271889400921659,0.7603550295857988,68190682,434,142
0,226,0.23389830508474577,0.4660831509846827,68533451,295,69
1,2618,0.3013077128369362,0.7041699449252558,69586454,3747,1129
1,407,0.3193979933110368,0.7342995169082126,69606943,598,191
0,1048,0.18443579766536966,0.38970938542162936,82008929,1285,237
2,540,0.5462184873949579,0.9514450867052023,69170864,1190,650
0,323,0.20833333333333334,0.45617977528089887,70514241,408,85
0,880,0.2163846838824577,0.4782146652497343,69157991,1123,243
1,1063,0.3922241280731847,0.8412017167381974,66695580,1749,686
1,183,0.31203007518796994,0.6818181818181818,67552443,266,83
0,465,0.06813627254509018,0.07027027027027027,80098340,499,34
0,250,0.08424908424908426,0.10120845921450151,80098956,273,23
1,1648,0.3344103392568659,0.7808163265306123,62826155,2476,828
1,596,0.39307535641547864,0.8674321503131524,63445704,982,386
0,1925,0.13053297199638664,0.14581178903826267,70646261,2214,289
1,2430,0.3223647518126046,0.7298833383188753,67993541,3586,1156
0,38,0.17391304347826086,0.3237410071942446,66423210,46,8
1,860,0.36950146627565983,0.8437152391546162,73816120,1364,504
1,1152,0.24160631994733378,0.5344108446298227,80125497,1519,367
0,588,0.09259259259259259,0.11232279171210469,63757421,648,60
0,655,0.03249630723781388,0.010175763182238668,63757442,677,22
0,391,0.0345679012345679,0.011922503725782414,63757491,405,14
0,1013,0.19282868525896416,0.36858316221765913,67553612,1255,242
1,1321,0.2909286097691895,0.6654526534859522,69092191,1863,542
1,763,0.31996434937611407,0.7669524551831645,64276093,1122,359
0,1483,0.2296103896103896,0.4635658914728682,70645841,1925,442
1,204,0.39104477611940297,0.8036649214659686,80131167,335,131
1,110,0.4329896907216495,0.8554216867469879,80131290,194,84
0,532,0.055062166962699825,0.20568927789934355,62838013,563,31
1,14,0.2631578947368421,0.7755102040816326,70687204,19,5
0,1083,0.06476683937823834,0.05388471177944862,54609583,1158,75
0,416,0.2,0.4173441734417344,69160406,520,104
0,3233,0.22358309317963496,0.4578370652691758,80117908,4164,931
0,889,0.1360544217687075,0.17830609212481427,70871010,1029,140
0,316,0.1270718232044199,0.33584499461786865,68775266,362,46
0,1115,0.1507996953541508,0.19759168035030103,68543993,1313,198
1,1246,0.26272189349112424,0.603219696969697,76116635,1690,444
1,843,0.3388235294117647,0.8094289508632138,68531141,1275,432
0,1168,0.2208138759172782,0.483054892601432,68535054,1499,331
2,47,0.6690140845070423,0.9619047619047619,68033252,142,95
2,220,0.590316573556797,0.9808917197452229,70251545,537,317
1,32,0.49206349206349204,0.9285714285714286,68434562,63,31
0,544,0.21726618705035972,0.42857142857142855,80117912,695,151
1,393,0.39908256880733944,0.8269525267993875,69458662,654,261
1,1391,0.30484757621189407,0.6385041551246537,69458704,2001,610
0,682,0.08456375838926175,0.09734513274336283,74667425,745,63
1,805,0.4366689993002099,0.9213857428381079,66010420,1429,624
0,394,0.22287968441814596,0.47805456702253857,68534956,507,113
1,438,0.28548123980424145,0.6729191090269636,68535852,613,175
0,1793,0.18053016453382084,0.35055478502080445,73816274,2188,395
1,601,0.3633474576271186,0.871413390010627,69154554,944,343
1,928,0.23809523809523808,0.5214953271028038,68535005,1218,290
1,592,0.3877973112719752,0.7961722488038278,70576716,967,375
1,761,0.45172910662824206,0.8899700598802395,69535585,1388,627
2,1339,0.5409667466575249,0.9672262190247801,62510560,2917,1578
2,6608,0.8142098012202322,0.9991374849059859,76079395,35567,28959
0,1081,0.07764505119453925,0.2514489522960321,62839126,1172,91
1,374,0.23203285420944558,0.5404120443740095,68540612,487,113
0,1129,0.21048951048951048,0.4492372435560231,63264516,1430,301
1,847,0.3283108643933386,0.792022792022792,69155863,1261,414
0,511,0.2222222222222222,0.4383116883116883,69165362,657,146
0,319,0.21621621621621623,0.40614886731391586,69165754,407,88
0,2318,0.23219609142100034,0.4896,73382435,3019,701
1,216,0.25259515570934254,0.6068515497553018,73194821,289,73
1,289,0.40289256198347106,0.8410596026490066,64325135,484,195
0,1109,0.1736214605067064,0.2753303964757709,63278586,1342,233
1,2445,0.24838610513372272,0.5099494097807757,65529254,3253,808
0,1913,0.14864263462394303,0.20745820831547365,80181313,2247,334
1,20,0.48717948717948717,0.9090909090909091,82047591,39,19
1,350,0.44532488114104596,0.9055232558139535,69925800,631,281
1,1109,0.3111801242236025,0.7455651292448049,70614544,1610,501
1,2750,0.3882091212458287,0.8632478632478633,73795155,4495,1745
1,820,0.3638479441427463,0.8579088471849866,68531974,1289,469
1,3400,0.2948983824139361,0.7101694915254237,82026279,4822,1422
0,418,0.13278008298755187,0.15601503759398497,67963714,482,64
0,928,0.18596491228070175,0.34406085430076067,63279111,1140,212
0,940,0.22824302134646962,0.45735217163788594,71358714,1218,278
1,1242,0.30028169014084505,0.7111607142857143,81976678,1775,533
0,108,0.16923076923076924,0.3608815426997245,72758756,130,22
1,1237,0.3437665782493369,0.724308300395257,70924231,1885,648
0,3027,0.11075205640423032,0.10876369327073553,74072663,3404,377
2,1275,0.501953125,0.8320855614973262,70179774,2560,1285
0,896,0.14909781576448244,0.2656972901520159,54609793,1053,157
1,297,0.30930232558139537,0.7345132743362832,65316055,430,133
1,685,0.26659528907922914,0.5816929133858267,80180164,934,249
1,661,0.4541701073492981,0.8776185226019846,69389453,1211,550
2,1043,0.5447402880838061,0.9450867052023122,65801603,2291,1248
0,4736,0.21132389675270608,0.43074854325414613,68602513,6005,1269
0,195,0.14473684210526316,0.1935483870967742,69622182,228,33
1,266,0.3090909090909091,0.7159468438538206,68236126,385,119
0,116,0.18309859154929578,0.36156351791530944,68642336,142,26
0,594,0.07763975155279502,0.08379888268156424,67333812,644,50
0,432,0.1,0.11413043478260869,74667446,480,48
2,347,0.609673790776153,0.9728183118741058,67184103,889,542
2,2,0.5,0.5,65183622,4,2
0,1411,0.14120511259890445,0.22682268226822683,73700683,1643,232
0,322,0.17857142857142858,0.4080338266384778,75459041,392,70
0,3374,0.081404846174789,0.07950459448661606,80145615,3673,299
0,649,0.12768817204301075,0.23709239130434784,70233926,744,95
1,314,0.3304904051172708,0.7865748709122203,69586216,469,155
1,541,0.36946386946386944,0.8691275167785235,69607146,858,317
1,898,0.24601175482787574,0.5082781456953642,70614642,1191,293
1,1225,0.4251525105584233,0.890748031496063,66812151,2131,906
0,910,0.12835249042145594,0.17993630573248406,74789260,1044,134
0,966,0.1242067089755213,0.2799227799227799,63837452,1103,137
1,1523,0.3042485153037917,0.6192660550458715,69547681,2189,666
2,229,0.7309048178613397,0.9951923076923077,69588974,851,622
2,414,0.593320235756385,0.9569471624266145,66811675,1018,604
1,441,0.39836289222373805,0.9058355437665783,63098546,733,292
1,2885,0.2965130455986345,0.6903331512834516,69588421,4101,1216
1,1379,0.4835205992509363,0.9556530214424951,68436074,2670,1291
0,3913,0.2220675944333996,0.4011928429423459,69705230,5030,1117
1,2377,0.2810042347247429,0.651698670605613,73703854,3306,929
0,565,0.23024523160762944,0.40893470790378006,73241896,734,169
1,4169,0.3936,0.8584111085818348,80119193,6875,2706
1,926,0.3323720259552992,0.6710526315789473,68401515,1387,461
1,1031,0.222473604826546,0.5220588235294118,60514251,1326,295
0,1201,0.18076398362892224,0.3802163833075734,68317781,1466,265
1,875,0.3248456790123457,0.7501585288522511,68496974,1296,421
0,1309,0.19987775061124693,0.3920398009950249,68544161,1636,327
1,890,0.3710247349823322,0.7837354781054513,70245644,1415,525
1,349,0.32625482625482627,0.6694101508916324,74330431,518,169
1,1286,0.31303418803418803,0.7298429319371728,73818535,1872,586
1,3921,0.24899444550852326,0.5029359203472045,70670985,5221,1300
0,1465,0.14527421236872812,0.2765290120230005,70252826,1714,249
0,2396,0.1387491013659238,0.20236720554272516,68535250,2782,386
0,1446,0.1423487544483986,0.27433050293925537,67840213,1686,240
1,2128,0.31860390650016013,0.7204483695652174,73703833,3123,995
1,1463,0.27610094012864916,0.556745182012848,67706065,2021,558
1,113,0.3352941176470588,0.5161290322580645,68509455,170,57
2,310,0.5193798449612403,0.8716216216216216,82018975,645,335
0,217,0.21660649819494585,0.47974413646055436,72293823,277,60
1,1451,0.3849088596863078,0.823252688172043,74776170,2359,908
1,1472,0.2755905511811024,0.592896174863388,80180466,2032,560
1,1070,0.46365914786967416,0.9150943396226415,69332116,1995,925
2,70,0.6111111111111112,0.9672131147540983,82041293,180,110
0,175,0.15458937198067632,0.3254901960784314,73637676,207,32
0,1354,0.1954842543077837,0.4071370640713706,73700494,1683,329
0,730,0.1628440366972477,0.29301075268817206,73700704,872,142
0,220,0.2114695340501792,0.4696132596685083,80140109,279,59
1,2154,0.2764528048370843,0.5383153894870171,80127525,2977,823
0,765,0.0783132530120482,0.18341463414634146,70649243,830,65
0,172,0.049723756906077346,0.0970873786407767,80124161,181,9
2,286,0.550314465408805,0.9601449275362319,68938625,636,350
2,84,0.6756756756756757,0.8955223880597015,66280963,259,175
2,13,0.6486486486486487,0.9622641509433962,82013633,37,24
0,2695,0.03335724533715925,0.0106928999144568,73864042,2788,93
1,2165,0.3409436834094368,0.7332567929582855,80096170,3285,1120
1,111,0.46634615384615385,0.9205776173285198,70536480,208,97
2,30,0.53125,0.8703703703703703,73642170,64,34
2,3,0.9538461538461539,0.8333333333333334,69666723,65,62
2,31,0.7686567164179104,0.90625,65949212,134,103
1,457,0.255700325732899,0.5736607142857143,80137645,614,157
0,1000,0.1063449508489723,0.09006211180124224,70182630,1119,119
2,291,0.6715575620767494,0.8226600985221675,70713692,886,595
2,974,0.5107985936715218,0.7321428571428571,68187763,1991,1017
0,4456,0.17542561065877127,0.32020997375328086,80118623,5404,948
0,395,0.11434977578475336,0.1232876712328767,82003876,446,51
1,1367,0.3847884788478848,0.750373692077728,74713653,2222,855
0,1174,0.15478761699064075,0.21146245059288538,82003874,1389,215
0,1074,0.1042535446205171,0.08108108108108109,82003875,1199,125
1,2434,0.48747104653611284,0.728923476005188,66826620,4749,2315
0,4147,0.1313364055299539,0.14307931570762053,82007088,4774,627
0,1406,0.23958896700919416,0.49015748031496065,68602492,1849,443
1,5287,0.2803865523342861,0.6779808529155787,69588442,7347,2060
1,389,0.4544179523141655,0.9271255060728745,82151295,713,324
1,1956,0.26132930513595165,0.6044726301735648,69960352,2648,692
1,2127,0.3986429177268872,0.8638184245660881,80125111,3537,1410
1,340,0.4426229508196721,0.93048128342246,70793576,610,270
0,1683,0.17459538989700835,0.297628156082632,67556013,2039,356
1,283,0.33568075117370894,0.6886363636363636,82108567,426,143
1,3648,0.4431384521447107,0.9313164349959117,63141176,6551,2903
0,214,0.14056224899598393,0.17647058823529413,70207053,249,35
1,657,0.3590243902439024,0.589527027027027,72433445,1025,368
0,1826,0.06979113601630157,0.045454545454545456,68539730,1963,137
0,528,0.17757009345794392,0.30260047281323876,68540661,642,114
1,507,0.36704119850187267,0.7894088669950738,66695601,801,294
0,567,0.1661764705882353,0.3088122605363985,67963420,680,113
0,626,0.1859557867360208,0.3473877176901925,68540416,769,143
0,693,0.12278481012658228,0.14958448753462603,63100485,790,97
0,2223,0.17636161541311596,0.304729094895083,67555306,2699,476
1,447,0.2971698113207547,0.6373873873873874,82008908,636,189
1,2936,0.32876085962505713,0.747588424437299,82120527,4374,1438
2,358,0.5155615696887687,0.9816700610997964,63141575,739,381
0,207,0.2188679245283019,0.41280353200883,66892434,265,58
1,819,0.2506861848124428,0.5518274415817855,80011260,1093,274
1,375,0.34554973821989526,0.7893296853625171,69165033,573,198
1,625,0.42765567765567764,0.8845789971617786,70202132,1092,467
0,384,0.09219858156028368,0.08946608946608947,80132328,423,39
1,2164,0.4434156378600823,0.9104204753199269,82062460,3888,1724
1,525,0.3,0.7122683142100618,68437894,750,225
0,1023,0.042134831460674156,0.009749303621169917,66930486,1068,45
0,220,0.2028985507246377,0.3731656184486373,68641951,276,56
0,489,0.18363939899833054,0.35163674762407604,68642042,599,110
1,135,0.3316831683168317,0.7864768683274022,76116341,202,67
0,753,0.1761487964989059,0.3166051660516605,68642126,914,161
1,238,0.23717948717948717,0.5723140495867769,70209762,312,74
1,260,0.34177215189873417,0.7668231611893583,63602616,395,135
1,702,0.4120603015075377,0.9013742926434923,70412846,1194,492
1,322,0.3263598326359833,0.7927927927927928,67557350,478,156
1,2265,0.25688976377952755,0.5915584415584415,80125451,3048,783
1,736,0.2770137524557957,0.6197643979057592,65315943,1018,282
1,210,0.27335640138408307,0.6476014760147601,65316013,289,79
1,240,0.3877551020408163,0.8373702422145328,70758443,392,152
1,476,0.3101449275362319,0.6126984126984127,69458620,690,214
1,645,0.35692921236291125,0.8,70645456,1003,358
1,903,0.3316062176165803,0.7797385620915033,67552702,1351,448
0,831,0.21529745042492918,0.33766233766233766,74320162,1059,228
0,1078,0.15384615384615385,0.19824046920821115,74320246,1274,196
1,584,0.2816728167281673,0.6757775683317625,68531274,813,229
1,353,0.2505307855626327,0.5703918722786647,80121227,471,118
0,13,0.07142857142857142,0.38181818181818183,68498493,14,1
1,319,0.35685483870967744,0.7027027027027027,60954061,496,177
1,4283,0.34168459883184754,0.7625534188034188,70720272,6506,2223
2,289,0.5034364261168385,0.9425531914893617,62589926,582,293
1,197,0.30633802816901406,0.6469135802469136,80135527,284,87
0,1081,0.13032984714400644,0.17793917385383567,63141386,1243,162
1,907,0.2403685092127303,0.5420037336652147,63278712,1194,287
0,416,0.20153550863723607,0.4090247452692867,61908875,521,105
1,5172,0.38230025080616264,0.8556603773584905,66765202,8373,3201
0,706,0.2433011789924973,0.4885433715220949,69165124,933,227
1,1260,0.28449744463373083,0.6754901960784314,80109974,1761,501
1,276,0.24795640326975477,0.5338461538461539,80045644,367,91
0,3297,0.12546419098143236,0.13568324480927088,67963322,3770,473
1,508,0.2616279069767442,0.5699177438307873,67942805,688,180
0,2266,0.2145580589254766,0.4499261447562777,70669340,2885,619
0,393,0.08816705336426914,0.13366834170854272,73884244,431,38
0,314,0.09510086455331412,0.20257826887661143,279993,347,33
2,882,0.51431718061674,0.944095038434661,80118358,1816,934
1,758,0.33567046450482035,0.7985611510791367,69586034,1141,383
1,761,0.34957264957264955,0.837007874015748,69586181,1170,409
1,1408,0.2878098128477491,0.6788290199406024,81965806,1977,569
1,1146,0.3262786596119929,0.7526236881559221,67716726,1701,555
1,279,0.2520107238605898,0.6528776978417267,68533584,373,94
1,427,0.2988505747126437,0.7370165745856354,70643202,609,182
1,72,0.4,0.7731481481481481,75121095,120,48
1,270,0.296875,0.7514204545454546,68236112,384,114
1,2488,0.39124051871788595,0.8860495436766623,63101430,4087,1599
1,134,0.4745098039215686,0.845771144278607,80175653,255,121
1,1903,0.4792008757525999,0.923679060665362,68420954,3654,1751
1,1371,0.35814606741573035,0.7925846319183235,80153462,2136,765
0,295,0.1983695652173913,0.3691376701966717,68537504,368,73
0,589,0.029654036243822075,0.012386457473162676,82012537,607,18
0,413,0.04838709677419355,0.02510460251046025,82043307,434,21
1,436,0.38935574229691877,0.8842887473460722,69165803,714,278
1,4271,0.4366178604405751,0.8868632707774798,80126982,7581,3310
1,659,0.3113897596656217,0.7851985559566786,80125363,957,298
0,1686,0.09257265877287406,0.18531889290012032,68318250,1858,172
1,28,0.2222222222222222,0.7741935483870968,69564943,36,8
0,1043,0.19209914794732766,0.32536382536382535,68535754,1291,248
0,394,0.23938223938223938,0.4975429975429975,68535866,518,124
1,189,0.45689655172413796,0.9174528301886793,73975041,348,159
0,383,0.22626262626262628,0.44353182751540043,62511764,495,112
1,383,0.329246935201401,0.780281690140845,68210695,571,188
1,823,0.31530782029950083,0.7437591776798825,80108084,1202,379
0,595,0.07894736842105263,0.06874328678839957,79788170,646,51
0,443,0.07127882599580712,0.04574132492113565,79788205,477,34
1,541,0.2974025974025974,0.7475538160469667,80124650,770,229
0,404,0.1903807615230461,0.3669141039236479,80109036,499,95
1,246,0.3955773955773956,0.8844765342960289,67589200,407,161
1,440,0.44584382871536526,0.8923327895595432,68040133,794,354
1,269,0.35799522673031026,0.803921568627451,69739096,419,150
0,646,0.1760204081632653,0.3314873417721519,68537581,784,138
1,471,0.21760797342192692,0.5065075921908894,68537595,602,131
2,56,0.5213675213675214,0.9807692307692307,82038328,117,61
1,282,0.29850746268656714,0.5444444444444444,68185481,402,120
2,127,0.5480427046263345,0.9471153846153846,57042440,281,154
1,1233,0.3202866593164278,0.7710563052582596,69607405,1814,581
2,709,0.5329380764163373,0.9722222222222222,68234593,1518,809
0,2093,0.10555555555555556,0.12179700499168053,70642215,2340,247
1,897,0.3523465703971119,0.8472310630171865,68542264,1385,488
0,1376,0.11738293778062861,0.12578616352201258,68542922,1559,183
0,412,0.1905697445972495,0.37756497948016415,68542950,509,97
1,802,0.25809435707678074,0.6169906407487401,68545246,1081,279
1,689,0.2607296137339056,0.6054054054054054,68545253,932,243
0,1688,0.09587573647562936,0.09667266187050359,80121152,1867,179
1,168,0.3114754098360656,0.7593984962406015,80124642,244,76
1,638,0.29812981298129815,0.6990291262135923,80124684,909,271
1,1321,0.2636566332218506,0.6076115485564304,68212214,1794,473
1,1103,0.3036616161616162,0.6491658488714426,70673512,1584,481
1,222,0.41114058355437666,0.8870636550308009,69152636,377,155
2,843,0.5058616647127784,0.9557640750670241,70317961,1706,863
1,1683,0.38599051441079896,0.8012139605462822,70576674,2741,1058
0,2059,0.05115207373271889,0.02553191489361702,80122726,2170,111
0,603,0.21992238033635186,0.465642683912692,81999990,773,170
1,1477,0.2895622895622896,0.6021341463414634,80127534,2079,602
0,1608,0.08428246013667426,0.09337016574585635,70206206,1756,148
2,328,0.6038647342995169,0.9812925170068028,70059234,828,500
1,1217,0.29161816065192087,0.5959206174200662,80161894,1718,501
1,606,0.26366950182260024,0.57992277992278,69607881,823,217
1,1270,0.2675893886966551,0.6605166051660517,68311684,1734,464
1,148,0.24873096446700507,0.5163934426229508,70202706,197,49
1,412,0.29931972789115646,0.6553966189856957,70632324,588,176
1,821,0.3030560271646859,0.7117711771177118,69094095,1178,357
0,345,0.15853658536585366,0.14014251781472684,69666576,410,65
2,1902,0.5288580629180084,0.9734591565909761,68474490,4037,2135
2,1360,0.5517468688200395,0.9629424778761062,61337626,3034,1674
0,2096,0.23698580269384784,0.40574162679425835,70112413,2747,651
0,389,0.2533589251439539,0.41522491349480967,82009546,521,132
1,912,0.3770491803278688,0.8125472411186697,70720965,1464,552
1,440,0.3914246196403873,0.7991360691144709,68421836,723,283
0,272,0.23595505617977527,0.45525291828793774,68813143,356,84
0,3225,0.21033300685602352,0.44127659574468087,73637473,4084,859
0,3815,0.11751098773999537,0.1501527717154081,73700676,4323,508
1,562,0.2729624838292367,0.6295955882352942,66930731,773,211
0,279,0.12539184952978055,0.19410745233968804,67285694,319,40
0,1035,0.13243922883487008,0.19616858237547893,67862655,1193,158
1,785,0.4088855421686747,0.879190385831752,62878284,1328,543
1,948,0.4542314335060449,0.9098901098901099,68410195,1737,789
1,412,0.48435544430538174,0.8728139904610492,74002110,799,387
2,275,0.7340425531914894,0.9360902255639098,70591101,1034,759
2,3,0.875,0.875,82034549,24,21
1,474,0.32670454545454547,0.768760907504363,80120430,704,230
0,1092,0.08389261744966443,0.09172661870503597,68539954,1192,100
1,1734,0.24444444444444444,0.5395772896808951,80110555,2295,561
1,727,0.3043062200956938,0.734678044996121,68600735,1045,318
0,732,0.25382262996941896,0.48778280542986424,80111003,981,249
0,325,0.19950738916256158,0.46120689655172414,77676781,406,81
1,1024,0.3342002600780234,0.71267252195734,67994465,1538,514
1,363,0.2896281800391389,0.6047297297297297,81956125,511,148
2,356,0.549367088607595,0.9616161616161616,80137883,790,434
1,455,0.2890625,0.6410614525139665,80180154,640,185
1,2900,0.3091948546927108,0.6958586125032973,80132194,4198,1298
0,1210,0.2178409825468649,0.4248927038626609,68544245,1547,337
1,844,0.25044404973357015,0.5705563093622795,69869415,1126,282
0,495,0.13612565445026178,0.18223234624145787,65355360,573,78
0,2099,0.15905448717948717,0.4321858150145168,73556756,2496,397
1,890,0.3484626647144949,0.7765486725663717,69739082,1366,476
0,2420,0.11775428363106089,0.10830564784053157,67555033,2743,323
0,1628,0.1752786220871327,0.3172609400324149,67555656,1974,346
0,446,0.17863720073664824,0.4074074074074074,70649145,543,97
1,460,0.3850267379679144,0.8347826086956521,67414543,748,288
0,1691,0.17912621359223302,0.31191369606003755,68018076,2060,369
0,134,0.10067114093959731,0.04316546762589928,68740770,149,15
0,1884,0.14828209764918626,0.2369584438549956,74886266,2212,328
1,154,0.3446808510638298,0.6536585365853659,70677061,235,81
0,3094,0.050920245398773004,0.02297250261051166,64163715,3260,166
1,1036,0.35532047293092717,0.8003523194362889,70762461,1607,571
0,3587,0.07883923985618901,0.08010091453800063,70641340,3894,307
1,343,0.41367521367521365,0.9125151883353585,80130183,585,242
1,2341,0.298681845416417,0.6617790811339198,76293553,3338,997
1,1942,0.2327143421572501,0.557632398753894,80118431,2531,589
0,939,0.18911917098445596,0.358974358974359,69480810,1158,219
1,591,0.4685251798561151,0.8958333333333334,80181009,1112,521
0,989,0.15901360544217688,0.19829284307288247,65851933,1176,187
0,1798,0.15823970037453183,0.22279129321382843,72393356,2136,338
1,326,0.2958963282937365,0.5984848484848485,80180208,463,137
0,1376,0.23427935447968837,0.47797527047913446,67154710,1797,421
1,685,0.26816239316239315,0.6228127025275437,73226482,936,251
1,598,0.2534332084893883,0.6052422557585385,74158714,801,203
1,746,0.35965665236051503,0.8374777975133215,69165082,1165,419
0,750,0.19786096256684493,0.4,80119363,935,185
1,610,0.30126002290950743,0.6602023608768971,80128632,873,263
1,2184,0.3709677419354839,0.7641221374045801,70720461,3472,1288
0,2127,0.17749419953596288,0.3029180176007411,79917782,2586,459
1,877,0.23472949389179756,0.5504531722054381,66931536,1146,269
0,3959,0.1719305584605731,0.26423425517081106,67963483,4781,822
0,1504,0.11788856304985337,0.12443900448796409,67963525,1705,201
1,1484,0.24974721941354905,0.5437523882307986,68211941,1978,494
0,2814,0.1881130986728217,0.3658787255909558,73816323,3466,652
0,829,0.15321756894790603,0.19929824561403509,70207760,979,150
1,333,0.4722662440570523,0.9250457038391224,66859996,631,298
1,2533,0.4017477562588569,0.8778438921946097,80125495,4234,1701
0,55,0.25675675675675674,0.4205128205128205,67623115,74,19
1,1163,0.35603543743078625,0.7951529140219273,70673533,1806,643
1,10,0.3333333333333333,0.6666666666666666,70225071,15,5
1,340,0.375,0.7692307692307693,80127532,544,204
1,4140,0.26005361930294907,0.5219650448748229,73852695,5595,1455
0,1055,0.05465949820788531,0.0732824427480916,82007807,1116,61
1,3314,0.36195610319599536,0.7762261580381471,63105714,5194,1880
0,1196,0.16596931659693165,0.4562920268972142,69659842,1434,238
0,1356,0.20608899297423888,0.3553191489361702,79917775,1708,352
1,2554,0.403828197945845,0.8532689450222882,70000581,4284,1730
2,2931,0.5827164009111617,0.9786142001710864,82041313,7024,4093
2,789,0.6246431969552807,0.9859894921190894,70115311,2102,1313
0,3650,0.2002629272567923,0.39185393258426965,65017295,4564,914
0,1780,0.203579418344519,0.3901975683890577,80145451,2235,455
1,708,0.2507936507936508,0.5656077348066298,69586461,945,237
0,2222,0.1937590711175617,0.33098343320408885,67554396,2756,534
0,184,0.1965065502183406,0.45315161839863716,73668532,229,45
1,1284,0.3712047012732615,0.8304423243712056,69574645,2042,758
2,286,0.5264900662251656,0.9185393258426966,80062010,604,318
1,629,0.33649789029535865,0.8293683347005743,80121298,948,319
1,225,0.1906474820143885,0.5575620767494357,66346126,278,53
2,1935,0.5841392649903289,0.9480396787907416,69529152,4653,2718
1,767,0.2688274547187798,0.6675148430873622,80110471,1049,282
1,1410,0.3587994542974079,0.7923728813559322,68518394,2199,789
1,4174,0.2590094088407598,0.5759493670886076,80122956,5633,1459
2,83,0.6139534883720931,0.9902439024390244,80127579,215,132
0,1174,0.15600287562904386,0.25114942528735634,69074663,1391,217
1,1797,0.3319702602230483,0.7150564001961746,70584675,2690,893
1,1619,0.37658837119753563,0.813815434430653,72735782,2597,978
1,843,0.2874049027895182,0.5654952076677316,72634674,1183,340
1,666,0.2792207792207792,0.6725325172149962,80121232,924,258
1,420,0.4,0.84,68040224,700,280
0,96,0.25,0.44308943089430897,69184262,128,32
1,628,0.3471933471933472,0.7976088812980359,70748503,962,334
0,1908,0.16971279373368145,0.2813852813852814,60900791,2298,390
0,1203,0.22884615384615384,0.3927801724137931,69660591,1560,357
1,243,0.3135593220338983,0.6866537717601547,80124685,354,111
0,314,0.07647058823529412,0.054242002781641166,54609604,340,26
0,324,0.14285714285714285,0.1977142857142857,54609646,378,54
0,309,0.10951008645533142,0.1080669710806697,54609723,347,38
1,5594,0.28965079365079366,0.6676092544987147,73637452,7875,2281
2,289,0.5667166416791605,0.9722735674676525,69635076,667,378
1,197,0.4732620320855615,0.9506172839506173,80130182,374,177
1,356,0.35855855855855856,0.8515337423312883,81967297,555,199
1,2131,0.43832366895097524,0.8838297872340426,74047750,3794,1663
1,83,0.23853211009174313,0.6600660066006601,70068236,109,26
0,1140,0.08286403861625101,0.16732128829536527,70330561,1243,103
1,108,0.47572815533980584,0.8819444444444444,62512065,206,98
0,1483,0.2418200408997955,0.46206115515288787,70677033,1956,473
1,654,0.34468937875751504,0.7806624888093107,80110023,998,344
1,2099,0.32486330009649406,0.7322859890990702,80124682,3109,1010
1,164,0.3138075313807531,0.5798816568047337,80180283,239,75
1,956,0.27520849128127367,0.6284023668639053,60502442,1319,363
1,331,0.2725274725274725,0.6517150395778364,68563460,455,124
0,2161,0.060843111690569315,0.06217807211184695,63336784,2301,140
0,1878,0.07714987714987714,0.0812603648424544,63336791,2035,157
0,1718,0.07084910762574365,0.07070240295748614,63336805,1849,131
0,1247,0.07148175725986597,0.070298769771529,63336833,1343,96
1,277,0.3558139534883721,0.8486394557823129,65984184,430,153
1,1113,0.33512544802867383,0.7909880564603692,80109302,1674,561
1,2371,0.44132893496701225,0.9055745164960182,66695650,4244,1873
0,2769,0.16871810267187032,0.2760388559093362,67291812,3331,562
0,464,0.18739054290718038,0.34066901408450706,69621993,571,107
0,1872,0.12686567164179105,0.1227106227106227,70207291,2144,272
1,1005,0.25775480059084194,0.5794099183929693,80125352,1354,349
1,1182,0.21773659827928524,0.5027472527472527,68534151,1511,329
0,48,0.1864406779661017,0.23357664233576642,74708690,59,11
0,2332,0.12,0.135237439779766,80130313,2650,318
0,219,0.18587360594795538,0.41448692152917505,54609772,269,50
0,89,0.11,0.16831683168316833,60312224,100,11
1,415,0.4713375796178344,0.9354304635761589,63281470,785,370
2,131,0.5574324324324325,0.96,70823242,296,165
0,1141,0.11959876543209877,0.23622545915136162,63092764,1296,155
0,644,0.17329910141206675,0.31016042780748665,63781340,779,135
1,1753,0.3483271375464684,0.7408152994464016,74045314,2690,937
2,868,0.5042832667047401,0.9678615574783683,70612283,1751,883
0,123,0.18,0.266025641025641,70660471,150,27
0,831,0.21825023518344308,0.2992465016146394,70644511,1063,232
1,701,0.2933467741935484,0.5888625592417062,70644553,992,291
1,2172,0.33881278538812787,0.7252827435242613,70201754,3285,1113
1,856,0.25435540069686413,0.5982195845697329,70487172,1148,292
0,1197,0.22323166774821546,0.471253534401508,73816134,1541,344
1,1175,0.29471788715486197,0.6901471243869817,80120435,1666,491
2,78,0.6438356164383562,0.9734513274336283,68586903,219,141
1,461,0.3067669172932331,0.7557894736842106,68536363,665,204
0,2199,0.1852537977028529,0.3284691629955947,82000067,2699,500
0,250,0.140893470790378,0.20875420875420875,68534473,291,41
0,697,0.1809635722679201,0.3380281690140845,68535425,851,154
1,818,0.2583862194016319,0.6365561044460127,68539982,1103,285
0,852,0.20448179271708683,0.4176117411607739,68642091,1071,219
1,896,0.23874256584536957,0.5552099533437014,68541620,1177,281
0,60,0.15492957746478872,0.19617224880382775,74513852,71,11
1,343,0.342911877394636,0.7813822284908322,70643433,522,179
1,740,0.3548387096774194,0.841147655703289,67552723,1147,407
1,1641,0.3119496855345912,0.7631067961165049,80124640,2385,744
0,1148,0.19888346127006282,0.2981715893108298,72748991,1433,285
1,185,0.40514469453376206,0.877906976744186,67346951,311,126
0,1339,0.15626969124133586,0.2407608695652174,81966334,1587,248
1,3664,0.3624499738994258,0.8225528244933161,81989537,5747,2083
0,938,0.2861491628614916,0.4635879218472469,70112364,1314,376
2,51,0.5677966101694916,0.7611940298507462,73442341,118,67
2,276,0.8167330677290837,0.9836956521739131,80178972,1506,1230
2,29,0.867579908675799,0.9024390243902439,73427172,219,190
1,11,0.3125,0.8225806451612904,81971179,16,5
1,161,0.25462962962962965,0.638676844783715,70649306,216,55
0,37,0.0975609756097561,0.2391304347826087,70681541,41,4
0,5,0.0,0.0,70693861,5,0
0,13,0.13333333333333333,0.38235294117647056,70694120,15,2
0,9,0.0,0.0,70697046,9,0
1,892,0.2931854199683043,0.7088290544771446,80117898,1262,370
0,340,0.036827195467422094,0.09982486865148861,82003740,353,13
0,349,0.05420054200542006,0.09884678747940692,80124229,369,20
2,797,0.5350058343057176,0.8378378378378378,66280123,1714,917
2,2446,0.5480413895048042,0.8998628257887518,69564656,5412,2966
2,672,0.5155010814708003,0.8395904436860068,70121912,1387,715
1,1266,0.42480690595184006,0.7062228654124457,80089940,2201,935
1,3451,0.2619760479041916,0.6434426229508197,67774931,4676,1225
0,5939,0.1779930795847751,0.48267986296155313,70691033,7225,1286
2,130,0.7445972495088409,0.9204545454545454,66062234,509,379
1,711,0.45931558935361216,0.7137546468401487,80089856,1315,604
0,1483,0.1362842166569598,0.1824352991090369,69239835,1717,234
0,2461,0.11091040462427745,0.11084905660377359,69240171,2768,307
0,1042,0.07295373665480427,0.054995417048579284,70641872,1124,82
1,661,0.24629418472063855,0.6329206117989803,70643524,877,216
1,456,0.36754507628294036,0.8473282442748091,80118395,721,265
1,302,0.42585551330798477,0.8958904109589041,68275732,526,224
0,2,0.0,0.0,70586642,2,0
1,1167,0.4070121951219512,0.8376237623762376,70638015,1968,801
0,2596,0.2039251763262803,0.3501511276447338,70638190,3261,665
1,955,0.3079710144927536,0.7070200573065902,80111423,1380,425
0,1489,0.20544290288153683,0.38734353268428373,80180380,1874,385
1,1177,0.29224293445580274,0.6870317002881844,75892992,1663,486
1,344,0.25217391304347825,0.5497702909647779,67666151,460,116
0,1093,0.1643730886850153,0.31496062992125984,70527380,1308,215
0,1021,0.05985267034990792,0.04018311291963377,80097570,1086,65
0,763,0.11072261072261072,0.1415204678362573,69912661,858,95
0,543,0.07179487179487179,0.09615384615384616,70606956,585,42
0,717,0.09125475285171103,0.11153846153846154,70606970,789,72
0,238,0.07392996108949416,0.13541666666666666,70606984,257,19
0,353,0.04594594594594595,0.04896907216494845,70607866,370,17
0,201,0.0821917808219178,0.16352201257861634,70607901,219,18
0,146,0.08176100628930817,0.16412213740458015,70607992,159,13
0,305,0.046875,0.047979797979797977,70608013,320,15
0,234,0.040983606557377046,0.04887218045112782,70608104,244,10
0,816,0.03773584905660377,0.02040816326530612,70608125,848,32
2,169,0.5493333333333333,0.9765625,67154521,375,206
1,197,0.39570552147239263,0.8514412416851441,69637050,326,129
1,97,0.3782051282051282,0.7894736842105263,75699155,156,59
0,1407,0.1431181485992692,0.17669715936446798,68530602,1642,235
1,1277,0.3598997493734336,0.7975460122699386,67994094,1995,718
1,1061,0.3297536323436513,0.7353827606992164,70463883,1583,522
0,742,0.22140608604407136,0.478539397821909,68535173,953,211
0,910,0.2066259808195292,0.4405107370864771,68535180,1147,237
0,4054,0.13041613041613043,0.222140221402214,81965652,4662,608
0,1319,0.2167458432304038,0.4189253447456015,70617904,1684,365
0,342,0.20279720279720279,0.4101184068891281,19915182,429,87
1,425,0.24242424242424243,0.5846817691477886,82006130,561,136
1,69,0.4344262295081967,0.751937984496124,72323790,122,53
1,341,0.33528265107212474,0.7878787878787878,80180153,513,172
1,296,0.3422222222222222,0.7881873727087576,80180155,450,154
1,1334,0.3601918465227818,0.8094021461420542,70762440,2085,751
1,730,0.3381686310063463,0.8118380062305296,81989527,1103,373
1,2481,0.26510663507109006,0.6025597844392051,69037885,3376,895
1,731,0.3593339176161262,0.7790449037776194,69166594,1141,410
1,321,0.24647887323943662,0.5682539682539682,70642173,426,105
1,331,0.2545045045045045,0.5560897435897436,66892455,444,113
1,714,0.2347266881028939,0.5351270553064275,68543720,933,219
0,931,0.17391304347826086,0.3898462971588263,80003406,1127,196
0,2838,0.1392174704276615,0.16748768472906403,66932061,3297,459
0,747,0.221875,0.44984802431610943,68545435,960,213
0,536,0.15457413249211358,0.34890510948905107,60249294,634,98
0,5704,0.11027920761191702,0.15857247976453273,70219716,6411,707
1,509,0.4556149732620321,0.9287776708373436,80127849,935,426
1,112,0.2679738562091503,0.518796992481203,81967330,153,41
1,897,0.4264705882352941,0.8705473501303215,80181008,1564,667
1,487,0.2774480712166172,0.6499118165784833,68236252,674,187
1,46,0.4457831325301205,0.9395973154362416,70593516,83,37
1,782,0.25239005736137665,0.5657062543921293,74990202,1046,264
0,364,0.17647058823529413,0.3247549019607843,67291525,442,78
2,427,0.5328227571115973,0.9714889123548046,80163530,914,487
1,326,0.379047619047619,0.8046594982078853,73524521,525,199
1,1866,0.2544946064722333,0.5613430908308222,80108672,2503,637
0,397,0.22612085769980506,0.41389728096676737,70080206,513,116
1,947,0.24300559552358114,0.5096735187424426,68541011,1251,304
1,254,0.37438423645320196,0.8857758620689655,69184332,406,152
1,1901,0.40482154038822793,0.8695345557122708,72966061,3194,1293
1,682,0.4570063694267516,0.9152317880794701,73131240,1256,574
1,373,0.3279279279279279,0.7636363636363637,82126697,555,182
0,2211,0.11666000799041151,0.27596899224806204,62413624,2503,292
1,79,0.4316546762589928,0.9009433962264151,80096415,139,60
0,115,0.1015625,0.11585365853658537,67136881,128,13
1,611,0.3263506063947078,0.7247278382581649,67876536,907,296
1,58,0.40816326530612246,0.8713450292397661,69073620,98,40
1,512,0.459915611814346,0.9272030651340997,80126580,948,436
0,1740,0.13216957605985039,0.1540785498489426,66203284,2005,265
1,795,0.2521166509877705,0.6218623481781377,69697852,1063,268
0,947,0.18221070811744386,0.3246006389776358,68543832,1158,211
0,680,0.18465227817745802,0.2938388625592417,70644994,834,154
1,7024,0.21493237956857048,0.5319446875546998,70701015,8947,1923
1,1678,0.2904862579281184,0.6889779559118236,69652744,2365,687
0,828,0.19767441860465115,0.3940620782726046,80121072,1032,204
0,1742,0.2177817691962281,0.4640275387263339,68534823,2227,485
1,574,0.34846765039727584,0.8116683725690891,70748461,881,307
0,1478,0.09602446483180428,0.10022271714922049,80117758,1635,157
1,114,0.2692307692307692,0.5294117647058824,70051275,156,42
0,588,0.15151515151515152,0.2,67555621,693,105
1,510,0.32628797886393657,0.7250673854447439,80178612,757,247
0,1618,0.17909690512430237,0.31204188481675393,80116624,1971,353
1,552,0.4556213017751479,0.9223385689354275,65693642,1014,462
1,900,0.43573667711598746,0.9168886521044219,70613494,1595,695
0,243,0.10989010989010989,0.13490725126475547,72493715,273,30
1,1279,0.25509609784507864,0.5826466311197286,82011760,1717,438
0,834,0.07023411371237458,0.054982817869415807,68539422,897,63
0,1004,0.1968,0.3962703962703963,68543783,1250,246
0,607,0.22871664548919948,0.47214076246334313,68543643,787,180
0,1281,0.199375,0.34243048403707516,70207165,1600,319
1,2432,0.23522012578616353,0.5025471980821097,80119340,3180,748
0,315,0.20454545454545456,0.46303501945525294,66930563,396,81
1,65,0.3010752688172043,0.7747252747252747,68883283,93,28
1,1800,0.2905005912495073,0.6865180854950675,66973060,2537,737
0,823,0.1728643216080402,0.30976965845909454,72906680,995,172
0,1112,0.20910384068278806,0.43657142857142855,68535642,1406,294
0,1563,0.16148068669527896,0.2706738131699847,70742105,1864,301
1,1481,0.3599827139152982,0.8183890577507599,69573553,2314,833
1,147,0.4235294117647059,0.8823529411764706,72616775,255,108
0,1377,0.20907524411257897,0.49319148936170215,67810036,1741,364
1,2433,0.261608497723824,0.5415454251535726,17976,3295,862
0,259,0.2127659574468085,0.36738703339882123,74545786,329,70
0,579,0.14727540500736377,0.23788546255506607,73113565,679,100
0,291,0.0761904761904762,0.07093821510297482,73113642,315,24
1,138,0.30303030303030304,0.6224489795918368,70207746,198,60
0,1900,0.1753472222222222,0.31793214862681746,81979701,2304,404
1,584,0.24645161290322581,0.565425023877746,68532023,775,191
0,351,0.08115183246073299,0.09836065573770492,63141351,382,31
0,374,0.04591836734693878,0.03128911138923655,63141372,392,18
1,143,0.37280701754385964,0.8703170028818443,81967353,228,85
1,1890,0.2976588628762542,0.7098428983648606,80130321,2691,801
1,768,0.26717557251908397,0.6504169339320077,63283353,1048,280
0,366,0.16055045871559634,0.3025871766029246,70643216,436,70
0,275,0.13249211356466878,0.1935007385524372,70643251,317,42
0,789,0.1054421768707483,0.13986486486486485,70643335,882,93
1,604,0.3333333333333333,0.7287705956907478,74955440,906,302
0,337,0.23927765237020315,0.45323741007194246,74545793,443,106
0,384,0.13901345291479822,0.20153846153846153,74545800,446,62
0,673,0.18424242424242424,0.3509991311902693,68537840,825,152
1,1175,0.2830994508846858,0.6388443017656501,82008918,1639,464
0,1049,0.10188356164383562,0.2338278931750742,67146226,1168,119
0,346,0.2311111111111111,0.49714937286202965,73091060,450,104
1,1368,0.29045643153526973,0.7088142707240294,80121181,1928,560
1,2290,0.2746278112131771,0.6246734397677793,70641655,3157,867
1,60,0.25,0.6822916666666666,75282984,80,20
0,1027,0.09991235758106924,0.11779607346421786,68743626,1141,114
1,4023,0.4054093999408809,0.8693540553666829,80153450,6766,2743
1,1321,0.39735401459854014,0.8943044906900328,67557420,2192,871
2,446,0.527542372881356,0.9677996422182469,68342113,944,498
0,485,0.10185185185185185,0.14314115308151093,72603895,540,55
1,632,0.307776560788609,0.7729422894985809,64974616,913,281
0,553,0.1795252225519288,0.4640250260688217,68669083,674,121
0,1093,0.15073815073815075,0.2166324435318275,67963301,1287,194
0,1173,0.17102473498233214,0.3013513513513513,69239870,1415,242
1,260,0.34673366834170855,0.7318548387096774,66859933,398,138
1,90,0.3181818181818182,0.6208791208791209,69315323,132,42
1,835,0.3440691280439906,0.7943775100401607,61632830,1273,438
1,30,0.3333333333333333,0.5818181818181818,65006025,45,15
1,95,0.43452380952380953,0.8699186991869918,69136025,168,73
1,555,0.3131188118811881,0.7693169092945129,80110436,808,253
0,1028,0.22822822822822822,0.42120343839541546,72748984,1332,304
0,1009,0.16265560165975104,0.26533822758259046,63279664,1205,196
0,3581,0.11427158050952263,0.13054499366286437,70615580,4043,462
1,67,0.33,0.7375565610859729,69724081,100,33
2,72,0.5294117647058824,0.8359375,70867202,153,81
0,374,0.242914979757085,0.48625180897250364,67141284,494,120
1,1175,0.26516572858036275,0.5428733674048836,80110016,1599,424
1,533,0.2816711590296496,0.5792540792540792,70645435,742,209
0,589,0.1325478645066274,0.19027181688125894,66808910,679,90
0,1922,0.13110307414104883,0.28111689540937057,61717663,2212,290
1,459,0.1624087591240876,0.50480109739369,64225560,548,89
1,145,0.41767068273092367,0.8796561604584527,60454212,249,104
1,4365,0.24402493938344302,0.5404454865181711,66409833,5774,1409
2,1243,0.542846634792203,0.9674915089762252,72615144,2719,1476
1,516,0.27221438645980256,0.6853080568720379,80134712,709,193
1,2396,0.25381501090003117,0.5800061900340452,80121009,3211,815
1,2104,0.35360983102918586,0.7583497053045186,80150405,3255,1151
2,138,0.5779816513761468,0.9892857142857143,64999900,327,189
1,113,0.30246913580246915,0.7491166077738516,67557084,162,49
0,1861,0.19853574504737295,0.40415704387990764,74446190,2322,461
1,1943,0.2199919710959454,0.5154852030282174,80118447,2491,548
1,506,0.32443257676902537,0.7239199157007377,82113166,749,243
0,1222,0.10867979576951131,0.09552438209752839,70646212,1371,149
0,738,0.08776266996291718,0.06739345887016848,70646324,809,71
0,1069,0.05897887323943662,0.19773024879965082,62836676,1136,67
2,150,0.6855345911949685,0.9969135802469136,67221770,477,327
1,183,0.32222222222222224,0.8206521739130435,80134710,270,87
1,706,0.24004305705059203,0.6145484949832776,68542145,929,223
1,2604,0.23185840707964603,0.5288615713522181,68239864,3390,786
1,104,0.2777777777777778,0.6325088339222615,69195056,144,40
1,75,0.3181818181818182,0.6774193548387096,69737171,110,35
0,1457,0.18237934904601572,0.3283395755305868,68543342,1782,325
1,804,0.25348189415041783,0.5301944728761515,69912780,1077,273
0,707,0.23650107991360692,0.45376549094375596,62141261,926,219
0,617,0.21601016518424396,0.44352331606217615,68533164,787,170
0,885,0.17597765363128492,0.3374327440430438,68537721,1074,189
0,2420,0.1466854724964739,0.21684782608695652,68535222,2836,416
0,1632,0.21913875598086124,0.4327700220426157,70669361,2090,458
1,607,0.31644144144144143,0.7708108108108108,67261985,888,281
0,1130,0.12606341840680588,0.1723433242506812,70609245,1293,163
0,4235,0.1369472182596291,0.19797859690844233,70527310,4907,672
0,608,0.1326676176890157,0.18706404565630944,81979685,701,93
1,398,0.24478178368121442,0.528558476881233,82124902,527,129
0,977,0.06685768863419293,0.0552112676056338,73148922,1047,70
0,869,0.10227272727272728,0.13054187192118227,73148936,968,99
0,725,0.19623059866962306,0.38412698412698415,80119303,902,177
1,118,0.33707865168539325,0.7968253968253968,67995074,178,60
0,378,0.12296983758700696,0.23025210084033612,73366363,431,53
0,670,0.17589175891758918,0.3751233958538993,73366391,813,143
1,196,0.24031007751937986,0.5861486486486487,70061103,258,62
0,310,0.03426791277258567,0.010178117048346057,80176485,321,11
0,710,0.13520097442143728,0.20915448188175462,82011834,821,111
1,1395,0.2619047619047619,0.552689756816507,76293560,1890,495
1,1261,0.35167095115681235,0.8081162324649298,69668774,1945,684
1,813,0.3336065573770492,0.8154080854309688,70627445,1220,407
0,369,0.1836283185840708,0.3190546528803545,70780696,452,83
0,2485,0.18949771689497716,0.3226675648366453,80181297,3066,581
0,2405,0.09039334341906202,0.09262295081967213,68625872,2644,239
1,437,0.27408637873754155,0.6651651651651652,67556223,602,165
0,556,0.16012084592145015,0.27249357326478146,65801722,662,106
1,2295,0.24031777557100298,0.5751006503561474,68158300,3021,726
1,616,0.19160104986876642,0.5042016806722689,70233744,762,146
1,951,0.29970544918998526,0.6793540945790081,67556713,1358,407
0,620,0.17771883289124668,0.28066378066378067,70658385,754,134
2,2505,0.5309867066092492,0.9642857142857143,70818972,5341,2836
0,1775,0.19023722627737227,0.3730512249443207,68537770,2192,417
1,767,0.24209486166007904,0.5850439882697948,68537791,1012,245
0,1630,0.18662674650698602,0.34491525423728814,68543671,2004,374
0,1278,0.20719602977667495,0.4333170493404983,68543790,1612,334
1,1204,0.38602753697093317,0.8742368742368742,80109134,1961,757
1,998,0.26832844574780057,0.5842105263157895,63100030,1364,366
0,1783,0.13823102948284197,0.1797583081570997,68151160,2069,286
0,1023,0.0986784140969163,0.11946386946386946,69101536,1135,112
0,725,0.21281216069489686,0.4110486891385768,67706870,921,196
1,1349,0.3067831449126413,0.7112740604949588,69101711,1946,597
1,715,0.3044747081712062,0.6881028938906752,67552716,1028,313
0,985,0.1029143897996357,0.102,73818430,1098,113
1,978,0.31029619181946405,0.7469437652811736,67556734,1418,440
1,635,0.2502951593860685,0.5031963470319635,67556755,847,212
0,170,0.1625615763546798,0.25617283950617287,67815363,203,33
2,479,0.5171370967741935,0.9214145383104125,69706301,992,513
1,896,0.29559748427672955,0.7143661971830986,67813081,1272,376
1,1176,0.40213523131672596,0.85456660849331,68187042,1967,791
1,1270,0.2975663716814159,0.6228855721393035,73049333,1808,538
1,1358,0.31655762455963765,0.6880086814975583,80126892,1987,629
0,1629,0.20068694798822376,0.41605557699729834,74095763,2038,409
0,480,0.041916167664670656,0.1522965350523771,62834646,501,21
0,572,0.032148900169204735,0.10355987055016182,62834926,591,19
2,214,0.5307017543859649,0.9712643678160919,69621342,456,242
1,260,0.27170868347338933,0.5169230769230769,56175833,357,97
1,191,0.2952029520295203,0.6335697399527187,81967328,271,80
1,1224,0.3230088495575221,0.73457199734572,67551701,1808,584
1,1665,0.2556995976754582,0.5544061302681992,69078576,2237,572
1,809,0.2658802177858439,0.5536445536445537,80107461,1102,293
0,2228,0.17846607669616518,0.3081761006289308,68544462,2712,484
0,957,0.158311345646438,0.26766226306720275,68544490,1137,180
0,771,0.1148105625717566,0.22718052738336714,811762,871,100
0,534,0.10851419031719532,0.2472375690607735,61297040,599,65
0,1465,0.07919547454431175,0.1554524361948956,63770063,1591,126
0,387,0.2543352601156069,0.45698924731182794,74029424,519,132
0,1456,0.13539192399049882,0.2523197715917202,70841785,1684,228
1,301,0.23214285714285715,0.5931558935361216,68541522,392,91
0,1487,0.1278592375366569,0.24537987679671458,68156144,1705,218
0,619,0.1768617021276596,0.352622061482821,68542782,752,133
0,399,0.19556451612903225,0.42601626016260163,68542810,496,97
0,3765,0.10271687321258341,0.10141414141414141,73700613,4196,431
0,422,0.12266112266112267,0.1858108108108108,75333230,481,59
1,1275,0.35768261964735515,0.7910714285714285,80140042,1985,710
0,261,0.13861386138613863,0.2175141242937853,82019106,303,42
1,192,0.4606741573033708,0.8,80090066,356,164
1,185,0.2857142857142857,0.7883597883597884,65947385,259,74
1,738,0.28901734104046245,0.7131849315068494,68171383,1038,300
0,2296,0.19832402234636873,0.3326417704011065,68758571,2864,568
1,1181,0.24246311738293777,0.5431246919664859,72387462,1559,378
2,230,0.7510822510822511,0.9342723004694836,70831761,924,694
1,522,0.4411134903640257,0.9297820823244553,64260455,934,412
0,674,0.3730232558139535,0.4163265306122449,68187756,1075,401
2,2633,0.5415288176911022,0.9106849315068493,66280921,5743,3110
1,960,0.3282015395381386,0.7475538160469667,69608000,1429,469
1,535,0.481086323957323,0.9386213408876298,73251353,1031,496
1,409,0.45611702127659576,0.94579945799458,67130994,752,343
0,937,0.2172096908939014,0.3657182512144344,69606824,1197,260
1,674,0.28525980911983034,0.6550907655880032,66930773,943,269
0,4756,0.15523978685612788,0.24254785064323817,68668985,5630,874
1,907,0.3973421926910299,0.8144475920679887,80126933,1505,598
0,2074,0.14368290668868702,0.2989309210526316,63092736,2422,348
1,865,0.25687285223367695,0.5982324949014276,66930654,1164,299
1,280,0.2650918635170604,0.6531302876480541,66930843,381,101
1,2511,0.3646255060728745,0.8332755632582323,80111171,3952,1441
1,743,0.40796812749003986,0.9147947327652982,69482070,1255,512
0,2487,0.1526405451448041,0.29565816678152995,61394235,2935,448
2,27,0.578125,0.8604651162790697,80178989,64,37
0,2694,0.16074766355140188,0.26498194945848375,66203291,3210,516
1,837,0.3455824863174355,0.7587672688629118,70316225,1279,442
1,215,0.25862068965517243,0.617169373549884,70615405,290,75
1,30,0.47368421052631576,0.9411764705882353,79796934,57,27
0,415,0.04157043879907621,0.0401854714064915,80117751,433,18
1,263,0.4194260485651214,0.8829174664107485,80178636,453,190
1,2756,0.3574259734203777,0.8266666666666667,77687995,4289,1533
0,1151,0.19735006973500696,0.35789473684210527,68542341,1434,283
1,1381,0.2353266888150609,0.5034514496088357,78045835,1806,425
0,2062,0.17022132796780684,0.25588235294117645,67554424,2485,423
1,232,0.4592074592074592,0.9341085271317829,67554452,429,197
0,610,0.23173803526448364,0.46677091477716964,70211911,794,184
1,380,0.2803030303030303,0.6959798994974874,66765272,528,148
0,3685,0.17506156256995747,0.3202317964222726,68171516,4467,782
0,613,0.11798561151079137,0.14681107099879662,70609385,695,82
1,297,0.36942675159235666,0.8713355048859935,81967267,471,174
0,2184,0.22249911000355999,0.45567375886524825,81979974,2809,625
1,411,0.21264367816091953,0.6,63752493,522,111
0,308,0.15151515151515152,0.4383561643835616,63769440,363,55
0,178,0.13170731707317074,0.46984924623115576,68383784,205,27
0,1176,0.15273775216138327,0.36733692986758215,64999494,1388,212
0,105,0.027777777777777776,0.029411764705882353,69999615,108,3
1,337,0.21809744779582366,0.6318051575931232,79976442,431,94
1,1304,0.3329923273657289,0.7808145766345124,80110975,1955,651
1,3523,0.2879951495553759,0.6270702455739577,80124965,4948,1425
1,1189,0.3213470319634703,0.7207792207792207,80180453,1752,563
0,3786,0.23095673369896405,0.44757401315789475,69586384,4923,1137
1,2547,0.45495399101219774,0.922106179286336,68579525,4673,2126
1,652,0.24624277456647398,0.5973895582329317,68538232,865,213
0,2411,0.0843144701860995,0.06295652173913044,68539352,2633,222
0,1557,0.11028571428571429,0.13130056004978222,68539786,1750,193
1,626,0.25829383886255924,0.5682903533906399,80112004,844,218
1,2225,0.42282749675745784,0.9059985369422092,74130952,3855,1630
1,997,0.3119392684610076,0.7505643340857788,80107825,1449,452
1,1582,0.29906956136464335,0.6565132858068697,74955433,2257,675
1,495,0.26229508196721313,0.5899280575539568,69127464,671,176
1,65,0.4672131147540984,0.8,69733181,122,57
1,801,0.25,0.547455295735901,80118452,1068,267
1,1197,0.2509386733416771,0.576662908680947,66930661,1598,401
1,672,0.22580645161290322,0.5149911816578483,68541655,868,196
2,81,0.509090909090909,0.9675324675324676,903532,165,84
0,3860,0.10503130071875724,0.16494845360824742,68155864,4313,453
0,2496,0.09203346671516915,0.14651639344262296,68156032,2749,253
0,610,0.10425844346549193,0.23626373626373626,811510,681,71
0,632,0.08139534883720931,0.20785013380909903,63771764,688,56
1,713,0.2724489795918367,0.6895958727429062,70659036,980,267
1,280,0.3899782135076253,0.9006622516556292,69179782,459,179
1,45,0.27419354838709675,0.603448275862069,69180384,62,17
0,897,0.21108179419525067,0.38108561835478455,70599270,1137,240
2,82,0.7929292929292929,0.9759036144578314,70700560,396,314
0,1438,0.16589327146171692,0.30174081237911027,68543181,1724,286
1,631,0.3474663908996898,0.8337639965546942,80121215,967,336
0,890,0.06708595387840671,0.1481651376146789,66058825,954,64
0,46,0.061224489795918366,0.009708737864077669,63051884,49,3
0,825,0.22022684310018903,0.4755244755244755,67277371,1058,233
0,1329,0.20466786355475763,0.39822134387351776,68544476,1671,342
0,1206,0.21992238033635186,0.45483528161530284,68544483,1546,340
2,154,0.5637393767705382,0.9447513812154696,80137024,353,199
1,87,0.41216216216216217,0.9030612244897959,70690543,148,61
1,358,0.40728476821192056,0.8775510204081632,73579002,604,246
0,1417,0.12368583797155226,0.13766359670382938,68536202,1617,200
1,3509,0.3069326486272961,0.7239662264559429,80130301,5063,1554
0,2842,0.2378653794582998,0.4831813895001572,70645813,3729,887
1,1906,0.27666034155597724,0.6143667296786389,71777174,2635,729
0,788,0.23196881091617932,0.4642857142857143,74326364,1026,238
0,511,0.2485294117647059,0.4946341463414634,69101732,680,169
0,645,0.16233766233766234,0.21456692913385828,69101753,770,125
1,408,0.32450331125827814,0.7497155858930603,69101823,604,196
1,594,0.2413793103448276,0.5227053140096618,69165152,783,189
0,1033,0.1762360446570973,0.33061778682959947,67556951,1254,221
0,2351,0.20948217888365836,0.4189686924493554,80111794,2974,623
2,1593,0.5263157894736842,0.9679641749913882,70233856,3363,1770
1,1628,0.45533623285379726,0.9262032085561497,70607075,2989,1361
2,31,0.7047619047619048,0.975,82086320,105,74
1,855,0.22202001819836215,0.6101010101010101,62507585,1099,244
0,149,0.10240963855421686,0.17857142857142858,70627053,166,17
1,2219,0.3100124378109453,0.7434491163924436,69628685,3216,997
0,3181,0.1713988017712946,0.27612456747404845,67555110,3839,658
1,57,0.3804347826086957,0.8378378378378378,80118129,92,35
1,35,0.2708333333333333,0.6551724137931034,82090251,48,13
0,442,0.2036036036036036,0.4953764861294584,60249336,555,113
2,464,0.5037433155080214,0.8948995363214838,64197364,935,471
1,191,0.3391003460207612,0.6356589147286822,80176770,289,98
1,381,0.37643207855973815,0.75,80176776,611,230
0,205,0.08888888888888889,0.47334410339256866,62834555,225,20
0,170,0.03954802259887006,0.15280135823429541,62834702,177,7
0,381,0.0661764705882353,0.3153232949512843,62834730,408,27
0,5366,0.08273504273504273,0.07728511270745603,70206304,5850,484
0,1654,0.15569167942827974,0.1844946025515211,67553521,1959,305
1,1208,0.32701949860724233,0.7407407407407407,69183933,1795,587
1,640,0.25840092699884126,0.7414075286415712,65510452,863,223
0,1054,0.2027231467473525,0.4267650158061117,68536860,1322,268
0,1066,0.21961932650073207,0.4092009685230024,70832216,1366,300
1,1051,0.27064538514920194,0.6028481012658228,70614635,1441,390
1,1066,0.31136950904392763,0.7443820224719101,80107321,1548,482
1,697,0.3317353787152445,0.7923452768729642,80108700,1043,346
0,609,0.20287958115183247,0.4016806722689076,68536482,764,155
0,1156,0.10595514307811292,0.1307785888077859,68539926,1293,137
1,147,0.25757575757575757,0.5431754874651811,67994885,198,51
1,922,0.2624,0.579182156133829,62141254,1250,328
0,696,0.19630484988452657,0.3457777777777778,70646555,866,170
1,547,0.31965174129353235,0.7610241820768137,67554263,804,257
2,452,0.5060109289617486,0.9517241379310345,69160581,915,463
1,111,0.45588235294117646,0.9283018867924528,65100392,204,93
0,2955,0.253410813542193,0.4978616352201258,70207676,3958,1003
1,621,0.302247191011236,0.7585004359197908,80118961,890,269
1,452,0.3561253561253561,0.8039399624765479,80124766,702,250
0,86,0.1568627450980392,0.3431372549019608,63141932,102,16
1,463,0.38837516512549536,0.906721536351166,80121094,757,294
0,493,0.10200364298724955,0.17177914110429449,60312791,549,56
0,457,0.09504950495049505,0.11363636363636363,70641921,505,48
0,1539,0.20341614906832298,0.39433701657458564,82000131,1932,393
1,673,0.3459669582118562,0.8083927157561361,67384723,1029,356
1,187,0.46418338108882523,0.9193083573487032,62510616,349,162
0,2430,0.1536050156739812,0.21238640188488725,67554970,2871,441
0,2438,0.13942816801976704,0.16810207336523125,67554984,2833,395
0,1777,0.21441202475685234,0.4179298397574708,67555754,2262,485
1,1683,0.2618421052631579,0.5461833391425583,67556622,2280,597
0,514,0.1419031719532554,0.2049102927289896,70206962,599,85
1,3201,0.33602986932171747,0.8036655211912944,70642152,4821,1620
0,20,0.25925925925925924,0.45652173913043476,74708963,27,7
0,135,0.21511627906976744,0.3673469387755102,81980707,172,37
1,7,0.46153846153846156,0.8,67665353,13,6
1,708,0.2594142259414226,0.5821862348178137,69607202,956,248
0,1186,0.21143617021276595,0.43255131964809385,63278691,1504,318
0,2065,0.16159155501421033,0.25299306868304977,70539791,2463,398
1,406,0.41329479768786126,0.8616010854816825,72652216,692,286
1,1231,0.2867902665121669,0.6755373592630501,80125508,1726,495
1,660,0.28879310344827586,0.6922421142369991,67291826,928,268
1,1374,0.27949659150498163,0.6219839142091153,80180468,1907,533
0,40,0.14893617021276595,0.3023255813953488,70832181,47,7
1,88,0.21428571428571427,0.7170542635658915,68317886,112,24
0,52,0.10344827586206896,0.022727272727272728,80172473,58,6
1,62,0.31868131868131866,0.7,80172475,91,29
1,754,0.3471861471861472,0.8233246301131418,70631995,1155,401
1,452,0.22336769759450173,0.5158730158730159,70632191,582,130
1,891,0.28890662410215484,0.6703877790834313,69607125,1253,362
1,871,0.24913793103448276,0.5275080906148867,62140715,1160,289
1,2043,0.2530164533820841,0.5207534007673527,69586006,2735,692
1,119,0.30409356725146197,0.7877906976744186,80090864,171,52
1,853,0.32622432859399686,0.679892400806994,70286573,1266,413
1,1138,0.3189706762417714,0.7735445205479452,68236385,1671,533
0,1021,0.073502722323049,0.08021390374331551,69603506,1102,81
1,3288,0.24897213339424396,0.5511193168705285,70614593,4378,1090
2,309,0.5087440381558028,0.9432048681541582,69551195,629,320
1,370,0.26,0.5565438373570522,69551783,500,130
0,19,0.09523809523809523,0.21052631578947367,960953,21,2
0,33,0.15384615384615385,0.25,999502,39,6
1,1086,0.2581967213114754,0.5508752735229759,80109085,1464,378
0,3846,0.14854992251494353,0.20730897009966778,69239772,4517,671
0,368,0.16173120728929385,0.2297872340425532,67159211,439,71
0,506,0.20189274447949526,0.44742729306487694,67159225,634,128
0,1590,0.18083462132921174,0.3245172124265323,74886301,1941,351
0,2223,0.16049848942598188,0.27473460721868365,68543132,2648,425
0,167,0.21962616822429906,0.45244956772334294,67815356,214,47
1,291,0.3431151241534989,0.785234899328859,66857112,443,152
0,1659,0.14923076923076922,0.22104144527098832,54460462,1950,291
1,557,0.33213429256594723,0.8088235294117647,70627865,834,277
1,1062,0.4103275957801222,0.8777189888300999,70795144,1801,739
0,556,0.22237762237762237,0.41601255886970173,71389255,715,159
0,6743,0.05401234567901234,0.032532117695814336,64108856,7128,385
1,1871,0.24158897446291042,0.503032345013477,81999117,2467,596
1,648,0.27839643652561247,0.6690843155031732,69165880,898,250
1,1173,0.3744,0.8268674001158077,72549232,1875,702
1,906,0.29876160990712075,0.702338766832034,80111626,1292,386
1,223,0.33827893175074186,0.8114143920595533,69608056,337,114
0,726,0.14184397163120568,0.25206349206349205,80119308,846,120
0,2806,0.06091030789825971,0.04161676646706587,70642726,2988,182
1,401,0.37636080870917576,0.8967813540510544,67775386,643,242
2,150,0.5833333333333334,0.9912536443148688,67753686,360,210
0,700,0.1822429906542056,0.36400651465798045,68536706,856,156
0,3365,0.13740066649577032,0.17920568291895383,70641312,3901,536
0,921,0.17027027027027028,0.30237154150197626,67291966,1110,189
0,816,0.21159420289855072,0.3653376729048006,68112520,1035,219
0,1531,0.1475501113585746,0.25635478637101133,68159875,1796,265
1,662,0.4961948249619482,0.9273318872017353,68413184,1314,652
1,153,0.49504950495049505,0.8739495798319328,70245231,303,150
1,370,0.24796747967479674,0.5788787483702738,68257056,492,122
0,84,0.023255813953488372,0.05426356589147287,80124253,86,2
1,649,0.49058084772370486,0.9495575221238938,80096093,1274,625
2,1,0.95,0.6666666666666666,69541360,20,19
0,700,0.25452609158679446,0.4664778092540132,69150830,939,239
1,870,0.2689075630252101,0.5239179954441914,69150914,1190,320
1,534,0.28894806924101196,0.5978260869565217,70209426,751,217
1,80,0.48717948717948717,0.9227272727272727,67307086,156,76
2,10,0.5238095238095238,0.8571428571428571,80178149,21,11
1,8,0.4666666666666667,0.5,80178150,15,7
0,4,0.0,0.0,80178151,4,0
1,1731,0.4822016153155848,0.8788449466415568,66280011,3343,1612
0,281,0.007067137809187279,0.0049261083743842365,80049354,283,2
0,279,0.010638297872340425,0.009852216748768473,80049396,282,3
0,153,0.012903225806451613,0.03636363636363636,80049466,155,2
0,222,0.10843373493975904,0.3231707317073171,80049494,249,27
0,454,0.046218487394957986,0.14285714285714285,80049571,476,22
1,238,0.48034934497816595,0.8470948012232415,80126441,458,220
1,2394,0.3506916192026037,0.7221037668798863,80118628,3687,1293
0,55,0.16666666666666666,0.3218390804597701,80125966,66,11
0,850,0.08405172413793104,0.05590717299578059,82095683,928,78
2,350,0.697754749568221,0.9625,69167791,1158,808
0,1203,0.11674008810572688,0.10148514851485149,69550271,1362,159
1,733,0.4550185873605948,0.8119047619047619,82147547,1345,612
1,525,0.3674698795180723,0.8121546961325967,80141444,830,305
1,170,0.35361216730038025,0.7527777777777778,82171354,263,93
1,386,0.2475633528265107,0.5645677694770544,69702976,513,127
1,221,0.19927536231884058,0.573502722323049,62850221,276,55
0,712,0.09414758269720101,0.1598317560462671,300363,786,74
1,520,0.39745075318655854,0.9046296296296297,69091582,863,343
1,540,0.309462915601023,0.6647286821705426,67619272,782,242
1,2573,0.3829736211031175,0.801765447667087,73869915,4170,1597
0,1538,0.12314709236031927,0.1699867197875166,80119297,1754,216
1,553,0.2636484687083888,0.5444330949948928,80108133,751,198
0,567,0.2002820874471086,0.44045368620037806,61948194,709,142
1,2083,0.2846840659340659,0.6414835164835165,64994776,2912,829
1,348,0.24017467248908297,0.5989130434782609,82041092,458,110
1,404,0.3322314049586777,0.7590027700831025,67511493,605,201
0,887,0.12265084075173097,0.23171355498721227,74789274,1011,124
1,1544,0.2654614652711703,0.5483870967741935,74355813,2102,558
0,525,0.041970802919708027,0.02457956015523933,60640286,548,23
0,147,0.14534883720930233,0.31563421828908556,66653412,172,25
1,1154,0.2894088669950739,0.6509433962264151,67994955,1624,470
1,1238,0.4418394950405771,0.8608193277310925,70720370,2218,980
1,358,0.3431192660550459,0.8045212765957447,82085450,545,187
1,95,0.4946808510638298,0.9375,67063080,188,93
0,828,0.08305647840531562,0.05791788856304985,80114160,903,75
0,2637,0.20524412296564196,0.3893229166666667,82000059,3318,681
2,79,0.5485714285714286,0.9828326180257511,80156768,175,96
1,862,0.34248665141113654,0.8084074373484236,80125498,1311,449
1,392,0.3134851138353765,0.7595375722543353,65312793,571,179
1,779,0.2981981981981982,0.6859688195991092,80109610,1110,331
1,505,0.24174174174174173,0.5219885277246654,67552982,666,161
1,123,0.32044198895027626,0.7308970099667774,68785136,181,58
1,355,0.2650103519668737,0.6366950182260024,67160450,483,128
1,363,0.3202247191011236,0.7289293849658315,80133164,534,171
0,3390,0.17216117216117216,0.27963981990995496,70870926,4095,705
0,54,0.05263157894736842,0.04878048780487805,73905972,57,3
0,1425,0.19446014697569247,0.3632019115890084,70643342,1769,344
0,1476,0.10273556231003039,0.10950854700854701,80181317,1645,169
0,347,0.2356828193832599,0.49521531100478466,68235986,454,107
0,464,0.13594040968342644,0.21816386969397827,68631444,537,73
0,1349,0.18143203883495146,0.3420459666516449,69549501,1648,299
0,32,0.13513513513513514,0.23529411764705882,80098690,37,5
0,2720,0.1712370505789153,0.28746851385390426,65291583,3282,562
1,1171,0.2593295382669197,0.5624636839047066,80109176,1581,410
1,1319,0.34378109452736316,0.7866449511400652,80109183,2010,691
0,289,0.1813031161473088,0.32125984251968503,80119370,353,64
0,430,0.22382671480144403,0.49753208292201384,72368933,554,124
0,352,0.23311546840958605,0.46096096096096095,72393293,459,107
0,2110,0.16468725257323832,0.24347826086956523,70641214,2526,416
1,1911,0.3646941489361702,0.8597216998871756,68532436,3008,1097
1,957,0.4724366041896362,0.934657270980141,69657385,1814,857
1,1059,0.430032292787944,0.8984962406015038,81964034,1858,799
1,89,0.2764227642276423,0.6981132075471698,70605612,123,34
0,139,0.26455026455026454,0.4666666666666667,67095910,189,50
0,161,0.21844660194174756,0.40271493212669685,69536334,206,45
1,218,0.35693215339233036,0.6954314720812182,82110568,339,121
2,304,0.7399486740804107,0.9712793733681462,73551373,1169,865
2,591,0.5840957072484166,0.966785290628707,73551800,1421,830
1,512,0.48282828282828283,0.9236812570145904,70816816,990,478
1,1230,0.4971381847914963,0.9332399626517274,80081106,2446,1216
1,2818,0.32357177148343735,0.7777479892761394,80124647,4166,1348
0,127,0.23493975903614459,0.4219269102990033,65749026,166,39
1,187,0.26953125,0.6130268199233716,80121115,256,69
1,232,0.3033033033033033,0.72,80125345,333,101
1,970,0.29557007988380535,0.7081339712918661,80125358,1377,407
0,1674,0.2213953488372093,0.4425207756232687,80125454,2150,476
1,124,0.4678111587982833,0.9166666666666666,67411344,233,109
0,786,0.20121951219512196,0.38903225806451613,72368884,984,198
0,599,0.15752461322081576,0.20039486673247778,72393286,711,112
0,1359,0.14041745730550284,0.30362116991643456,70252742,1581,222
0,130,0.09090909090909091,0.14893617021276595,70485982,143,13
1,1036,0.30423102753525855,0.6749256689791873,71971263,1489,453
1,378,0.26459143968871596,0.6468489892984542,67160422,514,136
1,459,0.33861671469740634,0.7997237569060773,70627340,694,235
0,587,0.18245125348189414,0.3475991649269311,70642383,718,131
0,246,0.0989010989010989,0.10021786492374728,68533913,273,27
0,492,0.06463878326996197,0.03571428571428571,68539562,526,34
0,443,0.20892857142857144,0.4533715925394548,68540703,560,117
2,840,0.5164075993091537,0.9757412398921833,79145703,1737,897
0,1567,0.13948380010982978,0.19460281261877613,68535236,1821,254
0,868,0.19330855018587362,0.3566621803499327,72293893,1076,208
1,4971,0.3886360841224942,0.8549560853199498,69800444,8131,3160
1,302,0.3105022831050228,0.7005813953488372,69705153,438,136
2,173,0.5154061624649859,0.9607843137254902,76627173,357,184
0,2083,0.22965976331360946,0.4881863560732113,70592963,2704,621
1,568,0.27918781725888325,0.6484194294525829,68763821,788,220
1,398,0.29432624113475175,0.675776397515528,82124937,564,166
0,456,0.18716577540106952,0.25041736227045075,71762523,561,105
0,641,0.06149341142020498,0.08189655172413793,80114552,683,42
0,3098,0.09863252836776258,0.13309024612579762,80117743,3437,339
1,827,0.25962399283795884,0.5711645101663586,63732655,1117,290
1,1032,0.40069686411149824,0.8611809045226131,80153465,1722,690
1,1446,0.2700656234225139,0.5590836012861736,82034309,1981,535
1,673,0.29083245521601686,0.6567505720823799,65313185,949,276
0,229,0.08764940239043825,0.03225806451612903,67556545,251,22
1,811,0.4632693580410324,0.9299583911234397,80159815,1511,700
1,312,0.2744186046511628,0.6024955436720143,66892462,430,118
0,179,0.2079646017699115,0.4376731301939058,66892665,226,47
0,545,0.11954765751211632,0.2522639068564036,54904472,619,74
0,1224,0.10981818181818181,0.1957501609787508,60249406,1375,151
1,337,0.26258205689277897,0.6614268440145102,68147604,457,120
1,573,0.4856373429084381,0.9352890422778257,79917600,1114,541
0,696,0.20998864926220204,0.43824701195219123,68540360,881,185
1,353,0.47313432835820896,0.9411042944785276,70612073,670,317
1,332,0.40714285714285714,0.8659966499162479,73650920,560,228
0,858,0.10810810810810811,0.09701492537313433,68541935,962,104
0,13,0.23529411764705882,0.4166666666666667,65871526,17,4
0,1004,0.19162640901771336,0.3909677419354839,68537483,1242,238
1,1039,0.262597586941093,0.6380368098159509,70615153,1409,370
0,2250,0.18713872832369943,0.3044654939106901,65851835,2768,518
0,847,0.17042115572967678,0.2755244755244755,68541053,1021,174
0,933,0.20392491467576793,0.33118140735958684,70207606,1172,239
1,1338,0.4032114183764496,0.8829100301334482,64928885,2242,904
0,497,0.2048,0.37894736842105264,68474784,625,128
0,3702,0.08456973293768547,0.09156409486640649,70641172,4044,342
0,447,0.18874773139745918,0.44334433443344334,70627116,551,104
1,3574,0.32361847085541257,0.7857737104825291,70627305,5284,1710
1,457,0.27229299363057324,0.6755813953488372,67942756,628,171
0,607,0.1278735632183908,0.1662799690641918,69239863,696,89
0,1220,0.18230563002680966,0.28754208754208754,70645246,1492,272
0,1608,0.11648351648351649,0.09514656415185008,67554914,1820,212
0,2615,0.23783153599533663,0.4981925731186329,67557294,3431,816
0,1299,0.19715698393077874,0.3809723386420788,64217531,1618,319
0,3177,0.15572681371246347,0.32754182754182753,80145414,3763,586
1,1771,0.2977795400475813,0.7084870848708487,81253864,2522,751
1,758,0.26692456479690524,0.5920289855072464,63141596,1034,276
1,224,0.29337539432176657,0.7467532467532467,68533654,317,93
1,557,0.42636457260556127,0.8292443572129539,63952994,971,414
1,697,0.2632135306553911,0.6774679728711379,63087906,946,249
1,437,0.26057529610829105,0.6310880829015544,66931333,591,154
0,380,0.23541247484909456,0.47135135135135137,71358854,497,117
0,410,0.1350210970464135,0.3452544704264099,67226180,474,64
1,1978,0.28797696184305255,0.6838511437350632,70215831,2778,800
1,1970,0.37598986379474186,0.7908973808501503,67675916,3157,1187
0,454,0.18783542039355994,0.4363827549947424,70252896,559,105
0,1330,0.05338078291814947,0.11016949152542373,60286961,1405,75
1,1127,0.2880606443461781,0.7041095890410959,80112382,1583,456
0,1570,0.17671735710540115,0.3290748898678414,68541823,1907,337
0,618,0.210727969348659,0.43975283213182287,68791254,783,165
0,2262,0.10628210193599368,0.12133285041651576,73346861,2531,269
1,147,0.3033175355450237,0.6798679867986799,67435802,211,64
1,1052,0.4059853190287973,0.9105645612073784,68532345,1771,719
2,1283,0.7279474130619169,0.9922978177150192,68214174,4716,3433
1,7175,0.25033956744331837,0.552731673582296,68155822,9571,2396
1,1586,0.23823246878001922,0.5425574828559904,68530994,2082,496
0,1414,0.192,0.3462739848282017,63278852,1750,336
0,50,0.07407407407407407,0.1619047619047619,67438245,54,4
2,142,0.5359477124183006,0.9746376811594203,69056701,306,164
0,370,0.09090909090909091,0.07117852975495916,69240234,407,37
1,1012,0.3611111111111111,0.8066298342541437,69187020,1584,572
1,459,0.37972972972972974,0.8938679245283019,69607426,740,281
1,296,0.3018867924528302,0.7052980132450332,70863492,424,128
1,1333,0.46271664651350264,0.9341035515618314,65787246,2481,1148
0,2338,0.19518072289156627,0.3504353233830846,67555572,2905,567
0,1133,0.17540029112081515,0.3159340659340659,67555642,1374,241
1,512,0.24372230428360414,0.6057803468208093,68540633,677,165
0,948,0.22103533278553822,0.44975786924939465,68535495,1217,269
0,889,0.1668228678537957,0.31797235023041476,68535551,1067,178
2,830,0.5281409891984082,0.967536231884058,73321010,1759,929
0,700,0.09090909090909091,0.1046875,70627473,770,70
0,329,0.23488372093023255,0.4256198347107438,71358763,430,101
1,125,0.2857142857142857,0.6177606177606177,69154141,175,50
1,1701,0.310498581272801,0.7145868465430016,80181388,2467,766
1,479,0.24088748019017434,0.5536261491317671,63264292,631,152
1,498,0.39636363636363636,0.9207383279044516,66470936,825,327
0,555,0.08866995073891626,0.10877192982456141,80098543,609,54
0,964,0.20918785890073832,0.4241362043064597,66510612,1219,255
1,647,0.36939571150097467,0.8260019550342131,64193346,1026,379
0,499,0.22152886115444617,0.43548387096774194,70207151,641,142
0,623,0.09840810419681621,0.1863425925925926,66348646,691,68
0,905,0.2375737152485257,0.4818523153942428,80021991,1187,282
0,910,0.1867739052725648,0.3487250172294969,68543944,1119,209
1,79,0.29464285714285715,0.6491935483870968,80139730,112,33
1,544,0.2517193947730399,0.593170731707317,68532044,727,183
0,1951,0.20334830543078808,0.3974658219406469,68537952,2449,498
1,605,0.26666666666666666,0.5998376623376623,62803062,825,220
0,406,0.04918032786885246,0.026836158192090395,66237535,427,21
0,841,0.15136226034308778,0.1940700808625337,68542033,991,150
0,1738,0.1530214424951267,0.17952069716775598,69607944,2052,314
0,261,0.08098591549295775,0.09195402298850575,73135286,284,23
1,2829,0.24439102564102563,0.5712557464311638,70626843,3744,915
1,1155,0.4385026737967914,0.934156378600823,69073403,2057,902
0,1548,0.2020618556701031,0.41362725450901805,70615055,1940,392
0,2931,0.20826580226904376,0.38805256869772997,73818395,3702,771
1,910,0.3391430646332607,0.7843648208469055,80108203,1377,467
1,285,0.28391959798994976,0.5719360568383659,70891863,398,113
1,198,0.2851985559566787,0.5639097744360902,70891912,277,79
1,603,0.2872340425531915,0.6735849056603773,68531862,846,243
2,782,0.5133789670192906,0.9484029484029484,67427094,1607,825
1,1183,0.3012404016538689,0.7347130761994356,67401586,1693,510
1,157,0.2831050228310502,0.6860158311345647,82126757,219,62
0,1633,0.15607235142118864,0.2539325842696629,68543160,1935,302
1,687,0.3067608476286579,0.7345132743362832,69094025,991,304
2,295,0.5509893455098934,0.9735449735449735,70202510,657,362
0,446,0.12890625,0.2619718309859155,300356,512,66
0,884,0.11511511511511512,0.23967551622418878,60249350,999,115
2,34,0.5342465753424658,0.8769230769230769,82041324,73,39
1,440,0.3741109530583215,0.8274894810659187,68254543,703,263
1,472,0.4824561403508772,0.926208651399491,72315040,912,440
1,689,0.3012170385395537,0.6821844225604298,80111584,986,297
1,395,0.3875968992248062,0.87,74372984,645,250
0,3845,0.17169323567427833,0.28945418621881946,73346756,4642,797
0,937,0.16858917480035493,0.2904761904761905,73346826,1127,190
1,702,0.36065573770491804,0.815418828762046,67764431,1098,396
1,2065,0.27620049071153174,0.6261971830985915,68763646,2853,788
1,308,0.350210970464135,0.841091492776886,69165943,474,166
0,325,0.0947075208913649,0.0963302752293578,72135406,359,34
0,206,0.11206896551724138,0.12383177570093458,72135420,232,26
0,204,0.1013215859030837,0.08755760368663594,72135434,227,23
1,616,0.3425827107790822,0.7150259067357513,67481981,937,321
1,1517,0.2807017543859649,0.6266666666666667,80111325,2109,592
1,252,0.37,0.8238866396761133,80072083,400,148
0,860,0.1746641074856046,0.262089552238806,58862720,1042,182
1,162,0.4022140221402214,0.887459807073955,67435935,271,109
1,1004,0.23823975720789076,0.506066734074823,80118960,1318,314
1,248,0.2811594202898551,0.6611570247933884,76043443,345,97
0,471,0.1062618595825427,0.2688330871491876,69965035,527,56
0,309,0.057926829268292686,0.16561844863731656,69965056,328,19
0,2137,0.15733438485804416,0.23501461988304093,80119306,2536,399
0,1121,0.07278742762613731,0.04689146469968388,68539814,1209,88
2,1075,0.5228584110075455,0.9701338825952626,80062514,2253,1178
0,403,0.201980198019802,0.3937947494033413,67627273,505,102
0,1013,0.15933609958506223,0.236796285548462,68544126,1205,192
1,1360,0.4359187059311489,0.9043478260869565,65777201,2411,1051
1,1846,0.25414141414141417,0.5734729493891798,67154654,2475,629
1,567,0.43582089552238806,0.944043321299639,69184514,1005,438
0,1686,0.22411412793373217,0.41898148148148145,69585943,2173,487
1,189,0.33916083916083917,0.7406015037593985,74386172,286,97
0,1141,0.1092896174863388,0.15546918378678512,70398881,1281,140
2,455,0.5735707591377694,0.9853723404255319,63961093,1067,612
1,1332,0.32829046898638425,0.7532216494845361,66401461,1983,651
0,1651,0.2649154051647373,0.4618556701030928,70541723,2246,595
1,531,0.3875432525951557,0.7165109034267912,70567763,867,336
1,281,0.3864628820960699,0.6927374301675978,72433606,458,177
1,132,0.37142857142857144,0.8662952646239555,65277793,210,78
1,655,0.4056261343012704,0.9154824233358265,65278423,1102,447
0,2415,0.06792744114241606,0.04716103009618368,69094305,2591,176
0,413,0.0982532751091703,0.13178294573643412,72522653,458,45
0,482,0.07307692307692308,0.07856532877882152,72522660,520,38
1,727,0.34445446348061315,0.8188131313131313,80128546,1109,382
0,682,0.08086253369272237,0.0651750972762646,68538890,742,60
0,541,0.1803030303030303,0.31327433628318585,68642483,660,119
1,1321,0.29433760683760685,0.7020579981290926,69669005,1872,551
1,4164,0.33524904214559387,0.7774905547822629,81989538,6264,2100
0,1112,0.10682730923694779,0.2088404868673927,60249364,1245,133
1,458,0.33910533910533913,0.8376288659793815,69722730,693,235
1,94,0.4748603351955307,0.9345238095238095,64196195,179,85
1,1187,0.4120851906884596,0.8874066168623266,64929046,2019,832
0,10,0.23076923076923078,0.38095238095238093,80123614,13,3
1,30,0.2682926829268293,0.5053763440860215,80124744,41,11
2,106,0.5938697318007663,0.9846743295019157,72198301,261,155
1,732,0.28305582761998044,0.5896414342629482,70604772,1021,289
0,2268,0.17706821480406387,0.3358011634056055,73637494,2756,488
0,2112,0.15248796147672553,0.21761133603238866,66808924,2492,380
0,2993,0.1637328862810841,0.2594654788418708,66964324,3579,586
0,228,0.088,0.2,68655930,250,22
0,570,0.12844036697247707,0.24058323207776428,68655944,654,84
1,1959,0.48984375,0.9203420342034203,80124826,3840,1881
1,483,0.23817034700315456,0.5411320754716981,73672676,634,151
2,547,0.6940715883668904,0.8867924528301887,70540645,1788,1241
0,1150,0.08146964856230032,0.18718381112984822,69701660,1252,102
0,209,0.13278008298755187,0.3917995444191344,70109746,241,32
0,600,0.05063291139240506,0.07459207459207459,80124208,632,32
0,106,0.061946902654867256,0.23411371237458195,80126899,113,7
1,977,0.439150401836969,0.8352059925093633,80062241,1742,765
1,30,0.4339622641509434,0.8181818181818182,66632384,53,23
0,253,0.2118380062305296,0.4738372093023256,73637655,321,68
0,1415,0.10612760581174985,0.12815884476534295,73700662,1583,168
1,29,0.32558139534883723,0.9074074074074074,73637704,43,14
1,123,0.2064516129032258,0.6324324324324324,73637753,155,32
2,46,0.8516129032258064,0.9534883720930233,82045536,310,264
1,611,0.43478260869565216,0.8830525272547076,80125067,1081,470
2,512,0.5105162523900574,0.9476334340382678,80096072,1046,534
1,2547,0.4974348855564325,0.9332566168009206,80124834,5068,2521
1,53,0.45918367346938777,0.6619718309859155,69617324,98,45
0,689,0.09934640522875816,0.04239401496259352,82007090,765,76
1,878,0.38900487125956856,0.8430311231393776,80153466,1437,559
2,664,0.5007518796992482,0.9538615847542627,66161480,1330,666
0,1110,0.12183544303797468,0.20124716553287983,80124514,1264,154
1,26,0.23529411764705882,0.5567010309278351,65286382,34,8
1,562,0.37969094922737306,0.8238993710691824,973154,906,344
1,195,0.3010752688172043,0.5854430379746836,69974723,279,84
0,1345,0.1051230871590153,0.22199488491048594,67837021,1503,158
1,667,0.23245109321058688,0.5088702147525677,68173903,869,202
0,496,0.13286713286713286,0.22425249169435216,80140147,572,76
1,417,0.4701397712833545,0.9681274900398407,67558141,787,370
0,1166,0.09682416731216112,0.08093994778067885,70871122,1291,125
1,693,0.28703703703703703,0.6755805770584096,63283311,972,279
0,1773,0.20278776978417265,0.37540453074433655,67556965,2224,451
1,234,0.30973451327433627,0.7352941176470589,68532653,339,105
0,300,0.12280701754385964,0.17125748502994012,66087301,342,42
0,517,0.011472275334608031,0.007475083056478406,68047623,523,6
0,525,0.0150093808630394,0.01076158940397351,68047630,533,8
1,245,0.3875,0.8433476394849786,70110271,400,155
0,2375,0.057539682539682536,0.06626303397241844,66742074,2520,145
0,2964,0.09963547995139732,0.09663476381599259,70605605,3292,328
1,171,0.397887323943662,0.8620689655172413,68750486,284,113
1,97,0.4121212121212121,0.8088235294117647,69867490,165,68
1,489,0.2679640718562874,0.5450861195542046,69499115,668,179
1,1960,0.4024390243902439,0.8561389003720545,80153454,3280,1320
1,293,0.39337474120082816,0.8958031837916064,66931074,483,190
0,1183,0.155,0.18952164009111616,70206976,1400,217
1,124,0.32972972972972975,0.7555555555555555,69056715,185,61
1,3340,0.25546143557735174,0.5487161449173409,80178632,4486,1146
1,1352,0.28465608465608466,0.5862068965517241,70654150,1890,538
0,295,0.15954415954415954,0.23454545454545456,63277732,351,56
0,1112,0.17872968980797638,0.292420814479638,67291686,1354,242
1,743,0.2997172478793591,0.7205438066465257,80109260,1061,318
1,502,0.35887611749680715,0.7458064516129033,67662532,783,281
0,4948,0.04955820207452939,0.021550591327201052,69601000,5206,258
0,1089,0.20684632192279678,0.3993212669683258,63278516,1373,284
0,2232,0.14580941446613088,0.27711255559356823,70219646,2613,381
0,667,0.2522421524663677,0.4856943475226797,70676865,892,225
1,186,0.27626459143968873,0.5187032418952618,72958466,257,71
1,457,0.28482003129890454,0.6091160220994475,70653632,639,182
1,1412,0.24612920448478376,0.502234863876473,65818935,1873,461
0,1190,0.10391566265060241,0.1706392199349946,68311950,1328,138
0,399,0.21456692913385828,0.4106217616580311,68532002,508,109
0,2256,0.17513711151736747,0.3055210918114144,70870982,2735,479
0,713,0.12942612942612944,0.19713728041639558,81979989,819,106
1,225,0.38016528925619836,0.7692307692307693,62142836,363,138
0,299,0.1830601092896175,0.4656188605108055,63982100,366,67
0,1469,0.21569674319273893,0.4341957255343082,66833025,1873,404
1,826,0.24289642529789185,0.5741345525800131,68537371,1091,265
1,234,0.4030612244897959,0.8171021377672208,69108753,392,158
0,461,0.06868686868686869,0.09144542772861357,80124159,495,34
1,1441,0.2606464853771165,0.5975046210720887,80125518,1949,508
1,1340,0.24592009003939225,0.5364932885906041,66284155,1777,437
0,1385,0.1327489041953663,0.1608567828643427,67554550,1597,212
0,3258,0.1795517501888693,0.3017845041789022,68535740,3971,713
0,2953,0.10866284334440085,0.09050249934227834,70207795,3313,360
2,498,0.7376185458377239,0.9922048997772829,73579394,1898,1400
0,1766,0.22202643171806166,0.4676479607482367,70599291,2270,504
1,2726,0.3218905472636816,0.7180141843971631,67994934,4020,1294
0,1551,0.11270022883295194,0.15337954939341422,67478803,1748,197
1,459,0.34334763948497854,0.8284263959390863,67668041,699,240
1,259,0.3018867924528302,0.6573556797020484,70822374,371,112
1,55,0.32926829268292684,0.6379310344827587,73514000,82,27
1,1332,0.2922422954303932,0.6933014354066985,70599501,1882,550
0,386,0.16630669546436286,0.30721649484536084,82000004,463,77
1,919,0.33741888968997835,0.759009009009009,74091451,1387,468
1,435,0.3949930458970793,0.9096109839816934,69177612,719,284
1,360,0.4339622641509434,0.9347826086956522,61888925,636,276
0,343,0.2239819004524887,0.4305210918114144,80103184,442,99
1,1716,0.22247394653375624,0.5660785019805545,78235472,2207,491
1,426,0.3535660091047041,0.8033707865168539,65984016,659,233
1,901,0.27103559870550165,0.6518615284128021,80121274,1236,335
1,546,0.33495736906211937,0.8303747534516766,80121296,821,275
1,288,0.4228456913827655,0.9176029962546817,65289126,499,211
1,626,0.3210412147505423,0.7528187337380746,67813130,922,296
2,139,0.6106442577030813,0.9896373056994818,67894736,357,218
1,360,0.2857142857142857,0.6796116504854369,69736373,504,144
1,2325,0.2688679245283019,0.6098901098901099,69158005,3180,855
1,189,0.30514705882352944,0.6467661691542289,66857140,272,83
1,804,0.2891246684350133,0.6167832167832168,67737173,1131,327
1,726,0.3888888888888889,0.8316467341306347,70628901,1188,462
1,463,0.28659476117103233,0.5040214477211796,81976032,649,186
0,176,0.1497584541062802,0.2454780361757106,68628931,207,31
1,394,0.37658227848101267,0.8804071246819338,68532576,632,238
1,311,0.3088888888888889,0.6746575342465754,68532772,450,139
1,1093,0.24255024255024255,0.5091991341991342,63100023,1443,350
1,940,0.3314366998577525,0.7945529899348727,80103086,1406,466
0,1477,0.13066509711595056,0.13568037974683544,70206983,1699,222
0,957,0.16782608695652174,0.3892931392931393,69551153,1150,193
1,2925,0.29193899782135074,0.6765878288599522,69586125,4131,1206
1,1101,0.30095238095238097,0.730561555075594,80121177,1575,474
0,459,0.18617021276595744,0.4108761329305136,80140112,564,105
0,1232,0.1550068587105624,0.2055596196049744,67706723,1458,226
1,133,0.3316582914572864,0.7983193277310925,81980712,199,66
1,374,0.3403880070546737,0.7830423940149626,66857091,567,193
0,516,0.18354430379746836,0.38144329896907214,80119366,632,116
1,996,0.28653295128939826,0.6760975609756098,81960443,1396,400
0,1138,0.1741654571843251,0.22851686823679185,81956113,1378,240
2,1107,0.5967213114754099,0.9846666666666667,80136353,2745,1638
1,1353,0.257001647446458,0.5174943566591422,70641291,1821,468
0,1083,0.20542920029347028,0.44798890429958393,69110811,1363,280
1,564,0.34494773519163763,0.7471264367816092,68751186,861,297
2,56,0.6083916083916084,0.967741935483871,66836196,143,87
1,984,0.3776091081593928,0.8886904761904761,80135190,1581,597
1,571,0.3503981797497156,0.821647379169503,80152810,879,308
1,1122,0.4707547169811321,0.9189814814814815,80123459,2120,998
0,1823,0.0916791230692576,0.09066901408450705,70615216,2007,184
1,576,0.2727272727272727,0.6567307692307692,68543601,792,216
0,1635,0.14532148457919497,0.2157838606469961,67703153,1913,278
0,86,0.2711864406779661,0.44339622641509435,68189660,118,32
2,39,0.5617977528089888,0.9634146341463414,79792384,89,50
0,582,0.1415929203539823,0.16918714555765596,69073410,678,96
1,658,0.4654752233956133,0.9165885660731021,73427704,1231,573
1,2236,0.31157635467980294,0.7052600646488393,80118462,3248,1012
1,1033,0.30202702702702705,0.7034135422495803,66857630,1480,447
0,2682,0.2167056074766355,0.4531197864531198,80125274,3424,742
1,773,0.3336206896551724,0.8,68531904,1160,387
0,7,0.125,0.0,65280173,8,1
0,919,0.12890995260663507,0.24596774193548387,68156123,1055,136
1,324,0.3032258064516129,0.7046875,71036980,465,141
1,448,0.4838709677419355,0.93,70202454,868,420
1,316,0.28018223234624146,0.5471204188481675,70654766,439,123
1,2241,0.25572899368980406,0.6501569584931984,70621712,3011,770
1,822,0.3667180277349769,0.8193146417445483,67706086,1298,476
1,741,0.32636363636363636,0.7608047690014903,69967254,1100,359
0,431,0.18984962406015038,0.3217665615141956,70645505,532,101
0,364,0.08771929824561403,0.08762886597938144,70646632,399,35
1,204,0.41040462427745666,0.8991596638655462,69498695,346,142
0,512,0.13659359190556492,0.23835616438356164,54609891,593,81
0,2458,0.12120128709331426,0.22686945500633712,70841463,2797,339
0,2218,0.2075741336191497,0.4088314809252028,67291784,2799,581
1,674,0.27213822894168466,0.6511831726555652,68545155,926,252
0,1059,0.18350038550501158,0.29754601226993865,68231653,1297,238
0,324,0.18181818181818182,0.38235294117647056,73194772,396,72
0,2908,0.15193934091571887,0.2337217272104181,80121158,3429,521
0,601,0.196524064171123,0.39931972789115644,70527506,748,147
1,8,0.2727272727272727,0.782608695652174,65279851,11,3
0,322,0.21654501216545013,0.3780487804878049,67666214,411,89
1,140,0.3034825870646766,0.7060133630289532,73709181,201,61
1,306,0.2765957446808511,0.6061381074168798,74266353,423,117
1,580,0.3192488262910798,0.7497949138638228,68113262,852,272
0,1666,0.18572825024437928,0.3333333333333333,70604926,2046,380
1,1224,0.2757396449704142,0.6504065040650406,80109883,1690,466
2,654,0.6590198123044838,0.9861351819757366,74046056,1918,1264
0,669,0.19300361881785283,0.369449378330373,66930850,829,160
0,779,0.19607843137254902,0.37824897400820795,66930892,969,190
0,1573,0.20675743822491174,0.4107142857142857,66931004,1983,410
1,1488,0.2357473035439137,0.5078014184397163,68530966,1947,459
1,887,0.23731728288907997,0.5576923076923077,68541452,1163,276
0,686,0.20876585928489041,0.45977011494252873,68541662,867,181
0,843,0.13803680981595093,0.20762423417290674,70870863,978,135
0,442,0.20930232558139536,0.487279843444227,69383531,559,117
2,786,0.5102803738317757,0.946,80181010,1605,819
1,617,0.3586278586278586,0.8566037735849057,73706556,962,345
1,55,0.2857142857142857,0.8413793103448276,65592170,77,22
0,878,0.09015544041450778,0.21865443425076453,69575401,965,87
0,875,0.18452935694315004,0.3195084485407066,72293872,1073,198
0,317,0.22682926829268293,0.38827258320126784,67556580,410,93
1,163,0.2347417840375587,0.5646687697160884,68533724,213,50
1,39,0.43478260869565216,0.9745762711864406,69180216,69,30
0,1152,0.21525885558583105,0.44385026737967914,68341385,1468,316
0,123,0.11510791366906475,0.14501510574018128,80071201,139,16
0,150,0.10714285714285714,0.16745283018867924,80071215,168,18
1,1152,0.26201153106982705,0.5990220048899756,63283304,1561,409
1,535,0.31585677749360613,0.781855249745158,80121295,782,247
0,1135,0.06584362139917696,0.11823647294589178,63771043,1215,80
1,32,0.30434782608695654,0.5,70940520,46,14
0,344,0.12690355329949238,0.1815680880330124,68740903,394,50
1,99,0.4816753926701571,0.7950310559006211,69512436,191,92
1,167,0.29831932773109243,0.6175438596491228,74362785,238,71
2,27,0.8491620111731844,0.9818181818181818,80126531,179,152
2,190,0.5529411764705883,0.950381679389313,66863293,425,235
0,826,0.06029579067121729,0.18592964824120603,72768752,879,53
0,571,0.03709949409780776,0.042105263157894736,80124262,593,22
0,214,0.009259259259259259,0.008287292817679558,80124333,216,2
0,211,0.09829059829059829,0.2579957356076759,80124407,234,23
0,1621,0.1951340615690169,0.384206529992407,70669431,2014,393
1,331,0.4203152364273205,0.875,69169940,571,240
1,196,0.30985915492957744,0.6858006042296072,69534276,284,88
0,130,0.14473684210526316,0.21721311475409835,69633921,152,22
2,0,1.0,1.0,82105372,1,1
0,345,0.13533834586466165,0.2581888246628131,80124250,399,54
2,233,0.7954345917471466,0.9691516709511568,80178971,1139,906
1,411,0.40863309352517985,0.8403908794788274,69162534,695,284
1,630,0.3,0.6199821587867975,69550194,900,270
2,1,0.5,0.8333333333333334,80139975,2,1
1,1107,0.22478991596638656,0.5046382189239332,73672662,1428,321
1,624,0.2909090909090909,0.5565217391304348,70174314,880,256
1,94,0.44047619047619047,0.8674033149171271,72323776,168,74
2,329,0.547455295735901,0.9774436090225563,82018848,727,398
1,221,0.46618357487922707,0.8894348894348895,70576660,414,193
1,206,0.3542319749216301,0.7077244258872651,74327036,319,113
1,358,0.337037037037037,0.7905918057663126,66471244,540,182
1,629,0.2234567901234568,0.6333059885151764,69551146,810,181
0,806,0.2197483059051307,0.44470727380248376,66931886,1033,227
0,764,0.16043956043956045,0.2782152230971129,69240276,910,146
1,88,0.3669064748201439,0.8784530386740331,69645555,139,51
1,133,0.3926940639269406,0.8838526912181303,70910056,219,86
0,1294,0.23792697290930506,0.3988439306358382,80173004,1698,404
0,749,0.1980728051391863,0.3865319865319865,66931641,934,185
1,585,0.355726872246696,0.8729613733905579,67553241,908,323
1,90,0.4267515923566879,0.9123505976095617,65278052,157,67
1,132,0.4107142857142857,0.6776859504132231,69055686,224,92
1,499,0.41431924882629106,0.8033419023136247,72320941,852,353
1,478,0.3557951482479784,0.8200913242009132,65312982,742,264
1,1016,0.4610079575596817,0.9442942130881558,69621363,1885,869
1,602,0.32962138084632514,0.749509483322433,73002034,898,296
1,21,0.36363636363636365,0.9166666666666666,65281265,33,12
1,145,0.2328042328042328,0.5657015590200446,72523073,189,44
1,1101,0.23328690807799443,0.5287912087912088,80056893,1436,335
0,726,0.16455696202531644,0.2861427714457109,81979987,869,143
0,1446,0.1844331641285956,0.3246753246753247,81999989,1773,327
1,1281,0.32861635220125784,0.7683673469387755,70626633,1908,627
1,20,0.3103448275862069,0.5283018867924528,65289553,29,9
1,260,0.4247787610619469,0.8830769230769231,61698595,452,192
1,32,0.4074074074074074,0.9493670886075949,66855880,54,22
1,24,0.4,0.851063829787234,65289721,40,16
1,189,0.29213483146067415,0.6124197002141327,66568943,267,78
1,282,0.36629213483146067,0.793168880455408,69504792,445,163
1,371,0.34683098591549294,0.7921348314606742,69863346,568,197
0,986,0.15798462852263023,0.22511848341232227,68372283,1171,185
0,69,0.11538461538461539,0.15591397849462366,69863416,78,9
0,1974,0.13761467889908258,0.28444444444444444,61717635,2289,315
2,260,0.56738768718802,0.9637681159420289,68040504,601,341
1,831,0.3430830039525692,0.8217687074829932,69154841,1265,434
1,856,0.3588014981273408,0.8159790438768828,67281795,1335,479
1,1666,0.2471757794848622,0.5459590704127645,80122957,2213,547
0,352,0.15384615384615385,0.31197097944377267,70641585,416,64
0,206,0.20155038759689922,0.480225988700565,70643510,258,52
0,838,0.2049335863377609,0.38490853658536583,68543622,1054,216
1,2243,0.4257552483358935,0.8983103879849812,80125112,3906,1663
0,726,0.17406143344709898,0.3133716160787531,68541060,879,153
1,338,0.3306930693069307,0.8062015503875969,62945393,505,167
0,2,0.0,0.0,61264602,2,0
1,1090,0.25799863852961197,0.5956175298804781,68535796,1469,379
1,642,0.33746130030959753,0.7793650793650794,70627011,969,327
1,3153,0.2568937072825831,0.5868603916614024,67246613,4243,1090
1,1929,0.29236977256052826,0.6830562433675275,70654493,2726,797
1,1038,0.3180026281208936,0.6606205250596658,79953951,1522,484
1,23,0.3611111111111111,0.6363636363636364,65288825,36,13
0,1286,0.18089171974522292,0.3364485981308411,68542096,1570,284
2,26,0.6486486486486487,0.9736842105263158,65280152,74,48
1,574,0.3333333333333333,0.7901459854014599,68531225,861,287
1,1312,0.2896589063345966,0.6855566700100301,68540983,1847,535
1,234,0.39690721649484534,0.924892703862661,82126699,388,154
1,322,0.30303030303030304,0.6432337434094904,82126800,462,140
2,24,0.5,0.9466666666666667,65281195,48,24
1,311,0.25240384615384615,0.5128983308042488,69724375,416,105
1,421,0.2815699658703072,0.6573099415204678,69724382,586,165
0,1249,0.13324080499653018,0.19115120274914088,73255084,1441,192
1,1338,0.25666666666666665,0.5951500205507604,69094193,1800,462
1,70,0.2391304347826087,0.5030674846625767,67281830,92,22
0,425,0.12008281573498965,0.17663817663817663,78624455,483,58
1,941,0.464123006833713,0.9134487350199734,82105886,1756,815
0,791,0.15219721329046088,0.23153320918684048,72368891,933,142
1,136,0.2916666666666667,0.683291770573566,69558433,192,56
0,258,0.16233766233766234,0.2568027210884354,67154745,308,50
0,1276,0.1773049645390071,0.33183250787933366,73346924,1551,275
0,2023,0.18950320512820512,0.3486271676300578,68545526,2496,473
0,272,0.1831831831831832,0.4380952380952381,70627151,333,61
0,1226,0.21460602178090968,0.45715528490648105,62687205,1561,335
1,340,0.32938856015779094,0.765625,65278465,507,167
0,4031,0.11054721977052075,0.19554519554519553,66741913,4532,501
1,1085,0.24125874125874125,0.5547169811320755,69622203,1430,345
0,14,0.125,0.13043478260869565,66379453,16,2
0,1835,0.11438223938223938,0.127734375,69960380,2072,237
1,583,0.47713004484304933,0.9219620958751393,72652202,1115,532
1,349,0.30060120240480964,0.7494331065759637,69219045,499,150
0,678,0.05702364394993046,0.03741496598639456,72900401,719,41
0,1742,0.19314497452524318,0.32994350282485874,65852052,2159,417
1,1115,0.2717178314826911,0.6443181818181818,64974672,1531,416
1,866,0.3032984714400644,0.7277386290839206,80121216,1243,377
0,881,0.1601525262154433,0.3008910212474297,68542894,1049,168
1,36,0.23404255319148937,0.632183908045977,70466186,47,11
0,234,0.145985401459854,0.19850187265917604,70713776,274,40
1,981,0.32946001367054,0.7473385379701917,68191025,1463,482
0,601,0.20502645502645503,0.4230769230769231,68541424,756,155
0,4297,0.14180147793089676,0.25892255892255894,77885661,5007,710
1,558,0.2184873949579832,0.6081208687440982,60232501,714,156
0,1597,0.18810371123538383,0.37839771101573677,69597836,1967,370
1,168,0.29707112970711297,0.6128048780487805,80162107,239,71
1,21,0.38235294117647056,0.8035714285714286,65286865,34,13
0,14,0.2222222222222222,0.34210526315789475,65293004,18,4
0,177,0.16901408450704225,0.23856858846918488,70525385,213,36
1,84,0.4782608695652174,0.945054945054945,79790144,161,77
0,2174,0.18055032039200905,0.32956152758132956,80180138,2653,479
0,331,0.04335260115606936,0.10166919575113809,63780801,346,15
0,1507,0.22399588053553038,0.46454662655779977,69397475,1942,435
1,9,0.4375,0.8928571428571429,70250306,16,7
2,9,0.55,0.9375,65288496,20,11
0,491,0.21939586645468998,0.4248587570621469,69625493,629,138
0,333,0.14175257731958762,0.19204152249134948,68171432,388,55
0,983,0.12622222222222224,0.19337887545980031,80116694,1125,142
0,155,0.1340782122905028,0.26170212765957446,80131453,179,24
0,2037,0.14086883171657527,0.1839557399723375,70207333,2371,334
1,215,0.3713450292397661,0.8165289256198347,68211815,342,127
1,718,0.2304394426580922,0.54207263064659,68541165,933,215
0,3273,0.2379511059371362,0.49098693105002256,67703265,4295,1022
1,722,0.25413223140495866,0.558960692871419,68237974,968,246
1,946,0.2296416938110749,0.5468354430379747,68540724,1228,282
1,1574,0.25929411764705884,0.5467594606350588,69586132,2125,551
0,234,0.16725978647686832,0.29550827423167847,68530700,281,47
1,1431,0.2732351447435246,0.5898845519516218,70207494,1969,538
1,3011,0.30829313117390306,0.7157998521074685,70627095,4353,1342
0,737,0.13801169590643275,0.2991596638655462,69383524,855,118
0,1156,0.0744595676541233,0.07025920873124147,69873671,1249,93
1,229,0.3438395415472779,0.8055555555555556,65813055,349,120
0,2369,0.05504587155963303,0.08803301237964237,792442,2507,138
0,554,0.1192368839427663,0.35876042908224076,63226905,629,75
1,1366,0.20070216500877705,0.5322033898305085,63780304,1709,343
0,1079,0.2292857142857143,0.4707750952986023,63100464,1400,321
0,1257,0.05772113943028486,0.02160168598524763,68539835,1334,77
0,1305,0.1984029484029484,0.3803462321792261,63264502,1628,323
0,1060,0.2077727952167414,0.41151832460732984,63278845,1338,278
0,1248,0.21608040201005024,0.4779693486590038,66931746,1592,344
1,114,0.2919254658385093,0.6666666666666666,66461892,161,47
1,763,0.3069936421435059,0.7368024132730016,69183723,1101,338
1,198,0.35294117647058826,0.8347639484978541,81967287,306,108
1,122,0.32967032967032966,0.8,82124920,182,60
1,320,0.36,0.8484848484848485,82126727,500,180
2,193,0.7826576576576577,0.9905362776025236,80061163,888,695
1,957,0.33217027215631545,0.6906278434940856,69981695,1433,476
0,921,0.2810304449648712,0.4723618090452261,70112406,1281,360
1,300,0.46619217081850534,0.9036544850498339,80124818,562,262
0,924,0.11068334937439846,0.0955137481910275,82001893,1039,115
1,199,0.18775510204081633,0.540268456375839,73637585,245,46
2,145,0.5382165605095541,0.7402597402597403,68620685,314,169
0,906,0.20105820105820105,0.3592630501535312,67266276,1134,228
2,3,0.7857142857142857,0.9,64299620,14,11
1,142,0.4600760456273764,0.9151943462897526,70701141,263,121
1,1402,0.29547738693467335,0.6863468634686347,68192474,1990,588
2,2,0.8,0.6666666666666666,65971143,10,8
1,2425,0.4322172793256849,0.7936814958091554,68258253,4271,1846
1,253,0.4559139784946237,0.9208791208791208,82007136,465,212
0,2971,0.21671500131821778,0.4675196850393701,78034642,3793,822
1,368,0.4381679389312977,0.9633251833740831,67558022,655,287
0,3679,0.04515961588372697,0.05415055043141922,70001610,3853,174
1,157,0.3022222222222222,0.5427631578947368,67836531,225,68
1,966,0.30151843817787416,0.675419401896426,80110954,1383,417
1,172,0.2742616033755274,0.6783369803063457,82018246,237,65
1,6698,0.3105506948018528,0.6656113969133359,63489160,9715,3017
2,120,0.6091205211726385,0.6611570247933884,70855491,307,187
1,617,0.4730999146029035,0.8734177215189873,68585510,1171,554
1,605,0.30698739977090495,0.7190669371196755,80108210,873,268
1,240,0.32011331444759206,0.6754032258064516,67994101,353,113
1,306,0.3274725274725275,0.7968526466380543,67305623,455,149
0,992,0.07202993451824134,0.07352941176470588,65832592,1069,77
0,598,0.19298245614035087,0.3827751196172249,66180072,741,143
1,624,0.34659685863874345,0.855779427359491,80121195,955,331
0,3632,0.09987608426270136,0.07101449275362319,82007089,4035,403
2,41,0.7337662337662337,0.95,66560620,154,113
2,204,0.5612903225806452,0.8852459016393442,67326161,465,261
1,751,0.47149894440534834,0.9313640312771503,62778590,1421,670
2,731,0.7041683528935654,0.943127962085308,66061380,2471,1740
1,4555,0.24171799567171634,0.5162213740458015,64421840,6007,1452
0,4302,0.20333333333333334,0.3947724200090131,68602464,5400,1098
1,118,0.1917808219178082,0.6373937677053825,63525434,146,28
2,4,0.9354838709677419,0.6666666666666666,61639403,62,58
1,134,0.33663366336633666,0.6213991769547325,66272360,202,68
2,1,0.5,0.8,73800755,2,1
0,488,0.2039151712887439,0.4578313253012048,80096226,613,125
1,1857,0.3044943820224719,0.7043630017452007,80109043,2670,813
0,310,0.13165266106442577,0.2124248496993988,80176757,357,47
1,124,0.25301204819277107,0.5803921568627451,80176786,166,42
2,1352,0.5427798444369293,0.9426605504587156,70009373,2957,1605
1,57,0.49107142857142855,0.7647058823529411,78980286,112,55
2,1178,0.710209102091021,0.9657631954350927,68574541,4065,2887
2,67,0.5073529411764706,0.9836956521739131,81971166,136,69
0,798,0.1756198347107438,0.459412780656304,70649103,968,170
1,53,0.3764705882352941,0.896551724137931,73000963,85,32
0,170,0.06077348066298342,0.12232415902140673,82003743,181,11
2,85,0.5224719101123596,0.975,69982955,178,93
0,1516,0.173391494002181,0.31387414708112205,62687275,1834,318
0,1292,0.22495500899820037,0.472007722007722,67556426,1667,375
1,98,0.4166666666666667,0.79,80174912,168,70
2,130,0.5622895622895623,0.9573770491803278,69589051,297,167
0,222,0.17777777777777778,0.2982791586998088,70207753,270,48
2,20,0.884393063583815,0.9795918367346939,80118603,173,153
2,63,0.5882352941176471,0.978021978021978,69475420,153,90
2,893,0.5063571033720288,0.9132134480062549,68579672,1809,916
1,4097,0.320789124668435,0.6670045615813482,70476553,6032,1935
1,301,0.47007042253521125,0.8654545454545455,80090045,568,267
1,1483,0.35070052539404556,0.7778925619834711,80118620,2284,801
0,422,0.1440162271805274,0.1824561403508772,80118621,493,71
1,234,0.3333333333333333,0.7282608695652174,80137646,351,117
0,644,0.15374507227332457,0.31833333333333336,69601994,761,117
0,637,0.11281337047353761,0.18687872763419483,70192654,718,81
1,5954,0.3127885503231764,0.6921576277799454,67271673,8664,2710
0,4443,0.2136283185840708,0.4125833574949261,68669006,5650,1207
1,315,0.4155844155844156,0.837248322147651,80124627,539,224
0,1739,0.12260343087790111,0.153960029607698,73700641,1982,243
1,1708,0.24923076923076923,0.5365053322395406,68602422,2275,567
1,3527,0.3989434219495569,0.8406153846153847,70687883,5868,2341
2,71,0.6502463054187192,0.7230769230769231,70855435,203,132
1,41,0.4383561643835616,0.8873239436619719,80089975,73,32
1,839,0.3122950819672131,0.7647790914747977,68531953,1220,381
2,27,0.7065217391304348,0.9571428571428572,72364740,92,65
1,306,0.34051724137931033,0.765704584040747,69165635,464,158
0,657,0.20652173913043478,0.4233983286908078,68540542,828,171
1,149,0.2436548223350254,0.5324232081911263,67940614,197,48
1,1089,0.30415335463258786,0.6447746883988494,72958060,1565,476
1,794,0.2343297974927676,0.5343461030383091,68537175,1037,243
0,2743,0.1965436438195665,0.4075616789490548,74142341,3414,671
1,584,0.2356020942408377,0.5515911282545806,70690781,764,180
1,311,0.32537960954446854,0.7458745874587459,67552933,461,150
1,499,0.27994227994227994,0.5168141592920354,63671216,693,194
0,1112,0.20229555236728838,0.3964968152866242,68151244,1394,282
1,800,0.3254637436762226,0.7859308671922377,70907676,1186,386
0,284,0.1791907514450867,0.36662606577344703,80116645,346,62
1,1027,0.3309446254071661,0.656855151045701,79255435,1535,508
1,85,0.2608695652173913,0.6355555555555555,68179132,115,30
0,271,0.14240506329113925,0.18051575931232092,69138643,316,45
1,647,0.4446351931330472,0.9294566253574833,69967282,1165,518
0,301,0.16620498614958448,0.2803030303030303,67555635,361,60
0,888,0.22377622377622378,0.45419103313840153,68481980,1144,256
1,693,0.25483870967741934,0.5906902086677368,63264264,930,237
0,407,0.13034188034188035,0.14195183776932827,68544042,468,61
0,275,0.13793103448275862,0.44466800804828976,63771253,319,44
1,103,0.46632124352331605,0.9477611940298507,70341572,193,90
1,1227,0.3036322360953462,0.728538283062645,70614551,1762,535
1,370,0.4668587896253602,0.9371345029239766,70670145,694,324
0,5,0.2857142857142857,0.4090909090909091,80150328,7,2
1,696,0.29124236252545826,0.6347962382445141,65884483,982,286
0,1010,0.19968304278922344,0.32727272727272727,65360561,1262,252
0,460,0.1958041958041958,0.3180428134556575,65360575,572,112
1,200,0.25925925925925924,0.5743073047858942,65941666,270,70
0,377,0.22268041237113403,0.4223512336719884,70645064,485,108
0,844,0.17818889970788704,0.3635782747603834,80098914,1027,183
0,880,0.14313534566699124,0.2168458781362007,80121160,1027,147
1,1551,0.40778923253150057,0.8553540587219344,80135718,2619,1068
1,902,0.2942097026604069,0.6858085808580858,68545666,1278,376
1,729,0.3199626865671642,0.6772315653298836,72958053,1072,343
1,993,0.4351535836177474,0.8978605935127675,73026625,1758,765
1,3216,0.42406876790830944,0.9177414732014904,69154113,5584,2368
0,243,0.24299065420560748,0.47334754797441364,74708795,321,78
1,2507,0.33921982076963625,0.7853817504655494,81965591,3794,1287
1,471,0.3124087591240876,0.6371463714637147,67994493,685,214
0,832,0.17296222664015903,0.33119795003203073,66931410,1006,174
0,169,0.06111111111111111,0.014204545454545454,70207473,180,11
0,2533,0.1539746158984636,0.32010161956176564,82043084,2994,461
0,1727,0.17130518234165068,0.3032581453634085,70532763,2084,357
0,1202,0.18783783783783783,0.3704478861448305,80056886,1480,278
0,2199,0.17732884399551066,0.3342830009496676,66817240,2673,474
0,1454,0.21192411924119242,0.4345342706502636,66833102,1845,391
0,729,0.1552723059096176,0.26777983920841064,81979698,863,134
0,2522,0.06210487169951655,0.06119704102219233,63336770,2689,167
0,1476,0.07460815047021943,0.07242990654205607,63336812,1595,119
0,1107,0.018617021276595744,0.015873015873015872,63336861,1128,21
1,320,0.27765237020316025,0.6423841059602649,67556615,443,123
2,0,1.0,1.0,80132349,46,46
1,440,0.21847246891651864,0.5226190476190476,68534361,563,123
0,402,0.20396039603960395,0.46675031367628605,68537553,505,103
0,960,0.22141119221411193,0.48702830188679247,63264355,1233,273
1,427,0.3683431952662722,0.8012684989429175,67203710,676,249
1,316,0.47333333333333333,0.8301435406698564,80180296,600,284
0,355,0.1362530413625304,0.21739130434782608,81979731,411,56
1,1373,0.27850761954808195,0.650049850448654,67557301,1903,530
1,492,0.3360323886639676,0.7948139797068771,69154036,741,249
0,2252,0.21396160558464222,0.40141342756183745,68151356,2865,613
0,749,0.12906976744186047,0.16,70564025,860,111
1,536,0.23863636363636365,0.5236396074933095,68534942,704,168
1,696,0.2603613177470776,0.559,70653765,941,245
0,1396,0.11308767471410419,0.27153652392947103,60087440,1574,178
1,233,0.36684782608695654,0.8764044943820225,62497813,368,135
1,495,0.46254071661237783,0.9393939393939394,65185911,921,426
0,1868,0.214135464871687,0.4539212143115287,70643272,2377,509
1,3114,0.2676387582314205,0.5952901189609129,80119338,4252,1138
0,2496,0.15188583078491336,0.20341767992113047,70207480,2943,447
0,1034,0.10785159620362382,0.08642726719415703,73818423,1159,125
0,1066,0.1942554799697657,0.3180147058823529,68535670,1323,257
2,1374,0.589483119211234,0.9781301257517769,70584591,3347,1973
0,244,0.2077922077922078,0.3819241982507289,75551154,308,64
1,139,0.305,0.5276381909547738,80125901,200,61
0,23,0.08,0.027777777777777776,80172975,25,2
1,624,0.40229885057471265,0.8943577430972389,69152482,1044,420
1,705,0.3694096601073345,0.8755555555555555,66410225,1118,413
1,518,0.4375678610206297,0.9081515499425947,69107682,921,403
0,898,0.15917602996254682,0.31180968564146133,70641802,1068,170
1,1089,0.28870019595035923,0.6291390728476821,69586272,1531,442
0,1023,0.21247113163972287,0.4539551357733176,66930864,1299,276
1,1180,0.30177514792899407,0.671919770773639,69692973,1690,510
1,1034,0.34390862944162437,0.8156512605042017,68531960,1576,542
0,111,0.075,0.06188118811881188,69416830,120,9
0,1122,0.1295577967416602,0.13674698795180723,67555082,1289,167
1,2259,0.34120734908136485,0.7874175545408422,81965590,3429,1170
0,2167,0.11731160896130347,0.12040682414698163,69240241,2455,288
0,540,0.19881305637982197,0.4037735849056604,68530560,674,134
0,954,0.14285714285714285,0.16322580645161291,68530581,1113,159
1,261,0.239067055393586,0.5122873345935728,68642406,343,82
1,158,0.3218884120171674,0.7393767705382436,69585936,233,75
1,89,0.2992125984251969,0.75,69417495,127,38
1,544,0.4629812438302073,0.9307201458523245,68028170,1013,469
1,295,0.45571955719557194,0.8957983193277311,80163482,542,247
1,839,0.25156110615521854,0.6400570206699929,68537826,1121,282
1,770,0.3056807935076646,0.7542932628797886,80121044,1109,339
0,938,0.08932038834951456,0.12288993923024984,67285771,1030,92
0,452,0.06418219461697723,0.21680216802168023,60286975,483,31
1,564,0.4019088016967126,0.8941704035874439,67994150,943,379
1,1315,0.28337874659400547,0.6595365418894831,73818486,1835,520
2,45,0.5212765957446809,0.9247311827956989,80054471,94,49
0,1452,0.14788732394366197,0.25590872045639773,72522870,1704,252
2,104,0.6090225563909775,0.9444444444444444,80137026,266,162
0,3035,0.20068475111930473,0.3601340033500838,82000011,3797,762
1,179,0.18636363636363637,0.5968586387434555,63752374,220,41
1,621,0.4732824427480916,0.8954501452081317,70202524,1179,558
2,100,0.5305164319248826,0.917098445595855,80160401,213,113
1,2192,0.2910737386804657,0.7281618887015177,68158314,3092,900
1,1044,0.32427184466019415,0.7137096774193549,68948110,1545,501
0,39,0.20408163265306123,0.265625,70646352,49,10
0,35,0.16666666666666666,0.2328767123287671,70646534,42,7
1,1289,0.23997641509433962,0.5608919382504288,70829486,1696,407
0,1999,0.20737509912767646,0.4465386009423704,81965672,2522,523
0,1228,0.1536871123363198,0.2782485875706215,68534711,1451,223
0,1017,0.23476297968397292,0.4961067853170189,65342466,1329,312
0,445,0.1981981981981982,0.44691607684529827,77676690,555,110
1,744,0.24543610547667344,0.6048034934497817,80109456,986,242
1,1000,0.2967651195499297,0.6271899088997898,80111115,1422,422
1,1512,0.37598018984729675,0.8632075471698113,80111136,2423,911
0,1175,0.11320754716981132,0.15482573726541554,70642404,1325,150
1,173,0.3993055555555556,0.8637413394919169,82119384,288,115
0,706,0.20495495495495494,0.4326996197718631,68537833,888,182
0,839,0.21368322399250234,0.49224544841537426,68633593,1067,228
1,1271,0.2883538633818589,0.6974006866110839,75892810,1786,515
0,2520,0.2,0.438722669735328,64929270,3150,630
1,1048,0.2598870056497175,0.6243455497382199,68540556,1416,368
0,1015,0.1950832672482157,0.29855643044619423,70645862,1261,246
1,647,0.2537485582468281,0.6248275862068966,80098396,867,220
0,1497,0.07478368355995056,0.07601713062098502,70641130,1618,121
0,507,0.15920398009950248,0.2618343195266272,70653695,603,96
0,1189,0.22742040285899934,0.42962417096536476,69155856,1539,350
1,85,0.31451612903225806,0.7771739130434783,70064141,124,39
0,926,0.14732965009208104,0.21114058355437665,81988933,1086,160
0,705,0.18023255813953487,0.33102143757881464,81988944,860,155
1,1227,0.3726993865030675,0.86281179138322,69586475,1956,729
1,1450,0.240041928721174,0.5078937235271467,67554172,1908,458
0,1219,0.16791808873720138,0.31371718882303135,70841393,1465,246
1,1379,0.2992886178861789,0.6860086767895879,80110870,1968,589
1,2082,0.3448709880427942,0.796875,80111010,3178,1096
0,63,0.14864864864864866,0.34309623430962344,73760253,74,11
1,306,0.2714285714285714,0.5910112359550562,80181375,420,114
1,212,0.3855072463768116,0.8966292134831461,67552940,345,133
1,192,0.3904761904761905,0.8992805755395683,66470796,315,123
1,511,0.24631268436578171,0.550251256281407,70179424,678,167
1,2860,0.31839847473784555,0.7646378153205277,80120438,4196,1336
0,417,0.11652542372881355,0.12027972027972028,68537000,472,55
1,2163,0.27196230225513296,0.5688429217840982,69160686,2971,808
1,366,0.3068181818181818,0.7301231802911534,64214283,528,162
1,530,0.42702702702702705,0.8977485928705441,62005111,925,395
1,108,0.4489795918367347,0.95260663507109,64164632,196,88
1,725,0.28217821782178215,0.686092715231788,69089685,1010,285
1,234,0.4507042253521127,0.9309623430962343,66411926,426,192
0,2056,0.192458758837392,0.34739015039811266,70583520,2546,490
0,1367,0.06943498978897208,0.16509730069052103,792484,1469,102
0,2211,0.08371322005801907,0.1708235294117647,60028234,2413,202
0,1317,0.07578947368421053,0.18337730870712401,60028304,1425,108
1,1178,0.24968152866242038,0.5656401944894651,68543755,1570,392
1,40,0.4520547945205479,0.9263157894736842,66493266,73,33
1,802,0.3404605263157895,0.7803571428571429,80108273,1216,414
1,384,0.3673805601317957,0.8173076923076923,80110065,607,223
1,143,0.35294117647058826,0.8513513513513513,66493154,221,78
1,118,0.2891566265060241,0.7226890756302521,68538806,166,48
0,379,0.10823529411764705,0.12106918238993711,80125341,425,46
0,3959,0.1178698752228164,0.22412336290663287,69638604,4488,529
1,396,0.22807017543859648,0.5311004784688995,69621426,513,117
1,576,0.23302263648468707,0.503690036900369,67159351,751,175
1,505,0.33201058201058203,0.8421559191530318,70072142,756,251
1,696,0.4666666666666667,0.9256535947712419,69602911,1305,609
0,1439,0.22174148188209844,0.4786206896551724,82096027,1849,410
0,16,0.15789473684210525,0.34,69416312,19,3
0,802,0.16804979253112035,0.3396880415944541,68173595,964,162
0,1018,0.13728813559322034,0.20029027576197386,68173910,1180,162
1,3540,0.2609603340292276,0.5679886685552408,69608966,4790,1250
1,1557,0.26313298627543774,0.5856741573033708,70179403,2113,556
0,274,0.014388489208633094,0.025490196078431372,63337050,278,4
0,797,0.19494949494949496,0.41089108910891087,68536685,990,193
1,358,0.2796780684104628,0.6934404283801874,67160583,497,139
0,4,0.0,0.0,82040807,4,0
0,365,0.15898617511520738,0.30634920634920637,68537756,434,69
1,2584,0.2757847533632287,0.5942467827403483,65312331,3568,984
0,886,0.21384205856255545,0.37824897400820795,70613676,1127,241
0,92,0.041666666666666664,0.09415584415584416,60028451,96,4
1,1101,0.2915057915057915,0.6236490781945327,69318172,1554,453
0,486,0.21739130434782608,0.4490238611713666,70871031,621,135
1,786,0.27019498607242337,0.6282051282051282,80121276,1077,291
1,781,0.43528561099060015,0.8987854251012146,70659134,1383,602
0,218,0.22968197879858657,0.4396135265700483,80180131,283,65
0,1598,0.2212475633528265,0.3897058823529412,69586314,2052,454
0,579,0.17285714285714285,0.28633975481611207,66930934,700,121
0,711,0.0907928388746803,0.08370044052863436,68539415,782,71
0,1664,0.20724154359218674,0.38424908424908427,70197491,2099,435
1,106,0.43315508021390375,0.9424778761061947,66493133,187,81
0,832,0.25314183123877915,0.49649532710280375,69166601,1114,282
1,991,0.3030942334739803,0.6642027455121436,80143960,1422,431
1,2292,0.28930232558139535,0.7060859532737237,66765230,3225,933
0,1073,0.2144948755490483,0.42960489705064,80111801,1366,293
1,547,0.2527322404371585,0.5259259259259259,65308670,732,185
0,486,0.1413427561837456,0.43123543123543123,60029263,566,80
0,1422,0.1474820143884892,0.17239370995923123,70641081,1668,246
0,1138,0.05403158769742311,0.023826714801444042,70641270,1203,65
1,378,0.3772652388797364,0.8062111801242235,70628775,607,229
0,790,0.16224814422057265,0.2944055944055944,70614712,943,153
1,1536,0.3059195661997289,0.6352583586626139,70644623,2213,677
1,986,0.2479023646071701,0.5162023877202956,73818101,1311,325
1,1026,0.3774271844660194,0.8831395348837209,67556125,1648,622
1,317,0.3298097251585624,0.7032136105860114,74978694,473,156
0,625,0.1893644617380026,0.3625531914893617,68534235,771,146
0,163,0.11891891891891893,0.20786516853932585,60514020,185,22
1,117,0.415,0.9264214046822743,62277285,200,83
1,383,0.35845896147403683,0.7881679389312977,80130624,597,214
0,36,0.16279069767441862,0.1038961038961039,69606712,43,7
1,93,0.2846153846153846,0.714975845410628,67555425,130,37
1,1367,0.4140591513073296,0.914572864321608,65278304,2333,966
0,1767,0.0458963282937365,0.07132931912922649,67837896,1852,85
0,785,0.03916768665850673,0.04839968774395004,70001015,817,32
0,3536,0.03361574200601257,0.02454354983537863,70001575,3659,123
0,2825,0.0351775956284153,0.034482758620689655,70001743,2928,103
1,174,0.31225296442687744,0.743142144638404,69091743,253,79
1,561,0.4228395061728395,0.8764367816091954,62511540,972,411
0,2411,0.12327272727272727,0.1268882175226586,70207242,2750,339
0,248,0.04247104247104247,0.08349514563106795,68743556,259,11
0,580,0.15204678362573099,0.18444995864350702,69540114,684,104
1,1260,0.2832764505119454,0.5936046511627907,70676382,1758,498
1,31,0.39215686274509803,0.8524590163934426,68400990,51,20
2,325,0.5213549337260678,0.9688385269121813,73321255,679,354
2,141,0.5171232876712328,0.9568965517241379,70414085,292,151
0,930,0.18563922942206654,0.36043036461446504,68536622,1142,212
1,314,0.3098901098901099,0.7703703703703704,81980458,455,141
1,1615,0.325678496868476,0.7542517006802721,69668760,2395,780
0,1668,0.0919978225367447,0.10115033716779057,80114363,1837,169
1,1538,0.2693586698337292,0.5923460898502496,63141526,2105,567
0,186,0.07,0.26640926640926643,70001701,200,14
1,702,0.24839400428265523,0.624439461883408,68953934,934,232
0,655,0.24452133794694347,0.49347659247889486,69586146,867,212
1,411,0.2712765957446808,0.6437346437346437,68545302,564,153
1,398,0.2892857142857143,0.6751592356687898,80108553,560,162
0,3774,0.19047619047619047,0.3552722260509993,66405150,4662,888
1,592,0.30760233918128654,0.7392857142857143,80111913,855,263
1,1064,0.21879588839941264,0.5104826913700634,80181501,1362,298
0,548,0.19293078055964655,0.3132760267430755,68535691,679,131
0,1197,0.20465116279069767,0.4348308374930671,68533983,1505,308
1,785,0.3167972149695387,0.7403314917127072,68542502,1149,364
0,381,0.1360544217687075,0.20752269779507135,69490813,441,60
1,39,0.4264705882352941,0.9578947368421052,66034892,68,29
1,159,0.3764705882352941,0.8925,69091701,255,96
0,68,0.09333333333333334,0.07428571428571429,62766130,75,7
0,458,0.22765598650927488,0.47215189873417723,80109855,593,135
1,893,0.3457875457875458,0.8328912466843501,80111934,1365,472
1,647,0.35493519441674976,0.831081081081081,68541914,1003,356
1,1005,0.28060128847530424,0.6135298057602143,80110751,1397,392
1,1162,0.2836004932182491,0.6198142414860681,80110835,1622,460
1,1641,0.4829867674858223,0.9669911129919594,68531036,3174,1533
0,1294,0.2251497005988024,0.49314462627156125,73816211,1670,376
0,156,0.1746031746031746,0.37587006960556846,80098620,189,33
0,458,0.12761904761904763,0.2208029197080292,80098942,525,67
1,751,0.29681647940074907,0.7014285714285714,68542593,1068,317
1,104,0.2777777777777778,0.7072243346007605,68642413,144,40
0,348,0.08900523560209424,0.15514018691588785,68017565,382,34
1,169,0.3130081300813008,0.7347417840375586,69833512,246,77
1,1223,0.4335340435386753,0.9208666980687706,70491974,2159,936
2,618,0.5896414342629482,0.968724279835391,65114035,1506,888
1,197,0.25660377358490566,0.581081081081081,80120469,265,68
0,827,0.1612576064908722,0.2969465648854962,82009770,986,159
0,1030,0.11130284728213978,0.14245014245014245,82009772,1159,129
1,1029,0.33698453608247425,0.7902467685076381,82008930,1552,523
1,681,0.34832535885167465,0.7833203429462198,82008931,1045,364
0,852,0.1908831908831909,0.4308405029781602,82062980,1053,201
0,862,0.16066212268743915,0.3864087301587302,80180486,1027,165
1,492,0.23483670295489892,0.5301556420233463,66931844,643,151
0,168,0.12041884816753927,0.12368972746331237,77676564,191,23
0,3769,0.1463193657984145,0.18236472945891782,82107798,4415,646
1,621,0.29671574178935445,0.7202295552367288,68763555,883,262
0,2401,0.11630474788369526,0.13512605042016806,80119354,2717,316
0,927,0.16184448462929477,0.2669172932330827,80119365,1106,179
1,360,0.4375,0.8991596638655462,75236560,640,280
1,1200,0.25742574257425743,0.6231569817866436,70626766,1616,416
0,349,0.1318407960199005,0.21461897356143078,68536944,402,53
1,1570,0.25380228136882127,0.5088105726872246,67555236,2104,534
1,1521,0.2659266409266409,0.5751738897806313,67555243,2072,551
0,73,0.09876543209876543,0.29949238578680204,69417411,81,8
1,428,0.21755027422303475,0.5319148936170213,60249413,547,119
0,258,0.07857142857142857,0.162291169451074,60833542,280,22
1,403,0.22796934865900384,0.5773026315789473,65779133,522,119
1,869,0.43498049414824447,0.927536231884058,68531582,1538,669
0,858,0.16374269005847952,0.2942542077771329,67554634,1026,168
1,255,0.2857142857142857,0.7513043478260869,69421485,357,102
0,991,0.05076628352490421,0.0892018779342723,60028815,1044,53
0,778,0.0671462829736211,0.16776859504132233,61704195,834,56
0,1357,0.056328233657858134,0.06462821403752605,63769391,1438,81
0,1512,0.07804878048780488,0.14458560193587416,66345776,1640,128
1,787,0.2948028673835125,0.6779348494161033,80120429,1116,329
1,1066,0.3813116656993616,0.896551724137931,80111416,1723,657
1,296,0.355119825708061,0.6938369781312127,80180238,459,163
1,605,0.3631578947368421,0.7835400225479143,64193262,950,345
0,818,0.1398527865404837,0.3188720173535792,67836993,951,133
0,409,0.2164750957854406,0.42759795570698467,69537020,522,113
0,338,0.18357487922705315,0.32441113490364026,19915126,414,76
1,281,0.3245192307692308,0.7485928705440901,81967325,416,135
0,434,0.1701720841300191,0.2804532577903683,68545512,523,89
0,866,0.20695970695970695,0.4041720990873533,67721906,1092,226
1,238,0.3101449275362319,0.7528830313014827,69100906,345,107
1,271,0.2849604221635884,0.5864661654135338,62744521,379,108
0,815,0.17510121457489877,0.35517970401691334,66817275,988,173
0,725,0.14705882352941177,0.2566063977746871,68538071,850,125
1,1656,0.2,0.5132837407013815,60028143,2070,414
0,2074,0.13258051024675868,0.24239298607529655,70841470,2391,317
1,609,0.34375,0.7957288765088208,80121240,928,319
1,939,0.24090541632983023,0.5213325540619521,72387434,1237,298
0,417,0.15415821501014199,0.22364672364672364,80127896,493,76
2,1326,0.5353889278206027,0.9579358196010408,64304065,2854,1528
1,765,0.2923219241443108,0.6338928856914469,69574652,1081,316
1,1027,0.22196969696969698,0.5104697226938314,66930913,1320,293
1,42,0.3114754098360656,0.5769230769230769,69334622,61,19
1,50,0.2753623188405797,0.5483870967741935,66993444,69,19
1,2440,0.3439096531325625,0.7778366914103924,70660345,3719,1279
0,351,0.2563559322033898,0.48346456692913387,81967303,472,121
1,1178,0.3355893965031021,0.7914669223394055,67597985,1773,595
0,4374,0.16764985727878212,0.30892494929006087,73266333,5255,881
1,993,0.4110320284697509,0.9012547735951991,80159811,1686,693
1,648,0.3142857142857143,0.6812080536912751,54551840,945,297
1,253,0.27507163323782235,0.6811023622047244,69091680,349,96
1,201,0.4401114206128134,0.9579207920792079,67554256,359,158
0,713,0.20953436807095344,0.39541892706449666,71389185,902,189
1,199,0.2737226277372263,0.6463414634146342,74708704,274,75
0,564,0.12422360248447205,0.11038107752956636,67630710,644,80
0,143,0.13855421686746988,0.22,67291490,166,23
0,907,0.1320574162679426,0.2058613295210865,68536986,1045,138
0,402,0.22243713733075435,0.3391167192429022,69489364,517,115
1,771,0.28345724907063197,0.5618515562649641,69489476,1076,305
1,177,0.3811188811188811,0.8961625282167043,70641914,286,109
1,511,0.3,0.7095032397408207,80125367,730,219
1,1499,0.2644749754661433,0.6015511391177897,67940551,2038,539
0,896,0.24769101595298068,0.4011142061281337,68995500,1191,295
0,404,0.1670103092783505,0.26875,68544056,485,81
1,907,0.35490753911806544,0.8102739726027397,80107790,1406,499
1,838,0.37555886736214605,0.8264729620661824,67667992,1342,504
0,2006,0.2179337231968811,0.47492537313432837,68534865,2565,559
1,4063,0.3192024128686327,0.7664444043971886,70643454,5968,1905
1,487,0.3716129032258065,0.8867052023121387,80111941,775,288
0,1031,0.18368962787015045,0.3305578684429642,68563551,1263,232
1,455,0.3698060941828255,0.7954545454545454,73323152,722,267
1,262,0.41517857142857145,0.8941176470588236,67148956,448,186
0,181,0.095,0.0514018691588785,67766860,200,19
0,512,0.23123123123123124,0.49154135338345867,80119318,666,154
0,527,0.11872909698996656,0.17247879359095195,54609835,598,71
1,44,0.45,0.898876404494382,69691384,80,36
1,40,0.3548387096774194,0.7192982456140351,72512671,62,22
0,2402,0.193689157435381,0.2901573362605196,70641102,2979,577
1,188,0.31386861313868614,0.7825,69421786,274,86
1,1470,0.2446043165467626,0.5228346456692914,67554242,1946,476
1,571,0.30450669914738127,0.6901098901098901,80120426,821,250
0,443,0.08847736625514403,0.06758620689655172,66471335,486,43
0,1145,0.20761245674740483,0.40614498319731157,80180141,1445,300
0,707,0.18548387096774194,0.47271487039563437,70121170,868,161
1,2080,0.31216931216931215,0.718093446221386,70516635,3024,944
1,1561,0.3021904336164506,0.7203533809038396,73298890,2237,676
1,36,0.42857142857142855,0.9425287356321839,65018646,63,27
1,1541,0.28191985088536814,0.6780650542118432,60502456,2146,605
1,488,0.36041939711664484,0.8324924318869829,61888946,763,275
1,194,0.3240418118466899,0.7587822014051522,69176912,287,93
0,1577,0.12583148558758314,0.228135593220339,70841386,1804,227
1,569,0.46872082166199813,0.9092422980849292,70486570,1071,502
0,5448,0.11644502108336037,0.13344562979599475,79678746,6166,718
2,83,0.5117647058823529,0.9503105590062112,66412122,170,87
1,998,0.49570490146538654,0.9440089585666294,62510364,1979,981
1,51,0.33766233766233766,0.6615384615384615,80177445,77,26
1,897,0.24558452481076534,0.5420641803989592,65299661,1189,292
1,2863,0.24538745387453875,0.5457175925925926,67876564,3794,931
1,336,0.40106951871657753,0.919558359621451,70632016,561,225
0,591,0.21825396825396826,0.40080563947633435,67556741,756,165
0,547,0.19558823529411765,0.38469284994964753,68530742,680,133
0,413,0.21183206106870228,0.4259485924112607,66931634,524,111
0,524,0.14238952536824878,0.20607175712971482,67554571,611,87
0,276,0.21142857142857144,0.3506172839506173,70653800,350,74
0,1201,0.23356732610082961,0.44084278768233387,69630204,1567,366
1,217,0.41509433962264153,0.7606060606060606,72433480,371,154
1,406,0.27629233511586454,0.7009132420091324,69031270,561,155
1,246,0.3955773955773956,0.9240246406570842,70642026,407,161
0,5914,0.14574606384515384,0.19990658570761327,65291982,6923,1009
0,802,0.20907297830374755,0.46115537848605576,68543202,1014,212
0,888,0.16776007497656983,0.26254434870755194,66423196,1067,179
1,615,0.33585313174946,0.7896405919661733,81967249,926,311
1,269,0.4336842105263158,0.9067357512953368,67588346,475,206
0,1180,0.1348973607038123,0.2106839740389416,68535313,1364,184
0,1998,0.12827225130890052,0.1168289290681502,82179482,2292,294
1,764,0.3160250671441361,0.7737520128824477,80112326,1117,353
1,1062,0.36330935251798563,0.8254861821903787,74091423,1668,606
1,1052,0.2848402447314752,0.6611047180667434,80135189,1471,419
2,2238,0.5203600514359195,0.9684669573968467,66633812,4666,2428
0,1159,0.06757843925985518,0.14040114613180515,60509603,1243,84
0,723,0.04491413474240423,0.07593582887700535,60542272,757,34
2,230,0.5296523517382413,0.9575757575757575,74982271,489,259
2,36,0.6326530612244898,0.967032967032967,80125555,98,62
1,231,0.3185840707964602,0.751219512195122,65353904,339,108
1,160,0.34959349593495936,0.7982456140350878,68532821,246,86
1,1025,0.2588575560375994,0.5827505827505828,82129388,1383,358
1,368,0.3720136518771331,0.8875,70206941,586,218
0,140,0.23497267759562843,0.47703180212014135,70516026,183,43
1,49,0.449438202247191,0.9047619047619048,70418432,89,40
1,422,0.24777183600713013,0.536318407960199,81979975,561,139
1,658,0.4570957095709571,0.9018087855297158,80096086,1212,554
1,1061,0.3005932762030323,0.595952023988006,81975741,1517,456
0,699,0.16983372921615203,0.3224043715846995,67303964,842,143
0,42,0.23636363636363636,0.42857142857142855,74158630,55,13
1,1219,0.3563885955649419,0.8474801061007957,67049843,1894,675
1,270,0.4386694386694387,0.8717948717948718,69691335,481,211
0,53,0.08620689655172414,0.14444444444444443,69691356,58,5
1,791,0.28802880288028804,0.6236453201970443,76293574,1111,320
1,431,0.4128065395095368,0.9373134328358209,67552520,734,303
0,1280,0.23444976076555024,0.48983050847457626,67555096,1672,392
1,14,0.44,0.6521739130434783,80177412,25,11
2,157,0.5422740524781341,0.9551724137931035,63725886,343,186
1,3228,0.3490623109497883,0.783301617507136,69625262,4959,1731
0,311,0.17066666666666666,0.34986595174262736,68537070,375,64
0,2459,0.22158911047799937,0.4438894438894439,80180142,3159,700
1,43,0.31746031746031744,0.743801652892562,68372304,63,20
1,795,0.35418359057676685,0.8547619047619047,80110660,1231,436
0,1437,0.13485851896447923,0.2242940863079382,70618142,1661,224
0,1019,0.10535557506584724,0.14623243933588762,70642943,1139,120
0,463,0.12310606060606061,0.2304075235109718,70642971,528,65
0,475,0.2288961038961039,0.4811083123425693,81980455,616,141
1,191,0.4212121212121212,0.8872340425531915,63975373,330,139
0,1107,0.02294792586054722,0.003968253968253968,68017544,1133,26
1,378,0.35494880546075086,0.7157894736842105,69108732,586,208
0,1909,0.19991617770326908,0.4626865671641791,61939332,2386,477
0,588,0.14905933429811866,0.18875502008032127,62141772,691,103
0,849,0.10443037974683544,0.11571185479296653,63141323,948,99
0,277,0.12341772151898735,0.12289156626506025,67435865,316,39
0,150,0.03225806451612903,0.05813953488372093,68743521,155,5
0,165,0.046242774566473986,0.07017543859649122,68743535,173,8
0,194,0.05825242718446602,0.1326530612244898,68743542,206,12
0,447,0.20603907637655416,0.36,69607293,563,116
1,825,0.24931756141947226,0.520586182833217,69607804,1099,274
0,166,0.22065727699530516,0.47093023255813954,70761180,213,47
1,468,0.31976744186046513,0.7475409836065574,69183212,688,220
1,383,0.302367941712204,0.6959287531806616,82126719,549,166
0,279,0.23978201634877383,0.45084745762711864,69607853,367,88
0,494,0.15555555555555556,0.2091346153846154,66919181,585,91
0,831,0.1334723670490094,0.1962121212121212,70615265,959,128
0,626,0.22139303482587064,0.4642857142857143,70642642,804,178
0,1817,0.10800196367206677,0.2279527559055118,69575373,2037,220
0,1503,0.09838032393521295,0.2001943634596696,69575464,1667,164
1,519,0.38287752675386444,0.9003831417624522,69645541,841,322
1,30,0.3333333333333333,0.7849462365591398,70045290,45,15
0,1485,0.16385135135135134,0.330119375573921,73816064,1776,291
2,302,0.683105981112277,0.9934782608695653,61501363,953,651
1,807,0.40748898678414097,0.8770743700061463,62878396,1362,555
0,1008,0.16,0.18681318681318682,70644756,1200,192
2,11,0.717948717948718,0.95,80177687,39,28
1,645,0.30570505920344454,0.7047619047619048,70830074,929,284
1,517,0.23407407407407407,0.567699836867863,70120036,675,158
1,714,0.3938879456706282,0.8571428571428571,70657622,1178,464
0,223,0.0860655737704918,0.07180385288966724,80071110,244,21
1,328,0.35812133072407043,0.8526912181303116,65277975,511,183
1,2131,0.341674389867161,0.8071845256370893,66124954,3237,1106
0,300,0.14285714285714285,0.15845824411134904,69155996,350,50
0,1264,0.2202344231955583,0.47652254765225477,80111766,1621,357
0,760,0.13636363636363635,0.17932489451476794,67554662,880,120
1,234,0.26875,0.672209026128266,68533864,320,86
0,423,0.06622516556291391,0.021341463414634148,68533906,453,30
0,377,0.12121212121212122,0.15251572327044025,68534074,429,52
0,639,0.14457831325301204,0.17326732673267325,68544014,747,108
1,2983,0.2607187112763321,0.6037782749192145,80135433,4035,1052
2,1330,0.5344767238361918,0.9490600363856883,80181480,2857,1527
0,1046,0.20213577421815407,0.3889145496535797,81988939,1311,265
0,344,0.12690355329949238,0.18081587651598677,82000147,394,50
1,1829,0.2807707432166732,0.6633148404993066,68536720,2543,714
1,308,0.346072186836518,0.7504621072088724,62988030,471,163
1,456,0.26570048309178745,0.5411764705882353,68168093,621,165
1,2338,0.3808262711864407,0.79245960502693,70720482,3776,1438
1,12,0.45454545454545453,0.9230769230769231,67812654,22,10
1,170,0.4444444444444444,0.8741258741258742,70758415,306,136
2,513,0.5515734265734266,0.9316666666666666,80053813,1144,631
1,196,0.24615384615384617,0.5289473684210526,82047601,260,64
0,197,0.043689320388349516,0.1787878787878788,66876376,206,9
0,668,0.08241758241758242,0.2828863346104725,68811442,728,60
0,107,0.02727272727272727,0.0927536231884058,68811470,110,3
0,171,0.03389830508474576,0.16071428571428573,68811505,177,6
0,422,0.08061002178649238,0.1049618320610687,70606914,459,37
1,1249,0.39013671875,0.9050022946305645,69586363,2048,799
0,152,0.14606741573033707,0.16972477064220184,67160345,178,26
2,231,0.5860215053763441,0.9809069212410502,70059262,558,327
0,20,0.2,0.47126436781609193,79807616,25,5
1,606,0.3594080338266385,0.7813351498637602,82043022,946,340
0,157,0.08187134502923976,0.09226190476190477,67630773,171,14
1,385,0.26806083650190116,0.6042183622828784,69606873,526,141
0,851,0.08396124865446716,0.07435897435897436,70641333,929,78
0,279,0.2206703910614525,0.45708582834331335,70645022,358,79
1,459,0.4888641425389755,0.9409722222222222,67306932,898,439
0,42,0.08695652173913043,0.15853658536585366,67285575,46,4
1,778,0.3053571428571429,0.7244755244755244,68531925,1120,342
1,744,0.3111111111111111,0.7436849925705795,68531946,1080,336
0,413,0.18217821782178217,0.35480572597137017,66931592,505,92
0,1431,0.26915219611848823,0.47111344537815125,69458501,1958,527
0,711,0.18087557603686635,0.2391304347826087,69458690,868,157
1,157,0.3261802575107296,0.7131979695431472,61019686,233,76
1,274,0.30808080808080807,0.6862745098039216,69180230,396,122
1,692,0.36044362292051757,0.8528963414634146,69184444,1082,390
0,1206,0.025848142164781908,0.005149330587023687,70072086,1238,32
0,652,0.057803468208092484,0.0296028880866426,82012551,692,40
1,1180,0.2891566265060241,0.7521186440677966,80128806,1660,480
2,46,0.5053763440860215,0.9368421052631579,69529404,93,47
0,221,0.25084745762711863,0.4906621392190153,70850640,295,74
1,656,0.2885032537960954,0.6307385229540918,80145287,922,266
0,438,0.20363636363636364,0.39849624060150374,81979792,550,112
1,661,0.23935558112773303,0.5526315789473685,66931830,869,208
0,504,0.11733800350262696,0.1064327485380117,68533262,571,67
0,810,0.1118421052631579,0.13754045307443366,68743605,912,102
1,550,0.27344782034346105,0.5117967332123412,74330641,757,207
1,448,0.29448818897637796,0.6820987654320988,69180636,635,187
1,212,0.3595166163141994,0.8650963597430407,69084442,331,119
0,1497,0.22314478463933576,0.4609127880704925,75892775,1927,430
0,1024,0.20926640926640927,0.40724815724815727,68542425,1295,271
0,3555,0.06496580746975276,0.04579025110782865,68539156,3802,247
1,1062,0.27110501029512696,0.674026728646136,68536783,1457,395
1,167,0.2863247863247863,0.5195729537366548,70713104,234,67
0,398,0.15498938428874734,0.22036082474226804,69622245,471,73
0,603,0.199203187250996,0.2750301568154403,81956109,753,150
1,591,0.39939024390243905,0.8580015026296018,68554122,984,393
0,76,0.1827956989247312,0.20863309352517986,71488445,93,17
1,46,0.34285714285714286,0.5789473684210527,71488452,70,24
1,711,0.25157894736842107,0.5737344093910491,75892943,950,239
0,1403,0.23832790445168295,0.4935185185185185,64410304,1842,439
0,2307,0.2271356783919598,0.49657410746483954,80112375,2985,678
0,1371,0.1705989110707804,0.33,73816043,1653,282
1,71,0.36607142857142855,0.6936936936936937,79838906,112,41
1,41,0.4533333333333333,0.8360655737704918,79838913,75,34
1,286,0.3286384976525822,0.6941431670281996,69955865,426,140
1,1025,0.2876997915218902,0.5895221646516984,80131112,1439,414
0,704,0.15384615384615385,0.2657784011220196,73148355,832,128
0,1459,0.16341743119266056,0.24324324324324326,63278684,1744,285
1,4091,0.4416541558618807,0.9264793783622236,63841316,7327,3236
0,1794,0.201246660730187,0.4035023713973003,63278831,2246,452
0,224,0.21403508771929824,0.43617021276595747,68532863,285,61
1,478,0.22276422764227644,0.5067567567567568,70627480,615,137
1,390,0.2585551330798479,0.5067466266866567,81967317,526,136
0,1201,0.14152966404574696,0.16870876531573986,70871052,1399,198
1,768,0.3209549071618037,0.7722660653889515,70687974,1131,363
1,785,0.3132108486439195,0.6579427875836884,80123760,1143,358
1,1200,0.27884615384615385,0.6687960687960688,68535663,1664,464
0,689,0.10519480519480519,0.12474849094567404,70206192,770,81
1,357,0.2958579881656805,0.5756302521008403,76756694,507,150
0,222,0.10843373493975904,0.14482758620689656,72493694,249,27
0,2825,0.17542323409223584,0.29010416666666666,63278803,3426,601
0,179,0.23829787234042554,0.4289544235924933,69607664,235,56
1,279,0.27906976744186046,0.6101190476190477,80180129,387,108
1,346,0.459375,0.9248366013071896,61454120,640,294
1,152,0.2727272727272727,0.6994219653179191,80112221,209,57
2,1137,0.5863950527464532,0.9831994156318481,67457523,2749,1612
0,225,0.0546218487394958,0.05979381443298969,80124271,238,13
1,495,0.23963133640552994,0.636968085106383,68742611,651,156
1,731,0.39983579638752054,0.8539224526600541,82047597,1218,487
0,1012,0.1343028229255774,0.2651141961486789,74789281,1169,157
0,649,0.08203677510608204,0.19927754364840458,80136481,707,58
1,413,0.41748942172073344,0.9178605539637058,68211794,709,296
1,755,0.3703085904920767,0.8437754271765663,80136479,1199,444
0,398,0.22868217054263565,0.47461629279811096,69869443,516,118
0,444,0.17929759704251386,0.3389513108614232,68534676,541,97
1,531,0.39244851258581237,0.7212041884816754,72321011,874,343
0,485,0.23622047244094488,0.36137931034482756,70653646,635,150
0,2129,0.18241167434715821,0.2690278824415976,68950042,2604,475
0,2474,0.21881907167666562,0.43212177694936316,80125463,3167,693
1,270,0.2950391644908616,0.636734693877551,80107951,383,113
1,478,0.3557951482479784,0.8451327433628318,67159631,742,264
0,1204,0.09541697971450037,0.1886569515557306,70330582,1331,127
0,174,0.04395604395604396,0.2059800664451827,70314685,182,8
1,1022,0.3511111111111111,0.6632503660322109,69055623,1575,553
0,630,0.06110283159463487,0.07246376811594203,66964212,671,41
0,702,0.16129032258064516,0.2781168265039233,68538155,837,135
1,47,0.2878787878787879,0.7244897959183674,68616800,66,19
1,219,0.2525597269624573,0.5486542443064182,72908185,293,74
0,1507,0.10616844602609728,0.13429368029739777,80119376,1686,179
1,159,0.32340425531914896,0.7014925373134329,73590055,235,76
1,419,0.2517857142857143,0.6314229249011858,76500704,560,141
1,303,0.34838709677419355,0.7783505154639175,80107734,465,162
1,125,0.27325581395348836,0.5979899497487438,69534136,172,47
1,566,0.3952991452991453,0.8747346072186837,67994185,936,370
0,549,0.1618320610687023,0.3514615907545887,61699036,655,106
1,1432,0.2370804475226425,0.5067969413763806,70564046,1877,445
1,259,0.3237597911227154,0.6590538336052202,70673491,383,124
2,83,0.553763440860215,0.9620853080568721,72270975,186,103
1,1712,0.2884455527847049,0.6927775781530722,68791233,2406,694
2,612,0.514670896114195,0.958966565349544,80126977,1261,649
1,3959,0.2609669591189098,0.6329639889196675,67774966,5357,1398
0,517,0.07513416815742398,0.31877394636015327,66876313,559,42
0,550,0.06462585034013606,0.2310126582278481,66876642,588,38
0,877,0.03732162458836443,0.050880626223091974,69701310,911,34
0,808,0.04941176470588235,0.14807692307692308,72768745,850,42
1,193,0.3566666666666667,0.7753001715265866,73034094,300,107
0,489,0.043052837573385516,0.06141732283464567,80126893,511,22
0,413,0.1554192229038855,0.2842497670083877,80098291,489,76
0,860,0.22312556458897922,0.4566236811254396,82011806,1107,247
1,1233,0.2594594594594595,0.6181039100160686,80110492,1665,432
2,560,0.5168248490077653,0.9502923976608187,69386884,1159,599
1,250,0.2138364779874214,0.5473372781065089,80135084,318,68
1,1011,0.2839943342776204,0.6808118081180812,69101592,1412,401
1,170,0.26406926406926406,0.6058631921824105,63051744,231,61
0,43,0.18867924528301888,0.33962264150943394,63051751,53,10
0,685,0.1501240694789082,0.2019704433497537,63052024,806,121
0,133,0.14743589743589744,0.2089041095890411,66931172,156,23
0,504,0.1265164644714038,0.4136607828089025,66876684,577,73
0,1017,0.1724979658258747,0.25827455236028213,68151174,1229,212
2,45,0.6739130434782609,0.9907407407407407,73330985,138,93
0,42,0.06666666666666667,0.2727272727272727,73331356,45,3
1,229,0.35674157303370785,0.7934782608695652,70669396,356,127
1,140,0.3577981651376147,0.7424242424242424,68750521,218,78
0,83,0.2782608695652174,0.4690265486725664,69080844,115,32
0,188,0.035897435897435895,0.10975609756097561,70109564,195,7
2,2,0.8333333333333334,0.9333333333333333,72417835,12,10
1,537,0.2562326869806094,0.5142140468227425,74554466,722,185
0,98,0.04854368932038835,0.11616161616161616,80124165,103,5
1,10,0.4117647058823529,0.8428571428571429,80158337,17,7
1,446,0.36737588652482267,0.824435318275154,73000956,705,259
1,82,0.4875,0.9829059829059829,74050200,160,78
0,1802,0.16728280961182995,0.2396598376497874,69606964,2164,362
1,1393,0.2494612068965517,0.5413739266198283,70179676,1856,463
0,311,0.17724867724867724,0.24484848484848484,71358805,378,67
1,46,0.4888888888888889,0.9152542372881356,70811755,90,44
1,815,0.45043830074173974,0.8994229183841714,68015402,1483,668
0,487,0.20684039087947884,0.49363507779349364,62508012,614,127
1,362,0.1735159817351598,0.5103734439834025,63920745,438,76
1,105,0.3712574850299401,0.7920489296636085,69044626,167,62
0,746,0.23955147808358818,0.47020725388601037,72135315,981,235
1,138,0.3581395348837209,0.6851211072664359,80028480,215,77
0,785,0.13067552602436322,0.14977973568281938,70871143,903,118
1,16,0.30434782608695654,0.7619047619047619,65282665,23,7
0,925,0.2220353238015139,0.42888165038002174,70174734,1189,264
1,923,0.28449612403100777,0.6720526630760024,69739250,1290,367
1,665,0.42073170731707316,0.8365570599613152,70201691,1148,483
1,735,0.25832492431886983,0.6081424936386769,68543650,991,256
1,214,0.3649851632047478,0.852112676056338,82126818,337,123
1,623,0.49472830494728304,0.9441829186281103,70222516,1233,610
0,168,0.20754716981132076,0.42995169082125606,80109225,212,44
2,499,0.501996007984032,0.9395121951219512,63725816,1002,503
1,295,0.402834008097166,0.8284518828451883,63847301,494,199
2,128,0.5362318840579711,0.959409594095941,68191830,276,148
0,270,0.23295454545454544,0.3433179723502304,66272213,352,82
1,122,0.34054054054054056,0.7911764705882353,69636973,185,63
1,492,0.43121387283236995,0.8818770226537217,62510651,865,373
0,517,0.15522875816993464,0.2416582406471183,66347953,612,95
0,1103,0.25773889636608344,0.47641509433962265,70644651,1486,383
1,546,0.2601626016260163,0.6015748031496063,68236343,738,192
0,629,0.18523316062176165,0.3821752265861027,80098634,772,143
1,1677,0.4751173708920188,0.9424947145877378,82018891,3195,1518
0,608,0.14606741573033707,0.18460329929300864,68530903,712,104
1,500,0.3084370677731674,0.6226937269372693,70632471,723,223
1,140,0.45098039215686275,0.9099099099099099,70748272,255,115
0,703,0.13316892725030827,0.32042833607907745,78868916,811,108
0,1363,0.1729368932038835,0.2935387248609328,66931025,1648,285
0,617,0.16054421768707483,0.275,67160240,735,118
0,201,0.04739336492890995,0.014705882352941176,68883311,211,10
0,220,0.140625,0.16872427983539096,79520182,256,36
0,1246,0.1523809523809524,0.2282958199356913,68544406,1470,224
0,580,0.2378449408672799,0.4740450538687561,72393300,761,181
1,407,0.27580071174377224,0.6030534351145038,65736440,562,155
2,298,0.6566820276497696,0.993421052631579,68449780,868,570
0,1725,0.20653173873045078,0.46314164415283676,82109205,2174,449
0,222,0.1590909090909091,0.26062846580406657,77676571,264,42
0,541,0.1778115501519757,0.2355263157894737,70641046,658,117
2,16,0.6444444444444445,0.8181818181818182,54552344,45,29
1,175,0.3055555555555556,0.6301775147928994,80107846,252,77
1,280,0.24324324324324326,0.5943952802359882,80134985,370,90
1,449,0.39731543624161075,0.9166666666666666,68532366,745,296
0,2568,0.15526315789473685,0.30246734397677794,69838783,3040,472
2,474,0.5931330472103005,0.9144736842105263,70544313,1165,691
1,192,0.32867132867132864,0.6932668329177057,67993562,286,94
0,523,0.18662519440124417,0.44376899696048633,70617652,643,120
1,1407,0.29011099899091825,0.6510891089108911,67556671,1982,575
1,655,0.2539863325740319,0.5910064239828694,80119003,878,223
1,1714,0.28820598006644516,0.6658545074834668,68253990,2408,694
1,626,0.2591715976331361,0.5541158536585366,70179536,845,219
0,442,0.2036036036036036,0.4365904365904366,65059141,555,113
0,21,0.125,0.3333333333333333,70210434,24,3
0,400,0.21568627450980393,0.49876543209876545,63264383,510,110
1,129,0.4027777777777778,0.8571428571428571,67612461,216,87
1,181,0.39464882943143814,0.8465116279069768,67612496,299,118
0,102,0.184,0.41846153846153844,80098725,125,23
0,1208,0.1402135231316726,0.36240786240786244,299992,1405,197
0,647,0.12567567567567567,0.4181654676258993,60028731,740,93
0,528,0.14285714285714285,0.4566410537870472,60286772,616,88
0,538,0.17103235747303544,0.486284289276808,63765772,649,111
0,190,0.24,0.4597315436241611,65435083,250,60
0,370,0.13953488372093023,0.20497803806734993,68543286,430,60
1,1001,0.3700440528634361,0.8427536231884057,80125505,1589,588
1,847,0.30230642504118616,0.7212328767123287,68532422,1214,367
1,931,0.30625931445603577,0.7142857142857143,68545295,1342,411
0,1123,0.1407804131599082,0.188470066518847,67554683,1307,184
0,591,0.11127819548872181,0.09163346613545817,82178170,665,74
0,557,0.1796759941089838,0.2779220779220779,73882970,679,122
1,880,0.271523178807947,0.5947955390334573,65849924,1208,328
0,1755,0.10550458715596331,0.3220735785953177,67905530,1962,207
2,392,0.5106117353308365,0.9595448798988622,64244222,801,409
1,467,0.23316912972085385,0.5148110316649642,68532842,609,142
1,1273,0.39496197718631176,0.8427925665494727,80122723,2104,831
1,37,0.4861111111111111,0.9,69011635,72,35
0,597,0.1591549295774648,0.24359912216532553,68534641,710,113
0,747,0.17184035476718404,0.31941808981657177,70643461,902,155
1,922,0.331399564902103,0.7806804374240583,67552674,1379,457
1,502,0.23823975720789076,0.5973101265822784,80056900,659,157
1,451,0.24958402662229617,0.531496062992126,67942581,601,150
0,551,0.21060171919770773,0.4230769230769231,68537294,698,147
1,2265,0.24525158280573142,0.512619372442019,804741,3001,736
1,173,0.2669491525423729,0.65439672801636,80116610,236,63
1,157,0.3458333333333333,0.8628158844765343,82036705,240,83
0,1459,0.08755472170106317,0.09370119729307652,68743654,1599,140
1,411,0.3104026845637584,0.7395957193816884,63099750,596,185
1,713,0.2739307535641548,0.6268939393939394,69153966,982,269
0,738,0.21656050955414013,0.4751066856330014,68535824,942,204
1,709,0.2157079646017699,0.5756551141166526,70121275,904,195
1,465,0.38976377952755903,0.8233082706766918,62753866,762,297
0,421,0.11554621848739496,0.1459521094640821,82011803,476,55
1,372,0.41965678627145087,0.9211309523809523,80111045,641,269
1,65,0.3564356435643564,0.7671957671957672,66379614,101,36
0,879,0.20452488687782805,0.3877182420228778,68537133,1105,226
1,73,0.4552238805970149,0.9261744966442953,67553766,134,61
0,3203,0.09647390691114245,0.08760450745183569,67706695,3545,342
1,2352,0.28205128205128205,0.653139566767206,80119302,3276,924
1,56,0.4105263157894737,0.8701298701298701,68532681,95,39
0,223,0.15849056603773584,0.18107667210440456,80118969,265,42
0,1205,0.1695382494831151,0.2546961325966851,63264236,1451,246
1,472,0.3218390804597701,0.7752808988764045,742560,696,224
1,235,0.26791277258566976,0.5900621118012422,74511962,321,86
0,1067,0.14434643143544507,0.22813688212927757,75551434,1247,180
1,739,0.2602602602602603,0.564327485380117,69177010,999,260
0,523,0.22056631892697467,0.46277820414428245,80116652,671,148
1,198,0.31724137931034485,0.6780045351473923,67555481,290,92
1,1677,0.3300039952057531,0.7827507350539039,81965828,2503,826
0,229,0.084,0.09947643979057591,66964275,250,21
0,546,0.17272727272727273,0.2970922882427307,68655986,660,114
0,676,0.1865222623345367,0.36141533277169335,68537350,831,155
1,947,0.3699268130405855,0.852922286448298,63378224,1503,556
0,392,0.09259259259259259,0.1059001512859304,73906056,432,40
0,464,0.07014028056112225,0.027257240204429302,62901440,499,35
0,883,0.18467220683287167,0.3476420798065296,67159274,1083,200
1,819,0.26348920863309355,0.6795797767564018,80121166,1112,293
1,107,0.34355828220858897,0.7802690582959642,69165824,163,56
1,385,0.23306772908366533,0.5288169868554095,72760415,502,117
0,53,0.22058823529411764,0.26851851851851855,80109722,68,15
1,98,0.2898550724637681,0.7674418604651163,67159722,138,40
1,781,0.23581213307240703,0.5347432024169184,80110394,1022,241
0,181,0.19196428571428573,0.28171641791044777,80118975,224,43
1,634,0.3233724653148346,0.7982370225269344,69621853,937,303
0,196,0.08411214953271028,0.05835010060362173,77676515,214,18
1,1120,0.3473193473193473,0.8269347958561852,69586062,1716,596
0,148,0.2127659574468085,0.24829931972789115,74708900,188,40
1,1217,0.3837974683544304,0.8805714285714286,80111402,1975,758
0,3014,0.16347488204274216,0.2652671755725191,70527303,3603,589
0,570,0.1786743515850144,0.3405365126676602,70532805,694,124
1,258,0.2564841498559078,0.5737410071942446,70649565,347,89
2,35,0.5394736842105263,0.9382716049382716,75636134,76,41
1,339,0.49022556390977445,0.8866498740554156,80062031,665,326
1,89,0.47337278106508873,0.8952380952380953,80062402,169,80
0,647,0.2423887587822014,0.4758842443729904,77282541,854,207
0,2471,0.06436955698599016,0.04862924281984334,70617764,2641,170
0,618,0.21374045801526717,0.3920061491160646,67551736,786,168
0,754,0.0991636798088411,0.11078998073217726,68539723,837,83
0,400,0.2,0.39501312335958005,68543846,500,100
0,1084,0.22901849217638692,0.4964243146603099,68561493,1406,322
1,210,0.2579505300353357,0.5244618395303327,80108070,283,73
1,792,0.32075471698113206,0.7382039573820396,80111122,1166,374
1,244,0.3259668508287293,0.6498800959232613,70489650,362,118
1,1196,0.3102652825836217,0.6475694444444444,80096156,1734,538
0,49,0.057692307692307696,0.08235294117647059,70679455,52,3
1,300,0.46714031971580816,0.873900293255132,72743223,563,263
0,232,0.03333333333333333,0.08215962441314555,72669240,240,8
2,87,0.5714285714285714,0.970873786407767,73331006,203,116
2,243,0.592964824120603,0.9355992844364938,67588703,597,354
0,49,0.25757575757575757,0.4793388429752066,70645736,66,17
0,46,0.19298245614035087,0.2903225806451613,70645911,57,11
2,0,1.0,1.0,82208203,2,2
0,24,0.07692307692307693,0.3670886075949367,80124316,26,2
1,500,0.29971988795518206,0.6118598382749326,80123742,714,214
1,452,0.34492753623188405,0.6014362657091562,70729491,690,238
2,337,0.5829207920792079,0.958981612446959,80137790,808,471
1,137,0.4925925925925926,0.9035714285714286,70576632,270,133
1,70,0.3137254901960784,0.6368421052631579,75121172,102,32
2,420,0.5488721804511278,0.96962879640045,70565180,931,511
0,87,0.011363636363636364,0.028409090909090908,70568533,88,1
0,206,0.05069124423963134,0.0821917808219178,70648641,217,11
2,74,0.5568862275449101,0.9473684210526315,72315411,167,93
0,588,0.14658925979680695,0.3387096774193548,72866836,689,101
0,809,0.04823529411764706,0.047508690614136734,80114545,850,41
0,201,0.18292682926829268,0.3191489361702128,65299346,246,45
0,1000,0.19549477071600965,0.34112490869247625,68018356,1243,243
0,121,0.11029411764705882,0.30612244897959184,67792564,136,15
0,119,0.14388489208633093,0.2926829268292683,67812003,139,20
1,493,0.301699716713881,0.7563499529633114,68633495,706,213
1,431,0.44025974025974024,0.9074333800841514,68741330,770,339
1,851,0.28846153846153844,0.7170245398773006,68539394,1196,345
0,3993,0.0780420226275687,0.0641323273360418,69600972,4331,338
0,213,0.2111111111111111,0.43917525773195876,80121268,270,57
0,296,0.10843373493975904,0.45907928388746805,62835374,332,36
0,791,0.1620762711864407,0.3792895845875978,72907856,944,153
1,1607,0.27285067873303165,0.6100506427736657,80058664,2210,603
1,1401,0.3847167325428195,0.8561580882352942,70627102,2277,876
1,448,0.29337539432176657,0.6492146596858639,69607111,634,186
1,450,0.3323442136498516,0.7455919395465995,80111661,674,224
0,588,0.13529411764705881,0.19662921348314608,68536895,680,92
0,1227,0.18363273453093812,0.3384401114206128,68537196,1503,276
0,2392,0.15566537239675257,0.2109771573604061,68533234,2833,441
0,2724,0.09591769000995685,0.22600710900473933,69575121,3013,289
1,1569,0.28875793291024476,0.7068415455512229,80098473,2206,637
1,656,0.2775330396475771,0.673582295988935,69421310,908,252
1,903,0.22289156626506024,0.5100742311770944,70627004,1162,259
1,572,0.42857142857142855,0.9287280701754386,65355731,1001,429
1,1336,0.288604898828541,0.6910144927536231,80110646,1878,542
1,1817,0.3204936424831713,0.7679578789018427,66425051,2674,857
0,1518,0.16039823008849557,0.2767527675276753,68537602,1808,290
1,4095,0.4146655231560892,0.8891235480464625,68496932,6996,2901
0,475,0.18803418803418803,0.284375,68533325,585,110
0,288,0.17002881844380405,0.29577464788732394,68533346,347,59
0,483,0.2197092084006462,0.46210526315789474,68533395,619,136
0,175,0.18604651162790697,0.3685636856368564,68533696,215,40
2,809,0.5003088326127239,0.9536082474226805,73503325,1619,810
1,1849,0.35191026989134244,0.7998065764023211,63141484,2853,1004
0,1499,0.19234913793103448,0.3257985257985258,70645512,1856,357
0,1022,0.1454849498327759,0.3302840635532017,66058692,1196,174
0,661,0.1370757180156658,0.2548342541436464,66058713,766,105
0,409,0.1601642710472279,0.35208333333333336,69638611,487,78
1,1057,0.27553118574366003,0.662797800855223,67940502,1459,402
1,290,0.271356783919598,0.6238738738738738,70921144,398,108
0,747,0.10431654676258993,0.10717372515125324,70642740,834,87
1,93,0.34507042253521125,0.6706586826347305,79726822,142,49
1,2158,0.29152987524622453,0.6922051965356429,64275652,3046,888
1,897,0.25683512841756423,0.6268028846153846,70515452,1207,310
0,53,0.18461538461538463,0.32978723404255317,68499802,65,12
0,1478,0.07451471509079524,0.06144170295113691,70617792,1597,119
0,538,0.0865874363327674,0.10613207547169812,70641676,589,51
1,339,0.28781512605042014,0.5631067961165048,70644630,476,137
0,696,0.12781954887218044,0.17982456140350878,60512725,798,102
1,820,0.3273174733388023,0.7861842105263158,54676013,1219,399
1,668,0.38995433789954337,0.8848167539267016,67552170,1095,427
1,762,0.2729007633587786,0.6850909090909091,67555201,1048,286
1,477,0.3510204081632653,0.813265306122449,67557994,735,258
1,728,0.3208955223880597,0.7756653992395437,80152859,1072,344
1,213,0.3983050847457627,0.8101983002832861,80118359,354,141
1,1827,0.2899339292654489,0.6824018126888217,80124667,2573,746
0,483,0.0547945205479452,0.027149321266968326,72522625,511,28
0,370,0.09090909090909091,0.12124711316397228,72522632,407,37
0,1264,0.09585121602288985,0.12921348314606743,73255063,1398,134
1,196,0.25475285171102663,0.591304347826087,81976695,263,67
1,557,0.2348901098901099,0.5371965544244323,67252682,728,171
1,439,0.24179620034542315,0.5158311345646438,68163781,579,140
1,801,0.23275862068965517,0.5982961992136304,63032046,1044,243
1,136,0.32338308457711445,0.7091633466135459,82047599,201,65
0,571,0.08051529790660225,0.0937231298366294,80097290,621,50
0,677,0.06620689655172414,0.05084745762711865,80097304,725,48
0,564,0.0976,0.13369467028003612,80097325,625,61
1,1033,0.46725116039195463,0.9243061396131202,62510693,1939,906
0,379,0.08009708737864078,0.0946969696969697,70627256,412,33
0,1255,0.23800850030358228,0.49537037037037035,69607972,1647,392
1,1128,0.2792332268370607,0.6538975501113585,68237981,1565,437
1,853,0.2696917808219178,0.6231155778894473,68254004,1168,315
1,1001,0.31438356164383563,0.7497123130034522,80103072,1460,459
1,342,0.29918032786885246,0.7445054945054945,66931263,488,146
0,305,0.13352272727272727,0.1960431654676259,68536993,352,47
1,75,0.4094488188976378,0.9444444444444444,82126814,127,52
1,414,0.36793893129770994,0.8275084554678692,69636896,655,241
0,248,0.20512820512820512,0.45607476635514016,70633605,312,64
1,861,0.2519548218940052,0.6281198003327787,68541200,1151,290
0,1337,0.11339522546419098,0.11724500525762356,68536216,1508,171
0,643,0.1334231805929919,0.1771689497716895,68538141,742,99
1,175,0.3320610687022901,0.6975476839237057,62376146,262,87
0,119,0.23225806451612904,0.40066225165562913,62376153,155,36
1,2973,0.2799709372729474,0.6132490379329302,67287570,4129,1156
1,861,0.2571182053494392,0.5815181518151815,68542313,1159,298
1,609,0.27928994082840236,0.6897133220910624,68542320,845,236
1,413,0.31281198003327787,0.7598566308243727,65289896,601,188
1,117,0.34269662921348315,0.7626582278481012,80134999,178,61
0,713,0.18700114025085518,0.36434612882238127,68534662,877,164
1,123,0.3241758241758242,0.7722007722007722,68542271,182,59
1,3264,0.25137614678899084,0.5051546391752577,68478214,4360,1096
0,190,0.20168067226890757,0.31645569620253167,80109540,238,48
0,991,0.10072595281306715,0.1241076331685887,68553646,1102,111
1,399,0.25140712945590993,0.5439698492462312,80109771,533,134
1,139,0.405982905982906,0.8171206225680934,67154262,234,95
0,2869,0.14689265536723164,0.19057702488088937,67291700,3363,494
0,1014,0.11518324607329843,0.32713936430317847,69638751,1146,132
0,250,0.09420289855072464,0.19730941704035873,80124178,276,26
1,570,0.24503311258278146,0.6374172185430463,69207551,755,185
0,583,0.15994236311239193,0.37774524158125916,64929571,694,111
0,298,0.04792332268370607,0.12121212121212122,67800383,313,15
1,592,0.3378076062639821,0.7140335392762577,72936290,894,302
1,42,0.3225806451612903,0.673469387755102,73024994,62,20
2,136,0.6034985422740525,0.9823232323232324,80081022,343,207
1,559,0.2869897959183674,0.6577181208053692,65366175,784,225
2,46,0.648854961832061,0.967391304347826,80126955,131,85
0,641,0.14075067024128687,0.34320074005550416,69575275,746,105
1,599,0.35102925243770317,0.8409638554216867,69031144,923,324
1,648,0.30097087378640774,0.7193638914873713,80111472,927,279
2,10,0.8701298701298701,0.9259259259259259,67064886,77,67
0,197,0.08372093023255814,0.1875,80124276,215,18
1,199,0.2815884476534296,0.6458752515090543,63270466,277,78
0,736,0.1598173515981735,0.2910737386804657,70119875,876,140
1,969,0.38593155893536124,0.822478386167147,82009285,1578,609
0,102,0.1206896551724138,0.15306122448979592,82011842,116,14
1,347,0.2845360824742268,0.6986111111111111,69622420,485,138
0,720,0.24210526315789474,0.4724358974358974,68763912,950,230
0,1013,0.22136817832436587,0.45536791314837155,80097633,1301,288
0,717,0.14744351961950058,0.24903474903474904,68561661,841,124
1,335,0.2826552462526767,0.5356415478615071,69169954,467,132
1,226,0.4005305039787798,0.8624338624338624,70760935,377,151
1,128,0.4980392156862745,0.9124579124579124,80127012,255,127
1,2815,0.23359651511026408,0.5298151460942159,80110513,3673,858
1,1170,0.2732919254658385,0.6712479384277076,80112200,1610,440
1,1044,0.27044025157232704,0.6005037783375314,70179550,1431,387
0,1072,0.18910741301059,0.27012641383898867,70653674,1322,250
1,1674,0.253678109674543,0.5407166123778502,72422476,2243,569
0,2109,0.10521849809079338,0.12429001002338791,70564032,2357,248
1,2476,0.2474164133738602,0.5698324022346368,64999396,3290,814
0,152,0.1783783783783784,0.37662337662337664,81965696,185,33
1,114,0.47465437788018433,0.9361702127659575,69531224,217,103
2,23,0.6229508196721312,0.9574468085106383,78286866,61,38
1,74,0.27450980392156865,0.5862068965517241,70649166,102,28
0,831,0.17966436327739388,0.3005427408412483,68530665,1013,182
0,2618,0.1571152607855763,0.22485714285714287,70871206,3106,488
1,1198,0.27084601339014,0.6274944567627494,67511395,1643,445
1,315,0.3076923076923077,0.6038732394366197,70720412,455,140
1,142,0.3515981735159817,0.7731958762886598,65825214,219,77
1,536,0.40904079382579933,0.84,61104701,907,371
0,5937,0.1494269340974212,0.400262467191601,70691194,6980,1043
0,1738,0.22341376228775692,0.49086669257675863,80121016,2238,500
1,135,0.3076923076923077,0.6905829596412556,69152202,195,60
1,576,0.47588717015468607,0.8914081145584726,70822332,1099,523
1,163,0.28193832599118945,0.6896551724137931,80160433,227,64
2,209,0.7175675675675676,0.9723926380368099,69187482,740,531
2,17,0.6304347826086957,0.918918918918919,69319761,46,29
0,196,0.18333333333333332,0.17733990147783252,69992321,240,44
0,74,0.23711340206185566,0.47674418604651164,69992426,97,23
1,785,0.26908752327746743,0.613564668769716,68531883,1074,289
0,282,0.17543859649122806,0.27714285714285714,68667046,342,60
1,1246,0.4953422438234103,0.9594947735191638,70317933,2469,1223
0,1235,0.08923303834808259,0.09037656903765691,65934526,1356,121
1,1326,0.2909090909090909,0.5961055276381909,68436116,1870,544
0,78,0.16129032258064516,0.25680933852140075,65395750,93,15
0,109,0.09166666666666666,0.1712707182320442,82059913,120,11
1,3904,0.34573487514663986,0.776685393258427,67145715,5967,2063
0,1277,0.19126029132362254,0.3569995988768552,67215806,1579,302
0,256,0.14950166112956811,0.19002375296912113,81966307,301,45
0,510,0.17073170731707318,0.3325,82016317,615,105
1,914,0.4084142394822006,0.8633696563285834,68254403,1545,631
1,368,0.4140127388535032,0.8818011257035647,68254473,628,260
1,648,0.22488038277511962,0.5323671497584541,68530861,836,188
0,531,0.12664473684210525,0.19679633867276888,70627165,608,77
0,369,0.08888888888888889,0.13126491646778043,70642901,405,36
1,487,0.3131170662905501,0.7554285714285714,80121118,709,222
0,4330,0.1639312608611701,0.2636692272932671,69074656,5179,849
0,1002,0.165,0.2679063360881543,80181299,1200,198
0,586,0.0593900481540931,0.05244755244755245,80181309,623,37
0,1013,0.17709179528838342,0.32640449438202246,68642133,1231,218
1,66,0.26666666666666666,0.6288659793814433,70058674,90,24
1,158,0.2914798206278027,0.7276341948310139,69486774,223,65
0,967,0.06840077071290944,0.04965859714463067,80118154,1038,71
0,1249,0.07890855457227139,0.08661778185151238,80121875,1356,107
2,609,0.5811554332874828,0.8935837245696401,65511236,1454,845
1,426,0.24734982332155478,0.5114754098360655,80178145,566,140
0,521,0.12436974789915967,0.18927973199329984,80178146,595,74
1,160,0.48881789137380194,0.8716814159292036,68283110,313,153
1,144,0.3949579831932773,0.5107913669064749,70631575,238,94
0,1020,0.2237442922374429,0.34572490706319703,69235040,1314,294
0,1241,0.27299355594610425,0.4791666666666667,74495085,1707,466
1,454,0.3797814207650273,0.8518041237113402,80180344,732,278
1,1434,0.29877750611246945,0.633954857703631,80124995,2045,611
1,155,0.29545454545454547,0.7204030226700252,65914030,220,65
1,1688,0.3447204968944099,0.7872670807453416,66408440,2576,888
0,821,0.16565040650406504,0.21161825726141079,80090206,984,163
1,2705,0.47759752800309,0.9073339940535183,69502650,5178,2473
2,160,0.5046439628482973,0.933806146572104,73415132,323,163
1,705,0.4777777777777778,0.9465500485908649,73347064,1350,645
1,30,0.34782608695652173,0.7441860465116279,82009537,46,16
1,231,0.4393203883495146,0.8919449901768173,67970980,412,181
0,590,0.23177083333333334,0.3904382470119522,69644533,768,178
1,626,0.3283261802575107,0.754863813229572,68953843,932,306
0,269,0.1897590361445783,0.45058139534883723,69602043,332,63
1,1490,0.3386595650244119,0.7978671837130392,63445970,2253,763
2,64,0.539568345323741,0.9425287356321839,68199614,139,75
0,1069,0.08632478632478632,0.07993730407523511,80140081,1170,101
0,377,0.19616204690831557,0.3841059602649007,80140113,469,92
0,189,0.1888412017167382,0.3503184713375796,80140114,233,44
0,2037,0.1227390180878553,0.13800424628450106,80141457,2322,285
1,876,0.44061302681992337,0.8823975720789075,68666395,1566,690
1,937,0.3989737010904426,0.8915343915343915,63445851,1559,622
1,1211,0.3083952027412907,0.651685393258427,70186361,1751,540
1,60,0.47368421052631576,0.9516129032258065,80180326,114,54
0,179,0.12682926829268293,0.14736842105263157,70605423,205,26
2,4,0.5555555555555556,0.7,70223083,9,5
2,694,0.5035765379113019,0.8899188876013905,68282431,1398,704
1,208,0.24087591240875914,0.5988372093023255,80140108,274,66
2,589,0.6054922973878097,0.8943781942078365,65499791,1493,904
1,69,0.39473684210526316,0.8169014084507042,68294184,114,45
2,120,0.53125,0.7914438502673797,73552570,256,136
1,92,0.4177215189873418,0.844559585492228,65191126,158,66
2,0,1.0,1.0,1040123,12,12
1,543,0.37442396313364057,0.6898470097357441,69055665,868,325
2,623,0.6203534430225472,0.9863481228668942,70586775,1641,1018
1,4812,0.2238709677419355,0.5827294685990339,70691166,6200,1388
0,206,0.23985239852398524,0.4506329113924051,69873811,271,65
2,645,0.584942084942085,0.9794344473007712,70035882,1554,909
0,1788,0.18206770356816102,0.36467095497278573,68173966,2186,398
1,137,0.3476190476190476,0.7841409691629956,80111234,210,73
0,1045,0.12258606213266163,0.1293471629042099,69100990,1191,146
1,444,0.291866028708134,0.7205720572057206,65327703,627,183
1,828,0.4068767908309456,0.8732802317161478,80000592,1396,568
0,1000,0.06279287722586692,0.1319796954314721,70001204,1067,67
1,1467,0.22051009564293306,0.5393129770992366,68158482,1882,415
0,149,0.16292134831460675,0.3468354430379747,67594835,178,29
1,1261,0.31911447084233263,0.7154944473823374,70822346,1852,591
1,450,0.3959731543624161,0.8731060606060606,80128027,745,295
1,546,0.3980154355016538,0.842993396918562,70222551,907,361
1,1057,0.27353951890034367,0.6370786516853932,72920393,1455,398
1,873,0.23954703832752614,0.5238917674150835,70642145,1148,275
0,1725,0.0959119496855346,0.08957871396895788,68539086,1908,183
2,1672,0.5474966170500677,0.9749009247027741,67118093,3695,2023
1,180,0.23076923076923078,0.5970149253731343,67985960,234,54
0,660,0.15384615384615385,0.1826086956521739,68533276,780,120
1,319,0.24407582938388625,0.5791044776119403,68533542,422,103
1,362,0.23142250530785563,0.52,80125441,471,109
1,681,0.23910614525139665,0.5526770293609672,80125488,895,214
1,711,0.4601366742596811,0.9334389857369255,70818944,1317,606
0,146,0.12048192771084337,0.17971014492753623,72900604,166,20
0,255,0.1930379746835443,0.4079173838209983,81978734,316,61
2,274,0.5009107468123861,0.9453551912568307,19550104,549,275
1,78,0.2909090909090909,0.7180616740088106,80139716,110,32
0,994,0.046065259117082535,0.086987270155587,63780521,1042,48
0,4,0.0,0.0,67094090,4,0
0,3,0.0,0.0,68521726,3,0
1,25,0.10714285714285714,0.6458333333333334,68521845,28,3
0,3992,0.10049571879224876,0.10616153205661949,73700655,4438,446
1,1132,0.34186046511627904,0.7861271676300579,80110891,1720,588
0,2553,0.04632050803137841,0.022296544035674472,68628595,2677,124
0,1541,0.20974358974358975,0.36176066024759285,70813960,1950,409
0,2845,0.21169298974785258,0.42923118717739744,73816113,3609,764
0,348,0.1792452830188679,0.3484626647144949,68791261,424,76
0,40,0.09090909090909091,0.019230769230769232,73129630,44,4
0,1153,0.0776,0.0836461126005362,73346763,1250,97
1,372,0.35304347826086957,0.7668488160291439,80180001,575,203
2,142,0.5590062111801242,0.9774011299435028,70933590,322,180
0,390,0.07363420427553444,0.07769423558897243,77182224,421,31
0,262,0.11784511784511785,0.15815085158150852,77182231,297,35
0,292,0.048859934853420196,0.03151862464183381,77182245,307,15
0,491,0.15051903114186851,0.30676552363299353,67809231,578,87
0,1616,0.05827505827505827,0.18950819672131147,70658595,1716,100
1,312,0.35135135135135137,0.8115183246073299,80111192,481,169
1,3104,0.4198130841121495,0.9145542580461407,80107405,5350,2246
1,296,0.45985401459854014,0.9089481946624803,65787351,548,252
0,300,0.20424403183023873,0.4500907441016334,67985946,377,77
2,48,0.6571428571428571,0.9642857142857143,69171095,140,92
0,145,0.15204678362573099,0.26813880126182965,70470722,171,26
0,628,0.15363881401617252,0.2556221889055472,68534690,742,114
0,936,0.07509881422924901,0.09246358454718176,70642362,1012,76
0,696,0.1724137931034483,0.46123260437375746,73194842,841,145
1,670,0.27956989247311825,0.6659850034083163,68151314,930,260
0,985,0.20178282009724474,0.4348060344827586,70532770,1234,249
0,945,0.10511363636363637,0.12668621700879765,70532875,1056,111
1,225,0.23208191126279865,0.5177664974619289,81979706,293,68
0,897,0.1947935368043088,0.36946564885496186,81979985,1114,217
0,1158,0.05546492659053834,0.024361948955916472,82012517,1226,68
1,773,0.32252410166520595,0.7098831030818279,74001123,1141,368
2,996,0.5671447196870926,0.9802431610942249,62512233,2301,1305
1,1317,0.4221149627029399,0.8895671476137624,80156785,2279,962
0,4723,0.1103786023733283,0.14294205052005943,73808882,5309,586
1,179,0.4131147540983607,0.8324022346368715,82011523,305,126
2,1,0.5,0.6666666666666666,64191883,2,1
1,87,0.4,0.8285714285714286,62738823,145,58
1,181,0.3418181818181818,0.8178807947019867,80128029,275,94
0,661,0.16329113924050634,0.29863813229571984,68537714,790,129
1,546,0.26907630522088355,0.6498649864986499,68633572,747,201
0,832,0.1431513903192585,0.18344252531268612,66931900,971,139
1,87,0.45625,0.9173553719008265,68288941,160,73
0,227,0.07346938775510205,0.38156359393232203,68798380,245,18
0,1831,0.12643129770992367,0.16731182795698923,73346742,2096,265
0,594,0.10676691729323308,0.13596491228070176,80133198,665,71
0,1663,0.22866419294990722,0.49143468950749464,70612850,2156,493
2,370,0.5105820105820106,0.966804979253112,70207725,756,386
1,693,0.32390243902439025,0.7107583774250441,66898944,1025,332
0,308,0.1323943661971831,0.171021377672209,74725266,355,47
0,671,0.19447779111644659,0.43211920529801323,68544224,833,162
1,1703,0.38696904247660185,0.8918249380677127,69586111,2778,1075
2,263,0.6387362637362637,0.9402654867256637,80018946,728,465
1,1269,0.28507042253521125,0.6256366723259762,74355771,1775,506
2,708,0.5438144329896907,0.956397426733381,80125795,1552,844
0,989,0.22064617809298662,0.45163170163170163,68537273,1269,280
0,2402,0.2208887447291599,0.4482120838471023,70605122,3083,681
0,104,0.2727272727272727,0.4608695652173913,80108483,143,39
1,1077,0.2608098833218943,0.6012994683992912,66930640,1457,380
1,326,0.34930139720558884,0.874051593323217,80121187,501,175
2,141,0.53,0.9779179810725552,74354084,300,159
2,410,0.6061479346781941,0.9851428571428571,82011674,1041,631
1,297,0.3044496487119438,0.6087570621468926,70617932,427,130
2,91,0.558252427184466,0.9826086956521739,73215975,206,115
1,503,0.4026128266033254,0.9048723897911833,80110695,842,339
1,490,0.4927536231884058,0.9512690355329949,80096023,966,476
2,227,0.509719222462203,0.955108359133127,70925771,463,236
2,1020,0.5415730337078651,0.9375,80062045,2225,1205
2,24,0.6,0.9767441860465116,72393160,60,36
1,338,0.44039735099337746,0.8736176935229067,70828744,604,266
0,111,0.26973684210526316,0.43915343915343913,66263554,152,41
2,164,0.6833976833976834,0.9572368421052632,80045560,518,354
1,15,0.16666666666666666,0.5625,70679021,18,3
2,36,0.5955056179775281,0.9615384615384616,82041323,89,53
2,0,1.0,1.0,80175980,11,11
1,11,0.26666666666666666,0.6666666666666666,80159896,15,4
1,7,0.36363636363636365,0.5,72759526,11,4
1,161,0.35080645161290325,0.7612903225806451,69172873,248,87
0,39,0.13333333333333333,0.1652892561983471,70605731,45,6
2,3,0.8,0.5,74122370,15,12
1,81,0.2831858407079646,0.6495327102803738,70566811,113,32
1,396,0.3981762917933131,0.8227060653188181,70576751,658,262
2,684,0.5272978576364893,0.9690721649484536,82010331,1447,763
2,34,0.6964285714285714,0.9591836734693877,66848691,112,78
0,430,0.16666666666666666,0.2850356294536817,68995430,516,86
1,1165,0.263590391908976,0.5592350746268657,69667661,1582,417
0,1387,0.06662180349932706,0.051452784503631964,70641284,1486,99
0,2314,0.1600725952813067,0.2286836935166994,70641410,2755,441
2,0,1.0,1.0,82020014,2,2
0,401,0.21372549019607842,0.35602094240837695,70078120,510,109
2,39,0.5517241379310345,0.7941176470588235,80056445,87,48
1,354,0.4354066985645933,0.8864516129032258,80096296,627,273
2,8,0.6,0.9473684210526315,82088775,20,12
2,42,0.6146788990825688,0.7833333333333333,63209461,109,67
0,1443,0.2246104245029554,0.3708165997322624,80118611,1861,418
2,1,0.8,0.9,79462572,5,4
0,1087,0.22078853046594982,0.3976153447382063,70676921,1395,308
1,50,0.375,0.7518796992481203,82023572,80,30
0,958,0.16185476815398075,0.21247113163972287,72455383,1143,185
1,589,0.25158831003811943,0.6047486033519553,66510640,787,198
0,237,0.04048582995951417,0.008421052631578947,68740875,247,10
1,51,0.25,0.7458563535911602,63028665,68,17
1,722,0.2684903748733536,0.5482315112540193,70462980,987,265
0,2457,0.04951644100580271,0.018844221105527637,68534585,2585,128
1,48,0.323943661971831,0.6923076923076923,80108385,71,23
0,690,0.19298245614035087,0.4150034411562285,80098704,855,165
0,839,0.1007502679528403,0.12167832167832168,80114153,933,94
1,968,0.27163280662151995,0.5971731448763251,68763562,1329,361
0,622,0.1560379918588874,0.2505353319057816,66423623,737,115
0,1811,0.2197328737613098,0.4592910011686794,67494910,2321,510
0,1536,0.08243727598566308,0.06322640632264064,69621440,1674,138
0,554,0.11642743221690591,0.15181518151815182,70061166,627,73
1,212,0.2664359861591695,0.6868217054263566,70061173,289,77
0,289,0.06168831168831169,0.058823529411764705,77182203,308,19
0,89,0.16822429906542055,0.4103585657370518,80124524,107,18
0,139,0.18235294117647058,0.3473193473193473,73194835,170,31
0,1816,0.18491921005385997,0.32968236582694416,68544413,2228,412
1,1042,0.23886048210372535,0.5265200517464425,68544574,1369,327
0,617,0.2373300370828183,0.44585091420534456,67555264,809,192
1,423,0.24464285714285713,0.6851385390428212,68537896,560,137
1,329,0.21852731591448932,0.5598086124401914,68537903,421,92
1,309,0.24634146341463414,0.6304347826086957,68537924,410,101
0,2515,0.056639159789947484,0.10152505446623093,792470,2666,151
0,651,0.12967914438502673,0.39383938393839385,60087433,748,97
0,140,0.02097902097902098,0.008108108108108109,60509820,143,3
0,986,0.05916030534351145,0.13163799551234107,60509911,1048,62
0,150,0.038461538461538464,0.05672268907563025,63775586,156,6
1,17,0.15,0.6511627906976745,80079272,20,3
1,930,0.34919524142757175,0.711764705882353,69530503,1429,499
0,758,0.10928319623971798,0.17956204379562044,70643083,851,93
1,1595,0.3406366267052501,0.7553330430996953,67199650,2419,824
0,109,0.07627118644067797,0.01507537688442211,68115516,118,9
1,365,0.3290441176470588,0.7211678832116788,70874181,544,179
0,63,0.1,0.24166666666666667,62414044,70,7
1,34,0.19047619047619047,0.6101694915254238,73739694,42,8
0,498,0.16020236087689713,0.3740808823529412,80121254,593,95
0,275,0.1716867469879518,0.3247011952191235,82077190,332,57
1,525,0.25106990014265335,0.5890968266883645,69421303,701,176
1,1068,0.32447817836812143,0.7877659574468086,70632233,1581,513
0,396,0.1391304347826087,0.16789396170839468,70641900,460,64
0,873,0.16936251189343482,0.2857142857142857,70642600,1051,178
0,1923,0.2134969325153374,0.38923829489867223,69586230,2445,522
0,707,0.04330175913396482,0.06711409395973154,70001022,739,32
2,21,0.7375,0.88,82140139,80,59
0,2061,0.20147229755908563,0.44489164086687305,68161520,2581,520
1,777,0.471068754254595,0.9436813186813187,80169867,1469,692
0,2153,0.11726117261172611,0.2393345854574725,81893568,2439,286
0,977,0.06685768863419293,0.16321243523316062,788081,1047,70
0,154,0.04938271604938271,0.1679790026246719,70001505,162,8
1,405,0.41389290882778584,0.8523316062176166,72322194,691,286
1,223,0.33432835820895523,0.8300395256916996,80121180,335,112
0,2208,0.1286503551696922,0.22506459948320415,70841673,2534,326
1,1866,0.2633241215949467,0.5951003742769649,66900806,2533,667
1,968,0.30906495360456815,0.7132216014897579,69176863,1401,433
1,540,0.41431670281995664,0.8780260707635009,68211843,922,382
0,1641,0.14397496087636932,0.17067067067067068,70641354,1917,276
1,1156,0.2692793931731985,0.6559911651021535,80112046,1582,426
0,377,0.2194616977225673,0.38273381294964026,67263693,483,106
0,727,0.12620192307692307,0.36568457538994803,67364241,832,105
1,148,0.3755274261603376,0.7638483965014577,80163479,237,89
2,2,0.5,0.75,70771092,4,2
1,232,0.3608815426997245,0.8787878787878788,65355724,363,131
1,1432,0.24392819429778248,0.5383920505871725,68535390,1894,462
0,365,0.15898617511520738,0.3367231638418079,69416753,434,69
0,1668,0.19068413391557495,0.322265625,70617176,2061,393
0,239,0.13405797101449277,0.1839863713798978,70638183,276,37
1,1408,0.2786885245901639,0.6303758233242929,68763961,1952,544
0,351,0.21123595505617979,0.4890322580645161,67555950,445,94
0,671,0.20872641509433962,0.4668560606060606,68538190,848,177
0,951,0.1926994906621392,0.41451104100946373,68538225,1178,227
1,465,0.3968871595330739,0.8781014023732471,69573112,771,306
1,224,0.37254901960784315,0.8672768878718535,67833710,357,133
1,108,0.23943661971830985,0.5866666666666667,69622000,142,34
0,848,0.2318840579710145,0.4762796504369538,68006470,1104,256
1,1359,0.34694858241230175,0.7653429602888087,68421262,2081,722
0,351,0.20408163265306123,0.28775510204081634,80180237,441,90
0,924,0.18590308370044054,0.3513022410660206,81989975,1135,211
0,215,0.03153153153153153,0.08539944903581267,62840106,222,7
1,21,0.08695652173913043,0.5639097744360902,62840603,23,2
0,333,0.045845272206303724,0.13197026022304834,65498531,349,16
0,1756,0.15900383141762453,0.3106837606837607,81965605,2088,332
0,715,0.06290956749672345,0.15822130299896586,60543224,763,48
0,2975,0.12833284500439496,0.16308303010254713,74320155,3413,438
1,325,0.3614931237721022,0.8148984198645598,80180471,509,184
1,513,0.2692307692307692,0.6601178781925344,68419680,702,189
1,1066,0.2581767571329158,0.6207446808510638,80111885,1437,371
0,953,0.2045075125208681,0.447739426349052,81965699,1198,245
0,417,0.12394957983193278,0.3094928478543563,300405,476,59
1,449,0.18065693430656934,0.5684848484848485,63775481,548,99
0,1110,0.060118543607112614,0.12852664576802508,63780346,1181,71
0,982,0.042884990253411304,0.0639367816091954,63780500,1026,44
0,159,0.04216867469879518,0.1025,63780962,166,7
0,456,0.11627906976744186,0.3712121212121212,69530426,516,60
1,987,0.47331910352187834,0.924816280384398,67306911,1874,887
0,168,0.2186046511627907,0.35081967213114756,72749166,215,47
0,831,0.10162162162162162,0.08949416342412451,72899281,925,94
0,484,0.12159709618874773,0.1423290203327172,72899295,551,67
0,1689,0.1626177491323748,0.25878462174452255,82107802,2017,328
0,654,0.1517509727626459,0.22903885480572597,81979805,771,117
0,611,0.21966794380587484,0.4769452449567723,81979806,783,172
0,1876,0.12131147540983607,0.15586343394359228,80180393,2135,259
0,289,0.08832807570977919,0.10150891632373114,69416116,317,28
0,881,0.18501387604070305,0.3942516268980477,80124516,1081,200
0,822,0.1499482936918304,0.26235294117647057,80140155,967,145
0,1547,0.1235127478753541,0.26258637709772953,81893579,1765,218
1,552,0.433264887063655,0.8723235527359239,70202426,974,422
0,1280,0.18106206014075496,0.38395590936925905,66202150,1563,283
1,401,0.24196597353497165,0.5701943844492441,66931620,529,128
1,350,0.2009132420091324,0.562708102108768,63503545,438,88
1,14,0.36363636363636365,0.9166666666666666,82145502,22,8
1,11,0.3888888888888889,0.875,82145526,18,7
0,526,0.15705128205128205,0.492798353909465,62530405,624,98
2,215,0.5023148148148148,0.9312169312169312,80155218,432,217
0,504,0.21739130434782608,0.45924627519719546,81979809,644,140
1,533,0.3787878787878788,0.8793774319066148,67556104,858,325
0,246,0.13986013986013987,0.15336463223787167,71458884,286,40
0,1740,0.03814262023217247,0.04194037392622536,60028836,1809,69
0,1417,0.2149584487534626,0.42628205128205127,68542054,1805,388
1,1359,0.281332628239027,0.6071713147410358,74345712,1891,532
0,3119,0.035559678416821276,0.008651073373918615,69600986,3234,115
1,305,0.2857142857142857,0.697508896797153,69736415,427,122
0,1333,0.2374141876430206,0.4400564174894217,70644770,1748,415
0,589,0.09384615384615384,0.2714285714285714,65516976,650,61
0,670,0.20710059171597633,0.41889483065953653,68538974,845,175
0,557,0.1723625557206538,0.4358108108108108,67810050,673,116
0,275,0.14330218068535824,0.20747663551401868,68174001,321,46
0,1069,0.042114695340501794,0.05377574370709382,67837042,1116,47
1,538,0.3137755102040816,0.7563786008230453,62769742,784,246
0,1042,0.22005988023952097,0.4638949671772429,68537301,1336,294
1,286,0.2759493670886076,0.7071917808219178,68542215,395,109
1,443,0.40854472630173566,0.8683473389355743,67306946,749,306
0,1351,0.06180555555555556,0.125,60287276,1440,89
0,4680,0.038619556285949055,0.03672316384180791,70001526,4868,188
1,227,0.3780821917808219,0.8855098389982111,70632303,365,138
1,1706,0.281078803202697,0.6634980988593155,82116580,2373,667
0,527,0.06227758007117438,0.16208251473477406,70001253,562,35
1,975,0.4819341126461211,0.924956369982548,62510721,1882,907
0,850,0.2216117216117216,0.49962546816479403,68541144,1092,242
1,1297,0.3255330213208528,0.767266395821242,66779286,1923,626
1,482,0.32016925246826516,0.7642857142857142,69607902,709,227
0,541,0.20441176470588235,0.38130155820348305,68535782,680,139
1,281,0.2701298701298701,0.598937583001328,65313234,385,104
1,153,0.2608695652173913,0.6297229219143576,67514132,207,54
1,907,0.22012037833190026,0.5006297229219143,68543804,1163,256
1,192,0.24705882352941178,0.5273159144893111,69974954,255,63
0,237,0.22039473684210525,0.45510204081632655,67598531,304,67
0,597,0.21031746031746032,0.391304347826087,70850731,756,159
0,531,0.13517915309446255,0.2546875,64929410,614,83
1,1300,0.3893846876467825,0.8820754716981132,78921395,2129,829
1,214,0.49047619047619045,0.9364035087719298,82023525,420,206
0,259,0.17252396166134185,0.3339382940108893,68538512,313,54
1,654,0.32991803278688525,0.7476871320437343,80108504,976,322
0,17,0.10526315789473684,0.2714285714285714,82152064,19,2
0,27,0.18181818181818182,0.45054945054945056,82152200,33,6
0,722,0.13739545997610514,0.17023096663815226,68534501,837,115
1,1074,0.25,0.5786267995570321,66931760,1432,358
0,254,0.18849840255591055,0.3245192307692308,67140171,313,59
0,258,0.2434017595307918,0.48542458808618505,80130004,341,83
0,595,0.21916010498687663,0.4968203497615262,82109662,762,167
0,2103,0.06491774121831925,0.14642857142857144,69383664,2249,146
1,122,0.2988505747126437,0.7396694214876033,69579202,174,52
0,996,0.20952380952380953,0.3835616438356164,66471356,1260,264
0,1219,0.11794500723589002,0.09961928934010152,66471412,1382,163
0,1375,0.24781181619256018,0.4789473684210526,62510245,1828,453
1,627,0.308710033076075,0.6184895833333334,69617450,907,280
1,206,0.4731457800511509,0.9030470914127424,66468850,391,185
0,594,0.1489971346704871,0.23620309050772628,68542964,698,104
0,1774,0.1367396593673966,0.1753402722177742,69960366,2055,281
1,64,0.2558139534883721,0.5735294117647058,82126681,86,22
0,563,0.09630818619582665,0.20662983425414364,62413764,623,60
0,427,0.06153846153846154,0.2689274447949527,62836284,455,28
1,320,0.24882629107981222,0.5019305019305019,67553276,426,106
1,70,0.4017094017094017,0.9390862944162437,67557413,117,47
0,218,0.102880658436214,0.15072463768115943,69416431,243,25
0,910,0.1069676153091266,0.13988559542381696,69416445,1019,109
0,145,0.05844155844155844,0.036016949152542374,69416900,154,9
1,307,0.4174573055028463,0.9141347424042272,80120452,527,220
0,1642,0.22946973251994368,0.3970885564092196,81971206,2131,489
0,469,0.1503623188405797,0.23661148977604674,68642462,552,83
1,137,0.2594594594594595,0.5105740181268882,69177304,185,48
0,10,0.2857142857142857,0.4,69179642,14,4
1,536,0.2276657060518732,0.5108695652173914,68543811,694,158
0,341,0.09066666666666667,0.21642764015645372,70660324,375,34
0,625,0.1610738255033557,0.31154381084840055,80140162,745,120
0,170,0.02857142857142857,0.02891566265060241,63780402,175,5
1,28,0.0967741935483871,0.5142857142857142,80089653,31,3
1,309,0.40576923076923077,0.8309037900874635,69162583,520,211
0,481,0.1590909090909091,0.25542570951585974,81979687,572,91
0,346,0.059782608695652176,0.04679144385026738,82043308,368,22
2,324,0.5317919075144508,0.9479638009049773,80181494,692,368
1,1100,0.27916120576671033,0.6457853523721787,81976693,1526,426
1,435,0.36496350364963503,0.8647925033467202,69165040,685,250
0,1354,0.19596199524940616,0.4103950103950104,74095770,1684,330
1,88,0.375886524822695,0.8716814159292036,69660423,141,53
1,743,0.23005181347150258,0.5131926121372031,68535152,965,222
0,882,0.229020979020979,0.49941176470588233,68535145,1144,262
0,1579,0.1627783669141039,0.26194086429112967,70617183,1886,307
0,690,0.1986062717770035,0.29904761904761906,66471566,861,171
1,1276,0.38088306647258613,0.8532070598364184,70607040,2061,785
0,651,0.20899149453219928,0.3913357400722022,67556440,823,172
1,338,0.36466165413533835,0.8530997304582211,68751522,532,194
0,94,0.12149532710280374,0.19123505976095617,69416305,107,13
0,340,0.12596401028277635,0.15571428571428572,70614810,389,49
0,390,0.24124513618677043,0.4345864661654135,81956097,514,124
1,744,0.3673469387755102,0.829105473965287,82062461,1176,432
1,1166,0.39112271540469973,0.8544973544973545,80134995,1915,749
0,3073,0.23117338003502627,0.48369429922827983,70614600,3997,924
1,172,0.29218106995884774,0.6477832512315271,67551890,243,71
0,313,0.1806282722513089,0.3342981186685962,68744753,382,69
1,3252,0.2887139107611549,0.6923984891406988,64275841,4572,1320
1,1013,0.35600762873490144,0.8147768086198051,67751222,1573,560
1,608,0.3620146904512067,0.8371454711802379,69073494,953,345
0,39,0.1875,0.3211009174311927,70062650,48,9
1,168,0.33067729083665337,0.7127937336814621,81967348,251,83
0,831,0.1415289256198347,0.2714987714987715,63322035,968,137
2,43,0.5865384615384616,0.9895833333333334,68441016,104,61
0,222,0.14285714285714285,0.24452554744525548,69221320,259,37
1,1262,0.21954236239950525,0.5143903715332286,70687736,1617,355
1,848,0.2721030042918455,0.640183346065699,80130747,1165,317
0,330,0.21428571428571427,0.38054607508532423,67706863,420,90
0,373,0.18201754385964913,0.3862536302032914,64214101,456,83
0,119,0.2119205298013245,0.3590504451038576,73669050,151,32
1,112,0.4666666666666667,0.9712918660287081,80110702,210,98
1,375,0.35456110154905335,0.8292964244521338,67652984,581,206
0,759,0.12958715596330275,0.15278733654507914,68542852,872,113
1,1033,0.22852875280059745,0.6394335511982571,69704005,1339,306
1,434,0.49061032863849763,0.9307359307359307,70576646,852,418
0,170,0.178743961352657,0.29945054945054944,67154766,207,37
0,63,0.07352941176470588,0.32894736842105265,60541712,68,5
1,983,0.2750737463126844,0.6140736668499175,80180147,1356,373
0,1948,0.14523913997367266,0.22763661677688826,67478852,2279,331
1,719,0.24790794979079497,0.5379984951091046,70870891,956,237
0,1138,0.21571330117160578,0.3733098177542622,70719971,1451,313
0,844,0.1684729064039409,0.26396327467482783,70646121,1015,171
0,866,0.07872340425531915,0.07003257328990228,70646415,940,74
2,542,0.5343642611683849,0.9863301787592008,66505796,1164,622
0,461,0.1855123674911661,0.34382284382284384,68533920,566,105
1,620,0.2565947242206235,0.6138433515482696,68533934,834,214
1,501,0.24434389140271492,0.6100502512562814,80121157,663,162
1,1351,0.28857293312269616,0.6842340330504689,80108511,1899,548
1,88,0.38028169014084506,0.7518248175182481,69167462,142,54
0,626,0.19225806451612903,0.359626802374894,80097682,775,149
0,945,0.2323314378554021,0.4550438596491228,74446155,1231,286
1,230,0.2459016393442623,0.519434628975265,68600784,305,75
1,691,0.37859712230215825,0.8190883190883191,80140043,1112,421
0,1170,0.17256011315417255,0.29802414928649834,65355255,1414,244
1,301,0.30324074074074076,0.759581881533101,68115530,432,131
1,166,0.2420091324200913,0.5724381625441696,70215943,219,53
1,80,0.40298507462686567,0.86,80110226,134,54
0,206,0.11587982832618025,0.17142857142857143,80071152,233,27
1,657,0.48470588235294115,0.9201754385964912,70057246,1275,618
1,690,0.4142614601018676,0.9098164405426975,63774620,1178,488
1,1536,0.36,0.8347707671357241,68563453,2400,864
1,1215,0.3005181347150259,0.7121057985757884,69585915,1737,522
0,2000,0.20729290527150218,0.413166144200627,82038983,2523,523
0,1070,0.1856925418569254,0.38691588785046727,68538120,1314,244
1,1350,0.2931937172774869,0.6731678486997635,66817261,1910,560
0,1136,0.0718954248366013,0.1862514688601645,67796540,1224,88
0,585,0.0594855305466238,0.15327102803738318,70001491,622,37
0,223,0.04700854700854701,0.12350597609561753,70001736,234,11
0,135,0.055944055944055944,0.1796875,70001771,143,8
0,75,0.23469387755102042,0.4716981132075472,63050883,98,23
0,187,0.041025641025641026,0.18851251840942562,62834863,195,8
0,72,0.22580645161290322,0.41714285714285715,67215575,93,21
0,210,0.21348314606741572,0.398422090729783,61584131,267,57
1,2801,0.2644432773109244,0.6320459290187892,67810281,3808,1007
0,642,0.14854111405835543,0.20689655172413793,77676424,754,112
1,485,0.3584656084656085,0.768033946251768,80178613,756,271
2,0,1.0,1.0,70608832,2,2
1,124,0.43119266055045874,0.8475609756097561,69588155,218,94
2,1,0.5,0.5,80180011,2,1
1,399,0.26519337016574585,0.6426966292134831,66931235,543,144
1,333,0.3231707317073171,0.7850877192982456,67305700,492,159
1,431,0.48444976076555024,0.9320987654320988,62512226,836,405
0,128,0.2147239263803681,0.2717391304347826,82005357,163,35
0,319,0.06725146198830409,0.3016032064128257,62839560,342,23
0,766,0.06012269938650307,0.23660262891809908,62837985,815,49
0,2083,0.0510250569476082,0.12931276297335204,68254634,2195,112
1,2774,0.3756470853027234,0.8628393665158371,70748356,4443,1669
0,91,0.21551724137931033,0.37398373983739835,82126676,116,25
1,192,0.27547169811320754,0.5882352941176471,69692980,265,73
1,580,0.360529217199559,0.800339847068819,80124673,907,327
1,160,0.4405594405594406,0.9,67970994,286,126
1,231,0.45390070921985815,0.8384615384615385,80180243,423,192
0,182,0.14953271028037382,0.205607476635514,66471272,214,32
0,1504,0.13711990820424555,0.17667570709027508,69239933,1743,239
0,738,0.0390625,0.12189205579138872,70251041,768,30
0,2811,0.1766256590509666,0.4927423535510627,70701064,3414,603
1,236,0.23870967741935484,0.5359712230215827,80121149,310,74
0,1752,0.17123935666982024,0.305052063247204,72692634,2114,362
1,1890,0.4067796610169492,0.8566941499803691,80125818,3186,1296
0,1221,0.19671052631578947,0.48044925124792015,67810022,1520,299
1,702,0.24271844660194175,0.5270164447924823,66930682,927,225
1,616,0.32603938730853393,0.7427222659323367,69089615,914,298
0,431,0.23851590106007067,0.47229551451187335,69165474,566,135
0,416,0.2490974729241877,0.494910941475827,69165600,554,138
0,1091,0.2105643994211288,0.4569343065693431,73266354,1382,291
1,144,0.32075471698113206,0.7543859649122807,80097171,212,68
0,269,0.19461077844311378,0.3378640776699029,80114713,334,65
0,1259,0.15503355704697985,0.24556062912227294,68541830,1490,231
1,7,0.36363636363636365,0.7,70253715,11,4
1,334,0.24263038548752835,0.5063025210084033,70850654,441,107
0,2394,0.12531969309462915,0.2742336371168186,77688226,2737,343
1,1132,0.3072215422276622,0.7275175013462574,68448821,1634,502
1,2044,0.4247115113988179,0.8725526413003325,70822325,3553,1509
0,134,0.18787878787878787,0.29694323144104806,70748874,165,31
1,151,0.43018867924528303,0.9084249084249084,73588382,265,114
0,685,0.14588528678304238,0.21139430284857572,68537224,802,117
0,1375,0.12140575079872204,0.1831180811808118,54609562,1565,190
0,587,0.16142857142857142,0.2613941018766756,70769860,700,113
2,62,0.6574585635359116,0.9473684210526315,80155214,181,119
1,951,0.26450116009280744,0.5339398180545836,70653723,1293,342
1,5522,0.25094953879544224,0.5062785388127854,70911435,7372,1850
0,376,0.2310838445807771,0.384703196347032,74346076,489,113
1,742,0.34044444444444444,0.7953568357695615,80108476,1125,383
0,1519,0.12650948821161587,0.15713621571362157,68538953,1739,220
0,289,0.1994459833795014,0.34763948497854075,80180225,361,72
1,516,0.3493064312736444,0.8413510747185261,63099834,793,277
1,114,0.36312849162011174,0.75,80053435,179,65
0,794,0.19635627530364372,0.4349525404801787,80118422,988,194
0,1508,0.05216844751728473,0.031221719457013575,82012515,1591,83
0,485,0.0779467680608365,0.08902077151335312,62940304,526,41
1,816,0.2547945205479452,0.6056096164854036,70049385,1095,279
0,631,0.21905940594059406,0.3488120950323974,66028900,808,177
1,118,0.2716049382716049,0.624113475177305,73637774,162,44
0,1756,0.16061185468451242,0.2717041800643087,73700690,2092,336
0,559,0.2059659090909091,0.45577211394302847,75459020,704,145
1,588,0.265,0.6118598382749326,80180469,800,212
0,1314,0.21223021582733814,0.34274193548387094,72331735,1668,354
0,900,0.137104506232023,0.15839243498817968,70645015,1043,143
0,736,0.07884856070087609,0.06859903381642513,70645162,799,63
1,34,0.38181818181818183,0.6136363636363636,68716494,55,21
1,618,0.27208480565371024,0.6393939393939394,70252693,849,231
1,579,0.3918067226890756,0.871866295264624,67994304,952,373
1,767,0.3650662251655629,0.7956204379562044,70418411,1208,441
1,128,0.350253807106599,0.7482014388489209,70891996,197,69
1,127,0.3385416666666667,0.7482758620689656,70892010,192,65
2,640,0.5721925133689839,0.9777138749101366,65865842,1496,856
1,1160,0.3271461716937355,0.7233595800524935,69998264,1724,564
1,538,0.2569060773480663,0.553832902670112,70207025,724,186
1,66,0.4406779661016949,0.8857142857142857,73026394,118,52
1,996,0.3561732385261797,0.7786964980544747,81971141,1547,551
1,681,0.3330068560235064,0.7536855036855037,81971145,1021,340
2,164,0.5603217158176944,0.9333333333333333,74362274,373,209
0,395,0.23449612403100775,0.43572241183162685,71389241,516,121
0,142,0.2111111111111111,0.47752808988764045,80109673,180,38
1,62,0.46551724137931033,0.7228915662650602,69587770,116,54
1,60,0.4957983193277311,0.8181818181818182,80128853,119,59
1,38,0.2692307692307692,0.5315315315315315,80135271,52,14
0,368,0.16930022573363432,0.3032694475760992,64217524,443,75
1,415,0.4945188794153471,0.9276595744680851,70009660,821,406
0,502,0.07889908256880734,0.1261061946902655,80140159,545,43
1,65,0.48,0.927461139896373,15883,125,60
1,77,0.32456140350877194,0.8393574297188755,80180992,114,37
0,875,0.16427889207258833,0.24920127795527156,70093065,1047,172
1,208,0.2597864768683274,0.5409252669039146,70655095,281,73
0,368,0.12380952380952381,0.2702380952380952,70660352,420,52
1,179,0.31153846153846154,0.714902807775378,73029593,260,81
0,40,0.23076923076923078,0.48404255319148937,74676280,52,12
0,140,0.19540229885057472,0.34417344173441733,80119053,174,34
0,1498,0.0707196029776675,0.059233449477351915,80119341,1612,114
1,596,0.412807881773399,0.91996699669967,80120450,1015,419
1,171,0.36900369003690037,0.8151898734177215,65384396,271,100
1,568,0.2661498708010336,0.5771428571428572,74708774,774,206
1,352,0.21428571428571427,0.6027522935779817,68413261,448,96
1,206,0.4621409921671018,0.8980099502487562,80125423,383,177
2,432,0.5947467166979362,0.9545454545454546,67349716,1066,634
0,542,0.2178932178932179,0.4106628242074928,67479104,693,151
1,1073,0.25589459084604715,0.5942921096810296,69869422,1442,369
0,694,0.18160377358490565,0.3395017793594306,63279622,848,154
0,877,0.21905609973285842,0.4189473684210526,67554410,1123,246
0,2873,0.08210862619808307,0.06686429512516469,68534543,3130,257
0,156,0.22,0.4371069182389937,69681094,200,44
1,1313,0.2974852862493312,0.7074317968015051,68545652,1869,556
1,126,0.373134328358209,0.8759124087591241,69154162,201,75
0,1625,0.1402116402116402,0.2007318348144276,69165313,1890,265
1,508,0.2583941605839416,0.526416906820365,80107776,685,177
1,116,0.4751131221719457,0.9660377358490566,80127352,221,105
1,47,0.3088235294117647,0.5686274509803921,82004786,68,21
1,203,0.3141891891891892,0.7195121951219512,69165502,296,93
0,379,0.12471131639722864,0.1085972850678733,66471321,433,54
1,662,0.31611570247933884,0.6884838442419221,69164914,968,306
1,491,0.2852983988355167,0.6930232558139535,72387455,687,196
1,515,0.36654366543665434,0.8250401284109149,67136832,813,298
1,349,0.17494089834515367,0.5007299270072992,70909090,423,74
1,366,0.17381489841986456,0.514792899408284,70909125,443,77
1,153,0.44765342960288806,0.9224598930481284,79807644,277,124
0,471,0.08187134502923976,0.10470588235294118,67285750,513,42
0,671,0.2077922077922078,0.4033816425120773,70670362,847,176
1,111,0.26490066225165565,0.5467625899280576,67556111,151,40
1,63,0.3942307692307692,0.918918918918919,80135825,104,41
0,208,0.018867924528301886,0.0398406374501992,62840680,212,4
0,276,0.12933753943217666,0.3862928348909657,63999320,317,41
0,604,0.07926829268292683,0.30893300248138955,68798093,656,52
0,123,0.031496062992125984,0.10077519379844961,68798121,127,4
1,183,0.34408602150537637,0.8284023668639053,69499493,279,96
0,116,0.14074074074074075,0.3839541547277937,80135207,135,19
1,26,0.1875,0.5473684210526316,82103831,32,6
1,346,0.27310924369747897,0.6369426751592356,66206476,476,130
1,881,0.3756201275690999,0.8680597014925373,69603576,1411,530
1,37,0.3392857142857143,0.7191011235955056,67993926,56,19
1,204,0.28421052631578947,0.5831265508684863,70644693,285,81
0,164,0.215311004784689,0.42671009771986973,73113551,209,45
0,742,0.1819184123484013,0.2692967409948542,74320106,907,165
0,1059,0.13267813267813267,0.13676371022342587,74320120,1221,162
0,1105,0.06435224386113463,0.13249211356466878,70001652,1181,76
1,214,0.2842809364548495,0.6571428571428571,80168511,299,85
1,871,0.4549436795994994,0.9098124098124099,69284922,1598,727
0,357,0.23390557939914164,0.4941588785046729,77065093,466,109
1,818,0.3678516228748068,0.8347653668208856,69573896,1294,476
1,11,0.3888888888888889,0.8723404255319149,65235674,18,7
1,1333,0.4780736100234926,0.9094202898550725,80181006,2554,1221
0,1108,0.22026741731175228,0.4186173108328797,69607300,1421,313
0,716,0.22844827586206898,0.42662389735364875,69607356,928,212
1,1208,0.3065442020665901,0.6830427892234548,80108175,1742,534
0,93,0.23770491803278687,0.481651376146789,67555292,122,29
0,337,0.2340909090909091,0.4736196319018405,65312772,440,103
0,132,0.23255813953488372,0.4318181818181818,70912660,172,40
1,1162,0.41870935467733866,0.8986682107701216,69267821,1999,837
1,1547,0.29489516864175025,0.6294681778552746,70631253,2194,647
1,747,0.25892857142857145,0.6256895193065406,67942574,1008,261
0,157,0.2523809523809524,0.4756637168141593,80145290,210,53
1,1044,0.4128233970753656,0.9030906233630173,60971834,1778,734
1,276,0.4945054945054945,0.9422382671480144,82023521,546,270
1,494,0.2713864306784661,0.6402164111812444,72882831,678,184
0,458,0.09664694280078895,0.12639821029082773,80114342,507,49
1,1262,0.2914093206064009,0.6860616587060356,80119026,1781,519
1,998,0.3731155778894472,0.887620719929763,63841414,1592,594
1,876,0.27603305785123966,0.5835843373493976,70658280,1210,334
0,403,0.1425531914893617,0.17109634551495018,78863232,470,67
1,460,0.49394939493949397,0.9472182596291013,72315033,909,449
1,675,0.36079545454545453,0.8346938775510204,67552324,1056,381
2,254,0.5658119658119658,0.9712230215827338,69588890,585,331
1,360,0.4019933554817276,0.8344459279038718,68189611,602,242
0,1272,0.23234761617380809,0.4535225048923679,80105823,1657,385
1,265,0.46356275303643724,0.95,80130000,494,229
1,271,0.3532219570405728,0.7511111111111111,73418205,419,148
1,101,0.3803680981595092,0.7959183673469388,81989280,163,62
0,132,0.06382978723404255,0.11382113821138211,80124168,141,9
0,137,0.16463414634146342,0.44668587896253603,80124372,164,27
1,359,0.296078431372549,0.6502659574468085,64238776,510,151
1,86,0.25862068965517243,0.515358361774744,69059662,116,30
1,1167,0.26045627376425856,0.5221323179438363,70658581,1578,411
0,293,0.21447721179624665,0.4473684210526316,70525455,373,80
2,23,0.5106382978723404,0.9298245614035088,79792223,47,24
0,646,0.09269662921348315,0.12509252405625462,80098550,712,66
0,1712,0.05674931129476584,0.11237623762376238,68242244,1815,103
0,1949,0.023547094188376753,0.02334267040149393,68242356,1996,47
1,272,0.23809523809523808,0.5648535564853556,68019826,357,85
1,213,0.432,0.8787234042553191,69982934,375,162
0,506,0.17857142857142858,0.2735674676524954,69489280,616,110
1,984,0.385,0.7844311377245509,80174920,1600,616
1,899,0.26008230452674896,0.5737246680642907,69165411,1215,316
0,90,0.1509433962264151,0.42152466367713004,18906335,106,16
0,1455,0.21478683216405828,0.4211013419713096,67435830,1853,398
2,580,0.5265306122448979,0.9755067567567568,80127461,1225,645
0,443,0.15458015267175573,0.25544794188861986,67554865,524,81
0,358,0.1536643026004728,0.26863572433192684,67555691,423,65
2,993,0.5617828773168579,0.9729064039408867,64244250,2266,1273
1,922,0.26825396825396824,0.5895691609977324,72393440,1260,338
0,635,0.15220293724966621,0.25287356321839083,73473960,749,114
0,816,0.15527950310559005,0.20401106500691563,82036904,966,150
1,1212,0.328159645232816,0.776551724137931,68236245,1804,592
1,163,0.4379310344827586,0.9454545454545454,82096422,290,127
1,66,0.3944954128440367,0.8089171974522293,80176670,109,43
0,916,0.1588613406795225,0.3662227602905569,70691173,1089,173
2,86,0.5274725274725275,0.9423076923076923,80172011,182,96
0,336,0.1662531017369727,0.245014245014245,67554333,403,67
0,2323,0.20445205479452055,0.31259968102073366,72748893,2920,597
0,283,0.19602272727272727,0.2717391304347826,72749250,352,69
0,95,0.22131147540983606,0.42805755395683454,69394150,122,27
1,676,0.2628135223555071,0.6252173913043478,69869436,917,241
0,5855,0.14250146455770357,0.3643097643097643,70691005,6828,973
1,197,0.39570552147239263,0.8946188340807175,80119028,326,129
0,2723,0.2166283084004603,0.43675131768088166,82000008,3476,753
1,61,0.32967032967032966,0.8292682926829268,80108910,91,30
1,152,0.4882154882154882,0.9351032448377581,72315026,297,145
1,301,0.26941747572815533,0.5348101265822784,82021924,412,111
2,8,0.5294117647058824,0.8823529411764706,79792405,17,9
1,2021,0.3622593878195014,0.8133039323778023,18025,3169,1148
1,729,0.2606490872210953,0.516320474777448,67994640,986,257
0,368,0.16363636363636364,0.32585596221959856,72900555,440,72
1,221,0.22996515679442509,0.5226586102719033,82011794,287,66
0,44,0.08333333333333333,0.10497237569060773,82011797,48,4
0,77,0.04938271604938271,0.03,82011798,81,4
0,568,0.20448179271708683,0.35542168674698793,68191221,714,146
1,495,0.3843283582089552,0.8407005838198499,77215670,804,309
0,285,0.22131147540983606,0.4957841483979764,77676354,366,81
2,25,0.5283018867924528,0.9583333333333334,79792363,53,28
1,350,0.291497975708502,0.6977401129943502,67552506,494,144
0,127,0.08633093525179857,0.2607655502392344,74923954,139,12
0,71,0.05333333333333334,0.17194570135746606,74924325,75,4
1,124,0.37055837563451777,0.8217821782178217,63189455,197,73
1,317,0.29555555555555557,0.6401384083044983,80111514,450,133
0,334,0.13246753246753246,0.22583926754832145,80140163,385,51
1,425,0.33176100628930816,0.7446270543615676,70874153,636,211
1,1103,0.2627005347593583,0.5864955357142857,80125357,1496,393
0,266,0.13355048859934854,0.4675118858954041,69133841,307,41
1,433,0.28665568369028005,0.6693386773547094,68537392,607,174
1,707,0.23484848484848486,0.5223179326546593,68545050,924,217
0,514,0.15599343185550082,0.2728592162554427,69073326,609,95
1,264,0.4709418837675351,0.8810483870967742,63064295,499,235
1,885,0.4971590909090909,0.9576167076167076,73404240,1760,875
1,1393,0.24986537425955843,0.5784392598551891,81976688,1857,464
0,278,0.19420289855072465,0.4901315789473684,64002792,345,67
0,752,0.08068459657701711,0.20397579948141745,67343283,818,66
0,1414,0.06481481481481481,0.13926174496644295,67343374,1512,98
1,1044,0.33205374280230326,0.7906683480453972,69586293,1563,519
0,1400,0.21612541993281076,0.3676721684689812,67145743,1786,386
1,123,0.25,0.5309446254071661,68533115,164,41
1,343,0.330078125,0.7737430167597765,69180335,512,169
0,1135,0.08688656476267095,0.2327831531018782,67796470,1243,108
0,176,0.1813953488372093,0.4066666666666667,64158941,215,39
0,1649,0.15174897119341563,0.18962722852512157,68530672,1944,295
1,199,0.27898550724637683,0.5749440715883669,80108364,276,77
0,1431,0.04344919786096257,0.020931802835921675,69167770,1496,65
0,1161,0.07416267942583732,0.07230769230769231,69167945,1254,93
0,2473,0.12676553672316385,0.14791924186238153,69699056,2832,359
0,111,0.16541353383458646,0.47766323024054985,60552765,133,22
1,928,0.42108546475358705,0.8266666666666667,69511792,1603,675
2,508,0.5238987816307404,0.977116704805492,68115551,1067,559
1,731,0.29846449136276393,0.7520117044623262,68542614,1042,311
0,329,0.049132947976878616,0.16308040770101925,66876586,346,17
0,253,0.055970149253731345,0.25544267053701014,68811652,268,15
0,566,0.17612809315866085,0.31595829991980756,66931704,687,121
1,308,0.29357798165137616,0.6521008403361345,80107993,436,128
1,547,0.3312958435207824,0.7387640449438202,65278234,818,271
0,60,0.0625,0.18181818181818182,74924290,64,4
0,805,0.17604912998976457,0.458307597282273,73366104,977,172
1,125,0.17763157894736842,0.5,65710344,152,27
0,252,0.19230769230769232,0.48879837067209775,68386612,312,60
0,272,0.10819672131147541,0.27958833619210977,80155838,305,33
0,16,0.0,0.0,82150134,16,0
0,958,0.17056277056277055,0.35674931129476584,68537084,1155,197
1,242,0.17687074829931973,0.5224839400428265,69389306,294,52
0,74,0.2127659574468085,0.4036697247706422,80176734,94,20
1,81,0.36220472440944884,0.8490566037735849,62815263,127,46
1,536,0.24186704384724186,0.5392231530845393,80120474,707,171
1,98,0.3466666666666667,0.7607655502392344,73650794,150,52
0,1506,0.2098635886673662,0.41219407471017605,68542453,1906,400
0,335,0.16666666666666666,0.28296703296703296,68542586,402,67
0,1047,0.17559055118110237,0.31731784582893346,69239926,1270,223
1,1056,0.25998598458304134,0.5886075949367089,80109505,1427,371
0,1182,0.13152094048493754,0.1423841059602649,77676410,1361,179
1,541,0.2890932982917214,0.6796116504854369,69608161,761,220
1,188,0.25396825396825395,0.5874587458745875,69522334,252,64
1,78,0.2571428571428571,0.5,80109680,105,27
1,350,0.22048997772828507,0.5042134831460674,66423924,449,99
1,602,0.23017902813299232,0.5650994575045208,68544154,782,180
1,43,0.25862068965517243,0.6601941747572816,69622042,58,15
1,134,0.3824884792626728,0.8198529411764706,68779424,217,83
1,151,0.25980392156862747,0.547945205479452,74646383,204,53
1,1013,0.2930914166085136,0.6999325691166555,74708781,1433,420
0,843,0.022041763341067284,0.0031746031746031746,80121022,862,19
1,111,0.3313253012048193,0.7248322147651006,80107811,166,55
1,674,0.39767649687220735,0.9057971014492754,66470950,1119,445
0,558,0.24390243902439024,0.43580131208997186,67553395,738,180
1,102,0.24444444444444444,0.5505226480836237,82126674,135,33
1,156,0.29411764705882354,0.696078431372549,82126797,221,65
0,62,0.1267605633802817,0.3923444976076555,70908845,71,9
1,119,0.3769633507853403,0.8647058823529412,80154139,191,72
0,747,0.2070063694267516,0.4241001564945227,63278992,942,195
0,604,0.12081513828238719,0.10591603053435114,67554921,687,83
0,1119,0.08653061224489796,0.27750247770069375,66389400,1225,106
1,150,0.336283185840708,0.8223350253807107,67694403,226,76
1,2080,0.2425345957756737,0.5437566702241196,80180135,2746,666
1,1343,0.25264329437952143,0.5932203389830508,68535061,1797,454
0,334,0.23218390804597702,0.3501006036217304,81956107,435,101
1,699,0.26421052631578945,0.5636634400595681,69177206,950,251
1,1156,0.3851063829787234,0.8461538461538461,70748482,1880,724
1,399,0.27454545454545454,0.7080436941410129,67846604,550,151
0,1181,0.028782894736842105,0.035975267003934795,68242412,1216,35
1,220,0.20863309352517986,0.6101398601398601,80165681,278,58
1,2995,0.2053595118068453,0.5675461741424802,70701050,3769,774
0,592,0.17433751743375175,0.31405895691609975,68539380,717,125
1,611,0.23433583959899748,0.5296722763507529,68542362,798,187
0,1752,0.1665080875356803,0.2822177822177822,80180386,2102,350
1,107,0.3096774193548387,0.6592592592592592,70909664,155,48
0,26,0.21212121212121213,0.21739130434782608,69184556,33,7
0,266,0.2153392330383481,0.4324712643678161,71389206,339,73
0,544,0.23163841807909605,0.32644017725258495,70251916,708,164
1,2064,0.2996267390566678,0.6389548693586699,80123758,2947,883
0,171,0.11398963730569948,0.18518518518518517,67653103,193,22
0,128,0.189873417721519,0.3181818181818182,70645484,158,30
1,1187,0.4017137096774194,0.87038158691702,67290734,1984,797
1,1203,0.2739891369945685,0.6596474045053868,65355066,1657,454
0,482,0.07839388145315487,0.08243243243243244,70646401,523,41
1,605,0.44393382352941174,0.9157345264727815,67306904,1088,483
0,190,0.1592920353982301,0.2608695652173913,68534004,226,36
1,1295,0.3472782258064516,0.7157079646017699,80162918,1984,689
1,57,0.3804347826086957,0.9064327485380117,66471055,92,35
1,118,0.2670807453416149,0.5936507936507937,66471062,161,43
1,83,0.319672131147541,0.7371428571428571,70005915,122,39
1,235,0.31486880466472306,0.7589641434262948,65365895,343,108
0,262,0.1437908496732026,0.15100671140939598,80174692,306,44
1,176,0.2931726907630522,0.7357630979498861,64030414,249,73
1,155,0.43014705882352944,0.9438202247191011,66931060,272,117
0,3504,0.05040650406504065,0.030882352941176472,70642313,3690,186
0,1339,0.10194500335345406,0.12519561815336464,70642376,1491,152
1,1943,0.30433225921947726,0.6633941093969145,80110716,2793,850
1,709,0.27505112474437626,0.5678438661710037,80111535,978,269
0,233,0.14652014652014653,0.35040983606557374,70617274,273,40
0,342,0.07065217391304347,0.0781078107810781,70641823,368,26
0,535,0.07599309153713299,0.06926070038910506,70643370,579,44
0,1345,0.1191879502292076,0.12793089263677498,67964106,1527,182
1,364,0.3333333333333333,0.7430703624733476,69092471,546,182
1,492,0.2202852614896989,0.5067497403946002,68537434,631,139
1,950,0.34797529169526425,0.8032573289902281,80107804,1457,507
1,1322,0.2975557917109458,0.6202418271383788,74347553,1882,560
1,202,0.30344827586206896,0.6372007366482505,80145293,290,88
1,78,0.376,0.7,81989289,125,47
1,175,0.35661764705882354,0.8392857142857143,65944942,272,97
1,289,0.40165631469979296,0.8625377643504532,67199356,483,194
1,468,0.2559618441971383,0.5653923541247485,68542180,629,161
1,1105,0.2623497997329773,0.6238361266294227,80110415,1498,393
1,878,0.32720306513409964,0.8052516411378556,80112214,1305,427
1,621,0.2562874251497006,0.6257615317667538,68545610,835,214
1,264,0.27472527472527475,0.6741996233521658,80121278,364,100
0,100,0.24242424242424243,0.3786407766990291,68995416,132,32
0,633,0.21851851851851853,0.3907637655417407,69705286,810,177
1,302,0.2669902912621359,0.5918854415274463,73024980,412,110
0,640,0.20398009950248755,0.39815526518063027,80108952,804,164
1,59,0.4778761061946903,0.9461538461538461,80110163,113,54
1,107,0.3668639053254438,0.7673267326732673,80110205,169,62
1,180,0.3155893536121673,0.7215909090909091,80136836,263,83
0,1480,0.03708523096942095,0.06396938217605248,67343353,1537,57
1,242,0.4622222222222222,0.8450413223140496,80180302,450,208
1,647,0.4349344978165939,0.8842815814850531,67568634,1145,498
1,117,0.37433155080213903,0.7510548523206751,69166412,187,70
1,262,0.2722222222222222,0.6127717391304348,82046886,360,98
0,1104,0.24279835390946503,0.4938434476693052,67555320,1458,354
1,225,0.23986486486486486,0.6401734104046243,68391876,296,71
0,412,0.08444444444444445,0.08705882352941176,68536272,450,38
1,954,0.2980132450331126,0.7658703071672355,68539975,1359,405
0,1341,0.09575185434929198,0.08045454545454546,70871150,1483,142
0,1402,0.12045169385194479,0.17285318559556787,74886231,1594,192
1,698,0.2675760755508919,0.5466666666666666,69839602,953,255
1,1285,0.31283422459893045,0.7472654001151411,78921416,1870,585
1,195,0.39814814814814814,0.926605504587156,70014063,324,129
0,1116,0.09268292682926829,0.108145106091718,68537056,1230,114
1,890,0.303054032889585,0.6490842490842491,70644455,1277,387
0,304,0.16939890710382513,0.3333333333333333,80119309,366,62
0,712,0.15639810426540285,0.22672758423757852,80139715,844,132
1,238,0.327683615819209,0.7929373996789727,70014035,354,116
1,1070,0.29045092838196285,0.6604834176503653,80107755,1508,438
1,155,0.27906976744186046,0.6075949367088608,70207515,215,60
0,381,0.14382022471910114,0.20022497187851518,67160254,445,64
0,435,0.13690476190476192,0.18411552346570398,70207144,504,69
1,421,0.4828009828009828,0.8937062937062937,70658742,814,393
1,438,0.2946859903381642,0.701067615658363,68542173,621,183
0,178,0.13170731707317074,0.2075,80097143,205,27
0,172,0.12690355329949238,0.17587939698492464,80097150,197,25
0,129,0.0979020979020979,0.10074626865671642,80097164,143,14
1,310,0.39571150097465885,0.9049295774647887,67159596,513,203
1,282,0.2713178294573643,0.6643356643356644,69603254,387,105
0,2385,0.12444933920704845,0.12822906940554,69240080,2724,339
1,322,0.31196581196581197,0.6345177664974619,67994122,468,146
1,348,0.4010327022375215,0.8586609989373007,73323110,581,233
1,535,0.3546441495778046,0.8236286919831224,65277471,829,294
1,1461,0.36780614452617916,0.843996840442338,80132192,2311,850
0,741,0.08856088560885608,0.10085836909871244,70524566,813,72
1,432,0.2739495798319328,0.6355685131195336,81967244,595,163
1,3785,0.24193871419987983,0.581057268722467,66765321,4993,1208
1,1882,0.29194883370955604,0.7028595109821799,69652975,2658,776
1,220,0.39226519337016574,0.8140043763676149,70286741,362,142
0,473,0.19283276450511946,0.4731574158325751,80097360,586,113
0,537,0.19610778443113772,0.36647009267059816,82000089,668,131
1,299,0.3770833333333333,0.889894419306184,69180041,480,181
1,1193,0.37734864300626303,0.8598958333333333,80110933,1916,723
1,23,0.3783783783783784,0.9117647058823529,80108805,37,14
1,430,0.35240963855421686,0.7632552404438965,70657636,664,234
0,9,0.1,0.23333333333333334,69726321,10,1
0,1154,0.17097701149425287,0.2875746066196419,69551755,1392,238
0,1653,0.05650684931506849,0.040568799665411964,82012514,1752,99
0,1184,0.18792866941015088,0.3256452498627128,67721976,1458,274
0,641,0.18447837150127228,0.37169650468883203,68541032,786,145
0,768,0.17419354838709677,0.3007246376811594,66381196,930,162
1,54,0.4375,0.8936170212765957,70234584,96,42
0,238,0.11851851851851852,0.36279926335174956,843381,270,32
0,182,0.037037037037037035,0.04888888888888889,67836951,189,7
1,218,0.21863799283154123,0.6548295454545454,68649203,279,61
1,450,0.3087557603686636,0.7660311958405546,69058073,651,201
0,302,0.19466666666666665,0.3985185185185185,81978733,375,73
1,687,0.41927303465765003,0.9240986717267552,70626724,1183,496
0,1332,0.16068052930056712,0.25489343192692476,67963350,1587,255
0,1445,0.1300421432871764,0.13996023856858847,67964176,1661,216
0,138,0.17365269461077845,0.21875,81956095,167,29
1,199,0.26022304832713755,0.6358792184724689,81980459,269,70
0,1329,0.11928429423459244,0.17169476486246674,69654256,1509,180
0,913,0.16315307057745188,0.3043230944254835,82011846,1091,178
1,2402,0.3456823753745573,0.7880197731898808,82039212,3671,1269
0,511,0.12048192771084337,0.2729439809296782,67343304,581,70
0,767,0.18055555555555555,0.33375235700817096,66931690,936,169
0,1698,0.19449715370018975,0.3891663465232424,66100804,2108,410
1,103,0.4340659340659341,0.9090909090909091,67057984,182,79
0,1024,0.14737718567860117,0.23161764705882354,82000068,1201,177
1,454,0.30153846153846153,0.7429171038824763,69073466,650,196
0,812,0.19042871385842472,0.2904062229904927,70720034,1003,191
1,862,0.25625539257981017,0.5741935483870968,65342445,1159,297
1,953,0.4834688346883469,0.936969696969697,74331803,1845,892
1,502,0.28591749644381226,0.6334056399132321,66383394,703,201
1,430,0.38483547925608014,0.843609022556391,69504806,699,269
0,456,0.15711645101663585,0.3210702341137124,80070725,541,85
1,287,0.22432432432432434,0.5562130177514792,82044807,370,83
1,464,0.3361945636623748,0.7391952309985097,76756701,699,235
0,956,0.1701388888888889,0.40762463343108507,65943731,1152,196
0,58,0.0,0.0,70908565,58,0
0,32,0.13513513513513514,0.3493975903614458,82150072,37,5
1,59,0.358695652173913,0.808641975308642,80108840,92,33
1,78,0.4090909090909091,0.9296875,82126792,132,54
1,269,0.3914027149321267,0.8772241992882562,67551862,442,173
0,497,0.1744186046511628,0.32139201637666326,70207214,602,105
2,89,0.677536231884058,0.9720670391061452,69129606,276,187
0,214,0.15748031496062992,0.40226171243941844,74923793,254,40
0,356,0.1623529411764706,0.2945205479452055,81979686,425,69
0,50,0.07407407407407407,0.24352331606217617,82150111,54,4
1,998,0.255779269202088,0.5628342245989305,67511416,1341,343
1,58,0.2839506172839506,0.6258064516129033,80161488,81,23
1,617,0.3470899470899471,0.779547359597653,80162105,945,328
1,150,0.4584837545126354,0.9208211143695014,80162176,277,127
1,971,0.24670287044220326,0.5135135135135135,67940474,1289,318
1,576,0.4086242299794661,0.8679562657695542,68211850,974,398
1,470,0.39588688946015427,0.8757346767422334,65840012,778,308
0,520,0.11864406779661017,0.11498708010335917,70646331,590,70
0,1865,0.12028301886792453,0.11743951612903226,70646674,2120,255
1,294,0.2422680412371134,0.6357723577235772,64001161,388,94
0,20,0.13043478260869565,0.23170731707317074,65716861,23,3
1,211,0.3127035830618892,0.7576374745417516,69926304,307,96
1,264,0.4556701030927835,0.9688013136288999,67556412,485,221
0,2129,0.031832651205093224,0.04684232538686742,62413883,2199,70
0,122,0.08955223880597014,0.12222222222222222,68299714,134,12
0,132,0.0896551724137931,0.10087719298245613,69100885,145,13
0,52,0.10344827586206896,0.1623931623931624,69100976,58,6
0,150,0.17582417582417584,0.24705882352941178,70645974,182,32
0,443,0.1279527559055118,0.17253521126760563,69603303,508,65
0,231,0.11494252873563218,0.42613636363636365,76805610,261,30
0,250,0.08088235294117647,0.31958762886597936,76805631,272,22
0,310,0.17333333333333334,0.2922705314009662,64158801,375,65
1,950,0.2770167427701674,0.6823222439660795,80112361,1314,364
1,587,0.23963730569948186,0.5048327137546469,80125447,772,185
0,494,0.2032258064516129,0.35450346420323325,70207123,620,126
1,1306,0.28905824714207945,0.6620370370370371,67557896,1837,531
2,20,0.5348837209302325,0.9857142857142858,80129780,43,23
0,2465,0.2296875,0.47332077840552417,68535201,3200,735
1,183,0.27380952380952384,0.6359550561797753,69607594,252,69
0,847,0.13747454175152748,0.17984189723320157,80156737,982,135
0,1362,0.15925925925925927,0.27134146341463417,80121146,1620,258
1,612,0.2653061224489796,0.5089408528198074,67752650,833,221
1,613,0.31737193763919824,0.6611661166116611,70645281,898,285
0,1933,0.1362823949955317,0.3468208092485549,65467150,2238,305
1,615,0.3546694648478489,0.7951363301400147,68212053,953,338
1,59,0.3854166666666667,0.8426966292134831,80156770,96,37
1,288,0.2538860103626943,0.7378318584070797,65261833,386,98
0,375,0.13793103448275862,0.18872549019607843,70524601,435,60
0,246,0.10545454545454545,0.13421828908554573,72493750,275,29
0,89,0.043010752688172046,0.1649746192893401,62836704,93,4
0,284,0.21329639889196675,0.4780023781212842,80116561,361,77
2,461,0.5376128385155466,0.9464285714285714,80125796,997,536
2,774,0.5661434977578476,0.9397501836884644,70117124,1784,1010
0,636,0.08882521489971347,0.15486432825943083,80140149,698,62
0,83,0.15306122448979592,0.3407079646017699,80155843,98,15
0,139,0.12578616352201258,0.4269340974212034,82150070,159,20
1,109,0.31875,0.5527950310559007,68401473,160,51
0,2322,0.15991316931982633,0.2543116964565695,70871185,2764,442
1,983,0.24151234567901234,0.5150265173836182,68537252,1296,313
0,600,0.19463087248322147,0.3659574468085106,68537280,745,145
1,667,0.24887387387387389,0.5689102564102564,67291742,888,221
1,260,0.3719806763285024,0.836038961038961,67766615,414,154
0,692,0.2045977011494253,0.30484330484330485,66838751,870,178
2,15,0.8275862068965517,0.9545454545454546,57050196,87,72
0,2039,0.21607074202229912,0.4332531569452796,67688215,2601,562
1,516,0.2411764705882353,0.5259336099585062,72293795,680,164
1,283,0.38611713665943603,0.874251497005988,63112462,461,178
0,370,0.25252525252525254,0.4257748776508972,70646492,495,125
1,266,0.4267241379310345,0.9201183431952663,64410493,464,198
1,359,0.38421955403087477,0.842809364548495,65835455,583,224
1,87,0.28688524590163933,0.5857142857142857,70710150,122,35
0,479,0.0735009671179884,0.0706896551724138,62940262,517,38
0,297,0.13411078717201166,0.23444976076555024,62940486,343,46
0,350,0.07894736842105263,0.08235294117647059,69416011,380,30
1,431,0.2792642140468227,0.6879699248120301,70618520,598,167
1,1489,0.40224809313528703,0.9059431524547804,78921381,2491,1002
1,1098,0.34290843806104127,0.8246505717916137,78921402,1671,573
0,702,0.18561484918793503,0.3066132264529058,82009368,862,160
1,1452,0.30857142857142855,0.682842287694974,67993961,2100,648
1,4241,0.21781630394688306,0.5037024281040124,61743094,5422,1181
0,7,0.0,0.0,62516804,7,0
0,529,0.23333333333333334,0.49349593495934957,80121078,690,161
1,258,0.3484848484848485,0.8412162162162162,69091694,396,138
1,53,0.4536082474226804,0.9473684210526315,80127349,97,44
1,223,0.32831325301204817,0.744466800804829,82126709,332,109
1,456,0.17689530685920576,0.5338253382533825,60909233,554,98
1,106,0.3977272727272727,0.7984496124031008,69150935,176,70
0,353,0.08549222797927461,0.29517241379310344,69701380,386,33
0,18,0.14285714285714285,0.3620689655172414,70680771,21,3
0,122,0.10294117647058823,0.1330049261083744,70566874,136,14
1,86,0.3435114503816794,0.8062283737024222,81971178,131,45
1,280,0.44223107569721115,0.8683274021352313,69550306,502,222
0,2003,0.031431334622823985,0.025925925925925925,80137165,2068,65
0,327,0.1825,0.2896551724137931,70566643,400,73
0,482,0.08538899430740038,0.11092436974789915,70566762,527,45
0,122,0.18120805369127516,0.25,70566853,149,27
0,1463,0.08448060075093868,0.08198549916341327,72707243,1598,135
1,35,0.4262295081967213,0.759493670886076,80161897,61,26
1,19,0.40625,0.7575757575757576,80161899,32,13
2,20,0.6153846153846154,0.9803921568627451,72417184,52,32
0,123,0.08888888888888889,0.2374429223744292,72417450,135,12
2,21,0.5882352941176471,0.8571428571428571,75576424,51,30
1,29,0.4528301886792453,0.875,72803353,53,24
0,291,0.07911392405063292,0.08423326133909287,70566832,316,25
1,1087,0.29644012944983816,0.6262434864992894,73024973,1545,458
2,85,0.6875,0.9908675799086758,80104472,272,187
0,612,0.049689440993788817,0.10233160621761658,69701114,644,32
2,103,0.5,0.9267399267399268,70586040,206,103
1,569,0.3815217391304348,0.9079189686924494,68542285,920,351
1,727,0.2649140546006067,0.5985130111524164,75459006,989,262
0,1500,0.2130115424973767,0.42574257425742573,80118630,1906,406
0,204,0.241635687732342,0.4855072463768116,64173753,269,65
1,4014,0.22658959537572254,0.6018455998199415,68801096,5190,1176
1,731,0.2998084291187739,0.6545842217484008,80127696,1044,313
0,363,0.14788732394366197,0.24622356495468278,68536230,426,63
1,307,0.32079646017699115,0.7884615384615384,72382394,452,145
1,498,0.41617819460726846,0.788563829787234,68614826,853,355
0,222,0.20714285714285716,0.42730496453900707,69166244,280,58
0,132,0.043478260869565216,0.06274509803921569,72545921,138,6
0,79,0.10227272727272728,0.15151515151515152,72546600,88,9
1,276,0.39869281045751637,0.8780160857908847,81971168,459,183
1,963,0.48939554612937436,0.7002652519893899,70182532,1886,923
2,19,0.62,0.9753086419753086,69978454,50,31
1,1852,0.19443236189647672,0.5007487271638215,70173936,2299,447
0,1782,0.14037626628075253,0.4092130518234165,70691061,2073,291
1,226,0.34110787172011664,0.6714697406340058,66272346,343,117
1,78,0.2972972972972973,0.6875,70081375,111,33
2,241,0.6320610687022901,0.9478827361563518,70604821,655,414
1,128,0.21951219512195122,0.5595854922279793,73700571,164,36
2,968,0.6141889198884017,0.9866279069767442,67371591,2509,1541
2,60,0.6078431372549019,0.8349514563106796,62087291,153,93
2,377,0.6293018682399213,0.7763157894736842,68342533,1017,640
0,132,0.1951219512195122,0.3595505617977528,65824171,164,32
0,292,0.0670926517571885,0.025,66412654,313,21
1,163,0.30042918454935624,0.7433628318584071,68538813,233,70
0,1682,0.11706036745406824,0.2990492653414002,69575583,1905,223
1,307,0.4130019120458891,0.8611632270168855,69215174,523,216
1,618,0.33762057877813506,0.578125,80128015,933,315
1,657,0.3670520231213873,0.7689594356261023,82009524,1038,381
0,274,0.04861111111111111,0.20603015075376885,62837922,288,14
0,878,0.06296691568836713,0.23202776400594943,68798464,937,59
2,270,0.5686900958466453,0.9836065573770492,62926710,626,356
1,1377,0.3885435168738899,0.8846701471286189,69072724,2252,875
0,914,0.1721014492753623,0.2939024390243902,68536475,1104,190
1,988,0.23706563706563707,0.5415535035306899,70532882,1295,307
1,607,0.32555555555555554,0.7179962894248608,67994332,900,293
1,443,0.37868162692847124,0.8509052183173589,67995235,713,270
1,455,0.2327150084317032,0.5043103448275862,66930920,593,138
0,319,0.11878453038674033,0.3150684931506849,67889241,362,43
1,379,0.287593984962406,0.7300884955752213,69156311,532,153
0,641,0.20864197530864198,0.3596559812353401,69606691,810,169
0,39,0.04878048780487805,0.025423728813559324,80149856,41,2
1,115,0.29878048780487804,0.6482412060301508,68767503,164,49
1,455,0.4129032258064516,0.924812030075188,67558113,775,320
2,25,0.576271186440678,0.9583333333333334,68769533,59,34
2,0,1.0,1.0,82016286,3,3
1,286,0.35294117647058826,0.7997347480106101,66355254,442,156
1,233,0.3285302593659942,0.79375,67552023,347,114
1,411,0.3598130841121495,0.8748435544430538,69177003,642,231
1,811,0.2573260073260073,0.5804878048780487,68542201,1092,281
0,462,0.17793594306049823,0.2629193109700816,70658413,562,100
1,1385,0.24728260869565216,0.5924528301886792,68540486,1840,455
1,122,0.29069767441860467,0.5049180327868853,66960670,172,50
1,703,0.4666160849772382,0.8683693516699411,79472071,1318,615
0,350,0.20993227990970656,0.4411764705882353,80118416,443,93
1,502,0.39151515151515154,0.8609865470852018,69998236,825,323
1,396,0.2220039292730845,0.5303468208092486,68537875,509,113
0,660,0.19315403422982885,0.3308144416456759,68530574,818,158
1,63,0.4,0.8157894736842105,69734252,105,42
2,193,0.5113924050632911,0.9481268011527377,69734294,395,202
0,191,0.1511111111111111,0.31910569105691056,70660254,225,34
1,139,0.31862745098039214,0.6114864864864865,68401333,204,65
0,905,0.16743330266789327,0.26458208057727,63277690,1087,182
0,28,0.15151515151515152,0.3644067796610169,70761040,33,5
1,273,0.3695150115473441,0.840620592383639,73183761,433,160
0,1021,0.22357414448669202,0.4880083420229406,73746862,1315,294
1,151,0.42585551330798477,0.899641577060932,74049654,263,112
1,177,0.292,0.7371428571428571,81980456,250,73
1,1213,0.3421908893709328,0.7803030303030303,80111185,1844,631
1,2091,0.3534322820037106,0.7639465191332411,68465320,3234,1143
1,1263,0.2678260869565217,0.565121412803532,70207816,1725,462
1,1192,0.2938388625592417,0.6851134477033758,78045856,1688,496
0,432,0.12550607287449392,0.20555555555555555,80119384,494,62
0,1105,0.07220822837951302,0.06683971447112265,80119398,1191,86
1,177,0.48546511627906974,0.9255014326647565,73650815,344,167
0,362,0.05974025974025974,0.04897959183673469,82095666,385,23
1,254,0.328042328042328,0.7509881422924901,68883332,378,124
1,218,0.29449838187702265,0.5919540229885057,17010581,309,91
1,144,0.38197424892703863,0.8518518518518519,80180311,233,89
0,112,0.08196721311475409,0.24324324324324326,80149886,122,10
1,531,0.36330935251798563,0.8586572438162544,68203590,834,303
1,518,0.3589108910891089,0.8145161290322581,67076142,808,290
0,323,0.10526315789473684,0.1552901023890785,68743374,361,38
1,14,0.44,0.8297872340425532,69667290,25,11
1,861,0.3376923076923077,0.744408945686901,70243082,1300,439
1,1254,0.3485714285714286,0.8017973040439341,70627186,1925,671
1,700,0.22394678492239467,0.5555555555555556,68541102,902,202
0,867,0.17819905213270143,0.31945205479452055,70582575,1055,188
0,507,0.1605960264900662,0.29055912007332724,68538106,604,97
1,954,0.4214675560946028,0.8755821689953427,73431344,1649,695
1,854,0.3259668508287293,0.7554980595084088,70760844,1267,413
0,929,0.24286878565607173,0.4981132075471698,80180128,1227,298
1,760,0.3134598012646793,0.6589769307923772,70677075,1107,347
1,19,0.3448275862068966,0.5294117647058824,66190754,29,10
1,72,0.38461538461538464,0.8074534161490683,70121163,117,45
1,1651,0.2855906533967979,0.6818535825545171,68171313,2311,660
0,469,0.2037351443123939,0.4697833523375142,68540591,589,120
0,2522,0.12369701181375956,0.12006578947368421,67555341,2878,356
0,210,0.10256410256410256,0.06467661691542288,79650942,234,24
2,232,0.6120401337792643,0.9718045112781954,68449822,598,366
0,456,0.21243523316062177,0.3336831059811123,70646072,579,123
1,85,0.34615384615384615,0.7934272300469484,82126781,130,45
0,3834,0.07681194317360944,0.1372495196266813,70001813,4153,319
1,1537,0.3965449548488418,0.8263736263736263,73239481,2547,1010
1,366,0.3028571428571429,0.7157772621809745,80120436,525,159
1,453,0.25370675453047775,0.571875,82128647,607,154
2,66,0.6413043478260869,0.9689922480620154,80119156,184,118
1,443,0.26166666666666666,0.623249299719888,80110310,600,157
1,450,0.38524590163934425,0.8965968586387435,71036931,732,282
1,118,0.25316455696202533,0.5910652920962199,67159680,158,40
0,1573,0.15656836461126006,0.4078254326561324,69859965,1865,292
0,430,0.048672566371681415,0.17926734216679657,82049090,452,22
1,3956,0.29945103594829114,0.7282204020848846,69652786,5647,1691
0,545,0.14442700156985872,0.18214285714285713,70545923,637,92
0,354,0.23376623376623376,0.46953405017921146,67350885,462,108
0,62,0.30337078651685395,0.4645669291338583,79976736,89,27
1,1388,0.266384778012685,0.5901262916188289,72135273,1892,504
2,994,0.5678260869565217,0.9846938775510204,69056295,2300,1306
1,48,0.4606741573033708,0.875,71147734,89,41
0,443,0.16729323308270677,0.2839024390243902,73884265,532,89
1,1648,0.2963279248505551,0.7153392330383481,68536734,2342,694
1,1013,0.2261268143621085,0.5050505050505051,70583534,1309,296
1,512,0.3926453143534994,0.8421052631578947,68372115,843,331
1,382,0.4781420765027322,0.948936170212766,69622294,732,350
0,519,0.04945054945054945,0.22808267997148968,69639094,546,27
1,1090,0.3534994068801898,0.7589082638362395,70720972,1686,596
1,1277,0.37646484375,0.8311840562719812,70476616,2048,771
1,535,0.2923280423280423,0.7179715302491103,69577473,756,221
0,571,0.0878594249201278,0.23880597014925373,70001295,626,55
1,446,0.32526475037821484,0.75093399750934,68531211,661,215
2,409,0.560687432867884,0.982532751091703,73321234,931,522
1,258,0.38571428571428573,0.9010989010989011,67553430,420,162
1,254,0.32625994694960214,0.759656652360515,66857406,377,123
0,833,0.21710526315789475,0.46013071895424834,68535831,1064,231
1,324,0.32075471698113206,0.7845968712394705,68236280,477,153
1,123,0.32786885245901637,0.6780185758513931,74347560,183,60
0,955,0.21913327882256745,0.44621026894865523,68543734,1223,268
2,321,0.539454806312769,0.9514978601997147,77319102,697,376
0,307,0.04361370716510903,0.07203389830508475,80118314,321,14
1,647,0.2520231213872832,0.5763831544178365,63278614,865,218
0,252,0.2125,0.4967741935483871,68534326,320,68
0,755,0.13516609392898052,0.14066852367688024,70870884,873,118
1,590,0.24744897959183673,0.5287569573283859,80111710,784,194
1,1142,0.26888604353393086,0.6083733100741386,70829136,1562,420
0,588,0.18559556786703602,0.32549595885378396,70841561,722,134
1,700,0.27835051546391754,0.7093275488069414,80130319,970,270
1,493,0.2696296296296296,0.6109979633401222,80159584,675,182
0,444,0.2099644128113879,0.4731285988483685,67159120,562,118
1,1119,0.23303632625085674,0.5202863961813843,80110534,1459,340
0,175,0.18981481481481483,0.21390374331550802,82116836,216,41
0,331,0.1620253164556962,0.26324237560192615,68534375,395,64
1,924,0.48148148148148145,0.9273479031305375,80125113,1782,858
1,58,0.45794392523364486,0.9177215189873418,70822360,107,49
1,427,0.45949367088607596,0.9357682619647355,63812,790,363
1,167,0.2610619469026549,0.5981941309255079,62687233,226,59
1,190,0.25196850393700787,0.6324324324324324,68533591,254,64
0,711,0.17421602787456447,0.375,66779272,861,150
1,536,0.18167938931297709,0.5136842105263157,70659911,655,119
1,380,0.2490118577075099,0.6758241758241759,70618296,506,126
0,455,0.052083333333333336,0.13177470775770456,64848133,480,25
0,184,0.0845771144278607,0.3309692671394799,67796533,201,17
0,120,0.24528301886792453,0.47840531561461797,67553500,159,39
0,301,0.19946808510638298,0.2949526813880126,82126744,376,75
1,1019,0.25728862973760935,0.6673458991339786,68760426,1372,353
1,350,0.35661764705882354,0.8443449048152296,70061810,544,194
1,1021,0.30068493150684933,0.7336065573770492,69094235,1460,439
0,1410,0.10133843212237094,0.17122040072859745,299894,1569,159
0,1011,0.11780104712041885,0.26892252894033836,300461,1146,135
0,287,0.15835777126099707,0.23260437375745527,70257460,341,54
1,1934,0.39354029476324864,0.8416572077185017,82108783,3189,1255
1,1072,0.4858513189448441,0.945071482317532,67485831,2085,1013
2,263,0.6080476900149031,0.9147058823529411,69585670,671,408
1,886,0.30672926447574334,0.7162904209884076,68536055,1278,392
0,2581,0.058372856621670924,0.033205619412515965,80156825,2741,160
0,169,0.1875,0.3723150357995227,66422895,208,39
1,506,0.31805929919137466,0.7835051546391752,67291980,742,236
1,1739,0.2953808752025932,0.7154316271963331,70215866,2468,729
1,220,0.4942528735632184,0.9467312348668281,82023516,435,215
0,1064,0.20239880059970014,0.3292753623188406,69498863,1334,270
1,1437,0.29489695780176645,0.6756892230576441,80111381,2038,601
1,293,0.3883089770354906,0.8656195462478184,67552191,479,186
0,1136,0.19203413940256045,0.38958333333333334,69160595,1406,270
0,45,0.25,0.4594594594594595,70230965,60,15
1,61,0.29069767441860467,0.6612021857923497,70802851,86,25
2,56,0.5725190839694656,0.9351851851851852,71021706,131,75
1,435,0.25,0.5565217391304348,68542516,580,145
1,1417,0.3255592574964303,0.7803847958704834,66826172,2101,684
0,1012,0.1805668016194332,0.4765380604796663,73366202,1235,223
1,349,0.38010657193605685,0.8103161397670549,700063,563,214
1,1117,0.28853503184713375,0.6394169835234474,80181380,1570,453
1,1034,0.3268229166666667,0.7531010041346722,81967247,1536,502
0,469,0.0389344262295082,0.1301775147928994,62835122,488,19
0,270,0.03225806451612903,0.08544600938967137,62836550,279,9
0,907,0.048268625393494226,0.17044881492687847,62838041,953,46
0,125,0.038461538461538464,0.14128440366972478,64183084,130,5
1,560,0.19655667144906744,0.5132192846034215,82018249,697,137
1,82,0.26126126126126126,0.6141078838174274,73245781,111,29
0,297,0.2481012658227848,0.47883597883597884,80053470,395,98
0,332,0.09782608695652174,0.1483739837398374,67706450,368,36
1,803,0.2986899563318777,0.6749598715890851,68191606,1145,342
0,233,0.25559105431309903,0.497907949790795,76219052,313,80
0,1228,0.18943894389438945,0.312112676056338,67721941,1515,287
0,262,0.10580204778156997,0.2669683257918552,60514132,293,31
0,1937,0.18373367045933417,0.3132932531730127,66931795,2373,436
1,89,0.34074074074074073,0.8609865470852018,70240793,135,46
0,2388,0.24094087730451366,0.48171846435100546,74555243,3146,758
0,1444,0.16192687173534534,0.2756360832690825,68163886,1723,279
0,1096,0.05679862306368331,0.035449735449735446,68163893,1162,66
0,974,0.0914179104477612,0.06997900629811056,66423385,1072,98
0,1085,0.1921072226358898,0.38095238095238093,68535656,1343,258
1,477,0.3300561797752809,0.7391774891774892,67994136,712,235
1,562,0.2526595744680851,0.5505050505050505,72706123,752,190
1,434,0.3997233748271093,0.8546931407942239,79953356,723,289
0,208,0.21804511278195488,0.4851301115241636,67246424,266,58
0,82,0.16326530612244897,0.3627906976744186,69415955,98,16
0,791,0.19939271255060728,0.37418974661166765,66510633,988,197
0,688,0.20919540229885059,0.4337748344370861,66775884,870,182
0,1274,0.05278810408921933,0.17317806160781368,69598046,1345,71
1,404,0.25871559633027524,0.6094470046082949,68531316,545,141
1,1105,0.35530921820303385,0.7237654320987654,81989286,1714,609
0,1031,0.151440329218107,0.26108682073703937,68541872,1215,184
1,194,0.3240418118466899,0.8063973063973064,67160492,287,93
2,143,0.6742596810933941,0.9703389830508474,69589002,439,296
1,116,0.2611464968152866,0.6379928315412187,69110706,157,41
1,681,0.343297974927676,0.8335832083958021,71389192,1037,356
0,1875,0.15426251691474965,0.2395946435034383,72692655,2217,342
0,319,0.14705882352941177,0.29973474801061006,80119364,374,55
0,266,0.05338078291814947,0.024054982817869417,80119372,281,15
0,365,0.04699738903394256,0.015625,80119373,383,18
0,542,0.06551724137931035,0.052795031055900624,80119378,580,38
0,512,0.07747747747747748,0.0712041884816754,80119379,555,43
0,135,0.14012738853503184,0.2151394422310757,67246333,157,22
0,1784,0.06449921342422653,0.22569333758367868,67887162,1907,123
0,702,0.06648936170212766,0.05781057810578106,70644875,752,50
1,802,0.2781278127812781,0.6074476338246703,80108294,1111,309
1,1061,0.33562930494677523,0.761433868974042,68191046,1597,536
1,1726,0.28143213988343047,0.5777049180327869,56175861,2402,676
0,1381,0.21310541310541312,0.3238341968911917,68383693,1755,374
1,407,0.49125,0.9085457271364318,68033210,800,393
2,15,0.9112426035502958,0.9565217391304348,70608622,169,154
0,1595,0.08122119815668202,0.06534772182254196,80121264,1736,141
0,557,0.17725258493353027,0.325354609929078,63279734,677,120
1,16,0.4074074074074074,0.8461538461538461,57210174,27,11
1,51,0.35443037974683544,0.7107438016528925,57210181,79,28
1,192,0.2967032967032967,0.667447306791569,80121219,273,81
0,189,0.1853448275862069,0.483271375464684,69416396,232,43
0,127,0.1056338028169014,0.1588089330024814,69417075,142,15
0,144,0.1111111111111111,0.224,69417285,162,18
1,467,0.22553897180762852,0.5623800383877159,70627431,603,136
1,3097,0.2814385150812065,0.6580348499515973,70641851,4310,1213
1,587,0.3142523364485981,0.7410628019323672,70643405,856,269
0,1295,0.17305236270753513,0.26520811099252933,74320183,1566,271
0,1607,0.05858230814294083,0.2139673105497771,67887344,1707,100
0,929,0.22518765638031693,0.4776938915579959,68542131,1199,270
0,798,0.23416506717850288,0.49252761533463285,68532835,1042,244
0,2177,0.1545631067961165,0.21932733301752724,60003244,2575,398
0,276,0.1906158357771261,0.37681159420289856,68115446,341,65
0,1509,0.0509433962264151,0.03963011889035667,69167602,1590,81
0,712,0.04172274562584118,0.017045454545454544,69167700,743,31
1,292,0.24352331606217617,0.5662650602409639,70215915,386,94
1,148,0.26,0.6235565819861432,66723643,200,52
2,584,0.5394321766561514,0.8447971781305115,70121751,1268,684
0,532,0.08117443868739206,0.11542857142857142,70642481,579,47
0,1155,0.113584036838066,0.16585956416464892,70642754,1303,148
1,224,0.3149847094801223,0.7288801571709234,80108441,327,103
0,2002,0.1686046511627907,0.2467485549132948,68545463,2408,406
1,1210,0.2750149790293589,0.6552287581699346,80121019,1669,459
0,2247,0.05189873417721519,0.05965909090909091,63771036,2370,123
1,3571,0.29062375844259036,0.677124928693668,66822462,5034,1463
0,712,0.10101010101010101,0.10630291627469426,70071071,792,80
1,398,0.3054101221640489,0.7750716332378224,70658952,573,175
1,192,0.26996197718631176,0.6354581673306773,73245823,263,71
1,364,0.34177215189873417,0.8686730506155951,68530833,553,189
1,793,0.3386155129274395,0.8121212121212121,69586174,1199,406
1,92,0.29770992366412213,0.7389830508474576,70626283,131,39
1,94,0.4303030303030303,0.8974358974358975,60519914,165,71
1,167,0.34765625,0.8169014084507042,70642110,256,89
1,726,0.3637160385626643,0.8039702233250621,80133622,1141,415
1,168,0.42857142857142855,0.8768844221105527,66995656,294,126
1,590,0.34225195094760313,0.6529562982005142,69731872,897,307
1,295,0.39549180327868855,0.701530612244898,72433466,488,193
1,5,0.375,0.6923076923076923,78252972,8,3
1,372,0.225,0.7080459770114943,64282190,480,108
1,424,0.4323962516733601,0.8989130434782608,70613522,747,323
1,2014,0.3424746980084884,0.8196667755635413,70642061,3063,1049
1,537,0.29342105263157897,0.6422287390029325,70179032,760,223
1,1829,0.38021009827177227,0.8873924429479985,68112471,2951,1122
0,84,0.21495327102803738,0.35877862595419846,69056316,107,23
1,146,0.3014354066985646,0.7007672634271099,69056582,209,63
1,263,0.37971698113207547,0.8542600896860987,80135432,424,161
0,3071,0.05245294662141314,0.02594070695553022,68534592,3241,170
0,697,0.1770956316410862,0.32131147540983607,68537616,847,150
0,435,0.19889502762430938,0.47362250879249707,68537623,543,108
1,1092,0.2616632860040568,0.5635294117647058,69607286,1479,387
1,919,0.33979885057471265,0.7905158936946326,65944956,1392,473
1,297,0.36538461538461536,0.8024263431542461,67761512,468,171
1,260,0.3719806763285024,0.8127413127413128,67761533,414,154
0,933,0.051829268292682924,0.10692307692307693,67343262,984,51
1,489,0.45966850828729283,0.9456928838951311,67506061,905,416
0,133,0.125,0.28978622327790976,68219116,152,19
0,1720,0.100418410041841,0.09259259259259259,70645610,1912,192
1,959,0.28857566765578635,0.6845425867507886,80108490,1348,389
1,400,0.2982456140350877,0.7295373665480427,80109792,570,170
1,150,0.4339622641509434,0.8553615960099751,73869901,265,115
0,1074,0.17384615384615384,0.2541743970315399,80140105,1300,226
0,707,0.12931034482758622,0.1382716049382716,80141465,812,105
1,668,0.2878464818763326,0.687801516195727,68600812,938,270
1,1743,0.2782608695652174,0.629600316580926,73818521,2415,672
1,1157,0.2578576010262989,0.6376899696048632,68541606,1559,402
1,1407,0.28578680203045687,0.6507686243594797,68212004,1970,563
1,653,0.31045406546990495,0.6724821570182395,80130383,947,294
0,1426,0.2390608324439701,0.45585585585585586,81971207,1874,448
1,840,0.3597560975609756,0.8158967391304348,67994962,1312,472
1,96,0.26153846153846155,0.5381165919282511,68741155,130,34
2,54,0.6351351351351351,0.9655172413793104,70812966,148,94
1,1463,0.3157156220767072,0.7537227949599083,63101283,2138,675
1,430,0.2674616695059625,0.6112334801762115,69607272,587,157
1,309,0.34394904458598724,0.834983498349835,80111640,471,162
1,762,0.22718052738336714,0.5142857142857142,68536713,986,224
1,515,0.27157001414427157,0.6646234676007006,64369585,707,192
1,350,0.33962264150943394,0.7667140825035562,66892840,530,180
0,798,0.11234705228031146,0.1813216821409066,69551846,899,101
0,233,0.19655172413793104,0.4099526066350711,72962456,290,57
1,64,0.28888888888888886,0.6216216216216216,74709033,90,26
1,486,0.3076923076923077,0.6026785714285714,70713951,702,216
1,635,0.31939978563772775,0.7634042553191489,68532660,933,298
1,264,0.34,0.7934272300469484,70645652,400,136
2,207,0.6256781193490054,0.9849785407725322,70250474,553,346
1,280,0.3170731707317073,0.7005813953488372,72749075,410,130
0,920,0.23460898502495842,0.4745508982035928,70645666,1202,282
1,75,0.4186046511627907,0.8387096774193549,63444101,129,54
1,798,0.2887700534759358,0.6543745480838756,73735081,1122,324
0,111,0.0975609756097561,0.12546125461254612,69416102,123,12
0,153,0.11046511627906977,0.1311881188118812,69416375,172,19
0,210,0.16,0.36617405582922824,69416690,250,40
0,897,0.09485368314833502,0.11346054667354306,70641564,991,94
1,285,0.41836734693877553,0.6573208722741433,82009343,490,205
0,162,0.04142011834319527,0.03322259136212625,63757533,169,7
1,314,0.4766666666666667,0.7871720116618076,80124794,600,286
1,444,0.2562814070351759,0.5845303867403315,66087266,597,153
0,2270,0.1443648699585375,0.3151618398637138,68161534,2653,383
1,434,0.31437598736176936,0.5898203592814372,80090241,633,199
1,53,0.38372093023255816,0.7142857142857143,79709693,86,33
1,601,0.25155666251556663,0.5896805896805897,80114293,803,202
1,132,0.37735849056603776,0.8647540983606558,63051842,212,80
1,492,0.43707093821510296,0.9327146171693735,67551960,874,382
1,688,0.2892561983471074,0.6978354978354978,80110324,968,280
0,1705,0.10121244069583553,0.33635752688172044,67455325,1897,192
1,896,0.2905779889152811,0.7222566646001239,80112053,1263,367
0,996,0.11466666666666667,0.35092467298150654,65295251,1125,129
1,657,0.3813559322033898,0.8258575197889182,69800451,1062,405
1,270,0.40919037199124725,0.8048780487804879,69098204,457,187
1,345,0.27824267782426776,0.67007299270073,67942532,478,133
1,173,0.3446969696969697,0.7978142076502732,67557462,264,91
1,9,0.3076923076923077,0.6190476190476191,79648954,13,4
1,670,0.3211752786220871,0.8081761006289309,80121182,987,317
0,112,0.21678321678321677,0.46078431372549017,80140115,143,31
1,259,0.4911591355599214,0.9121405750798722,67307051,509,250
0,649,0.22553699284009546,0.48390064397424104,68542446,838,189
0,472,0.20270270270270271,0.35714285714285715,68543965,592,120
0,359,0.20044543429844097,0.4366576819407008,68542075,449,90
1,679,0.25792349726775954,0.6103216155572176,69531623,915,236
0,2127,0.09872881355932203,0.31728538283062646,66502625,2360,233
1,37,0.3620689655172414,0.7096774193548387,80176602,58,21
1,81,0.31932773109243695,0.7692307692307693,80090836,119,38
0,1472,0.21660457690260776,0.4335800545383716,74886273,1879,407
0,82,0.023809523809523808,0.05741626794258373,67868612,84,2
0,1441,0.056319580877537655,0.16808905380333952,68130706,1527,86
0,637,0.03484848484848485,0.09024663677130045,69598060,660,23
1,893,0.27161500815660683,0.6800554016620498,68541095,1226,333
1,407,0.30664395229982966,0.6888888888888889,67995396,587,180
2,569,0.7510936132983377,0.9583333333333334,80118333,2286,1717
0,546,0.11650485436893204,0.07272727272727272,68040252,618,72
1,361,0.266260162601626,0.647410358565737,75459034,492,131
0,2621,0.08929812369701182,0.29345889539322983,67034604,2878,257
1,1607,0.27020890099909173,0.669220945083014,70621306,2202,595
0,8,0.0,0.0,80140079,8,0
0,30,0.03225806451612903,0.07692307692307693,80140083,31,1
1,91,0.2222222222222222,0.6271186440677966,80140122,117,26
1,38,0.22448979591836735,0.5641025641025641,80141451,49,11
2,1754,0.5269687162891047,0.9604790419161676,67065544,3708,1954
1,322,0.2222222222222222,0.5077639751552795,54609786,414,92
0,399,0.16,0.3854415274463007,60896052,475,76
1,337,0.34942084942084944,0.8159268929503917,62650385,518,181
2,369,0.535264483627204,0.9584569732937686,68577684,794,425
1,168,0.30864197530864196,0.8162162162162162,68533766,243,75
1,627,0.2978723404255319,0.6732438831886346,69180440,893,266
1,22,0.18518518518518517,0.5625,80124701,27,5
0,899,0.21621621621621623,0.37441130298273156,67070703,1147,248
1,1444,0.3333333333333333,0.7345803842264914,70486605,2166,722
0,812,0.14616193480546794,0.22229381443298968,80119295,951,139
1,472,0.30177514792899407,0.6831797235023042,80107972,676,204
0,604,0.21963824289405684,0.39178356713426854,69478045,774,170
0,738,0.16515837104072398,0.20798514391829154,69478136,884,146
0,1082,0.08922558922558922,0.34862869198312235,63968954,1188,106
0,480,0.09774436090225563,0.3849721706864564,64076873,532,52
0,176,0.1065989847715736,0.34444444444444444,64399440,197,21
1,194,0.14537444933920704,0.5326732673267327,64400252,227,33
0,109,0.043859649122807015,0.0926517571884984,67888324,114,5
0,53,0.07017543859649122,0.22388059701492538,67888674,57,4
0,99,0.09174311926605505,0.29347826086956524,80149857,109,10
1,426,0.20522388059701493,0.5014836795252225,68542824,536,110
0,770,0.19791666666666666,0.39169811320754716,68536853,960,190
1,412,0.33974358974358976,0.8503597122302158,70627781,624,212
0,399,0.2385496183206107,0.47816349384098544,73088281,524,125
1,9,0.47058823529411764,0.92,80130704,17,8
1,270,0.2857142857142857,0.62882096069869,80133412,378,108
1,365,0.49164345403899723,0.966832504145937,63099211,718,353
1,119,0.4251207729468599,0.9257142857142857,80180115,207,88
1,1106,0.24350205198358413,0.6305048335123523,82026278,1462,356
0,598,0.19079837618403248,0.3473684210526316,80140088,739,141
1,1805,0.23224159931943852,0.5921985815602837,73706570,2351,546
0,456,0.23618090452261306,0.48515769944341375,80180140,597,141
1,1264,0.4441512752858399,0.9364997418688694,68531022,2274,1010
0,970,0.18281381634372368,0.4432605221097496,69807976,1187,217
0,4032,0.10658098825614891,0.10524961399897066,68645136,4513,481
1,140,0.29292929292929293,0.7368421052631579,297360,198,58
0,186,0.13488372093023257,0.40752351097178685,63771281,215,29
0,214,0.11934156378600823,0.31317494600431967,63771365,243,29
0,629,0.2186335403726708,0.4921928038017651,67836853,805,176
1,55,0.42105263157894735,0.9539473684210527,76586391,95,40
1,381,0.32685512367491165,0.7684674751929438,81965830,566,185
1,235,0.3880208333333333,0.8461538461538461,81971171,384,149
1,137,0.33170731707317075,0.7262773722627737,70174713,205,68
1,752,0.22950819672131148,0.5153181461115475,80110506,976,224
0,119,0.19047619047619047,0.3858520900321543,82016314,147,28
2,181,0.5552825552825553,0.9838709677419355,68112485,407,226
1,279,0.2520107238605898,0.5329192546583851,82124931,373,94
1,135,0.22857142857142856,0.5127551020408163,80003392,175,40
0,76,0.08433734939759036,0.24110671936758893,80135069,83,7
1,31,0.225,0.6017699115044248,69153175,40,9
0,602,0.18867924528301888,0.35502958579881655,77676312,742,140
1,508,0.38795180722891565,0.8290155440414507,66695615,830,322
0,186,0.17699115044247787,0.246,70686763,226,40
1,550,0.3757094211123723,0.8016528925619835,74554515,881,331
0,382,0.09263657957244656,0.06890756302521009,70646562,421,39
0,530,0.23299565846599132,0.4107142857142857,70646611,691,161
1,97,0.2971014492753623,0.6472868217054264,65932531,138,41
2,35,0.6464646464646465,0.8064516129032258,66280634,99,64
0,349,0.2478448275862069,0.464471403812825,70813176,464,115
0,454,0.060041407867494824,0.12433155080213903,69701716,483,29
1,330,0.3900184842883549,0.8316953316953317,70286566,541,211
0,434,0.20512820512820512,0.4714867617107943,70634410,546,112
1,44,0.18518518518518517,0.5698924731182796,80124376,54,10
0,480,0.060665362035225046,0.12403100775193798,80126897,511,31
0,123,0.18543046357615894,0.3358208955223881,69157816,151,28
0,105,0.11764705882352941,0.2613065326633166,69157942,119,14
0,565,0.2585301837270341,0.4706397896581946,73435236,762,197
0,842,0.2189239332096475,0.371868978805395,80123743,1078,236
2,93,0.6642599277978339,0.9126984126984127,73442355,277,184
0,813,0.05465116279069768,0.06273062730627306,82007801,860,47
0,617,0.05222734254992319,0.07435897435897436,82007805,651,34
1,1490,0.29417337754618667,0.5841013824884793,80130620,2111,621
0,348,0.036011080332409975,0.11227402473834443,62835101,361,13
0,837,0.048863636363636366,0.1459054209919262,66389365,880,43
0,157,0.0872093023255814,0.4463452566096423,78540784,172,15
0,200,0.12280701754385964,0.4579831932773109,80128652,228,28
1,1418,0.3109815354713314,0.7886323268206039,65750601,2058,640
1,235,0.28134556574923547,0.723826714801444,80121091,327,92
1,466,0.31268436578171094,0.6832298136645962,80124675,678,212
1,882,0.27823240589198034,0.619,65307354,1222,340
1,1810,0.311787072243346,0.7288194444444445,80132299,2630,820
0,702,0.1884393063583815,0.3600883652430044,66931571,865,163
0,772,0.18565400843881857,0.3367741935483871,66931676,948,176
1,798,0.31266149870801035,0.765637371338084,68542663,1161,363
1,960,0.2883617494440326,0.7303851640513552,80121249,1349,389
0,165,0.23255813953488372,0.3219178082191781,72077754,215,50
0,235,0.1696113074204947,0.28821656050955413,68563215,283,48
0,301,0.1568627450980392,0.2563758389261745,69498723,357,56
1,1585,0.35173824130879344,0.7984866587017124,70762475,2445,860
1,370,0.4236760124610592,0.9329829172141918,69954311,642,272
1,1633,0.2553579571363429,0.5629222972972973,68542061,2193,560
1,596,0.3673036093418259,0.8569651741293532,80110275,942,346
1,669,0.42077922077922075,0.905829596412556,70659085,1155,486
1,1098,0.3529758397171479,0.8180991359708959,72658530,1697,599
1,1096,0.270791749833666,0.5987292277614858,67556692,1503,407
0,1905,0.16116248348745046,0.21786064769381747,70207634,2271,366
1,108,0.2987012987012987,0.6209677419354839,80108812,154,46
1,261,0.36650485436893204,0.8664047151277013,63099855,412,151
2,98,0.7142857142857143,0.8791208791208791,69996584,343,245
2,2162,0.5259811444858583,0.9414893617021277,80124828,4561,2399
0,1788,0.12567237163814182,0.12377560106856635,67555670,2045,257
1,279,0.4211618257261411,0.8745247148288974,68741491,482,203
0,1587,0.1802685950413223,0.3359375,70614740,1936,349
1,438,0.3261538461538461,0.6926070038910506,68211745,650,212
0,87,0.25,0.47368421052631576,69536712,116,29
1,133,0.3316582914572864,0.7078651685393258,69538266,199,66
1,335,0.25389755011135856,0.6301703163017032,67771781,449,114
1,628,0.2887882219705549,0.6167820069204152,73709146,883,255
1,404,0.2937062937062937,0.5773195876288659,74045300,572,168
2,89,0.5527638190954773,0.9372197309417041,82022869,199,110
0,942,0.08187134502923976,0.08047945205479452,70206290,1026,84
1,68,0.23595505617977527,0.5327102803738317,69498492,89,21
1,163,0.26576576576576577,0.6445783132530121,65004576,222,59
1,527,0.32087628865979384,0.676130389064143,80123784,776,249
0,622,0.26128266033254155,0.4766146993318486,70640983,842,220
2,308,0.5704323570432357,0.9889064976228209,82012228,717,409
1,216,0.38108882521489973,0.8497109826589595,66355233,349,133
0,699,0.19655172413793104,0.2739393939393939,70646275,870,171
0,139,0.2057142857142857,0.41336633663366334,73914365,175,36
0,228,0.15867158671586715,0.2603648424543947,79520126,271,43
0,814,0.1005524861878453,0.11617100371747212,70609273,905,91
0,621,0.12535211267605634,0.16265912305516267,74290083,710,89
1,882,0.23570190641247835,0.519893899204244,68532870,1154,272
1,428,0.45616264294790343,0.9490254872563718,63281484,787,359
1,916,0.3438395415472779,0.8400495970241786,80121052,1396,480
1,168,0.27896995708154504,0.6157407407407407,81980718,233,65
1,1298,0.287596048298573,0.7657920310981535,73556721,1822,524
0,2813,0.11121642969984202,0.1935163744624545,63092666,3165,352
1,135,0.3691588785046729,0.8272058823529411,80136841,214,79
1,519,0.38869257950530034,0.8314255983350677,70753291,849,330
0,288,0.0914826498422713,0.08389261744966443,70466130,317,29
0,50,0.15254237288135594,0.22522522522522523,70466151,59,9
1,492,0.27218934911242604,0.6577490774907749,68532030,676,184
0,1208,0.15818815331010452,0.4064665127020785,63769412,1435,227
2,176,0.5356200527704486,0.9511002444987775,69085163,379,203
1,644,0.3783783783783784,0.8779599271402551,70643286,1036,392
1,327,0.30128205128205127,0.6366906474820144,80110254,468,141
1,670,0.34506353861192574,0.7851528384279476,80110261,1023,353
1,307,0.4438405797101449,0.9105545617173524,67154451,552,245
1,775,0.44404591104734575,0.8891481913652275,62511484,1394,619
0,1467,0.09332509270704574,0.08977556109725686,70201901,1618,151
0,106,0.08620689655172414,0.05555555555555555,82096266,116,10
1,592,0.2858866103739445,0.673352435530086,68191613,829,237
1,1335,0.2708902239213545,0.603448275862069,65308824,1831,496
1,665,0.3618042226487524,0.8456837280366692,65268455,1042,377
1,907,0.2326565143824027,0.5563709139426284,80121244,1182,275
0,714,0.1968503937007874,0.373134328358209,68540353,889,175
0,1177,0.1871546961325967,0.3189219539584503,72393405,1448,271
0,208,0.07964601769911504,0.2541743970315399,67836930,226,18
1,989,0.30450070323488043,0.7492660011743981,68155612,1422,433
1,1799,0.4994435169727323,0.9524142757172848,82011414,3594,1795
0,1020,0.15,0.23125,68536300,1200,180
1,1309,0.27358490566037735,0.6789598108747045,67812724,1802,493
1,798,0.46153846153846156,0.923927178153446,70916825,1482,684
0,1881,0.14886877828054298,0.22307157748436415,70614684,2210,329
1,2322,0.3671300081766149,0.8175916910094125,67994073,3669,1347
0,279,0.20285714285714285,0.4220032840722496,77676536,350,71
0,158,0.13186813186813187,0.2,73347015,182,24
2,576,0.5223880597014925,0.9642857142857143,68040070,1206,630
1,177,0.4884393063583815,0.9705159705159705,70350014,346,169
1,992,0.30919220055710306,0.6716686674669868,67993583,1436,444
1,136,0.32338308457711445,0.6,80127287,201,65
0,3157,0.17571801566579634,0.30178497301784973,82009373,3830,673
0,931,0.10738255033557047,0.15555555555555556,80178633,1043,112
0,1028,0.2086220169361047,0.44567757009345793,68537784,1299,271
0,616,0.1619047619047619,0.36767676767676766,74020366,735,119
0,335,0.12987012987012986,0.17455138662316477,66423574,385,50
1,771,0.2827906976744186,0.6718120805369128,66930745,1075,304
1,96,0.4146341463414634,0.8497652582159625,72616740,164,68
1,1747,0.2754043965159685,0.65489443378119,64275834,2411,664
1,666,0.4527526705012325,0.8971774193548387,65690051,1217,551
2,81,0.6746987951807228,0.9830508474576272,73348821,249,168
0,491,0.2231012658227848,0.3824228028503563,82062466,632,141
1,57,0.2875,0.7468354430379747,67791724,80,23
1,277,0.38031319910514544,0.851602023608769,70659155,447,170
1,109,0.2967741935483871,0.7255639097744361,70398832,155,46
1,1226,0.37031330251669237,0.8665966386554622,69316576,1947,721
0,873,0.20273972602739726,0.458950201884253,73195815,1095,222
1,2883,0.3032866118898018,0.6680482290881689,74001081,4138,1255
1,947,0.32357142857142857,0.6631376323387873,74675524,1400,453
1,1320,0.39588100686498856,0.8804691023906179,80119013,2185,865
0,303,0.12173913043478261,0.24385245901639344,64930992,345,42
0,526,0.05734767025089606,0.24172185430463577,62839343,558,32
0,2233,0.08931484502446982,0.17920540997464074,80140148,2452,219
2,1476,0.5371589840075258,0.8752922837100545,57201900,3189,1713
1,212,0.4479166666666667,0.9182561307901907,68040126,384,172
0,997,0.18009868421052633,0.3438685208596713,68537672,1216,219
1,240,0.42992874109263657,0.8375634517766497,80059042,421,181
1,25,0.24242424242424243,0.5833333333333334,68688025,33,8
0,495,0.0444015444015444,0.1822289156626506,65911685,518,23
1,97,0.3576158940397351,0.7243243243243244,80172936,151,54
2,12,0.6,0.9791666666666666,80176085,30,18
1,1594,0.36645468998410174,0.8285580084546735,80107524,2516,922
1,296,0.39094650205761317,0.8913043478260869,80107531,486,190
0,1656,0.06704225352112676,0.047285464098073555,70617295,1775,119
0,853,0.07883369330453564,0.09593837535014006,70617302,926,73
0,774,0.13616071428571427,0.3294198895027624,82043083,896,122
0,272,0.19047619047619047,0.38837516512549536,72900660,336,64
1,459,0.46252927400468385,0.9616977225672878,68112562,854,395
0,750,0.14869466515323496,0.25028312570781425,70609420,881,131
0,52,0.018867924528301886,0.04580152671755725,68356876,53,1
1,237,0.18275862068965518,0.6215469613259669,80128667,290,53
1,1174,0.3404494382022472,0.7079081632653061,82039904,1780,606
2,220,0.56,0.7924528301886793,70906486,500,280
1,1664,0.3537864077669903,0.7842368045649073,69925730,2575,911
0,788,0.212,0.43014705882352944,80097654,1000,212
1,747,0.3790523690773067,0.8739164696611506,70632240,1203,456
2,160,0.6467991169977925,0.9920212765957447,79784201,453,293
0,182,0.19823788546255505,0.4129979035639413,77676620,227,45
1,785,0.3886292834890966,0.9051282051282051,80111542,1284,499
1,37,0.4714285714285714,0.8787878787878788,67971071,70,33
2,109,0.5045454545454545,0.9349112426035503,80128839,220,111
0,1272,0.08686288585786073,0.05902606984751599,70207270,1393,121
2,320,0.5144157814871017,0.8939393939393939,72838150,659,339
1,619,0.2595693779904306,0.5267123287671233,70658343,836,217
0,818,0.1720647773279352,0.3097674418604651,60514083,988,170
0,812,0.19042871385842472,0.37577639751552794,68537735,1003,191
2,72,0.6086956521739131,0.8861788617886179,79373294,184,112
2,189,0.615071283095723,0.953551912568306,82019110,491,302
0,181,0.2701612903225806,0.4980237154150198,80128575,248,67
2,186,0.667262969588551,0.9638242894056848,72790613,559,373
1,168,0.3563218390804598,0.7490774907749077,68400983,261,93
0,318,0.17402597402597403,0.31283422459893045,695513,385,67
1,959,0.2536964980544747,0.5390127388535032,60195121,1285,326
0,209,0.032407407407407406,0.07674418604651163,62834982,216,7
0,873,0.08105263157894736,0.30430528375733856,62835395,950,77
0,686,0.05898491083676269,0.1948286229705352,67868752,729,43
1,156,0.34177215189873417,0.7522935779816514,68782455,237,81
1,523,0.3207792207792208,0.7398739873987399,67533613,770,247
0,555,0.25101214574898784,0.49712643678160917,60074392,741,186
0,2748,0.139367366113373,0.27986798679867986,68311915,3193,445
0,750,0.3081180811808118,0.3698630136986301,70182546,1084,334
1,320,0.4295900178253119,0.9436860068259386,80136835,561,241
0,731,0.04193971166448231,0.11984392419175027,62838104,763,32
1,193,0.1608695652173913,0.5697674418604651,63478373,230,37
1,1220,0.43622920517560076,0.9109677419354839,70058954,2164,944
2,219,0.5228758169934641,0.9601769911504425,64697815,459,240
1,929,0.2696540880503145,0.5186855670103093,70946841,1272,343
1,566,0.28445006321112515,0.6902834008097166,68534886,791,225
0,709,0.1952326901248581,0.4057971014492754,68534921,881,172
0,284,0.11801242236024845,0.36749633967789164,67364206,322,38
0,726,0.16359447004608296,0.2709284627092846,68544196,868,142
1,474,0.28072837632776937,0.628696604600219,69998250,659,185
1,984,0.24249422632794457,0.5529272619751626,69549144,1299,315
0,177,0.06842105263157895,0.4175257731958763,62834520,190,13
1,298,0.45119705340699817,0.9405204460966543,67154402,543,245
0,589,0.07389937106918239,0.06367924528301887,73148915,636,47
0,851,0.06892778993435449,0.06799083269671505,73906014,914,63
0,264,0.11409395973154363,0.17729083665338646,73906091,298,34
0,1515,0.18284789644012944,0.3038698328935796,70207732,1854,339
0,577,0.17335243553008595,0.3205699020480855,68537182,698,121
0,1159,0.17508896797153026,0.30344478216818643,68537231,1405,246
0,121,0.21428571428571427,0.363914373088685,69608133,154,33
0,1796,0.07135470527404343,0.05322128851540616,68534424,1934,138
1,614,0.4298978644382544,0.7606263982102909,80176793,1077,463
1,1098,0.24536082474226803,0.5255023183925811,74990181,1455,357
1,322,0.23877068557919623,0.5548780487804879,75523014,423,101
1,736,0.3166202414113278,0.7155038759689922,70761250,1077,341
1,136,0.34615384615384615,0.7136752136752137,80180114,208,72
0,1131,0.11640625,0.1458106637649619,54609730,1280,149
0,783,0.13861386138613863,0.20574534161490685,60512753,909,126
0,1733,0.09171907756813417,0.1172,62356742,1908,175
0,2081,0.22982975573649148,0.49328089151098,80124521,2702,621
1,295,0.24936386768447838,0.5073529411764706,66892441,393,98
2,668,0.7549523110785032,0.9801980198019802,69708135,2726,2058
0,376,0.168141592920354,0.3086816720257235,70040894,452,76
1,606,0.3152542372881356,0.7001013171225937,80136820,885,279
1,253,0.29526462395543174,0.673728813559322,80135253,359,106
0,358,0.06282722513089005,0.05037313432835821,271096,382,24
0,71,0.05333333333333334,0.062111801242236024,67281956,75,4
1,195,0.3010752688172043,0.6514806378132119,80107335,279,84
1,435,0.4041095890410959,0.9184149184149184,66471132,730,295
0,266,0.10437710437710437,0.10793650793650794,70201705,297,31
0,1579,0.14463705308775732,0.19951923076923078,80140097,1846,267
0,1043,0.058664259927797835,0.059498956158663886,70606711,1108,65
1,78,0.30357142857142855,0.7789473684210526,73398962,112,34
1,61,0.34408602150537637,0.8562874251497006,80135819,93,32
0,152,0.055900621118012424,0.31791044776119404,62834870,161,9
0,599,0.04313099041533546,0.14622950819672131,62835276,626,27
1,1279,0.24139976275207592,0.5968894493484658,68162500,1686,407
0,1128,0.1493212669683258,0.39659489233850775,69638730,1326,198
0,2119,0.1611243072050673,0.42549317147192717,69638863,2526,407
0,114,0.05785123966942149,0.3643410852713178,70250803,121,7
0,1077,0.12367778681855167,0.2861883036084612,80140156,1229,152
1,113,0.2662337662337662,0.6686746987951807,78863680,154,41
1,214,0.4830917874396135,0.9511627906976744,73215954,414,200
1,423,0.3242811501597444,0.7700348432055749,65355682,626,203
1,1119,0.3250904704463209,0.7904761904761904,65267020,1658,539
0,858,0.20037278657968313,0.40688685874912156,68534172,1073,215
1,292,0.24155844155844156,0.5545171339563862,80139720,385,93
0,521,0.12436974789915967,0.17330462863293863,62234550,595,74
2,6,0.6666666666666666,0.9285714285714286,70860342,18,12
0,813,0.21976967370441458,0.4517825832846289,70909783,1042,229
1,1652,0.3150912106135987,0.7409704487413353,66756830,2412,760
1,861,0.2420774647887324,0.571320182094082,68541501,1136,275
2,62,0.6820512820512821,0.9833333333333333,70762783,195,133
0,376,0.17362637362637362,0.2837326607818411,68545386,455,79
0,1234,0.19240837696335078,0.3691369606003752,80121030,1528,294
1,2830,0.40856844305120166,0.7963955187530444,66280823,4785,1955
1,1716,0.2400354295837024,0.5359628770301624,70092932,2258,542
0,619,0.24049079754601227,0.49409158050221563,71358784,815,196
1,733,0.2764067127344521,0.6737633061991234,80121138,1013,280
1,631,0.322234156820623,0.7591489361702127,80107895,931,300
1,714,0.2916666666666667,0.6726825266611977,63445914,1008,294
1,415,0.3284789644012945,0.7871396895787139,66471111,618,203
0,7375,0.21417155034629728,0.39700837107177167,80125459,9385,2010
0,297,0.20161290322580644,0.4533029612756264,69106821,372,75
0,169,0.14213197969543148,0.25925925925925924,69106863,197,28
0,248,0.11428571428571428,0.21726190476190477,69106961,280,32
0,362,0.06701030927835051,0.1154562383612663,69107080,388,26
0,413,0.078125,0.11720226843100189,69107094,448,35
0,616,0.05084745762711865,0.05981794538361508,69107115,649,33
0,319,0.06725146198830409,0.09302325581395349,60536924,342,23
1,131,0.44017094017094016,0.8504672897196262,68039902,234,103
1,127,0.46638655462184875,0.8829268292682927,68039916,238,111
1,1381,0.2399559713813979,0.5603885135135135,68535103,1817,436
0,1260,0.14979757085020243,0.23932926829268292,73245620,1482,222
1,545,0.26450742240215924,0.6193181818181818,80109533,741,196
1,1090,0.26894701542588867,0.5544286680189318,68018384,1491,401
1,1367,0.3831227436823105,0.8379947229551451,68254536,2216,849
1,131,0.3701923076923077,0.9197080291970803,80121282,208,77
1,256,0.2967032967032967,0.6859504132231405,80135252,364,108
0,190,0.22448979591836735,0.4064039408866995,82126788,245,55
1,395,0.30823117338003503,0.7788944723618091,80125487,571,176
1,293,0.30238095238095236,0.6558139534883721,80135257,420,127
0,1082,0.18829707426856715,0.4180287270926201,77688233,1333,251
1,110,0.4270833333333333,0.9326923076923077,69154820,192,82
0,1748,0.15840154068367837,0.2793473935535217,70615622,2077,329
0,70,0.1566265060240964,0.2261904761904762,80121129,83,13
0,603,0.21484375,0.43629697525206235,68642063,768,165
0,628,0.1693121693121693,0.2916666666666667,68544112,756,128
1,309,0.396484375,0.8543307086614174,64857212,512,203
1,39,0.417910447761194,0.8488372093023255,69734273,67,28
1,88,0.3282442748091603,0.7807017543859649,70206885,131,43
1,117,0.3389830508474576,0.7627627627627628,65919014,177,60
1,77,0.4166666666666667,0.9699570815450643,69603583,132,55
1,333,0.3405940594059406,0.7310469314079422,80127375,505,172
1,121,0.2621951219512195,0.5882352941176471,80135000,164,43
2,61,0.5378787878787878,0.9401709401709402,82135618,132,71
1,564,0.33016627078384797,0.827021494370522,80121250,842,278
1,106,0.28378378378378377,0.6366906474820144,69195070,148,42
0,319,0.17571059431524547,0.2420785804816223,67551666,387,68
1,890,0.27346938775510204,0.6643151087595532,80109841,1225,335
0,288,0.17714285714285713,0.31444241316270566,63277676,350,62
0,1090,0.2020497803806735,0.38265034592868546,70207256,1366,276
0,767,0.23833167825223436,0.46064814814814814,69607951,1007,240
1,202,0.34627831715210355,0.8329809725158562,80120456,309,107
0,459,0.17889087656529518,0.39565217391304347,80121029,559,100
1,744,0.2914285714285714,0.7053206002728513,67305644,1050,306
1,182,0.38095238095238093,0.8885714285714286,67305686,294,112
1,240,0.3798449612403101,0.8667953667953668,67305693,387,147
0,633,0.11715481171548117,0.15527950310559005,68352305,717,84
0,614,0.18890356671070013,0.39644970414201186,68352312,757,143
0,623,0.125,0.17248908296943233,68352403,712,89
0,565,0.047217537942664416,0.03899721448467967,68352410,593,28
0,474,0.038539553752535496,0.01818181818181818,69028386,493,19
0,371,0.18461538461538463,0.3937007874015748,69604451,455,84
0,291,0.090625,0.11170212765957446,69604493,320,29
0,223,0.01762114537444934,0.0,69604500,227,4
0,225,0.021739130434782608,0.006535947712418301,69604514,230,5
2,68,0.5878787878787879,0.9401709401709402,80118345,165,97
2,12,0.76,0.8181818181818182,68157180,50,38
0,1509,0.06389578163771713,0.1292517006802721,70109620,1612,103
0,327,0.04664723032069971,0.09227871939736347,70109795,343,16
1,12,0.4,0.9142857142857143,72946363,20,8
0,440,0.03296703296703297,0.054365733113673806,80126896,455,15
0,625,0.21679197994987467,0.3944223107569721,69705111,798,173
1,62,0.4095238095238095,0.8477366255144033,80037951,105,43
1,894,0.3107170393215112,0.6603624901497241,80096240,1297,403
0,71,0.04054054054054054,0.09615384615384616,80124230,74,3
0,616,0.0144,0.03956478733926805,80124278,625,9
0,72,0.08860759493670886,0.2832618025751073,80124403,79,7
0,380,0.042821158690176324,0.0412573673870334,80135330,397,17
0,273,0.12218649517684887,0.1969309462915601,80135339,311,38
1,59,0.37894736842105264,0.7837837837837838,80137389,95,36
1,17,0.34615384615384615,0.6666666666666666,70933625,26,9
0,67,0.0,0.0,67376442,67,0
0,125,0.04580152671755725,0.17903930131004367,68548823,131,6
0,176,0.053763440860215055,0.19622641509433963,68548872,186,10
0,116,0.056910569105691054,0.22564102564102564,68548893,123,7
0,63,0.08695652173913043,0.3125,68548914,69,6
0,129,0.03731343283582089,0.18095238095238095,68548942,134,5
0,112,0.08196721311475409,0.29850746268656714,68548970,122,10
0,113,0.11023622047244094,0.4297520661157025,68549005,127,14
0,9,0.1,0.4146341463414634,70238063,10,1
0,29,0.03333333333333333,0.14634146341463414,70238693,30,1
0,97,0.0673076923076923,0.25125628140703515,70239372,104,7
1,390,0.2261904761904762,0.575075075075075,70746753,504,114
0,194,0.015228426395939087,0.16120906801007556,70825013,197,3
2,3,0.5,0.8333333333333334,79953895,6,3
1,107,0.24647887323943662,0.694560669456067,80158075,142,35
2,21,0.6865671641791045,0.9807692307692307,73348863,67,46
2,16,0.673469387755102,0.851063829787234,82020370,49,33
1,234,0.4264705882352941,0.8496042216358839,70485730,408,174
2,66,0.8447058823529412,0.9891891891891892,80118215,425,359
1,1142,0.30365853658536585,0.6749034749034749,80180470,1640,498
2,13,0.7592592592592593,0.9629629629629629,69166356,54,41
0,707,0.10506329113924051,0.1906519065190652,80124255,790,83
2,1,0.5,0.8,72804235,2,1
0,13,0.0,0.0,72809016,13,0
0,180,0.23404255319148937,0.41386138613861384,74228714,235,55
2,3,0.6666666666666666,0.75,80049886,9,6
2,238,0.5492424242424242,0.9730639730639731,80137981,528,290
0,41,0.29310344827586204,0.44565217391304346,66272024,58,17
1,236,0.4511627906976744,0.8787185354691075,69399365,430,194
2,123,0.6272727272727273,0.9906542056074766,80150979,330,207
1,534,0.37028301886792453,0.8428128231644261,80121239,848,314
2,127,0.5189393939393939,0.7284768211920529,80178147,264,137
0,349,0.14878048780487804,0.2175732217573222,69708611,410,61
0,597,0.2326478149100257,0.42348008385744235,80125038,778,181
0,147,0.18333333333333332,0.35080645161290325,80180121,180,33
0,591,0.07075471698113207,0.041884816753926704,80140073,636,45
2,307,0.5498533724340176,0.9739130434782609,69480215,682,375
0,500,0.1554054054054054,0.25448334756618274,62766725,592,92
0,244,0.1527777777777778,0.26,62766781,288,44
0,2170,0.15924060441689267,0.285248953001396,66203333,2581,411
1,295,0.23177083333333334,0.5712451861360719,80095421,384,89
0,440,0.08523908523908524,0.09422492401215805,80098732,481,41
1,1252,0.24623720650210718,0.5228730226592561,80122960,1661,409
0,1512,0.12041884816753927,0.15864166244298022,80181311,1719,207
1,559,0.4195223260643821,0.8745098039215686,65930991,963,404
0,218,0.13147410358565736,0.1885593220338983,80079916,251,33
1,276,0.4127659574468085,0.8092369477911646,72321004,470,194
1,257,0.45085470085470086,0.9362139917695473,67290713,468,211
1,883,0.27504105090311987,0.6510721247563352,63278481,1218,335
1,900,0.3150684931506849,0.7640511964385086,70626696,1314,414
0,1175,0.22236929185969556,0.46495557749259625,70627424,1511,336
0,1027,0.16504065040650406,0.29896907216494845,68537105,1230,203
2,314,0.6070087609511889,0.9835820895522388,67753693,799,485
1,344,0.26495726495726496,0.5563258232235702,66459134,468,124
1,807,0.2569060773480663,0.5600612088752869,69165551,1086,279
0,270,0.13738019169329074,0.2535211267605634,68019812,313,43
0,542,0.11001642036124795,0.12897822445561138,69549375,609,67
1,114,0.2191780821917808,0.5238095238095238,80071243,146,32
0,184,0.20689655172413793,0.4491803278688525,73700550,232,48
1,415,0.3833580980683507,0.8686534216335541,67995221,673,258
1,169,0.4131944444444444,0.9245742092457421,67995774,288,119
1,808,0.24060150375939848,0.5137991779213154,80180144,1064,256
0,101,0.10619469026548672,0.225,67706436,113,12
1,50,0.34210526315789475,0.8613138686131386,69421884,76,26
1,85,0.4097222222222222,0.8689320388349514,80127344,144,59
1,357,0.297244094488189,0.733983286908078,70072156,508,151
1,244,0.42042755344418054,0.8814432989690721,72966082,421,177
1,290,0.26582278481012656,0.5987748851454824,77676270,395,105
1,714,0.3419354838709677,0.6365422396856582,69055616,1085,371
0,283,0.15522388059701492,0.1683366733466934,62901384,335,52
0,264,0.20481927710843373,0.38285714285714284,66892644,332,68
1,360,0.37823834196891193,0.8491189427312775,60332433,579,219
0,321,0.15079365079365079,0.22100954979536153,62795075,378,57
0,238,0.18213058419243985,0.30528375733855184,66471440,291,53
1,107,0.42473118279569894,0.9010238907849829,67506096,186,79
1,1354,0.3263681592039801,0.7824919441460795,80125504,2010,656
0,1145,0.07809983896940419,0.0705958549222798,69873636,1242,97
0,933,0.19776440240756663,0.4837133550488599,73194793,1163,230
0,653,0.19877300613496932,0.3951675759937646,67556244,815,162
2,307,0.5589080459770115,0.9603024574669187,63900991,696,389
1,113,0.4052631578947368,0.9227642276422764,68536454,190,77
1,263,0.3553921568627451,0.799163179916318,74978701,408,145
1,451,0.3248502994011976,0.7165450121654501,67995291,668,217
0,618,0.06363636363636363,0.02140309155766944,79788100,660,42
0,857,0.08145766345123258,0.05511811023622047,79788114,933,76
0,2036,0.21268368136117555,0.38987951807228916,68285833,2586,550
0,925,0.23742786479802144,0.4834054834054834,69242621,1213,288
1,919,0.38855622089155023,0.8839645447219984,80111500,1503,584
1,645,0.2833333333333333,0.6696428571428571,71388086,900,255
0,1659,0.16966966966966968,0.2832302936630603,67554543,1998,339
1,2507,0.22956361401352182,0.5134328358208955,81965698,3254,747
1,322,0.26651480637813213,0.6826516220028209,80134711,439,117
1,86,0.48502994011976047,0.8926553672316384,69691321,167,81
1,1036,0.26887791107974596,0.6492585428755642,66423014,1417,381
0,442,0.16129032258064516,0.2935251798561151,66423595,527,85
0,1073,0.1739799846035412,0.31634349030470915,68544175,1299,226
1,368,0.3532513181019332,0.7587064676616916,69003375,569,201
0,1321,0.1628643852978454,0.28578680203045687,68537644,1578,257
1,376,0.2838095238095238,0.7103218645948945,69421233,525,149
1,829,0.3033613445378151,0.6722383720930233,80124134,1190,361
0,890,0.22743055555555555,0.4804297774366846,70641536,1152,262
1,2155,0.26375128117526475,0.6348335162824734,80110485,2927,772
0,891,0.22319093286835223,0.45616438356164385,63623532,1147,256
0,547,0.21294964028776978,0.3547925608011445,80157071,695,148
1,115,0.23333333333333334,0.5342465753424658,68642434,150,35
0,519,0.17488076311605724,0.2713347921225383,68163753,629,110
0,1969,0.06416349809885931,0.047339449541284405,70532784,2104,135
0,3043,0.16216960352422907,0.26442548921224285,70532840,3632,589
0,1634,0.08664058133035216,0.09367296631059983,70532861,1789,155
1,690,0.2834890965732087,0.6342329545454546,68763653,963,273
0,62,0.17333333333333334,0.3148148148148148,73700515,75,13
1,2540,0.24584323040380046,0.5431222707423581,66409854,3368,828
1,499,0.38089330024813894,0.8246097337006428,70676942,806,307
0,759,0.1951219512195122,0.36638264910921764,68645101,943,184
1,390,0.23976608187134502,0.5045558086560364,80118956,513,123
1,100,0.3670886075949367,0.8333333333333334,69091631,158,58
0,848,0.1346938775510204,0.16174183514774496,68536181,980,132
1,1236,0.4049109292248435,0.899753086419753,70070581,2077,841
0,2051,0.1789431545236189,0.28557046979865774,68544231,2498,447
0,88,0.12871287128712872,0.17045454545454544,73524661,101,13
1,137,0.4790874524714829,0.9453125,70781480,263,126
1,1135,0.40105540897097625,0.8910005589714924,69573532,1895,760
0,65,0.16666666666666666,0.32666666666666666,73700522,78,13
2,1399,0.5903367496339678,0.9903455284552846,69056400,3415,2016
1,742,0.3652694610778443,0.6788154897494305,72320892,1169,427
1,1844,0.3700034164673727,0.8749063670411985,70632275,2927,1083
1,740,0.28085519922254615,0.6201083684527393,68212172,1029,289
1,74,0.3211009174311927,0.7407407407407407,70324996,109,35
1,60,0.3103448275862069,0.6988636363636364,67394103,87,27
0,90,0.20353982300884957,0.27586206896551724,69183135,113,23
1,60,0.27710843373493976,0.576271186440678,69183443,83,23
1,111,0.26,0.538235294117647,80155183,150,39
1,492,0.28798842257597684,0.69164265129683,65778510,691,199
1,1305,0.3372270187912646,0.7918552036199095,66401391,1969,664
1,686,0.355868544600939,0.8517191977077364,67553234,1065,379
1,494,0.36909323116219667,0.8783351120597652,68457242,783,289
1,167,0.3070539419087137,0.6333333333333333,69177605,241,74
1,1547,0.2939297124600639,0.6517857142857143,80145396,2191,644
1,1466,0.34670231729055256,0.7280276816608997,69522383,2244,778
0,889,0.24146757679180889,0.4966261808367072,65360554,1172,283
1,62,0.4959349593495935,0.8742138364779874,82009594,123,61
0,1259,0.1980891719745223,0.41705187467899335,68538001,1570,311
1,1137,0.48921832884097033,0.952855245683931,70058933,2226,1089
1,211,0.3258785942492013,0.7549019607843137,69152461,313,102
2,17,0.6046511627906976,0.9666666666666667,80175646,43,26
0,1364,0.07650643195666892,0.18302828618968386,67837035,1477,113
2,244,0.5187376725838264,0.9697542533081286,76587945,507,263
0,73,0.24742268041237114,0.4573170731707317,68962621,97,24
1,36,0.3333333333333333,0.7564102564102564,69177220,54,18
2,142,0.6658823529411765,0.9961240310077519,80172927,425,283
0,301,0.09880239520958084,0.10905730129390019,70835800,334,33
2,353,0.5658056580565806,0.9789325842696629,64244285,813,460
1,262,0.43043478260869567,0.9173989455184535,66423952,460,198
0,612,0.08928571428571429,0.1013745704467354,80119390,672,60
1,155,0.3080357142857143,0.7345132743362832,69165796,224,69
1,474,0.3611859838274933,0.7781456953642384,69573721,742,268
0,740,0.1956521739130435,0.41619047619047617,64158416,920,180
0,132,0.18012422360248448,0.4019933554817276,67539696,161,29
1,25,0.40476190476190477,0.631578947368421,70718781,42,17
1,358,0.4043261231281198,0.7971014492753623,72320990,601,243
1,2484,0.2650887573964497,0.5540089086859689,67556650,3380,896
0,179,0.182648401826484,0.351931330472103,73058356,219,40
1,850,0.33437744714173845,0.7727272727272727,70654220,1277,427
1,178,0.38831615120274915,0.8864142538975501,69613754,291,113
1,874,0.300240192153723,0.7157829839704068,81976673,1249,375
1,186,0.25,0.6028225806451613,68236091,248,62
1,1844,0.3093632958801498,0.7156962887299966,69799695,2670,826
0,1108,0.15484363081617086,0.22375690607734808,73818416,1311,203
1,679,0.4568,0.9406528189910979,80118394,1250,571
1,283,0.3213429256594724,0.7754098360655738,68391855,417,134
1,370,0.41823899371069184,0.9345549738219895,80121207,636,266
0,1021,0.12958226768968456,0.19901234567901235,82036707,1173,152
0,113,0.058333333333333334,0.07003891050583658,69508922,120,7
0,290,0.1495601173020528,0.3103448275862069,72522765,341,51
0,915,0.17119565217391305,0.3160463697376449,70617113,1104,189
0,1599,0.18955904713634059,0.33657351154313486,80125457,1973,374
1,62,0.4700854700854701,0.918918918918919,72560964,117,55
0,892,0.13482056256062075,0.24468085106382978,82028912,1031,139
1,79,0.2403846153846154,0.5373134328358209,70047614,104,25
0,297,0.2204724409448819,0.4488778054862843,70047670,381,84
0,584,0.22340425531914893,0.4749090909090909,70062622,752,168
0,1724,0.23851590106007067,0.44132306298142276,69499283,2264,540
1,740,0.23316062176165803,0.5116438356164383,70802816,965,225
0,430,0.19626168224299065,0.43163841807909603,67160576,535,105
2,12,0.6,0.9032258064516129,61022024,30,18
0,1663,0.157548125633232,0.24477611940298508,68544434,1974,311
1,213,0.3861671469740634,0.8599137931034483,69628825,347,134
1,74,0.3565217391304348,0.8333333333333334,80139729,115,41
0,575,0.19804741980474197,0.39981617647058826,67291532,717,142
1,463,0.28217054263565894,0.6370757180156658,80102960,645,182
1,434,0.2517241379310345,0.5294117647058824,68151195,580,146
1,1321,0.27097130242825607,0.6531895777178796,80114300,1812,491
1,108,0.2602739726027397,0.668769716088328,70047600,146,38
0,535,0.13290113452188007,0.1850431447746884,82044806,617,82
0,379,0.13073394495412843,0.22115384615384615,68537014,436,57
1,180,0.27419354838709675,0.5822784810126582,68546156,248,68
1,490,0.3049645390070922,0.6512605042016807,70870856,705,215
1,344,0.38898756660746003,0.9002976190476191,69606670,563,219
1,1685,0.2661149825783972,0.5951219512195122,69606810,2296,611
0,679,0.12387096774193548,0.1643312101910828,67706716,775,96
0,377,0.12933025404157045,0.1883495145631068,67810120,433,56
1,1130,0.27143778207607994,0.6845303867403315,68155780,1551,421
1,493,0.3936039360393604,0.8085351787773933,67070584,813,320
1,621,0.3421610169491525,0.6877323420074349,80126929,944,323
1,300,0.3135011441647597,0.7258883248730964,67775043,437,137
2,572,0.5712143928035982,0.9758909853249476,70597331,1334,762
2,77,0.5722222222222222,0.9651162790697675,72321984,180,103
1,137,0.33816425120772947,0.7703081232492998,80180309,207,70
0,1141,0.04837364470391994,0.03499675955930007,80123750,1199,58
2,9,0.625,0.9230769230769231,69530706,24,15
2,185,0.7030497592295345,0.937125748502994,72534294,623,438
0,1202,0.14630681818181818,0.2575360419397117,74934111,1408,206
0,1277,0.18662420382165604,0.3726182074805928,73637522,1570,293
1,218,0.3373860182370821,0.7568807339449541,68275046,329,111
0,846,0.2188365650969529,0.4855305466237942,66930955,1083,237
1,279,0.27154046997389036,0.6578073089700996,80109470,383,104
1,679,0.24303232998885171,0.5076045627376425,80118626,897,218
2,245,0.5224171539961013,0.9024390243902439,80135009,513,268
0,185,0.23236514522821577,0.44353182751540043,74477816,241,56
1,657,0.4552238805970149,0.8897216274089935,70576702,1206,549
0,54,0.1,0.2671232876712329,70568113,60,6
0,315,0.0625,0.13034188034188035,70568204,336,21
0,146,0.1797752808988764,0.3961661341853035,70568274,178,32
0,163,0.012121212121212121,0.028225806451612902,70568421,165,2
0,110,0.12698412698412698,0.22972972972972974,72543891,126,16
0,198,0.16455696202531644,0.327683615819209,80149267,237,39
1,257,0.3307291666666667,0.6780715396578538,69146994,384,127
0,1921,0.21910569105691058,0.4288753799392097,66575985,2460,539
1,207,0.37462235649546827,0.8883610451306413,82126791,331,124
0,326,0.15979381443298968,0.23783783783783785,66471405,388,62
2,84,0.6283185840707964,0.9955357142857143,70350091,226,142
2,150,0.6031746031746031,0.9567901234567902,80019632,378,228
1,618,0.40804597701149425,0.8045540796963947,80131173,1044,426
0,187,0.06030150753768844,0.33077905491698595,67872903,199,12
0,407,0.06864988558352403,0.3484201537147737,68356386,437,30
1,1377,0.3038422649140546,0.6562043795620438,80127535,1978,601
1,403,0.45614035087719296,0.8981348637015782,67092445,741,338
1,246,0.37084398976982097,0.871268656716418,69073452,391,145
1,384,0.32275132275132273,0.7812113720642769,80135834,567,183
1,1761,0.31103286384976525,0.7532051282051282,75892950,2556,795
0,476,0.14234234234234233,0.26200873362445415,81990316,555,79
0,782,0.21956087824351297,0.4748427672955975,67291574,1002,220
1,474,0.4261501210653753,0.9209302325581395,63975331,826,352
1,18,0.35714285714285715,0.6538461538461539,69611451,28,10
1,373,0.329136690647482,0.8266666666666667,66931256,556,183
1,271,0.4758220502901354,0.944,82019413,517,246
0,414,0.13389121338912133,0.12111292962356793,70653716,478,64
1,285,0.489247311827957,0.9528301886792453,72271003,558,273
1,352,0.3230769230769231,0.7250324254215305,63468363,520,168
1,683,0.30306122448979594,0.6813471502590673,80107272,980,297
0,884,0.21908127208480566,0.4110787172011662,70207284,1132,248
0,306,0.14763231197771587,0.3333333333333333,69416970,359,53
0,188,0.1415525114155251,0.1506849315068493,70645701,219,31
2,158,0.5093167701863354,0.9430051813471503,67037054,322,164
2,0,1.0,1.0,70706706,1,1
1,734,0.31529850746268656,0.7749803304484658,69586391,1072,338
1,445,0.31007751937984496,0.7156448202959831,71820644,645,200
0,1242,0.22905027932960895,0.4369158878504673,70653751,1611,369
0,1467,0.1446064139941691,0.17709384460141273,70653842,1715,248
1,524,0.37841043890865955,0.8449023861171366,68040231,843,319
1,948,0.2690824980724749,0.6490618485059069,68540472,1297,349
0,372,0.1079136690647482,0.19461444308445533,69416144,417,45
1,54,0.2894736842105263,0.7533333333333333,69421373,76,22
0,618,0.026771653543307086,0.013686131386861315,73245655,635,17
1,361,0.3818493150684932,0.8480662983425414,80162106,584,223
0,1249,0.1122956645344705,0.11892402076451156,82011857,1407,158
1,300,0.3288590604026846,0.8112522686025408,68642014,447,147
1,501,0.23159509202453987,0.5490196078431373,68642084,652,151
1,797,0.2761126248864669,0.60984393757503,68763982,1101,304
1,1066,0.3157894736842105,0.7702084392475852,69606684,1558,492
1,816,0.3142857142857143,0.764375,80132298,1190,374
0,199,0.18442622950819673,0.44204322200392926,70119882,244,45
0,1256,0.06408345752608048,0.0259946949602122,68539821,1342,86
0,255,0.13559322033898305,0.22737306843267108,82095669,295,40
0,1531,0.13843556555993247,0.16161616161616163,70646163,1777,246
0,135,0.1,0.09507042253521127,82116608,150,15
0,667,0.15247776365946633,0.24315297261189045,69239912,787,120
1,778,0.46307798481711526,0.9164105716041795,70925512,1449,671
1,172,0.4266666666666667,0.8941176470588236,82037501,300,128
1,675,0.2639040348964013,0.6710628394103957,80121125,917,242
1,761,0.2907735321528425,0.630057803468208,74326651,1073,312
1,398,0.3722397476340694,0.8649789029535865,67076212,634,236
1,664,0.3182751540041068,0.7825641025641026,69586013,974,310
0,1,0.0,0.0,77577521,1,0
2,9,0.7,0.953125,79990176,30,21
2,14,0.5882352941176471,0.9444444444444444,82024861,34,20
1,182,0.3381818181818182,0.8861788617886179,68542250,275,93
0,659,0.07960893854748603,0.06401551891367604,70642502,716,57
1,1546,0.292772186642269,0.7374301675977654,80110674,2186,640
0,309,0.2036082474226804,0.37424547283702214,70748860,388,79
1,254,0.4847870182555781,0.9276595744680851,80125066,493,239
1,652,0.45302013422818793,0.9179743223965763,70073710,1192,540
1,617,0.3059617547806524,0.6488853503184714,70628894,889,272
1,370,0.3032015065913371,0.6992125984251969,67127816,531,161
1,344,0.21818181818181817,0.5444287729196051,63277662,440,96
0,421,0.18725868725868725,0.3030690537084399,54550874,518,97
1,119,0.31213872832369943,0.6795366795366795,70509012,173,54
0,1232,0.14622314622314622,0.20018796992481203,69239940,1443,211
0,81,0.21359223300970873,0.4318181818181818,65616852,103,22
1,432,0.22994652406417113,0.5102459016393442,80095414,561,129
0,539,0.2716216216216216,0.49950248756218907,65116982,740,201
1,104,0.40229885057471265,0.8535031847133758,69044640,174,70
0,826,0.14669421487603307,0.21702838063439064,82011799,968,142
1,841,0.2570671378091873,0.5593080724876441,67804065,1132,291
1,258,0.2892561983471074,0.7017543859649122,72915591,363,105
1,709,0.3215311004784689,0.8133116883116883,80108644,1045,336
1,148,0.3242009132420091,0.7662337662337663,69152174,219,71
0,487,0.10805860805860806,0.15789473684210525,82011844,546,59
1,653,0.3383991894630192,0.7718360071301248,69967212,987,334
1,12,0.42857142857142855,0.8888888888888888,61566015,21,9
2,31,0.651685393258427,0.9733333333333334,80119153,89,58
1,29,0.21621621621621623,0.6057692307692307,69415822,37,8
0,228,0.08433734939759036,0.0941385435168739,69417334,249,21
0,793,0.16350210970464135,0.2935112189205579,70641683,948,155
0,510,0.06764168190127971,0.05067567567567568,70642866,547,37
1,540,0.29133858267716534,0.6403127715030409,67726834,762,222
0,246,0.03529411764705882,0.019157088122605363,68741106,255,9
1,233,0.2532051282051282,0.5380952380952381,80135240,312,79
1,518,0.28055555555555556,0.5166320166320166,80167985,720,202
0,552,0.23226703755215578,0.4495726495726496,69606985,719,167
1,1719,0.24539069359086918,0.5041621425986247,69607734,2278,559
1,719,0.2640736949846469,0.5860128617363344,80124686,977,258
1,241,0.24922118380062305,0.5854616895874263,82116605,321,80
1,195,0.36688311688311687,0.8316221765913757,67764473,308,113
1,600,0.4106090373280943,0.9053803339517625,63445662,1018,418
1,486,0.4426605504587156,0.7884615384615384,70544215,872,386
1,932,0.2797527047913447,0.5912508544087491,70676396,1294,362
1,63,0.32978723404255317,0.6741573033707865,69978342,94,31
1,277,0.3733031674208145,0.7757575757575758,82108568,442,165
1,510,0.3494897959183674,0.8251953125,69603163,784,274
1,495,0.308659217877095,0.6306156405990017,80127536,716,221
2,117,0.5447470817120622,0.9640522875816994,82053833,257,140
1,196,0.27941176470588236,0.6083086053412463,68384260,272,76
1,53,0.4803921568627451,0.9847328244274809,67173351,102,49
1,703,0.25133120340788073,0.5480494766888677,71388093,939,236
1,227,0.2884012539184953,0.6390977443609023,82001872,319,92
1,325,0.3564356435643564,0.8070739549839229,69073564,505,180
2,168,0.5543766578249337,0.9741935483870968,63962465,377,209
1,89,0.35036496350364965,0.7931034482758621,69176555,137,48
1,383,0.4062015503875969,0.9168618266978923,80133431,645,262
0,164,0.17587939698492464,0.4103585657370518,82011795,199,35
1,1337,0.2013142174432497,0.5139732685297691,73194765,1674,337
1,914,0.2746031746031746,0.7002275312855518,80118442,1260,346
0,523,0.2027439024390244,0.45541635961680177,80040940,656,133
0,1678,0.2355353075170843,0.44871794871794873,70660555,2195,517
1,399,0.3804347826086957,0.8465553235908142,80118461,644,245
1,318,0.33611691022964507,0.7644444444444445,69184605,479,161
0,1687,0.23178506375227687,0.44571428571428573,70498694,2196,509
0,969,0.10608856088560886,0.14210985178727115,70609336,1084,115
1,909,0.23805532271584243,0.5347793567688855,70612815,1193,284
1,1802,0.2760144636400161,0.6240227434257285,68211920,2489,687
1,90,0.34306569343065696,0.7315436241610739,69546484,137,47
1,600,0.269183922046285,0.6476377952755905,67553906,821,221
2,13,0.5517241379310345,0.96,82039842,29,16
1,194,0.2679245283018868,0.6572052401746725,66758503,265,71
1,2307,0.24236453201970443,0.5280970625798213,73816232,3045,738
0,672,0.07945205479452055,0.08525345622119816,80137331,730,58
1,656,0.36062378167641324,0.7968901846452867,70110341,1026,370
0,1678,0.14168797953964193,0.2661235573659199,70841491,1955,277
2,62,0.8649237472766884,0.9418604651162791,66991246,459,397
0,1284,0.2361689470553242,0.49720044792833146,63373653,1681,397
0,866,0.16328502415458937,0.26875852660300137,63373674,1035,169
1,2007,0.33454907161803715,0.7313242784380306,70688086,3016,1009
1,339,0.360377358490566,0.8101644245142003,69998201,530,191
1,883,0.42022324359816154,0.9007529089664613,65825165,1523,640
1,48,0.30434782608695654,0.7358490566037735,69081061,69,21
0,393,0.16913319238900634,0.31473010064043916,69534913,473,80
2,24,0.5471698113207547,0.9859154929577465,70598402,53,29
1,152,0.3559322033898305,0.7603773584905661,69627915,236,84
1,177,0.3723404255319149,0.8508474576271187,67552380,282,105
0,223,0.1890909090909091,0.27294685990338163,69681115,275,52
0,796,0.20874751491053678,0.42120343839541546,68541403,1006,210
1,1436,0.35978600089166296,0.8253638253638254,75341322,2243,807
1,425,0.3189102564102564,0.7610256410256411,70645540,624,199
1,502,0.425629290617849,0.8910984848484849,68211822,874,372
0,186,0.22821576763485477,0.3585434173669468,66614002,241,55
2,33,0.5714285714285714,0.9861111111111112,67553850,77,44
1,158,0.4397163120567376,0.924119241192412,67558092,282,124
1,55,0.2948717948717949,0.64375,82126778,78,23
1,754,0.2714975845410628,0.5206812652068127,81956099,1035,281
1,1084,0.2665764546684709,0.6047794117647058,80108280,1478,394
1,910,0.27835051546391754,0.660253164556962,68236406,1261,351
0,322,0.08522727272727272,0.12336892052194544,72523192,352,30
0,353,0.0636604774535809,0.04941176470588235,66808896,377,24
0,1387,0.12822124450031427,0.13980789754535752,80123753,1591,204
1,293,0.3488888888888889,0.8165680473372781,82001873,450,157
1,185,0.3462897526501767,0.8283752860411899,81967276,283,98
1,56,0.37777777777777777,0.7263157894736842,70646870,90,34
1,457,0.39947437582128775,0.8559463986599665,70925582,761,304
0,568,0.0642504118616145,0.2290167865707434,69625696,607,39
0,97,0.09345794392523364,0.2987012987012987,80124341,107,10
0,607,0.0530421216848674,0.10599721059972106,80124432,641,34
1,84,0.42857142857142855,0.91,81971177,147,63
2,242,0.5179282868525896,0.9322799097065463,80181498,502,260
0,115,0.1015625,0.17777777777777778,70486031,128,13
0,85,0.10526315789473684,0.21768707482993196,70638022,95,10
1,8,0.42857142857142855,0.9375,80129196,14,6
0,130,0.1390728476821192,0.2823920265780731,69960240,151,21
0,26,0.10344827586206896,0.08450704225352113,72759750,29,3
1,434,0.33024691358024694,0.784971098265896,68200524,648,214
1,766,0.22937625754527163,0.5165036674816625,68535775,994,228
0,991,0.19626926196269262,0.4565342544617156,73194905,1233,242
1,366,0.26506024096385544,0.6151645207439199,63264285,498,132
0,150,0.23857868020304568,0.4672897196261682,82095678,197,47
0,651,0.1308411214953271,0.16276041666666666,80172869,749,98
1,172,0.4707692307692308,0.9647058823529412,68210884,325,153
0,1285,0.19737663960024984,0.3791469194312796,80121148,1601,316
1,1038,0.3682288496652465,0.783157894736842,65888683,1643,605
0,1418,0.12523133867982728,0.1567357512953368,68543174,1621,203
0,2608,0.2529361214551704,0.41566820276497696,69234984,3491,883
1,162,0.40441176470588236,0.7974137931034483,80124811,272,110
1,1199,0.29387514723203767,0.6800791556728232,82008924,1698,499
1,250,0.25595238095238093,0.5077951002227171,69177241,336,86
1,306,0.28169014084507044,0.6624843161856964,81967301,426,120
1,94,0.437125748502994,0.9073170731707317,66423945,167,73
1,292,0.2997601918465228,0.7433155080213903,67942644,417,125
0,438,0.23426573426573427,0.4724576271186441,71444562,572,134
0,1229,0.14771151178918168,0.2129798903107861,80172871,1442,213
2,188,0.5369458128078818,0.9321428571428572,79816191,406,218
0,553,0.20202020202020202,0.49552772808586765,73637613,693,140
0,156,0.21608040201005024,0.3761755485893417,69118525,199,43
0,763,0.08949880668257756,0.23519009725906279,68318292,838,75
1,75,0.38524590163934425,0.8491620111731844,66228365,122,47
0,311,0.17724867724867724,0.30952380952380953,70207830,378,67
0,783,0.12611607142857142,0.17641509433962263,65026780,896,113
0,382,0.0883054892601432,0.06630824372759857,65026976,419,37
1,417,0.36335877862595417,0.8635014836795252,67291994,655,238
0,478,0.2138157894736842,0.3388888888888889,66029663,608,130
1,444,0.3431952662721893,0.8,80167005,676,232
1,1961,0.2557874762808349,0.6054229057061918,80110450,2635,674
0,235,0.09961685823754789,0.18528610354223432,60312910,261,26
0,312,0.21804511278195488,0.49379652605459057,70649152,399,87
0,61,0.19736842105263158,0.42201834862385323,70660002,76,15
1,470,0.265625,0.6734177215189874,61518184,640,170
1,449,0.47729918509895225,0.9358649789029536,67214805,859,410
0,220,0.2413793103448276,0.46,67815741,290,70
1,163,0.33739837398373984,0.8309178743961353,60312945,246,83
0,1314,0.15715202052597818,0.26625766871165646,80145621,1559,245
0,1718,0.2411660777385159,0.4568868980963046,70644791,2264,546
1,199,0.24621212121212122,0.502906976744186,63681590,264,65
2,831,0.5840840840840841,0.9807321772639692,62512205,1998,1167
1,435,0.30952380952380953,0.7236704900938478,69628944,630,195
0,2085,0.0625,0.046511627906976744,69167644,2224,139
1,53,0.2638888888888889,0.549618320610687,75892873,72,19
0,1545,0.1842661034846885,0.33507223113964685,68536594,1894,349
0,690,0.12878787878787878,0.20982142857142858,80098361,792,102
2,207,0.6019230769230769,0.9420289855072463,66803520,520,313
1,348,0.22321428571428573,0.5403458213256485,82096028,448,100
0,437,0.19521178637200737,0.37946943483275664,67833745,543,106
0,92,0.0891089108910891,0.04669260700389105,68641902,101,9
0,333,0.07242339832869081,0.09777777777777778,70606683,359,26
0,1161,0.05991902834008097,0.06,70606802,1235,74
0,588,0.03764320785597381,0.025682182985553772,70606844,611,23
0,1493,0.0508582326764145,0.04616530156366344,70606865,1573,80
0,750,0.029754204398447608,0.0166865315852205,70606900,773,23
0,1395,0.048431105047748974,0.037955073586367155,70608090,1466,71
0,314,0.09510086455331412,0.13037974683544304,80097192,347,33
0,1241,0.08883994126284875,0.07371428571428572,68539450,1362,121
1,186,0.4329268292682927,0.7841726618705036,80174904,328,142
2,855,0.666406554818572,0.9625850340136054,80045574,2563,1708
0,701,0.18488372093023256,0.3633474576271186,67336731,860,159
0,1839,0.19235836627140976,0.35600182565038796,68171656,2277,438
0,1901,0.16107678729037953,0.26362297496318116,68173924,2266,365
0,242,0.10037174721189591,0.07228915662650602,68741113,269,27
1,59,0.32954545454545453,0.6710526315789473,69964363,88,29
1,347,0.3288201160541586,0.6544585987261147,80180198,517,170
1,34,0.43333333333333335,0.8703703703703703,72640960,60,26
1,389,0.34840871021775544,0.6943620178041543,82108571,597,208
2,1083,0.5281045751633987,0.9428294573643411,69692392,2295,1212
0,471,0.23909531502423265,0.46265060240963857,69607454,619,148
1,124,0.4854771784232365,0.9523809523809523,73131261,241,117
0,341,0.18421052631578946,0.3421658986175115,54460490,418,77
0,712,0.09067688378033206,0.08695652173913043,70071064,783,71
1,69,0.30303030303030304,0.6666666666666666,69183114,99,30
1,77,0.40310077519379844,0.848314606741573,62653521,129,52
0,632,0.1738562091503268,0.38461538461538464,68536923,765,133
0,324,0.22302158273381295,0.4126984126984127,70753214,417,93
0,670,0.15404040404040403,0.2302839116719243,62793941,792,122
0,509,0.15867768595041323,0.2697290930506478,69622371,605,96
1,214,0.28187919463087246,0.6586826347305389,69165684,298,84
1,919,0.4715353651523864,0.9211640211640212,81989270,1739,820
1,2328,0.24806201550387597,0.5502732240437158,82000012,3096,768
1,284,0.41683778234086244,0.9288079470198676,66470831,487,203
1,94,0.31386861313868614,0.5808823529411765,65931110,137,43
0,1144,0.17341040462427745,0.3101449275362319,80119357,1384,240
1,339,0.3287128712871287,0.7537878787878788,61744732,505,166
1,366,0.4087237479806139,0.9182630906768838,69180083,619,253
1,384,0.36423841059602646,0.765625,66919104,604,220
1,346,0.308,0.71875,68371744,500,154
0,519,0.14918032786885246,0.4740015071590053,67834613,610,91
1,541,0.24123422159887797,0.6805970149253732,69574365,713,172
2,187,0.5835189309576837,0.8267326732673267,72426032,449,262
1,819,0.29759862778730706,0.5895904436860068,80019646,1166,347
1,737,0.2702970297029703,0.5710549258936356,80019653,1010,273
1,735,0.2801175318315377,0.6011754827875735,80019674,1021,286
1,32,0.3333333333333333,0.6979166666666666,76353151,48,16
1,223,0.09716599190283401,0.575075075075075,67888863,247,24
2,14,0.65,0.68,62482224,40,26
2,26,0.7011494252873564,0.8867924528301887,70179802,87,61
2,102,0.5188679245283019,0.8282828282828283,70506086,212,110
2,33,0.6526315789473685,0.8064516129032258,70506121,95,62
1,235,0.4547563805104408,0.6651162790697674,70637301,431,196
1,713,0.4914407988587732,0.7765567765567766,70182553,1402,689
2,170,0.6942446043165468,0.8726114649681529,77884821,556,386
2,128,0.6973995271867612,0.9128205128205128,74490843,423,295
1,71,0.48175182481751827,0.8979591836734694,80053680,137,66
2,17,0.7951807228915663,0.9824561403508771,73427165,83,66
1,99,0.31724137931034485,0.6649746192893401,70863380,145,46
0,767,0.24507874015748032,0.42950285248573755,66554390,1016,249
1,1251,0.29441624365482233,0.5720430107526882,69157886,1773,522
0,25,0.038461538461538464,0.11458333333333333,70693595,26,1
1,99,0.4375,0.897196261682243,73071705,176,77
2,138,0.7802547770700637,0.9647887323943662,80178970,628,490
0,809,0.18282828282828284,0.39838220424671383,70649250,990,181
0,241,0.1543859649122807,0.2511111111111111,80124185,285,44
0,712,0.10327455919395466,0.2536,80126908,794,82
0,707,0.14199029126213591,0.15816857440166493,69165992,824,117
2,1,0.875,0.6666666666666666,82036972,8,7
0,937,0.25752773375594296,0.42005813953488375,74324110,1262,325
0,153,0.2783018867924528,0.43005181347150256,80090262,212,59
2,761,0.65828468792097,0.8540145985401459,68342505,2227,1466
0,350,0.19908466819221968,0.3128491620111732,74545821,437,87
0,353,0.18850574712643678,0.3208279430789133,68642441,435,82
0,677,0.24526198439241917,0.49761146496815284,80108126,897,220
1,238,0.49682875264270615,0.9505208333333334,82091016,473,235
1,1003,0.18653690186536903,0.5489212242849975,72556351,1233,230
1,310,0.4026974951830443,0.8552036199095022,73323145,519,209
1,315,0.378698224852071,0.888268156424581,67159400,507,192
1,489,0.41437125748502995,0.9512437810945273,61840464,835,346
0,951,0.11452513966480447,0.1556712962962963,72493743,1074,123
1,242,0.25308641975308643,0.5604026845637584,70234766,324,82
1,57,0.27848101265822783,0.6643356643356644,70659953,79,22
1,19,0.4864864864864865,0.9117647058823529,54048393,37,18
0,722,0.12696493349455865,0.15854665565648224,80104633,827,105
0,161,0.11538461538461539,0.10714285714285714,67285526,182,21
1,375,0.3194192377495463,0.6895388076490439,67737166,551,176
1,589,0.225,0.5239179954441914,82002084,760,171
1,1012,0.28125,0.6810551558752997,80117904,1408,396
1,532,0.2580195258019526,0.5358114233907525,65422546,717,185
0,1418,0.011157601115760111,0.006043956043956044,63336735,1434,16
1,69,0.46511627906976744,0.98989898989899,65278605,129,60
0,1167,0.21677852348993287,0.45355474831344056,68540976,1490,323
0,348,0.15328467153284672,0.27487562189054726,70752402,411,63
0,637,0.20275344180225283,0.31175298804780877,68010866,799,162
0,498,0.14871794871794872,0.4903069466882068,64249066,585,87
1,140,0.34579439252336447,0.7350427350427351,67601016,214,74
0,162,0.21359223300970873,0.4025157232704403,65299892,206,44
1,730,0.2450879007238883,0.5273095077545515,71358770,967,237
0,1333,0.10114632501685772,0.08771168041684758,69239793,1483,150
0,1366,0.14195979899497488,0.20073956682514527,69960394,1592,226
1,877,0.4070317782285328,0.848421052631579,69629112,1479,602
2,363,0.707258064516129,0.9753086419753086,70933562,1240,877
1,160,0.33884297520661155,0.7803468208092486,80140057,242,82
0,379,0.20210526315789473,0.3908918406072106,64158815,475,96
1,76,0.2549019607843137,0.5945945945945946,64158906,102,26
2,52,0.695906432748538,0.9947368421052631,80104486,171,119
0,229,0.2564935064935065,0.48878923766816146,69498611,308,79
1,448,0.2328767123287671,0.5154109589041096,80137326,584,136
0,606,0.1984126984126984,0.45269016697588127,69602071,756,150
1,477,0.26615384615384613,0.5881683731513083,68531204,650,173
1,990,0.49047864127637675,0.9412711182622687,63379764,1943,953
1,791,0.2709677419354839,0.6503021148036254,66930626,1085,294
0,325,0.16020671834625322,0.30494505494505497,54609856,387,62
0,360,0.15294117647058825,0.2503597122302158,63914431,425,65
0,113,0.058333333333333334,0.136,67066594,120,7
0,1877,0.03147574819401445,0.039837030330466275,62413855,1938,61
0,1803,0.039936102236421724,0.058004640371229696,62413876,1878,75
0,463,0.06653225806451613,0.0673076923076923,74326336,496,33
0,866,0.11722731906218145,0.17767441860465116,74326343,981,115
1,95,0.2692307692307692,0.6142857142857143,82126677,130,35
0,13,0.23529411764705882,0.4444444444444444,82119390,17,4
1,423,0.22527472527472528,0.5061147695202258,66027535,546,123
0,356,0.2088888888888889,0.46447507953340406,66062906,450,94
0,313,0.12078651685393259,0.447576099210823,80128655,356,43
1,267,0.348780487804878,0.7623762376237624,67411386,410,143
1,2240,0.21951219512195122,0.514277035236938,262822,2870,630
1,299,0.2997658079625293,0.7183288409703504,65359140,427,128
1,637,0.29768467475192945,0.7123287671232876,80121220,907,270
1,37,0.28846153846153844,0.6050955414012739,72986340,52,15
0,262,0.09965635738831616,0.14145658263305322,70627312,291,29
0,759,0.19936708860759494,0.3927973199329983,80112312,948,189
1,593,0.43361986628462273,0.8898163606010017,82015330,1047,454
2,842,0.5005931198102017,0.9402684563758389,82021098,1686,844
1,595,0.44547996272134205,0.8684461391801716,63603372,1073,478
1,62,0.45132743362831856,0.9251700680272109,72919175,113,51
1,239,0.3151862464183381,0.7739602169981917,70048013,349,110
1,144,0.37117903930131,0.900990099009901,67942441,229,85
1,3,0.4,0.8888888888888888,67434794,5,2
0,17,0.15,0.21875,69724340,20,3
1,50,0.38271604938271603,0.8717948717948718,65683744,81,31
1,188,0.31636363636363635,0.7724137931034483,68395992,275,87
0,1114,0.13976833976833977,0.20277777777777778,80180383,1295,181
0,68,0.08108108108108109,0.4578313253012048,62837544,74,6
0,28,0.0,0.0,68356771,28,0
0,183,0.19383259911894274,0.2782101167315175,70814212,227,44
0,1456,0.15496227510156704,0.2581903276131045,69094102,1723,267
1,370,0.29791271347248577,0.7004889975550123,69607265,527,157
1,5,0.375,0.7647058823529411,65812285,8,3
0,332,0.17,0.34615384615384615,66062892,400,68
1,144,0.3949579831932773,0.803921568627451,68943070,238,94
0,658,0.20435308343409916,0.35443037974683544,72393391,827,169
0,2641,0.10292119565217392,0.1700064641241112,68312160,2944,303
1,159,0.273972602739726,0.5482625482625483,73650780,219,60
1,167,0.4748427672955975,0.8849557522123894,73652103,318,151
0,339,0.17518248175182483,0.4989733059548255,63769454,411,72
1,2184,0.26858673811118555,0.6326714801444043,69107941,2986,802
0,525,0.16666666666666666,0.2931985294117647,67160191,630,105
1,274,0.408207343412527,0.9046153846153846,60522875,463,189
1,229,0.24172185430463577,0.5276073619631901,66423042,302,73
1,224,0.2703583061889251,0.6496519721577726,66423161,307,83
1,160,0.36507936507936506,0.8514851485148515,68391862,252,92
1,164,0.24423963133640553,0.5330578512396694,70769804,217,53
0,500,0.15966386554621848,0.2694063926940639,82011813,595,95
2,408,0.5718782791185729,0.9661705006765899,70512295,953,545
0,850,0.24039320822162646,0.48549019607843136,67513110,1119,269
1,183,0.3838383838383838,0.8813559322033898,69622343,297,114
0,1651,0.16951710261569417,0.2526829268292683,66838842,1988,337
0,96,0.1864406779661017,0.18229166666666666,82060566,118,22
0,69,0.25,0.32575757575757575,82060567,92,23
1,30,0.3181818181818182,0.5714285714285714,82060568,44,14
0,613,0.13172804532577903,0.23464711274060496,297262,706,93
1,275,0.22096317280453256,0.5793103448275863,70398811,353,78
0,725,0.20066152149944874,0.40497737556561086,68537140,907,182
0,608,0.21649484536082475,0.4324577861163227,63264271,776,168
0,659,0.21454112038140644,0.42719227674979887,63264376,839,180
2,353,0.5474358974358975,0.9695945945945946,69622231,780,427
0,312,0.11864406779661017,0.2772727272727273,64929396,354,42
1,342,0.2769556025369979,0.7188235294117648,65683681,473,131
0,928,0.2135593220338983,0.43370568237008256,66475402,1180,252
0,1092,0.21155234657039712,0.4172794117647059,66622563,1385,293
1,48,0.4606741573033708,0.943089430894309,69607223,89,41
0,2236,0.1520667425104285,0.22761810373306904,80114146,2637,401
0,127,0.1962025316455696,0.2492753623188406,70864472,158,31
0,1405,0.13538461538461538,0.16982836495031617,73637543,1625,220
1,206,0.2771929824561403,0.5149911816578483,69626116,285,79
1,757,0.3779786359901397,0.7928286852589641,65660350,1217,460
1,1425,0.27035330261136714,0.6531068395172106,75892880,1953,528
1,269,0.27882037533512066,0.7169491525423729,67160471,373,104
0,78,0.1958762886597938,0.3645833333333333,68641930,97,19
0,1209,0.17191780821917807,0.2467733608673206,68533080,1460,251
0,1308,0.09103544127866574,0.2289929441949968,67343220,1439,131
0,1606,0.04518430439952437,0.08163265306122448,67343346,1682,76
1,138,0.49264705882352944,0.9163879598662207,70626535,272,134
1,1356,0.29521829521829523,0.6882504288164666,68211983,1924,568
0,693,0.2222222222222222,0.43553223388305845,60900896,891,198
1,276,0.24795640326975477,0.6029143897996357,68497051,367,91
0,3094,0.12967651195499297,0.19107340464773145,73808861,3555,461
0,1309,0.09097222222222222,0.0859504132231405,69621524,1440,131
0,509,0.1132404181184669,0.13656387665198239,73906035,574,65
0,336,0.1864406779661017,0.38016528925619836,69944343,413,77
1,184,0.3475177304964539,0.8144104803493449,82126696,282,98
1,1803,0.2601559294214198,0.6446700507614214,68155766,2437,634
1,846,0.44305464121132326,0.9192100538599641,67030320,1519,673
1,405,0.2513863216266174,0.5739644970414202,82046831,541,136
1,466,0.356353591160221,0.8630751964085297,80120464,724,258
1,257,0.23964497041420119,0.5854214123006833,68533612,338,81
1,267,0.23931623931623933,0.568019093078759,68533990,351,84
1,129,0.42410714285714285,0.8642384105960265,80136858,224,95
2,2,0.5,0.75,73652243,4,2
1,47,0.3380281690140845,0.8253968253968254,80079923,71,24
1,529,0.3174193548387097,0.7892518440463646,80121275,775,246
1,80,0.2523364485981308,0.5581395348837209,82128668,107,27
1,186,0.34275618374558303,0.7708830548926014,82126639,283,97
1,763,0.3609715242881072,0.7922077922077922,68254375,1194,431
0,1130,0.2169092169092169,0.4417496751840624,80130756,1443,313
1,1727,0.27801003344481606,0.6550850524791892,80098424,2392,665
1,397,0.42795389048991356,0.8851063829787233,79786994,694,297
1,609,0.3548728813559322,0.854,80125364,944,335
1,180,0.3382352941176471,0.7665289256198347,60887155,272,92
1,954,0.29542097488921715,0.7159590043923866,80125480,1354,400
1,754,0.2846299810246679,0.6680642907058001,68535922,1054,300
1,217,0.31761006289308175,0.6527777777777778,66964121,318,101
0,613,0.21005154639175258,0.39931448157669236,70476672,776,163
1,927,0.3544568245125348,0.7231182795698925,80122724,1436,509
1,535,0.2951251646903821,0.6191536748329621,70646520,759,224
1,914,0.28537920250195464,0.66398243045388,69091792,1279,365
0,741,0.18571428571428572,0.3142650253439537,70047852,910,169
0,202,0.11790393013100436,0.3605150214592275,63770945,229,27
0,811,0.20955165692007796,0.4697183098591549,68537476,1026,215
0,711,0.08139534883720931,0.2448210922787194,67343255,774,63
1,1332,0.19710669077757687,0.5888641425389755,72556323,1659,327
0,714,0.06666666666666667,0.25225806451612903,62835472,765,51
0,369,0.08436724565756824,0.43674456083803387,68356561,403,34
0,565,0.16789396170839468,0.3563218390804598,69551174,679,114
1,349,0.24295010845986983,0.5896017699115044,72760345,461,112
1,311,0.3224400871459695,0.8157894736842105,70642432,459,148
1,833,0.27628149435273675,0.6678062678062678,81965829,1151,318
0,479,0.0945179584120983,0.10677618069815195,80104612,529,50
0,668,0.220536756126021,0.45454545454545453,63100513,857,189
1,367,0.28875968992248063,0.6740947075208914,67940460,516,149
1,128,0.26857142857142857,0.5,69165586,175,47
0,681,0.18831942789034564,0.41225626740947074,80097346,839,158
0,140,0.09090909090909091,0.10046728971962617,80131451,154,14
1,827,0.33252623083131555,0.7851239669421488,69101746,1239,412
1,275,0.4136460554371002,0.8754940711462451,69967163,469,194
0,1215,0.16322314049586778,0.2484988452655889,68535404,1452,237
1,736,0.2950191570881226,0.6903515332834704,71358812,1044,308
1,83,0.23148148148148148,0.5649717514124294,65299626,108,25
2,65,0.5833333333333334,0.9586776859504132,74046364,156,91
1,376,0.45977011494252873,0.9080882352941176,80159809,696,320
0,858,0.019428571428571427,0.021632937892533146,63336840,875,17
0,286,0.033783783783783786,0.06504065040650407,63336882,296,10
0,83,0.03488372093023256,0.14136125654450263,63336945,86,3
0,50,0.0,0.0,63337022,50,0
0,969,0.14700704225352113,0.3687038280725319,62426812,1136,167
0,1649,0.12053333333333334,0.29533169533169534,62742680,1875,226
0,873,0.09907120743034056,0.23449920508744038,67343192,969,96
0,964,0.05304518664047151,0.10023866348448687,67343332,1018,54
0,668,0.17632552404438964,0.3031709203402939,80117910,811,143
1,225,0.2879746835443038,0.5644171779141104,66613855,316,91
0,575,0.18899858956276447,0.38333333333333336,68540521,709,134
1,357,0.4069767441860465,0.9042904290429042,69180531,602,245
0,1261,0.06245353159851301,0.23691570115860966,66502590,1345,84
0,392,0.220675944333996,0.4183937823834197,80105830,503,111
1,63,0.35714285714285715,0.8015267175572519,70700896,98,35
1,5,0.375,0.7586206896551724,69180783,8,3
0,1709,0.23191011235955056,0.45633096531550355,70645715,2225,516
1,448,0.30970724191063176,0.6903153153153153,72920386,649,201
1,13,0.2777777777777778,0.6818181818181818,73735452,18,5
1,1234,0.3090705487122061,0.7297840281265696,75892754,1786,552
1,75,0.4444444444444444,0.8584070796460177,64924510,135,60
1,1383,0.267478813559322,0.5768892794376098,73816246,1888,505
1,242,0.35809018567639256,0.8096947935368043,64331071,377,135
0,343,0.04456824512534819,0.006589785831960461,66930472,359,16
1,1337,0.262954796030871,0.6283944735588376,80125513,1814,477
0,550,0.1419656786271451,0.26492537313432835,68291006,641,91
1,608,0.27532777115613827,0.5654506437768241,60519865,839,231
1,47,0.25396825396825395,0.5346534653465347,70531090,63,16
1,699,0.3467289719626168,0.8282157676348548,80110912,1070,371
1,259,0.4681724845995893,0.9241935483870968,69162625,487,228
1,814,0.40843023255813954,0.8096256684491978,80174919,1376,562
1,163,0.33739837398373984,0.6907216494845361,70485723,246,83
2,5,0.6666666666666666,0.9285714285714286,82046924,15,10
2,1,0.875,0.5,72803780,8,7
1,857,0.3618763961280715,0.8012519561815337,73002041,1343,486
2,183,0.7366906474820144,0.9027027027027027,67281991,695,512
1,415,0.46243523316062174,0.851063829787234,80155221,772,357
2,123,0.5543478260869565,0.6354166666666666,70855512,276,153
1,35,0.3,0.7027027027027027,70331324,50,15
1,1129,0.4946284691136974,0.9169934640522875,64197203,2234,1105
1,15,0.4,0.8974358974358975,80137334,25,10
1,150,0.39759036144578314,0.8949880668257757,80156767,249,99
1,776,0.3395744680851064,0.6838006230529595,69157893,1175,399
1,365,0.4251968503937008,0.8725490196078431,69609512,635,270
0,519,0.13210702341137123,0.2427797833935018,80070760,598,79
1,32,0.30434782608695654,0.6162790697674418,69180776,46,14
0,208,0.168,0.40836012861736337,70660380,250,42
1,157,0.1989795918367347,0.5549132947976878,60338460,196,39
1,865,0.2650807136788445,0.6864966949952785,66345650,1177,312
1,901,0.297191887675507,0.7224137931034482,70545846,1282,381
1,787,0.45686680469289165,0.9173826834104428,82052038,1449,662
0,946,0.10501419110690634,0.18198700092850512,70649124,1057,111
1,55,0.34523809523809523,0.8012048192771084,80123617,84,29
0,2179,0.13325377883850437,0.1615523465703971,67963336,2514,335
0,488,0.17428087986463622,0.2832800851970181,70601573,591,103
1,516,0.3493064312736444,0.8382352941176471,70659932,793,277
1,343,0.32745098039215687,0.8064102564102564,66931242,510,167
1,638,0.3147153598281418,0.6779661016949152,80180460,931,293
1,2854,0.21957888980038281,0.5966024915062288,73713220,3657,803
0,756,0.056179775280898875,0.17544875506658947,64248730,801,45
1,804,0.2690909090909091,0.6040931545518702,77687981,1100,296
1,301,0.2531017369727047,0.647887323943662,68537420,403,102
1,29,0.32558139534883723,0.7411764705882353,70509411,43,14
0,1722,0.1200817577925396,0.16377079482439927,68535306,1957,235
1,574,0.37336244541484714,0.8677685950413223,80110681,916,342
1,868,0.3917309039943938,0.8755215577190543,66776164,1427,559
0,1163,0.18156228008444758,0.3561320754716981,68537630,1421,258
1,334,0.2561247216035635,0.6922024623803009,70618324,449,115
1,307,0.32229580573951433,0.705982905982906,65447935,453,146
1,1092,0.2631578947368421,0.5161716171617162,81956111,1482,390
1,240,0.26605504587155965,0.5291005291005291,66897635,327,87
1,164,0.2807017543859649,0.6374407582938388,68763674,228,64
2,667,0.5070214338507022,0.9448818897637795,69587644,1353,686
0,1311,0.13636363636363635,0.25049019607843137,81965607,1518,207
1,441,0.22495606326889278,0.5186274509803922,81965694,569,128
0,898,0.15203021718602455,0.25516693163751986,68173945,1059,161
1,775,0.27973977695167285,0.5815668202764976,80111493,1076,301
1,431,0.4336399474375821,0.8894173602853745,74226145,761,330
0,406,0.10375275938189846,0.11282660332541568,81999334,453,47
0,587,0.16855524079320114,0.30995670995670993,81999336,706,119
1,601,0.29871645274212366,0.6935866983372921,81965693,857,256
1,280,0.27648578811369506,0.6744548286604362,77676263,387,107
1,354,0.2948207171314741,0.668903803131991,68371814,502,148
1,542,0.36682242990654207,0.8561501042390549,68224961,856,314
1,781,0.40743550834597875,0.9160186625194401,68532331,1318,537
1,826,0.36510376633358954,0.7853152434158021,80053043,1301,475
0,1979,0.15823054019566143,0.22879543834640056,67554823,2351,372
1,747,0.23305954825462014,0.5038434661076171,68218584,974,227
1,24,0.2727272727272727,0.74,68392086,33,9
0,432,0.06493506493506493,0.1446280991735537,60070374,462,30
0,198,0.07906976744186046,0.24821002386634844,60543371,215,17
1,482,0.27627627627627627,0.6351118760757315,68763695,666,184
0,919,0.043704474505723206,0.015769439912996192,80097584,961,42
1,54,0.41304347826086957,0.8958333333333334,80132306,92,38
1,815,0.27939876215738285,0.6051423324150597,70809935,1131,316
1,287,0.32786885245901637,0.7813688212927756,68532380,427,140
1,222,0.28846153846153844,0.6825775656324582,67384863,312,90
0,325,0.02694610778443114,0.07037037037037037,62839441,334,9
1,277,0.41561181434599154,0.9144144144144144,67922680,474,197
1,259,0.34760705289672544,0.8184818481848185,67556482,397,138
1,426,0.21834862385321102,0.5076219512195121,67985953,545,119
2,259,0.6081694402420574,0.9962825278810409,65290071,661,402
0,1045,0.13991769547325103,0.2129032258064516,65299731,1215,170
1,1216,0.2692307692307692,0.654320987654321,80110604,1664,448
1,778,0.2789620018535681,0.6929392446633826,80110625,1079,301
1,655,0.2410196987253766,0.5252008765522279,805476,863,208
1,496,0.24620060790273557,0.5432780847145487,80103156,658,162
1,993,0.4071641791044776,0.8649318463444857,80153458,1675,682
1,218,0.4930232558139535,0.9027431421446384,80124941,430,212
2,111,0.6419354838709678,0.9782608695652174,61501370,310,199
0,302,0.14204545454545456,0.23346303501945526,68538204,352,50
0,314,0.18441558441558442,0.37436762225969644,68538211,385,71
0,3245,0.0828151498021481,0.06352718078381796,68539772,3538,293
1,302,0.34773218142548595,0.8377425044091711,68530840,463,161
0,1088,0.17762660619803478,0.3411336453458138,68544511,1323,235
1,230,0.3215339233038348,0.7567567567567568,69607503,339,109
0,297,0.16101694915254236,0.28256880733944956,68791191,354,57
0,1431,0.1567472009428403,0.23816736084816356,82000007,1697,266
0,176,0.1497584541062802,0.29577464788732394,80124182,207,31
0,1928,0.1823579304495335,0.3333333333333333,72368926,2358,430
1,132,0.2978723404255319,0.6819571865443425,68668551,188,56
0,294,0.11976047904191617,0.20253164556962025,68535285,334,40
1,25,0.3902439024390244,0.75,79989721,41,16
0,24,0.1724137931034483,0.11428571428571428,79989735,29,5
1,790,0.2630597014925373,0.6248073959938367,80112011,1072,282
0,10,0.0,0.0,70582554,10,0
1,1362,0.27009646302250806,0.6603006907761073,80118435,1866,504
1,284,0.39957716701902746,0.9186046511627907,80121209,473,189
0,1320,0.14341336794289422,0.22554347826086957,73346875,1541,221
2,217,0.581888246628131,0.955503512880562,74361791,519,302
2,463,0.5021505376344086,0.9264705882352942,63140014,930,467
1,192,0.3402061855670103,0.7986270022883295,69176646,291,99
1,240,0.4174757281553398,0.8442622950819673,80118581,412,172
1,688,0.40842648323301806,0.922514619883041,68532324,1163,475
1,121,0.4646017699115044,0.9057239057239057,72322026,226,105
0,978,0.04678362573099415,0.032598274209012464,80114531,1026,48
0,513,0.2071097372488408,0.36770186335403726,80114636,647,134
0,613,0.1738544474393531,0.3792,60800530,742,129
0,2802,0.11413215301928549,0.17566302652106083,66394475,3163,361
0,181,0.07653061224489796,0.16849015317286653,70660023,196,15
1,1167,0.3354214123006834,0.7751134154244977,80111654,1756,589
1,978,0.2782287822878229,0.6742344244984161,69531630,1355,377
0,682,0.043478260869565216,0.013307984790874524,69601014,713,31
1,497,0.24582701062215478,0.5056947608200456,69165565,659,162
1,273,0.23529411764705882,0.5085271317829457,82011761,357,84
0,651,0.10082872928176796,0.2527352297592998,60028311,724,73
0,1703,0.06787082649151614,0.1532033426183844,60028626,1827,124
0,543,0.028622540250447227,0.030518819938962362,64251082,559,16
0,610,0.12607449856733524,0.2944507361268403,67225900,698,88
1,60,0.3684210526315789,0.9144736842105263,67555831,95,35
1,31,0.2619047619047619,0.5657894736842105,69155926,42,11
1,358,0.3358070500927644,0.7749140893470791,80180000,539,181
0,533,0.051601423487544484,0.21488871834228704,62835710,562,29
0,1312,0.09828178694158075,0.0966702470461869,69551825,1455,143
0,365,0.1330166270783848,0.25483870967741934,80124173,421,56
0,915,0.23238255033557048,0.4567699836867863,67555712,1192,277
0,722,0.16046511627906976,0.24975514201762977,69170066,860,138
1,211,0.4056338028169014,0.8537005163511188,69832350,355,144
2,7,0.6111111111111112,0.8,67665521,18,11
1,892,0.45242480049109884,0.9125520523497918,70760214,1629,737
1,360,0.3283582089552239,0.6848920863309352,69150886,536,176
0,697,0.1405672009864365,0.16102683780630106,67819906,811,114
1,210,0.2953020134228188,0.576427255985267,80180286,298,88
0,410,0.19291338582677164,0.4253731343283582,82011792,508,98
1,527,0.24063400576368876,0.5418410041841004,68534935,694,167
0,622,0.1560379918588874,0.2021903959561921,68535334,737,115
1,404,0.34838709677419355,0.7530712530712531,63141162,620,216
0,1398,0.2006861063464837,0.38866930171277997,68536825,1749,351
0,458,0.16423357664233576,0.3593314763231198,82000076,548,90
0,187,0.07881773399014778,0.3153153153153153,69383650,203,16
0,654,0.1905940594059406,0.29055007052186177,70648186,808,154
1,214,0.27702702702702703,0.5544554455445545,82041262,296,82
1,137,0.4017467248908297,0.9228070175438596,70064155,229,92
1,400,0.3640699523052464,0.8183990442054958,82143797,629,229
0,977,0.1496953872932985,0.21212121212121213,68536524,1149,172
1,2281,0.24269588313413015,0.5306365258774539,76043401,3012,731
0,479,0.13537906137184116,0.24283305227655985,64915242,554,75
0,342,0.1385390428211587,0.319634703196347,64929403,397,55
0,297,0.18181818181818182,0.484251968503937,64929655,363,66
1,885,0.4162269129287599,0.8901540522438044,65947721,1516,631
1,1725,0.2513020833333333,0.5187576875768758,64399055,2304,579
1,391,0.2509578544061303,0.6624015748031497,80135428,522,131
1,663,0.23441108545034642,0.5009276437847866,80112116,866,203
1,359,0.38421955403087477,0.7814070351758794,69708121,583,224
0,1754,0.1538832609744332,0.24240331491712708,70609413,2073,319
0,636,0.07423580786026202,0.03821656050955414,72104515,687,51
1,751,0.37416666666666665,0.8614690721649485,65278395,1200,449
1,1519,0.2502467917077986,0.5748649975454099,69739215,2026,507
0,193,0.1572052401746725,0.40976645435244163,81965617,229,36
1,444,0.3629842180774749,0.7909319899244333,67994346,697,253
1,580,0.34015927189988626,0.7428571428571429,67994353,879,299
0,221,0.19047619047619047,0.3905579399141631,81980454,273,52
1,825,0.2224316682375118,0.5694444444444444,67804135,1061,236
0,290,0.11585365853658537,0.15398230088495576,67285701,328,38
1,233,0.2626582278481013,0.5465994962216625,68531190,316,83
1,761,0.31379621280432823,0.7191726332537789,68531393,1109,348
1,34,0.34615384615384615,0.7361111111111112,82126588,52,18
0,79,0.14130434782608695,0.14285714285714285,80126980,92,13
0,41,0.19607843137254902,0.3409090909090909,66087350,51,10
1,29,0.40816326530612246,0.898876404494382,68330073,49,20
0,22,0.15384615384615385,0.15517241379310345,74708984,26,4
0,666,0.12137203166226913,0.13432835820895522,69240262,758,92
1,134,0.29842931937172773,0.6267123287671232,81967262,191,57
1,101,0.2109375,0.5086206896551724,70252833,128,27
1,661,0.32619775739041795,0.7705357142857143,70761152,981,320
1,58,0.3333333333333333,0.6846153846153846,62498093,87,29
0,747,0.08004926108374384,0.06101281269066504,69240010,812,65
0,889,0.072992700729927,0.1906677393403057,70001001,959,70
1,274,0.29198966408268734,0.7312859884836852,69622112,387,113
1,60,0.4827586206896552,0.875,62510105,116,56
1,419,0.2340036563071298,0.5776942355889725,68542684,547,128
0,563,0.1793002915451895,0.3187721369539551,80127691,686,123
0,2893,0.1827683615819209,0.3464681844716871,74886252,3540,647
0,360,0.23404255319148937,0.4739010989010989,70562233,470,110
0,753,0.17070484581497797,0.3395259449071108,69625220,908,155
0,1148,0.18869257950530036,0.37349397590361444,70073150,1415,267
0,727,0.18314606741573033,0.34125412541254124,80114426,890,163
1,404,0.22007722007722008,0.5377358490566038,68540584,518,114
0,547,0.09735973597359736,0.12657091561938957,54609800,606,59
1,499,0.21786833855799373,0.5308641975308642,68540766,638,139
0,74,0.08641975308641975,0.09644670050761421,69160476,81,7
0,905,0.2109851787271142,0.4584487534626039,70641634,1147,242
0,794,0.17463617463617465,0.30210970464135023,70641942,962,168
0,904,0.1645101663585952,0.3070652173913043,78624441,1082,178
1,395,0.2921146953405018,0.6180021953896817,74738321,558,163
0,1919,0.11157407407407408,0.1257285595337219,70615160,2160,241
1,259,0.3541147132169576,0.8811881188118812,80121194,401,142
1,2131,0.40424937098126923,0.8814070351758794,67993870,3577,1446
1,747,0.2361963190184049,0.5230400957510473,80122958,978,231
0,86,0.033707865168539325,0.04247104247104247,65914940,89,3
0,17,0.15,0.49122807017543857,70669501,20,3
1,30,0.34782608695652173,0.8191489361702128,82018811,46,16
0,547,0.11631663974151858,0.16319824753559695,67725483,619,72
1,450,0.35714285714285715,0.7722063037249284,80180332,700,250
0,1530,0.1326530612244898,0.26541274817136884,81965661,1764,234
1,538,0.3865450399087799,0.7111756168359942,72433613,877,339
0,89,0.32575757575757575,0.48695652173913045,72775045,132,43
2,61,0.5906040268456376,0.9957081545064378,69162506,149,88
1,490,0.2598187311178248,0.5274086378737541,69172796,662,172
0,302,0.21963824289405684,0.469119579500657,74850041,387,85
1,163,0.30638297872340425,0.7333333333333333,63806106,235,72
2,77,0.615,0.986013986013986,73330950,200,123
1,89,0.23931623931623933,0.5450819672131147,66964233,117,28
0,36,0.05263157894736842,0.13541666666666666,66964240,38,2
0,483,0.07648183556405354,0.0627177700348432,73199980,523,40
0,183,0.12857142857142856,0.39956331877729256,70649740,210,27
1,10,0.3333333333333333,0.5625,72801946,15,5
2,65,0.5637583892617449,0.944954128440367,82034157,149,84
0,154,0.2413793103448276,0.4965277777777778,69157984,203,49
0,1251,0.1484002722940776,0.37283621837549935,70649096,1469,218
0,95,0.07766990291262135,0.26570048309178745,80124239,103,8
1,51,0.4069767441860465,0.7796610169491526,72270933,86,35
2,54,0.6966292134831461,0.9819277108433735,80104493,178,124
0,156,0.28440366972477066,0.37037037037037035,80178923,218,62
2,29,0.8693693693693694,0.9824561403508771,69692280,222,193
0,416,0.15789473684210525,0.443952802359882,300433,494,78
1,165,0.4642857142857143,0.9533799533799534,70768173,308,143
0,184,0.1559633027522936,0.3339622641509434,80118424,218,34
0,565,0.029209621993127148,0.007113821138211382,80121013,582,17
0,156,0.22388059701492538,0.45850622406639,65905406,201,45
0,302,0.14204545454545456,0.2384428223844282,72522646,352,50
0,558,0.13488372093023257,0.1364190012180268,70645771,645,87
1,697,0.28365878725590954,0.7012622720897616,69628650,973,276
2,176,0.5487179487179488,0.9735576923076923,80131302,390,214
0,221,0.22456140350877193,0.46153846153846156,68289074,285,64
0,574,0.2232746955345061,0.49252336448598133,63264404,739,165
1,832,0.2373968835930339,0.5170499603489295,63100730,1091,259
0,414,0.10775862068965517,0.09549795361527967,63100751,464,50
1,182,0.4678362573099415,0.9156626506024096,80132322,342,160
1,22,0.42105263157894735,0.6585365853658537,80136625,38,16
1,327,0.3433734939759036,0.6467236467236467,80132371,498,171
0,842,0.09267241379310345,0.11126961483594865,63757554,928,86
1,122,0.2823529411764706,0.7133105802047781,68642315,170,48
2,13,0.6578947368421053,0.8235294117647058,82171881,38,25
2,452,0.7315914489311164,0.9269662921348315,68179146,1684,1232
1,833,0.253584229390681,0.605009633911368,68536811,1116,283
1,163,0.2850877192982456,0.6837209302325581,82135547,228,65
0,1215,0.22264875239923224,0.4618138424821002,80141452,1563,348
0,797,0.2155511811023622,0.41731175228712175,68541963,1016,219
0,2427,0.056376360808709176,0.03160040774719674,68539905,2572,145
0,512,0.20124804992199688,0.39166666666666666,79520035,641,129
0,463,0.152014652014652,0.19489559164733178,67428445,546,83
0,106,0.17829457364341086,0.17427385892116182,80131485,129,23
1,607,0.3172103487064117,0.694672131147541,68614014,889,282
0,657,0.14785992217898833,0.1619718309859155,82007309,771,114
0,555,0.09313725490196079,0.05603448275862069,82007310,612,57
1,55,0.38202247191011235,0.6428571428571429,763056,89,34
2,52,0.5398230088495575,0.7843137254901961,82108142,113,61
2,348,0.5677018633540373,0.9474940334128878,66495786,805,457
1,900,0.2946708463949843,0.696584058941728,68120164,1276,376
0,16,0.0,0.0,70209482,16,0
0,23,0.0,0.0,70209510,23,0
1,672,0.3575525812619503,0.5877862595419847,82009346,1046,374
0,81,0.03571428571428571,0.010416666666666666,69039383,84,3
0,96,0.15789473684210525,0.1449814126394052,69177283,114,18
1,423,0.46387832699619774,0.9425981873111783,80159814,789,366
1,232,0.3236151603498542,0.7828947368421053,69073585,343,111
0,941,0.13511029411764705,0.2945527908540686,63773640,1088,147
0,1962,0.2145716573258607,0.4760420724581223,68312202,2498,536
1,354,0.3689839572192513,0.8280871670702179,66064831,561,207
0,1086,0.04903677758318739,0.08134280180761781,68242272,1142,56
0,1214,0.22179487179487178,0.35255570117955437,66471573,1560,346
0,2123,0.23107569721115537,0.46623534169025477,70605101,2761,638
1,571,0.2594033722438392,0.6436265709156194,67160534,771,200
2,452,0.7272178636089318,0.9877675840978594,80127582,1657,1205
0,1338,0.1526282457251425,0.33269138180067404,69575261,1579,241
1,185,0.3485915492957746,0.8032520325203252,72932300,284,99
0,663,0.21071428571428572,0.4528301886792453,69893481,840,177
1,211,0.4417989417989418,0.8898756660746003,80145305,378,167
1,534,0.372502937720329,0.8005082592121983,61078024,851,317
1,80,0.38461538461538464,0.8148148148148148,80050446,130,50
1,217,0.34441087613293053,0.7702407002188184,66065930,331,114
1,389,0.27153558052434457,0.6345885634588564,70641963,534,145
1,247,0.29428571428571426,0.7652671755725191,68642021,350,103
1,136,0.2648648648648649,0.6914893617021277,80071082,185,49
0,431,0.05895196506550218,0.08015267175572519,70608076,458,27
0,440,0.2014519056261343,0.3811230585424134,67558120,551,111
2,230,0.5021645021645021,0.9783653846153846,63099183,462,232
1,170,0.40350877192982454,0.861244019138756,72331742,285,115
0,409,0.23977695167286245,0.451559934318555,67652032,538,129
0,1202,0.16002795248078266,0.24032489249880554,70539735,1431,229
1,883,0.27145214521452143,0.6047652417659425,80110793,1212,329
0,55,0.2361111111111111,0.4260869565217391,80139728,72,17
0,313,0.1806282722513089,0.40559440559440557,70617120,382,69
1,805,0.35958631662688945,0.8444302176696543,73739050,1257,452
0,1037,0.23298816568047337,0.40551181102362205,68421241,1352,315
1,52,0.3953488372093023,0.9224137931034483,68547206,86,34
1,1748,0.3827683615819209,0.8739903069466882,69739124,2832,1084
1,727,0.26565656565656565,0.5821635012386458,68531855,990,263
1,662,0.2425629290617849,0.5115681233933161,69165446,874,212
1,653,0.4236540158870256,0.9297337278106509,80125348,1133,480
2,402,0.6658354114713217,0.9934747145187602,63176911,1203,801
1,734,0.38371116708648195,0.8929765886287625,68531505,1191,457
1,240,0.24290220820189273,0.5418181818181819,66930752,317,77
1,535,0.28761651131824234,0.674852652259332,62415115,751,216
1,750,0.3392070484581498,0.7454545454545455,73703812,1135,385
0,558,0.1,0.13570741097208855,80124513,620,62
1,427,0.2429078014184397,0.5473554735547356,68530623,564,137
0,191,0.21074380165289255,0.2752941176470588,80103051,242,51
0,147,0.09259259259259259,0.08408408408408409,66412570,162,15
0,587,0.20027247956403268,0.3815028901734104,69622385,734,147
1,145,0.21621621621621623,0.5080385852090032,70047943,185,40
1,1476,0.2821011673151751,0.704991587212563,70658756,2056,580
0,231,0.07228915662650602,0.24478178368121442,62548164,249,18
1,166,0.2687224669603524,0.6009852216748769,66210060,227,61
1,525,0.2895805142083897,0.7030784508440914,77688016,739,214
0,659,0.1772784019975031,0.34049409237379163,66423602,801,142
0,2968,0.06519685039370078,0.04972554084597998,69601070,3175,207
0,711,0.052,0.16932153392330385,62838951,750,39
0,295,0.08668730650154799,0.37615526802218113,80128650,323,28
0,278,0.11746031746031746,0.36203866432337434,60028430,315,37
0,1742,0.0578691184424013,0.08122568093385214,81965818,1849,107
0,622,0.1408839779005525,0.15146948003014318,67554193,724,102
1,355,0.2040358744394619,0.5094890510948905,70618282,446,91
0,497,0.07962962962962963,0.09696969696969697,70626605,540,43
1,329,0.15206185567010308,0.5229508196721312,60509554,388,59
1,485,0.25499231950844853,0.5010504201680672,80107986,651,166
0,340,0.15632754342431762,0.20512820512820512,68530721,403,63
1,866,0.28192371475953565,0.614877024595081,74355806,1206,340
1,991,0.28447653429602887,0.6980497646267653,80111990,1385,394
0,625,0.1209563994374121,0.1310344827586207,69735463,711,86
2,172,0.5141242937853108,0.9395604395604396,63725830,354,182
0,345,0.21052631578947367,0.4078516902944384,71358623,437,92
1,82,0.2807017543859649,0.6485148514851485,67993681,114,32
0,467,0.1892361111111111,0.3543990086741016,69385925,576,109
0,1283,0.20211442786069653,0.364010989010989,73818402,1608,325
1,186,0.4959349593495935,0.9581993569131833,67455444,369,183
1,1504,0.3148063781321184,0.7459490740740741,65808561,2195,691
0,314,0.08985507246376812,0.14212548015364918,70627060,345,31
1,763,0.23547094188376755,0.5060757684060043,80111752,998,235
0,503,0.05451127819548872,0.12671594508975711,70001141,532,29
1,584,0.27543424317617865,0.6013570822731128,80109106,806,222
0,120,0.04,0.08480565371024736,68743465,125,5
1,602,0.2858837485172005,0.7024193548387097,65018464,843,241
1,898,0.2453781512605042,0.5106853352984525,69155975,1190,292
1,452,0.31097560975609756,0.7638888888888888,70070756,656,204
0,95,0.17391304347826086,0.4533762057877814,69417082,115,20
0,1405,0.17011222681630242,0.27250124316260566,67721990,1693,288
0,453,0.13714285714285715,0.19575699132111862,54609653,525,72
1,826,0.409578270192995,0.8879837067209776,67706072,1399,573
0,4,0.0,0.0,80125395,4,0
1,320,0.32914046121593293,0.7841409691629956,66471083,477,157
1,28,0.3333333333333333,0.6153846153846154,80053981,42,14
1,207,0.425,0.8153409090909091,72320906,360,153
0,370,0.16666666666666666,0.24770642201834864,80176763,444,74
1,61,0.41904761904761906,0.6666666666666666,80176024,105,44
2,113,0.7160804020100503,0.9878048780487805,80172016,398,285
2,177,0.6746323529411765,0.9752066115702479,80172017,544,367
1,43,0.3384615384615385,0.6790123456790124,69944630,65,22
1,175,0.4186046511627907,0.834061135371179,70225232,301,126
2,103,0.5095238095238095,0.9027777777777778,69733440,210,107
0,6,0.14285714285714285,0.05263157894736842,76081243,7,1
0,98,0.216,0.4942528735632184,69058570,125,27
0,441,0.15839694656488548,0.1952247191011236,74512032,524,83
1,342,0.32007952286282304,0.6276150627615062,80051783,503,161
0,217,0.1962962962962963,0.28619528619528617,80180224,270,53
1,63,0.35714285714285715,0.7121212121212122,80180279,98,35
1,65,0.25287356321839083,0.5535714285714286,80051930,87,22
0,888,0.14942528735632185,0.20825852782764812,68115460,1044,156
1,253,0.3253333333333333,0.7344827586206897,82126728,375,122
1,349,0.2920892494929006,0.6680761099365751,65313171,493,144
0,101,0.15833333333333333,0.2222222222222222,67748926,120,19
1,114,0.3448275862068966,0.7479674796747967,68040210,174,60
0,314,0.18441558441558442,0.2868632707774799,68534984,385,71
1,1193,0.28391356542617047,0.6410256410256411,68763814,1666,473
1,211,0.45618556701030927,0.9535353535353536,70014105,388,177
0,335,0.11842105263157894,0.15080527086383602,82178179,380,45
0,1093,0.15987701767870868,0.29069767441860467,68542936,1301,208
1,150,0.22279792746113988,0.5251256281407035,80131235,193,43
0,219,0.043668122270742356,0.22798552472858866,68357023,229,10
2,23,0.5964912280701754,0.8666666666666667,70414113,57,34
0,1172,0.18041958041958042,0.2677564825253664,69586286,1430,258
1,650,0.26636568848758463,0.5559736594543744,80108231,886,236
2,5,0.5833333333333334,0.9090909090909091,77881055,12,7
0,110,0.29936305732484075,0.45569620253164556,80127286,157,47
2,34,0.5584415584415584,0.95,70925596,77,43
1,909,0.328159645232816,0.7103905674281503,64135183,1353,444
0,1119,0.09612277867528271,0.117170626349892,69534836,1238,119
1,410,0.26523297491039427,0.6101694915254238,69165481,558,148
2,41,0.5494505494505495,0.9618320610687023,82021927,91,50
0,591,0.12053571428571429,0.18899273104880582,68539646,672,81
0,736,0.15402298850574714,0.3920406435224386,60541901,870,134
1,104,0.3333333333333333,0.802013422818792,65315901,156,52
1,1167,0.2931556632344034,0.6947256259989345,75892831,1651,484
0,169,0.07142857142857142,0.2930232558139535,64240974,182,13
0,720,0.09433962264150944,0.2646331409727947,70654661,795,75
0,1132,0.21660899653979238,0.4644175013178703,68543405,1445,313
0,1056,0.0982066609735269,0.09325486645540969,69082671,1171,115
0,1874,0.1122690667929891,0.14388777555110221,70615223,2111,237
0,1457,0.1347980997624703,0.19543343653250775,70641641,1684,227
0,1021,0.19732704402515724,0.4027879677182685,70642705,1272,251
0,877,0.17652582159624414,0.3331482509716824,68535411,1065,188
0,594,0.11475409836065574,0.17323481116584566,70642103,671,77
2,41,0.5816326530612245,0.9384615384615385,70713601,98,57
1,1293,0.2615648201027984,0.5023068050749712,68018342,1751,458
1,81,0.39097744360902253,0.8839285714285714,69183534,133,52
0,842,0.13195876288659794,0.14176829268292682,69550341,970,128
0,200,0.20948616600790515,0.43661971830985913,63141610,253,53
1,1143,0.32045184304399527,0.7623762376237624,80125499,1682,539
1,543,0.33455882352941174,0.7911392405063291,68532401,816,273
1,630,0.296875,0.6999161777032691,67552534,896,266
1,129,0.4669421487603306,0.9087837837837838,66860003,242,113
0,119,0.1619718309859155,0.3333333333333333,80072111,142,23
0,111,0.075,0.10101010101010101,80072132,120,9
0,35,0.16666666666666666,0.3064516129032258,80072153,42,7
0,98,0.14782608695652175,0.29473684210526313,80072195,115,17
1,270,0.4589178356713427,0.9166666666666666,80117936,499,229
1,1165,0.277743335399876,0.6525714285714286,80110464,1613,448
0,2319,0.19367176634214187,0.32621502209131076,65299675,2876,557
1,196,0.3333333333333333,0.739247311827957,81967306,294,98
0,151,0.03821656050955414,0.18275154004106775,70314650,157,6
1,130,0.3434343434343434,0.7847533632286996,68782483,198,68
0,227,0.20350877192982456,0.4377952755905512,82011778,285,58
1,88,0.296,0.7748917748917749,69943125,125,37
1,251,0.27873563218390807,0.6583333333333333,65941743,348,97
0,186,0.10576923076923077,0.18666666666666668,80098816,208,22
0,65,0.2073170731707317,0.46285714285714286,64944803,82,17
0,79,0.13186813186813187,0.2645161290322581,61908882,91,12
1,1139,0.37962962962962965,0.8673012318029115,63445886,1836,697
1,355,0.29563492063492064,0.6724598930481284,70871136,504,149
0,1057,0.2004538577912254,0.4004226096143687,60887050,1322,265
1,214,0.3903133903133903,0.8433734939759037,64857226,351,137
1,266,0.29815303430079154,0.7245590230664858,65313220,379,113
0,377,0.09156626506024096,0.10619469026548672,67333854,415,38
1,416,0.27526132404181186,0.6513249651324965,69165740,574,158
0,208,0.1148936170212766,0.16978193146417445,80098312,235,27
0,889,0.20766488413547238,0.373775433308214,80180165,1122,233
0,45,0.16666666666666666,0.2761904761904762,73977750,54,9
0,444,0.07883817427385892,0.11363636363636363,67437293,482,38
1,238,0.2631578947368421,0.663235294117647,72382331,323,85
0,792,0.1826625386996904,0.29425695677915925,70841645,969,177
1,691,0.33938814531548755,0.7484197218710493,69100171,1046,355
0,1413,0.1394640682095006,0.18864774624373956,67963511,1642,229
0,968,0.053763440860215055,0.11232676878191102,60028843,1023,55
1,716,0.38593481989708406,0.8800666296501943,69161113,1166,450
0,736,0.09693251533742331,0.1185137732222934,72522730,815,79
0,1108,0.09328968903436989,0.091324200913242,72522744,1222,114
1,273,0.23743016759776536,0.5516637478108581,70613704,358,85
1,234,0.2822085889570552,0.5987780040733197,80128485,326,92
1,86,0.3900709219858156,0.9017857142857143,67556006,141,55
1,683,0.37511436413540716,0.8403565640194489,77095662,1093,410
2,23,0.54,0.9666666666666667,80127884,50,27
0,929,0.16079494128274616,0.38239339752407153,80140157,1107,178
1,686,0.3447946513849093,0.8169398907103825,69992216,1047,361
0,232,0.1888111888111888,0.43506493506493504,70633514,286,54
1,353,0.23593073593073594,0.5129682997118156,68530553,462,109
1,460,0.21232876712328766,0.5187424425634825,68542691,584,124
0,699,0.16785714285714284,0.3347826086956522,69416403,840,141
1,1192,0.33183856502242154,0.8141135972461274,80121188,1784,592
0,129,0.1513157894736842,0.17391304347826086,65891623,152,23
0,442,0.0635593220338983,0.06949152542372881,69106975,472,30
0,790,0.21393034825870647,0.4477925718290119,80111864,1005,215
0,907,0.17395264116575593,0.29350104821802936,80140100,1098,191
0,380,0.16299559471365638,0.27909887359199,69165180,454,74
0,754,0.20715036803364878,0.4058697208303508,67154605,951,197
0,287,0.2222222222222222,0.40221914008321774,80118965,369,82
0,337,0.18795180722891566,0.34623655913978496,69056561,415,78
0,1327,0.2143280047365305,0.4232081911262799,70614663,1689,362
0,1278,0.22073170731707317,0.46524307133121307,66931011,1640,362
0,1334,0.16677076826983137,0.2719459791282996,70241332,1601,267
0,2354,0.13360323886639677,0.15050448430493274,63278761,2717,363
0,1110,0.16978309648466716,0.2882797731568998,66931802,1337,227
1,1362,0.3152337858220211,0.6600306278713629,64959342,1989,627
1,162,0.40875912408759124,0.8637873754152824,67346832,274,112
0,168,0.16417910447761194,0.2831858407079646,69057513,201,33
1,584,0.3225058004640371,0.802130898021309,66409980,862,278
0,702,0.21651785714285715,0.47192716236722304,70660373,896,194
0,1350,0.21739130434782608,0.49043715846994534,68538183,1725,375
0,454,0.21724137931034482,0.4892268694550063,68540626,580,126
1,721,0.25746652935118436,0.607565011820331,63278544,971,250
1,784,0.27069767441860465,0.6054901960784314,67552065,1075,291
1,1050,0.27184466019417475,0.6164604626143088,69606726,1442,392
1,881,0.25528317836010145,0.5584615384615385,68563516,1183,302
1,411,0.3819548872180451,0.8464566929133859,69059235,665,254
1,538,0.46995073891625616,0.928164196123147,67154444,1015,477
0,203,0.06018518518518518,0.2718168812589413,78540714,216,13
0,1205,0.08781226343679031,0.20418271876719868,73366265,1321,116
0,910,0.07614213197969544,0.2908665105386417,62838860,985,75
1,196,0.37777777777777777,0.8691099476439791,64193402,315,119
0,304,0.05,0.19484536082474227,65910901,320,16
1,329,0.4588815789473684,0.9621559633027523,70593642,608,279
1,220,0.2786885245901639,0.6514806378132119,60514006,305,85
0,2319,0.04959016393442623,0.027906976744186046,67706492,2440,121
0,1454,0.1877094972067039,0.35705100728675526,68544420,1790,336
2,152,0.5189873417721519,0.9205607476635514,80019506,316,164
1,1215,0.25778863775198535,0.5706106870229007,80109015,1637,422
0,310,0.16216216216216217,0.24752475247524752,73524542,370,60
0,987,0.06622516556291391,0.07384615384615385,70607873,1057,70
0,345,0.15647921760391198,0.43060959792477305,64225161,409,64
0,1271,0.059911242603550297,0.09264793783622235,70252714,1352,81
1,78,0.38095238095238093,0.8711340206185567,66856195,126,48
0,64,0.20987654320987653,0.33116883116883117,69183814,81,17
0,614,0.040625,0.061606160616061605,70001113,640,26
1,7,0.3,0.5,70240646,10,3
1,2240,0.369901547116737,0.796109240553685,65830394,3555,1315
1,752,0.3632514817950889,0.8488745980707395,68531064,1181,429
1,313,0.2635294117647059,0.5652173913043478,72932265,425,112
1,426,0.23792486583184258,0.5266666666666666,80119325,559,133
0,51,0.16393442622950818,0.2108843537414966,80118414,61,10
0,1289,0.18158730158730158,0.3028464769015399,68533024,1575,286
1,1251,0.35348837209302325,0.7723970944309927,70179053,1935,684
1,1027,0.38941736028537455,0.8597768073750607,68371800,1682,655
1,48,0.3424657534246575,0.8717948717948718,60312952,73,25
1,362,0.49299719887955185,0.9554896142433235,63384951,714,352
1,333,0.3004201680672269,0.7228017883755589,68530945,476,143
1,1318,0.35233415233415233,0.7979522184300342,67168780,2035,717
1,106,0.40782122905027934,0.9236641221374046,66471076,179,73
0,1808,0.13534194165471067,0.15948601662887377,66413830,2091,283
1,4,0.3333333333333333,0.8695652173913043,76340901,6,2
1,390,0.42050520059435365,0.8514056224899599,70576625,673,283
1,468,0.3953488372093023,0.8615782664941786,70676802,774,306
1,1106,0.3030875866414619,0.7259747391543108,68203961,1587,481
0,260,0.20489296636085627,0.47191011235955055,67159253,327,67
2,22,0.7349397590361446,0.7692307692307693,66118164,83,61
1,270,0.47368421052631576,0.8852813852813853,80132302,513,243
0,273,0.2288135593220339,0.43243243243243246,82007308,354,81
1,971,0.4438717067583047,0.865582191780822,82122268,1746,775
1,311,0.3480083857442348,0.6643835616438356,80090010,477,166
0,940,0.15009041591320071,0.24367088607594936,65831262,1106,166
2,166,0.6490486257928119,0.7014925373134329,82049153,473,307
1,385,0.3974960876369327,0.6828193832599119,82009344,639,254
2,34,0.5802469135802469,0.5172413793103449,60679542,81,47
1,695,0.4279835390946502,0.8435374149659864,68567576,1215,520
0,928,0.15789473684210525,0.3547925608011445,69383482,1102,174
0,651,0.11065573770491803,0.35805626598465473,69383601,732,81
0,633,0.05943536404160475,0.20245398773006135,69383706,673,40
0,630,0.06666666666666667,0.11397423191278494,80124236,675,45
0,109,0.12096774193548387,0.4197080291970803,80124373,124,15
2,24,0.7073170731707317,0.9130434782608695,66228715,82,58
0,76,0.10588235294117647,0.2672811059907834,80067575,85,9
2,266,0.503731343283582,0.9051094890510949,79472085,536,270
2,1,0.75,0.5,82061201,4,3
2,10,0.5833333333333334,0.8888888888888888,70515291,24,14
1,421,0.35130970724191063,0.8443908323281062,66470845,649,228
1,410,0.3354943273905997,0.8170426065162907,66470922,617,207
1,195,0.36893203883495146,0.8609756097560975,68210814,309,114
1,183,0.2988505747126437,0.6406685236768802,68210835,261,78
0,68,0.2,0.3026315789473684,80181329,85,17
1,748,0.3472949389179756,0.7401459854014598,80141441,1146,398
0,9,0.0,0.0,80124198,9,0
2,10,0.5833333333333334,0.9375,80051811,24,14
1,320,0.3700787401574803,0.8063583815028902,80140045,508,188
2,13,0.6666666666666666,0.9375,69733482,39,26
2,799,0.560989010989011,0.9832835820895522,73321451,1820,1021
1,102,0.4486486486486487,0.9302325581395349,279804,185,83
0,1480,0.14302258251302838,0.17059961315280464,66931823,1727,247
0,344,0.057534246575342465,0.16299559471365638,63780332,365,21
0,152,0.02564102564102564,0.021505376344086023,63780871,156,4
2,279,0.5514469453376206,0.9738317757009346,67823105,622,343
1,1155,0.24113009198423127,0.52977503308337,73382463,1522,367
1,520,0.45435466946484787,0.9065180102915952,72776466,953,433
0,1107,0.18060695780903036,0.35701492537313434,68538043,1351,244
1,882,0.32825590251332826,0.8014608233731739,70626731,1313,431
1,475,0.26697530864197533,0.6623235613463626,77676746,648,173
1,276,0.25806451612903225,0.6272,70618555,372,96
0,197,0.22134387351778656,0.4275,66892686,253,56
0,335,0.2334096109839817,0.4252136752136752,67551904,437,102
0,1261,0.15369127516778525,0.2536162005785921,69549515,1490,229
1,714,0.31213872832369943,0.7460087082728593,65267034,1038,324
1,401,0.3500810372771475,0.8477777777777777,82038332,617,216
0,2066,0.16994777018883087,0.2944095269599735,82000097,2489,423
1,286,0.21643835616438356,0.5103211009174312,82011845,365,79
1,34,0.2916666666666667,0.5555555555555556,66855915,48,14
0,1383,0.17727543129089826,0.39539860888175493,82028895,1681,298
1,94,0.35172413793103446,0.7159763313609467,70781494,145,51
1,258,0.21818181818181817,0.5662460567823344,69158943,330,72
1,446,0.3190839694656489,0.7389380530973452,70618233,655,209
0,164,0.006060606060606061,0.002105263157894737,70001456,165,1
0,139,0.07947019867549669,0.3333333333333333,60286786,151,12
0,749,0.03974358974358974,0.05334394904458599,63426272,780,31
0,137,0.08053691275167785,0.3641456582633053,65516934,149,12
0,201,0.04285714285714286,0.145933014354067,70001372,210,9
0,20,0.0,0.0,69509160,20,0
1,127,0.2905027932960894,0.659375,80121213,179,52
2,103,0.6068702290076335,0.9806201550387597,80125552,262,159
1,279,0.24390243902439024,0.571917808219178,67160632,369,90
1,971,0.23962411902897415,0.5140750670241286,70115045,1277,306
0,1088,0.1850187265917603,0.3416757344940152,66422860,1335,247
1,50,0.4444444444444444,0.893491124260355,63773136,90,40
1,574,0.28428927680798005,0.7018469656992085,63278502,802,228
0,1702,0.020713463751438434,0.029290617848970253,68242363,1738,36
0,150,0.025974025974025976,0.055944055944055944,78762761,154,4
0,159,0.1497326203208556,0.2585669781931464,73347001,187,28
1,407,0.28091872791519434,0.6213389121338913,68474742,566,159
2,400,0.50186799501868,0.9333333333333333,82041305,803,403
0,202,0.09009009009009009,0.41080196399345337,82050488,222,20
0,1543,0.05279312461632903,0.10167533217793183,60028521,1629,86
0,318,0.2318840579710145,0.43219264892268694,65308621,414,96
1,401,0.36450079239302696,0.7760968229954615,67766622,631,230
1,974,0.24903623747108714,0.551923076923077,68236392,1297,323
1,1097,0.4473551637279597,0.9293150684931507,774053,1985,888
0,258,0.15960912052117263,0.36622073578595316,70633535,307,49
1,311,0.37675350701402804,0.7620137299771167,70246680,499,188
0,1218,0.17869184086311532,0.29538615847542626,63264334,1483,265
1,1804,0.24487233151946422,0.5378787878787878,68535572,2389,585
0,327,0.20048899755501223,0.46441281138790036,80145617,409,82
2,3,0.625,0.8571428571428571,80134757,8,5
0,392,0.16059957173447537,0.37644341801385683,63306292,467,75
1,384,0.3786407766990291,0.8589743589743589,65029902,618,234
0,987,0.11638316920322292,0.3189149560117302,63226954,1117,130
0,645,0.07593123209169055,0.19865642994241842,63227122,698,53
0,696,0.20457142857142857,0.43710191082802546,68535635,875,179
1,578,0.31516587677725116,0.7202868852459017,80107923,844,266
1,416,0.3157894736842105,0.7761194029850746,70070763,608,192
1,535,0.4081858407079646,0.8219954648526077,70713160,904,369
0,247,0.06439393939393939,0.18938053097345134,63781011,264,17
0,1395,0.16666666666666666,0.2963350785340314,68537651,1674,279
1,101,0.31756756756756754,0.7375415282392026,69158922,148,47
1,1059,0.4083798882681564,0.8607856650585803,65383325,1790,731
1,18,0.3793103448275862,0.8913043478260869,75327301,29,11
0,17,0.15,0.10909090909090909,69180566,20,3
0,1822,0.19380530973451326,0.392018779342723,805056,2260,438
1,439,0.2571912013536379,0.6356589147286822,62840624,591,152
1,137,0.42436974789915966,0.9473684210526315,68542306,238,101
1,274,0.3397590361445783,0.7702702702702703,69177766,415,141
1,252,0.24550898203592814,0.5805785123966942,66930514,334,82
1,160,0.27927927927927926,0.7207977207977208,66930535,222,62
1,494,0.4069627851140456,0.8910585817060637,68496946,833,339
0,174,0.04395604395604396,0.11448598130841121,61946171,182,8
0,277,0.14506172839506173,0.23020527859237536,73347050,324,47
1,387,0.43004418262150224,0.9397874852420307,65029951,679,292
1,531,0.3320754716981132,0.7453769559032717,80109386,795,264
1,53,0.42391304347826086,0.8852459016393442,65277681,92,39
1,94,0.265625,0.5661157024793388,80109631,128,34
0,685,0.1874258600237248,0.34641068447412354,68541851,843,158
1,427,0.22644927536231885,0.5171503957783641,81979807,552,125
1,1657,0.33023443815683107,0.81,80110632,2474,817
1,360,0.41935483870967744,0.8761904761904762,82021097,620,260
0,1296,0.20733944954128442,0.46271008403361347,70605045,1635,339
0,175,0.06417112299465241,0.057971014492753624,82011839,187,12
0,502,0.233587786259542,0.48823529411764705,80121103,655,153
1,898,0.2578512396694215,0.5851259987707437,80121108,1210,312
0,564,0.18497109826589594,0.39233576642335766,69621972,692,128
0,535,0.07439446366782007,0.07365792759051186,69601056,578,43
0,791,0.1638477801268499,0.31303288672350793,68535530,946,155
0,399,0.13449023861171366,0.17480136208853575,69239954,461,62
0,784,0.14035087719298245,0.19774436090225564,70614803,912,128
0,632,0.21588089330024815,0.43285024154589374,70643132,806,174
1,668,0.3048907388137357,0.7187274041937817,80120428,961,293
1,178,0.43312101910828027,0.9174603174603174,70670313,314,136
1,804,0.25348189415041783,0.6021390374331551,82036693,1077,273
1,476,0.2732824427480916,0.6407879490150638,80128482,655,179
0,985,0.12053571428571429,0.14373297002724797,80133197,1120,135
1,575,0.2532467532467532,0.601813110181311,82152432,770,195
1,542,0.3923766816143498,0.921875,80121299,892,350
1,190,0.3870967741935484,0.8847262247838616,66471174,310,120
2,226,0.5791433891992551,0.9251336898395722,80137984,537,311
1,93,0.41875,0.9278846153846154,65018695,160,67
1,236,0.4114713216957606,0.9063097514340345,71358980,401,165
1,566,0.26588845654993515,0.6400394477317555,80125361,771,205
1,145,0.36403508771929827,0.801762114537445,65958984,228,83
2,363,0.5223684210526316,0.9353348729792148,80066301,760,397
0,901,0.23253833049403747,0.4629993451211526,69165271,1174,273
2,466,0.5180972078593589,0.9550691244239631,70202461,967,501
1,83,0.2966101694915254,0.6304347826086957,80134783,118,35
1,542,0.3645955451348183,0.7140495867768595,80134979,853,311
1,392,0.26454033771106944,0.6488833746898263,66931305,533,141
0,845,0.16666666666666666,0.32547864506627394,63323736,1014,169
0,21,0.3,0.47619047619047616,80180260,30,9
1,1341,0.2288671650373778,0.5253164556962026,80124517,1739,398
1,128,0.41284403669724773,0.8443708609271523,62510014,218,90
0,47,0.1896551724137931,0.36470588235294116,80070004,58,11
1,516,0.34099616858237547,0.844097995545657,68530616,783,267
1,230,0.3882978723404255,0.8277310924369747,70633640,376,146
1,38,0.22448979591836735,0.5689655172413793,73151323,49,11
1,65,0.3010752688172043,0.609375,65934036,93,28
0,44,0.022222222222222223,0.0,69613775,45,1
0,837,0.11708860759493671,0.193717277486911,63322000,948,111
0,243,0.09328358208955224,0.17114093959731544,63613284,268,25
1,732,0.3041825095057034,0.7068965517241379,80111052,1052,320
1,139,0.35648148148148145,0.8622950819672132,80135835,216,77
0,128,0.20496894409937888,0.46736292428198434,70583583,161,33
1,1155,0.3296575739988392,0.7256198347107438,67993954,1723,568
1,990,0.27472527472527475,0.5656081485919713,67994633,1365,375
1,317,0.3108695652173913,0.6671177266576455,74511955,460,143
0,1010,0.22900763358778625,0.3872832369942196,70628740,1310,300
1,389,0.34731543624161076,0.7529585798816568,67411372,596,207
0,139,0.18235294117647058,0.23717948717948717,68192061,170,31
0,172,0.21818181818181817,0.46702317290552586,70062664,220,48
0,193,0.11467889908256881,0.37373737373737376,78763363,218,25
0,315,0.19023136246786632,0.47680412371134023,62840743,389,74
1,61,0.24691358024691357,0.5904255319148937,70045220,81,20
1,409,0.30204778156996587,0.7434782608695653,80137528,586,177
1,728,0.35288888888888886,0.6567342073897497,72433536,1125,397
1,327,0.2967741935483871,0.774496644295302,67160590,465,138
1,536,0.34474327628361856,0.8103004291845494,68537406,818,282
1,412,0.28222996515679444,0.6688172043010753,69799765,574,162
0,1159,0.18437719915552428,0.28420434527304755,67721920,1421,262
1,1272,0.2825719120135364,0.6778761061946903,70627655,1773,501
0,119,0.19594594594594594,0.38904109589041097,67036340,148,29
0,426,0.22404371584699453,0.4573304157549234,82113172,549,123
1,151,0.416988416988417,0.8969465648854962,68952072,259,108
1,169,0.40070921985815605,0.9293193717277487,70641711,282,113
0,81,0.1,0.09004739336492891,65273635,90,9
1,496,0.30434782608695654,0.710019267822736,69176674,713,217
1,166,0.319672131147541,0.761437908496732,63957635,244,78
1,626,0.29345372460496616,0.7181146025878004,80125362,886,260
1,700,0.2584745762711864,0.5286396181384249,69983571,944,244
2,361,0.5199468085106383,0.9320809248554913,80145397,752,391
1,410,0.30743243243243246,0.7784172661870503,60249343,592,182
1,1291,0.3466599190283401,0.8116539140670983,80107356,1976,685
0,274,0.21264367816091953,0.3188720173535792,81967256,348,74
0,751,0.12572759022118743,0.1857394366197183,73346833,859,108
1,683,0.2757158006362672,0.6097826086956522,69705202,943,260
0,700,0.09326424870466321,0.12333333333333334,70626780,772,72
0,259,0.1563517915309446,0.49889135254988914,61297012,307,48
0,171,0.1895734597156398,0.4307228915662651,73700431,211,40
1,236,0.2507936507936508,0.5602536997885835,80112256,315,79
0,1574,0.14502987506789788,0.2182377049180328,80140120,1841,267
1,1395,0.35684647302904565,0.7676411290322581,70201845,2169,774
1,281,0.4059196617336152,0.9330143540669856,69165894,473,192
1,744,0.3066169617893756,0.7435137138621201,66930696,1073,329
0,488,0.0996309963099631,0.27342047930283225,62507641,542,54
0,875,0.10071942446043165,0.2658326817826427,63780444,973,98
1,216,0.25517241379310346,0.6643192488262911,61712952,290,74
0,138,0.14285714285714285,0.1940928270042194,69100766,161,23
1,416,0.32247557003257327,0.7405004633920297,81971151,614,198
1,463,0.3785234899328859,0.8405797101449275,65825102,745,282
1,189,0.42201834862385323,0.9021526418786693,66563812,327,138
1,664,0.2852529601722282,0.6394963552021206,72135350,929,265
1,597,0.41355599214145383,0.8482003129890454,80140044,1018,421
0,1053,0.17670054730258014,0.272419627749577,80140096,1279,226
2,766,0.539386650631389,0.9661949685534591,78265705,1663,897
1,384,0.2713472485768501,0.7165354330708661,61386066,527,143
0,503,0.025193798449612403,0.020902090209020903,64240323,516,13
0,447,0.04487179487179487,0.08098591549295775,64240792,468,21
0,2060,0.04141461144718474,0.04022737210319195,70001680,2149,89
1,1414,0.2744997434581837,0.6272416737830914,66284015,1949,535
1,65,0.48,0.8977272727272727,68040371,125,60
1,305,0.2159383033419023,0.5247410817031071,68474735,389,84
1,373,0.3467600700525394,0.8569570871261378,68200181,571,198
0,1727,0.08865435356200528,0.0821472143147621,67478796,1895,168
0,610,0.1899070385126162,0.3675143560295324,81999929,753,143
0,209,0.12184873949579832,0.08254716981132075,67555761,238,29
0,473,0.233387358184765,0.36857142857142855,82020727,617,144
1,599,0.244640605296343,0.7049019607843138,63775495,793,194
1,267,0.38620689655172413,0.8666666666666667,70910035,435,168
1,1204,0.293841642228739,0.6735442457588262,81976696,1705,501
1,1639,0.27541998231653403,0.614798206278027,80181382,2262,623
1,185,0.40705128205128205,0.8525,68741386,312,127
0,172,0.19248826291079812,0.4339622641509434,70046620,213,41
1,849,0.2737382378100941,0.6663037561241154,66912062,1169,320
1,509,0.28005657708628007,0.552734375,72077761,707,198
0,298,0.2358974358974359,0.44427244582043346,69739306,390,92
1,418,0.3301282051282051,0.7948442534908701,69180825,624,206
1,156,0.30357142857142855,0.6193181818181818,67994031,224,68
0,382,0.04738154613466334,0.20771513353115728,69383566,401,19
0,371,0.05115089514066496,0.1935483870967742,69383713,391,20
0,222,0.20430107526881722,0.49514563106796117,69502034,279,57
0,451,0.119140625,0.3649815043156597,63772065,512,61
0,625,0.051593323216995446,0.11937377690802348,63780731,659,34
0,12,0.25,0.45714285714285713,72208633,16,4
1,100,0.40476190476190477,0.9119170984455959,67555880,168,68
0,759,0.22392638036809817,0.4763335837716003,80109813,978,219
1,439,0.3129890453834116,0.6029411764705882,67994115,639,200
1,1877,0.24799679487179488,0.6227286726208808,70221872,2496,619
0,772,0.08747044917257683,0.14934565050038492,60312721,846,74
1,297,0.32036613272311215,0.8007312614259597,69216973,437,140
1,39,0.3709677419354839,0.673469387755102,77563115,62,23
2,317,0.6524122807017544,0.9893805309734514,73348814,912,595
1,15,0.4230769230769231,0.8571428571428571,72803605,26,11
2,83,0.8643790849673203,0.978494623655914,82045537,612,529
0,704,0.23060109289617486,0.44968004653868526,65313206,915,211
1,844,0.2804774083546462,0.6713804713804714,66425212,1173,329
2,106,0.5891472868217055,0.9973118279569892,70586551,258,152
0,376,0.050505050505050504,0.1302170283806344,80124305,396,20
0,645,0.09026798307475317,0.28431372549019607,70600600,709,64
1,91,0.3933333333333333,0.8855721393034826,65919063,150,59
1,50,0.2537313432835821,0.5454545454545454,65919091,67,17
1,201,0.42406876790830944,0.7083333333333334,80176029,349,148
2,58,0.5503875968992248,0.5714285714285714,70855393,129,71
2,603,0.5206677265500795,0.9331065759637188,70614271,1258,655
2,70,0.7095435684647303,0.7701149425287356,73447584,241,171
2,199,0.634862385321101,0.8504273504273504,63602840,545,346
2,221,0.5297872340425532,0.8369905956112853,70121842,470,249
0,227,0.12015503875968993,0.25625,68625893,258,31
0,398,0.08083140877598152,0.0990990990990991,73399613,433,35
2,15,0.8543689320388349,0.9583333333333334,69754111,103,88
0,1814,0.1731996353691887,0.2529037092544024,69100892,2194,380
1,758,0.21694214876033058,0.5115303983228512,68642112,968,210
0,710,0.15976331360946747,0.4652888182299947,80180489,845,135
1,150,0.3877551020408163,0.883008356545961,82126723,245,95
1,511,0.34571062740076824,0.817283950617284,68531372,781,270
1,545,0.23562412342215988,0.5722964763061968,68540745,713,168
1,9,0.3076923076923077,0.6470588235294118,66635303,13,4
1,582,0.266078184110971,0.5011857707509881,80153475,793,211
0,568,0.20891364902506965,0.450693374422188,70042392,718,150
1,569,0.2779187817258883,0.6180713743356112,63141421,788,219
0,117,0.23026315789473684,0.4797297297297297,81956131,152,35
1,165,0.3319838056680162,0.7450980392156863,66326491,247,82
0,255,0.1774193548387097,0.31136044880785413,68497184,310,55
1,890,0.2632450331125828,0.6238207547169812,70545720,1208,318
0,695,0.07085561497326204,0.04200626959247649,70643062,748,53
0,211,0.053811659192825115,0.20364741641337386,76805645,223,12
1,215,0.3909348441926346,0.8612612612612612,80180170,353,138
0,147,0.057692307692307696,0.23518164435946462,82103947,156,9
0,925,0.22268907563025211,0.4857142857142857,68537763,1190,265
0,116,0.23684210526315788,0.46540880503144655,69183954,152,36
1,50,0.35064935064935066,0.9083969465648855,82116871,77,27
1,169,0.4702194357366771,0.9064039408866995,72638293,319,150
1,766,0.3004566210045662,0.6880131362889984,66471384,1095,329
1,455,0.2857142857142857,0.7055785123966942,70871003,637,182
0,1731,0.2131818181818182,0.3939134162023146,72393342,2200,469
0,538,0.22028985507246376,0.44661921708185054,72493722,690,152
0,481,0.22419354838709676,0.3899308983218164,69021365,620,139
0,545,0.1497659906396256,0.4739803094233474,66876544,641,96
1,574,0.2622107969151671,0.6053846153846154,67252584,778,204
1,363,0.25766871165644173,0.5948361469712016,73816316,489,126
0,995,0.1995172968624296,0.44087992667277726,66121202,1243,248
1,1232,0.23809523809523808,0.5429061784897025,80112410,1617,385
0,704,0.21076233183856502,0.4535768645357686,63278985,892,188
1,648,0.24563445867287545,0.5978511128165771,68535845,859,211
1,606,0.25644171779141106,0.5808325266214908,67942665,815,209
1,419,0.2570921985815603,0.5472636815920398,69165103,564,145
0,1684,0.10899470899470899,0.11049723756906077,68542915,1890,206
1,395,0.23151750972762647,0.5099778270509978,69498653,514,119
1,139,0.4734848484848485,0.9403508771929825,80001775,264,125
1,112,0.3,0.6652542372881356,66471230,160,48
1,826,0.23730378578024008,0.5402298850574713,68541151,1083,257
0,1572,0.16427432216905902,0.32065217391304346,70841344,1881,309
1,1615,0.40625,0.8907309721175584,69574673,2720,1105
0,617,0.2120051085568327,0.45565217391304347,10395,783,166
0,1072,0.12561174551386622,0.1697986577181208,80119399,1226,154
1,543,0.2072992700729927,0.5101143359718557,70626850,685,142
1,713,0.31770334928229665,0.747086247086247,69118203,1045,332
1,219,0.4032697547683924,0.906060606060606,69161092,367,148
0,596,0.2147562582345191,0.47638888888888886,81979986,759,163
0,951,0.22493887530562348,0.4987510407993339,70604975,1227,276
0,2080,0.1916051301982122,0.33530717986676534,72393265,2573,493
0,1344,0.14666666666666667,0.21340887629839472,73346903,1575,231
1,43,0.2711864406779661,0.7083333333333334,70527373,59,16
2,854,0.5294765840220386,0.9654761904761905,62510630,1815,961
0,1345,0.19122068550811785,0.348380244291025,65850841,1663,318
0,647,0.21670702179176757,0.4180522565320665,80121084,826,179
1,85,0.27350427350427353,0.5230769230769231,69482056,117,32
0,1044,0.18818040435458788,0.32576210400478184,68542411,1286,242
0,1209,0.1875,0.39373716632443534,68538015,1488,279
1,657,0.22796709753231492,0.5150442477876106,68539996,851,194
1,886,0.3050980392156863,0.6855345911949685,80140046,1275,389
1,351,0.43569131832797425,0.8804159445407279,73850791,622,271
0,564,0.1441578148710167,0.4584286803966438,68811512,659,95
1,392,0.30742049469964666,0.7208201892744479,63689682,566,174
1,67,0.23863636363636365,0.5154639175257731,82124906,88,21
1,1081,0.35075075075075074,0.7968917470525188,69668984,1665,584
0,510,0.18789808917197454,0.3116279069767442,68534963,628,118
0,631,0.1049645390070922,0.1724137931034483,80098746,705,74
0,720,0.12195121951219512,0.19944789510006902,80098753,820,100
0,27,0.1,0.07246376811594203,80137548,30,3
0,19,0.09523809523809523,0.03125,80137551,21,2
1,18,0.28,0.6981132075471698,80137553,25,7
0,31,0.225,0.43434343434343436,80137554,40,9
0,355,0.1839080459770115,0.3364485981308411,82119690,435,80
1,179,0.32196969696969696,0.7708333333333334,67558015,264,85
1,125,0.3279569892473118,0.7525083612040134,69176933,186,61
1,683,0.2802950474183351,0.6164021164021164,70613613,949,266
0,735,0.22139830508474576,0.48761742100768574,68541473,944,209
1,1097,0.2792378449408673,0.5883636363636363,67421760,1522,425
0,587,0.16142857142857142,0.21234119782214156,68532996,700,113
0,184,0.17488789237668162,0.24285714285714285,67627343,223,39
1,121,0.4265402843601896,0.9195402298850575,70771281,211,90
1,345,0.32879377431906615,0.6750369276218612,80129504,514,169
1,184,0.31851851851851853,0.7548543689320388,69177164,270,86
1,121,0.23417721518987342,0.5186440677966102,70049420,158,37
1,1076,0.2948885976408912,0.7263392857142857,69603926,1526,450
1,135,0.2931937172774869,0.6216216216216216,70216412,191,56
1,500,0.24357034795763993,0.5500807754442649,65316573,661,161
1,886,0.2622814321398834,0.6314567614625652,66931865,1201,315
1,488,0.2823529411764706,0.5846560846560847,68284594,680,192
1,117,0.417910447761194,0.8804780876494024,64203384,201,84
0,50,0.12280701754385964,0.17142857142857143,80128849,57,7
0,620,0.14127423822714683,0.23415361670395227,72522940,722,102
0,928,0.2336911643270025,0.47817327065144394,69092065,1211,283
0,292,0.17045454545454544,0.3641114982578397,73346980,352,60
1,1173,0.4336069531627233,0.8894557823129252,69629126,2071,898
1,825,0.3574766355140187,0.8146551724137931,80167013,1284,459
1,387,0.2411764705882353,0.5338114754098361,67703475,510,123
0,346,0.0748663101604278,0.09876543209876543,62957272,374,28
1,748,0.24214792299898683,0.5521936459909228,63278600,987,239
1,150,0.23469387755102042,0.5746478873239437,68641993,196,46
1,248,0.41784037558685444,0.9285714285714286,67993814,426,178
1,707,0.3095703125,0.7101556708673091,69574435,1024,317
0,296,0.2230971128608924,0.44582593250444047,67204025,381,85
1,449,0.2962382445141066,0.6334841628959276,82113170,638,189
0,1181,0.21632382216323823,0.4118447923757658,82129387,1507,326
1,1232,0.3957822461991172,0.8812296227293899,81989972,2039,807
1,20,0.47368421052631576,0.9365079365079365,69058031,38,18
0,454,0.06776180698151951,0.1271523178807947,63771162,487,33
1,917,0.266986410871303,0.6784682080924855,68302045,1251,334
1,1077,0.24208304011259676,0.5776309579990562,80098452,1421,344
1,389,0.2782931354359926,0.6970998925886144,82014186,539,150
0,490,0.07020872865275142,0.2753968253968254,66876446,527,37
1,138,0.32019704433497537,0.5662650602409639,80131291,203,65
0,100,0.15966386554621848,0.3128205128205128,64158360,119,19
0,389,0.13747228381374724,0.2108695652173913,64158850,451,62
0,59,0.2236842105263158,0.42857142857142855,66461885,76,17
0,1096,0.1746987951807229,0.2906178489702517,68544091,1328,232
0,356,0.19457013574660634,0.4046306504961411,70067004,442,86
1,66,0.2826086956521739,0.6285714285714286,80135915,92,26
0,1091,0.17411052233156699,0.37024683122081387,70618170,1321,230
0,639,0.14228187919463087,0.2462962962962963,70618191,745,106
1,580,0.23381770145310435,0.5106809078771696,70760746,757,177
1,510,0.22844175491679275,0.5491329479768786,80070781,661,151
2,57,0.6627218934911243,0.8641975308641975,69520493,169,112
1,157,0.4163568773234201,0.8253424657534246,82033201,269,112
2,13,0.6388888888888888,0.8333333333333334,70222495,36,23
1,328,0.3492063492063492,0.6396694214876033,80178984,504,176
2,162,0.6275862068965518,0.9648562300319489,67719141,435,273
1,298,0.3752620545073375,0.8023598820058997,80053414,477,179
1,39,0.35,0.6632653061224489,70567791,60,21
1,104,0.38095238095238093,0.788546255506608,80180197,168,64
2,78,0.5916230366492147,0.925,80062066,191,113
2,44,0.5056179775280899,0.9042553191489362,80180202,89,45
2,345,0.5838359469240049,0.907563025210084,80174922,829,484
2,352,0.5873388042203986,0.925,80018554,853,501
1,356,0.3219047619047619,0.5046728971962616,80174471,525,169
1,854,0.4355584930601454,0.7583187390542907,80176751,1513,659
1,272,0.4538152610441767,0.8945827232796486,80048052,498,226
1,212,0.4976303317535545,0.9487179487179487,69156962,422,210
0,69,0.19767441860465115,0.3383458646616541,63051513,86,17
1,59,0.42718446601941745,0.8360655737704918,73300024,103,44
0,26,0.2571428571428571,0.2978723404255319,70112385,35,9
2,34,0.7068965517241379,0.6388888888888888,65780932,116,82
2,34,0.6263736263736264,0.7272727272727273,69139315,91,57
1,39,0.4657534246575342,0.6041666666666666,80168319,73,34
0,6,0.25,0.0,80168329,8,2
1,348,0.2673684210526316,0.5075757575757576,70242543,475,127
2,150,0.6296296296296297,0.7391304347826086,70860776,405,255
1,1421,0.2731457800511509,0.5314207650273224,80124972,1955,534
1,25,0.34210526315789475,0.7884615384615384,73635086,38,13
1,247,0.36989795918367346,0.8211920529801324,80140049,392,145
0,1444,0.16144018583042974,0.215007215007215,80140101,1722,278
2,25,0.8520710059171598,0.9333333333333333,80052413,169,144
2,60,0.5161290322580645,0.7027027027027027,79457406,124,64
1,21,0.3225806451612903,0.8352941176470589,70692356,31,10
2,29,0.7363636363636363,0.9722222222222222,72315432,110,81
0,41,0.046511627906976744,0.1368421052631579,80124193,43,2
1,60,0.3617021276595745,0.7619047619047619,69208202,94,34
0,100,0.15966386554621848,0.48120300751879697,70649285,119,19
0,142,0.034013605442176874,0.0728476821192053,80124209,147,5
0,192,0.04950495049504951,0.11270983213429256,80124382,202,10
0,533,0.15127388535031847,0.26186943620178044,80116575,628,95
1,52,0.34177215189873417,0.7283950617283951,70655081,79,27
2,31,0.7686567164179104,0.9759036144578314,69112393,134,103
1,269,0.37587006960556846,0.7990867579908676,69978363,431,162
1,391,0.37936507936507935,0.8943436499466382,63516551,630,239
1,46,0.2923076923076923,0.6981132075471698,70741853,65,19
0,298,0.14121037463976946,0.2048780487804878,70802242,347,49
0,241,0.20462046204620463,0.3441780821917808,70802256,303,62
1,625,0.3842364532019704,0.8370197904540163,80178610,1015,390
0,560,0.0728476821192053,0.08372093023255814,80070900,604,44
0,491,0.18438538205980065,0.36035313001605135,80070935,602,111
0,1020,0.23308270676691728,0.49666059502125076,67291945,1330,310
1,190,0.2549019607843137,0.66723259762309,69545511,255,65
1,1959,0.41100420926037284,0.8532658693652254,70576730,3326,1367
0,496,0.05343511450381679,0.09393063583815028,80126895,524,28
2,541,0.5095194922937444,0.9638655462184874,67282341,1103,562
1,309,0.2813953488372093,0.6343085106382979,69177395,430,121
1,14,0.3333333333333333,0.8809523809523809,69559434,21,7
1,180,0.3382352941176471,0.8074398249452954,70543564,272,92
1,227,0.23825503355704697,0.539179104477612,70515354,298,71
1,412,0.33974358974358976,0.7103174603174603,72322180,624,212
1,265,0.3851508120649652,0.7707865168539326,73242890,431,166
0,368,0.1965065502183406,0.41682974559686886,80116540,458,90
0,558,0.16840536512667661,0.36065573770491804,61939514,671,113
1,253,0.47401247401247404,0.9444444444444444,64048355,481,228
1,235,0.3880208333333333,0.8821218074656189,70112042,384,149
1,1126,0.32004830917874394,0.7720430107526882,70641970,1656,530
0,741,0.20748663101604278,0.4613368283093054,70641844,935,194
2,799,0.5294464075382803,0.963773069036227,80123461,1698,899
1,188,0.49326145552560646,0.9489795918367347,68033273,371,183
1,122,0.39603960396039606,0.8986928104575164,63141561,202,80
1,204,0.43333333333333335,0.9236842105263158,774081,360,156
1,267,0.25,0.5537974683544303,73524675,356,89
0,194,0.2145748987854251,0.3860759493670886,73524780,247,53
1,709,0.23516720604099245,0.5431679129843644,70627214,927,218
0,3868,0.23753203232801104,0.47693817468105987,68192012,5073,1205
1,858,0.22980251346499103,0.5288919102651257,68537994,1114,256
0,276,0.10097719869706841,0.11607142857142858,77182210,307,31
0,1574,0.052378085490668275,0.15217391304347827,62834240,1661,87
1,726,0.32465116279069767,0.7806291390728477,68531911,1075,349
0,368,0.18403547671840353,0.4023354564755839,80097185,451,83
0,155,0.14835164835164835,0.39308176100628933,70642880,182,27
0,1113,0.10602409638554217,0.11529026982829109,70609434,1245,132
1,322,0.3206751054852321,0.6740467404674046,69388606,474,152
1,610,0.22094508301404853,0.5136399064692128,82109206,783,173
1,33,0.42105263157894735,0.7948717948717948,62407891,57,24
1,309,0.4616724738675958,0.9524714828897338,67553290,574,265
1,445,0.3624641833810888,0.7891891891891892,62407961,698,253
0,1078,0.1389776357827476,0.19960988296488946,68173994,1252,174
1,383,0.25775193798449614,0.6847599164926931,80118426,516,133
1,496,0.27058823529411763,0.6794310722100656,80121273,680,184
1,117,0.417910447761194,0.8897338403041825,69056736,201,84
1,429,0.4736196319018405,0.9038142620232172,69635244,815,386
1,208,0.32247557003257327,0.7420042643923241,67552296,307,99
1,1385,0.26874340021119325,0.5836621941594318,80119269,1894,509
0,204,0.11688311688311688,0.13404825737265416,67428361,231,27
1,590,0.28311057108140947,0.7028145695364238,80111773,823,233
1,525,0.21875,0.5258620689655172,68534214,672,147
1,252,0.28,0.7048929663608563,65901353,350,98
1,129,0.29120879120879123,0.7403598971722365,68733385,182,53
0,188,0.06930693069306931,0.031746031746031744,66015551,202,14
1,552,0.25,0.5465465465465466,74990195,736,184
1,407,0.28596491228070176,0.6118918918918919,74420941,570,163
0,136,0.17575757575757575,0.20903954802259886,69498821,165,29
0,922,0.22845188284518828,0.4908120924718435,68537266,1195,273
0,879,0.20882088208820881,0.42924251321197887,63279713,1111,232
0,285,0.16666666666666666,0.2527075812274368,67159204,342,57
0,949,0.19983136593591905,0.3840782122905028,65355276,1186,237
0,84,0.19230769230769232,0.32450331125827814,69868582,104,20
1,845,0.2683982683982684,0.6680697534576068,80121270,1155,310
2,103,0.8078358208955224,0.9725274725274725,80118205,536,433
1,157,0.2764976958525346,0.6134831460674157,71236802,217,60
0,423,0.10947368421052632,0.2508250825082508,72392782,475,52
0,288,0.1724137931034483,0.36877523553162855,80098711,348,60
1,143,0.24338624338624337,0.6111111111111112,70398825,189,46
0,295,0.22572178477690288,0.4619815668202765,80121113,381,86
1,676,0.48119723714504986,0.9230080572963295,80125397,1303,627
1,660,0.4101876675603217,0.8634686346863468,80125398,1119,459
1,152,0.32142857142857145,0.6775244299674267,80125400,224,72
0,285,0.13636363636363635,0.36476043276661513,299222,330,45
0,841,0.21621621621621623,0.4613117170228445,72706102,1073,232
1,324,0.2602739726027397,0.6175908221797323,69981772,438,114
0,2083,0.15633859862292426,0.23479118710950345,80119356,2469,386
2,809,0.5694518360830229,0.9769874476987448,64172584,1879,1070
1,430,0.312,0.6879535558780842,80111262,625,195
1,437,0.2764900662251656,0.5862676056338029,74050515,604,167
1,587,0.29531812725090034,0.6236559139784946,66029635,833,246
1,44,0.3888888888888889,0.7611940298507462,70064092,72,28
1,44,0.47619047619047616,0.8974358974358975,65118473,84,40
2,29,0.5915492957746479,0.9302325581395349,69733132,71,42
1,188,0.36486486486486486,0.7731629392971247,63729043,296,108
1,24,0.2727272727272727,0.5172413793103449,69977523,33,9
1,777,0.34152542372881356,0.8087520259319287,80107853,1180,403
1,193,0.49076517150395776,0.935656836461126,63395066,379,186
2,41,0.6771653543307087,0.9583333333333334,70700714,127,86
1,432,0.2859504132231405,0.6294416243654822,74708802,605,173
1,423,0.3380281690140845,0.7041139240506329,62497162,639,216
0,121,0.20915032679738563,0.44166666666666665,66110282,153,32
0,102,0.08928571428571429,0.15137614678899083,66110436,112,10
0,154,0.12994350282485875,0.2844311377245509,66110492,177,23
0,50,0.09090909090909091,0.16964285714285715,66110611,55,5
0,101,0.192,0.3655913978494624,66110723,125,24
0,138,0.15337423312883436,0.3254901960784314,66110793,163,25
1,29,0.275,0.8942307692307693,62530531,40,11
0,4,0.2,0.3888888888888889,73295663,5,1
2,9,0.7804878048780488,0.9333333333333333,67780916,41,32
0,324,0.13829787234042554,0.15939278937381404,70646114,376,52
2,0,1.0,1.0,82056731,10,10
1,451,0.3796423658872077,0.7934272300469484,72390815,727,276
1,184,0.3611111111111111,0.7807017543859649,80152461,288,104
1,108,0.4461538461538462,0.9158163265306123,81971182,195,87
2,23,0.77,0.9655172413793104,82041318,100,77
2,83,0.7313915857605178,0.9831932773109243,82023569,309,226
0,97,0.1565217391304348,0.4794520547945205,70649670,115,18
1,808,0.3404081632653061,0.6672897196261682,80128014,1225,417
2,91,0.542713567839196,0.8819875776397516,69585544,199,108
1,387,0.3560732113144759,0.7901591895803184,80180308,601,214
1,400,0.40476190476190477,0.8246268656716418,64966286,672,272
1,572,0.41030927835051545,0.8870229007633588,68953850,970,398
2,1,0.8,0.5,65963940,5,4
2,125,0.5265151515151515,0.9266666666666666,69167504,264,139
0,1812,0.11910549343704424,0.16251354279523295,80145614,2057,245
2,8,0.5555555555555556,0.8666666666666667,82172733,18,10
2,59,0.5203252032520326,0.7536231884057971,80168331,123,64
0,960,0.08918406072106262,0.07492795389048991,70182651,1054,94
1,432,0.3464447806354009,0.5032679738562091,69202343,661,229
2,129,0.7783505154639175,0.9419354838709677,62237133,582,453
2,15,0.6511627906976745,0.5625,66533054,43,28
0,19,0.24,0.10526315789473684,70892304,25,6
2,79,0.5212121212121212,0.5192307692307693,70911365,165,86
2,98,0.5333333333333333,0.6571428571428571,70911386,210,112
0,1278,0.20423412204234123,0.408,80141456,1606,328
1,113,0.42346938775510207,0.8608695652173913,80124984,196,83
1,341,0.2881002087682672,0.7416020671834626,70588000,479,138
1,1120,0.27927927927927926,0.5989911727616646,80141448,1554,434
1,81,0.474025974025974,0.550561797752809,63952336,154,73
1,71,0.4701492537313433,0.5882352941176471,63952343,134,63
2,46,0.6973684210526315,0.9565217391304348,69942334,152,106
2,50,0.7536945812807881,0.9324324324324325,8012095,203,153
2,256,0.6363636363636364,0.8385826771653543,69590640,704,448
0,1694,0.1387900355871886,0.2565262791507135,70841694,1967,273
2,239,0.5386100386100386,0.967266775777414,70073731,518,279
2,22,0.6857142857142857,0.9772727272727273,69069091,70,48
1,471,0.3032544378698225,0.6167800453514739,69551013,676,205
0,156,0.1657754010695187,0.3333333333333333,80119362,187,31
0,144,0.08280254777070063,0.07936507936507936,80119377,157,13
0,109,0.09166666666666666,0.10344827586206896,80119395,120,11
1,839,0.3145424836601307,0.6783216783216783,70720951,1224,385
1,593,0.4983079526226734,0.9480620155038759,63725802,1182,589
0,249,0.25,0.44575471698113206,80180957,332,83
0,822,0.20656370656370657,0.3825396825396825,68543615,1036,214
0,927,0.13847583643122677,0.36472065285624605,67836846,1076,149
0,788,0.13215859030837004,0.3726235741444867,69597955,908,120
0,82,0.06818181818181818,0.06274509803921569,70061831,88,6
0,73,0.16091954022988506,0.297029702970297,70061873,87,14
0,176,0.1926605504587156,0.4282608695652174,70539742,218,42
2,4,0.8,0.8333333333333334,73609662,20,16
0,461,0.23166666666666666,0.47532188841201717,67552051,600,139
0,1261,0.18434670116429497,0.3480597014925373,70614733,1546,285
0,92,0.11538461538461539,0.34615384615384615,61939521,104,12
0,367,0.19162995594713655,0.37603993344425957,68543216,454,87
0,686,0.2069364161849711,0.4577922077922078,68543244,865,179
1,76,0.4492753623188406,0.9322916666666666,70234815,138,62
1,1474,0.24834268230494647,0.5346153846153846,80121079,1961,487
0,217,0.1556420233463035,0.31809145129224653,70350574,257,40
0,1183,0.19796610169491524,0.3704720087815587,63140231,1475,292
0,860,0.09282700421940929,0.11375212224108659,68743612,948,88
0,529,0.21861152141802068,0.4014300306435138,74320232,677,148
1,226,0.4405940594059406,0.9380733944954128,70641760,404,178
1,1106,0.27284681130834976,0.5879095523765574,67840206,1521,415
1,857,0.34076923076923077,0.7725060827250608,80127898,1300,443
1,246,0.385,0.8459869848156182,80180350,400,154
0,1422,0.21043864519711272,0.49940828402366866,70768495,1801,379
1,312,0.298876404494382,0.6867977528089888,69183121,445,133
0,1412,0.15550239234449761,0.2929368029739777,70841512,1672,260
0,137,0.11612903225806452,0.19550561797752808,81979815,155,18
1,481,0.4915433403805497,0.938337801608579,80124711,946,465
1,651,0.2551487414187643,0.6362252663622526,68536755,874,223
1,1000,0.24642049736247174,0.573320255026974,82000085,1327,327
0,382,0.03535353535353535,0.109284332688588,62834611,396,14
1,259,0.27247191011235955,0.539568345323741,67287885,356,97
1,840,0.2539964476021314,0.5403726708074534,68156375,1126,286
0,74,0.16853932584269662,0.38349514563106796,79650991,89,15
1,64,0.36,0.8134328358208955,69184325,100,36
0,668,0.23569794050343248,0.4719424460431655,71444541,874,206
0,526,0.0539568345323741,0.12076271186440678,70001162,556,30
1,322,0.34419551934826886,0.8306332842415317,68534774,491,169
0,886,0.14478764478764478,0.31876606683804626,69383594,1036,150
0,449,0.2136602451838879,0.482646420824295,68536804,571,122
0,984,0.21090617481956697,0.4344911639244363,67160205,1247,263
1,928,0.36655290102389076,0.8491965389369592,65278213,1465,537
2,24,0.6470588235294118,0.98,72962526,68,44
0,639,0.15364238410596026,0.24509803921568626,44821,755,116
2,312,0.543859649122807,0.9485903814262023,80145398,684,372
1,1167,0.25998731769181993,0.611046511627907,70642425,1577,410
1,1612,0.2914285714285714,0.5831191088260497,70677005,2275,663
1,744,0.43849056603773584,0.8869257950530035,70202412,1325,581
0,407,0.21428571428571427,0.43936170212765957,62768076,518,111
1,568,0.23655913978494625,0.5440278988666085,66931312,744,176
0,469,0.1955403087478559,0.2842712842712843,70609294,583,114
0,580,0.20110192837465565,0.34306569343065696,72413873,726,146
1,2156,0.37343795408311536,0.8238270469181233,74942973,3441,1285
0,510,0.18138041733547353,0.35443037974683544,67246410,623,113
0,513,0.10471204188481675,0.08752327746741155,79822456,573,60
1,90,0.44785276073619634,0.9180327868852459,72560971,163,73
1,560,0.2679738562091503,0.6227897838899804,80125369,765,205
1,293,0.2656641604010025,0.521311475409836,70673484,399,106
1,133,0.47843137254901963,0.8862973760932945,61022031,255,122
0,544,0.14195583596214512,0.36353211009174313,811783,634,90
0,729,0.10989010989010989,0.15210084033613444,72899820,819,90
1,217,0.3710144927536232,0.8663697104677061,82126806,345,128
0,422,0.2271062271062271,0.46474820143884893,82036695,546,124
0,385,0.16304347826086957,0.17846607669616518,80152854,460,75
0,372,0.18777292576419213,0.33213429256594723,68535341,458,86
0,765,0.17207792207792208,0.30368098159509205,65355353,924,159
1,162,0.2669683257918552,0.6062639821029083,67617494,221,59
1,357,0.3225806451612903,0.7433751743375174,18698862,527,170
1,414,0.29949238578680204,0.7199017199017199,69177290,591,177
1,90,0.3233082706766917,0.6954022988505747,80135836,133,43
1,269,0.21574344023323616,0.6520547945205479,82056900,343,74
1,251,0.257396449704142,0.5119453924914675,63141554,338,87
1,153,0.2714285714285714,0.5626666666666666,68371751,210,57
1,144,0.424,0.8300970873786407,69169975,250,106
1,75,0.43609022556390975,0.8525641025641025,65798425,133,58
0,596,0.20320855614973263,0.4390467461044913,68536545,748,152
0,1888,0.1548791405550582,0.23319892473118278,68536573,2234,346
0,1684,0.19038461538461537,0.3783783783783784,68536580,2080,396
1,526,0.3862310385064177,0.8682399213372665,69184115,857,331
0,303,0.10619469026548672,0.13468013468013468,80071285,339,36
0,2505,0.13561076604554864,0.37814610190300796,70701071,2898,393
0,415,0.08388520971302428,0.07142857142857142,67304601,453,38
1,198,0.3753943217665615,0.5911330049261084,76571873,317,119
2,196,0.5160493827160494,0.89568345323741,80047051,405,209
2,82,0.8922470433639947,0.995049504950495,69943853,761,679
2,15,0.5714285714285714,0.8857142857142857,80153656,35,20
1,49,0.4895833333333333,0.83,80159642,96,47
2,185,0.8741496598639455,0.9947229551451188,72457301,1470,1285
2,66,0.5714285714285714,0.9217391304347826,69533275,154,88
2,72,0.5167785234899329,0.8888888888888888,82009599,149,77
2,654,0.6155202821869489,0.9597701149425287,80019464,1701,1047
1,169,0.40492957746478875,0.8504672897196262,80175638,284,115
1,213,0.421195652173913,0.8537170263788969,72322124,368,155
0,165,0.22169811320754718,0.38461538461538464,80180284,212,47
0,657,0.2169249106078665,0.4743112434847357,82002085,839,182
1,273,0.41541755888650966,0.936026936026936,68171236,467,194
0,880,0.1364082433758587,0.21866666666666668,82011807,1019,139
0,801,0.05207100591715976,0.022271714922048998,82011808,845,44
0,572,0.11864406779661017,0.1891891891891892,82011809,649,77
1,535,0.22575976845151954,0.5013428827215757,70686812,691,156
1,765,0.24778761061946902,0.5125303152789006,69155786,1017,252
1,526,0.29301075268817206,0.6593279258400927,75892922,744,218
1,573,0.29606879606879605,0.7204522096608428,69482063,814,241
1,170,0.4637223974763407,0.8770491803278688,63847210,317,147
1,772,0.25193798449612403,0.5709342560553633,82110436,1032,260
1,671,0.3804247460757156,0.8594009983361065,66098081,1083,412
1,563,0.336866902237927,0.7964970809007507,69638646,849,286
0,934,0.08161258603736479,0.2019672131147541,70001463,1017,83
0,604,0.0944527736131934,0.2741792369121562,70001624,667,63
0,204,0.10526315789473684,0.1943127962085308,70617442,228,24
0,617,0.16508795669824086,0.33035714285714285,70617603,739,122
1,216,0.33126934984520123,0.7832957110609481,70642194,323,107
0,576,0.1864406779661017,0.2936596218020022,69056260,708,132
0,738,0.16326530612244897,0.2973451327433628,70605346,882,144
1,615,0.3379978471474704,0.7948960302457467,80108861,929,314
1,108,0.2751677852348993,0.6653386454183267,69165061,149,41
0,717,0.18891402714932126,0.3278301886792453,82051903,884,167
1,148,0.39591836734693875,0.9391534391534392,69177472,245,97
1,994,0.23597232897770945,0.5163398692810458,69893516,1301,307
0,526,0.17295597484276728,0.2965811965811966,62767810,636,110
1,257,0.2958904109589041,0.7455830388692579,67160506,365,108
0,53,0.19696969696969696,0.4338235294117647,69256313,66,13
0,801,0.11589403973509933,0.12071651090342679,68115544,906,105
2,24,0.7575757575757576,0.972972972972973,80137028,99,75
0,340,0.18854415274463007,0.33865248226950356,69242635,419,79
0,456,0.17689530685920576,0.363905325443787,79254833,554,98
0,359,0.15330188679245282,0.24915824915824916,80071292,424,65
0,175,0.1784037558685446,0.36792452830188677,80097241,213,38
0,165,0.11764705882352941,0.21040189125295508,80097276,187,22
0,782,0.1963001027749229,0.3603833865814696,66340666,973,191
1,607,0.40255905511811024,0.8627684964200477,80127927,1016,409
1,606,0.27598566308243727,0.5725288831835686,80181312,837,231
2,669,0.5062730627306273,0.9516008935219658,80123434,1355,686
2,821,0.5130486358244365,0.9015544041450777,80176798,1686,865
1,375,0.30297397769516726,0.6276729559748427,70209412,538,163
1,32,0.47540983606557374,0.9139784946236559,64930656,61,29
0,6,0.0,0.0,70702856,6,0
0,1,0.0,0.0,70703185,1,0
0,8,0.0,0.0,70705292,8,0
0,16,0.058823529411764705,0.25609756097560976,70707322,17,1
1,370,0.38023450586264657,0.8694362017804155,81971165,597,227
0,77,0.15384615384615385,0.35175879396984927,80124179,91,14
1,211,0.33647798742138363,0.6968325791855203,70209433,318,107
1,360,0.48717948717948717,0.9093655589123867,69522320,702,342
1,294,0.3049645390070922,0.6856435643564357,70812756,423,129
1,692,0.3870682019486271,0.7205188679245284,72433550,1129,437
2,317,0.5167682926829268,0.7842465753424658,80178143,656,339
0,540,0.20118343195266272,0.47074122236671,73700445,676,136
1,183,0.48450704225352115,0.8360128617363344,70245224,355,172
1,171,0.316,0.6428571428571429,73702363,250,79
0,220,0.1760299625468165,0.28426395939086296,73702552,267,47
0,392,0.24324324324324326,0.48158640226628896,69577501,518,126
2,293,0.5100334448160535,0.94,63570850,598,305
1,406,0.3164983164983165,0.8018372703412073,70659064,594,188
1,480,0.3229901269393512,0.6972193614830072,69874420,709,229
0,794,0.20916334661354583,0.42660944206008583,69073550,1004,210
1,419,0.22407407407407406,0.5268935236004391,68147611,540,121
1,675,0.2765273311897106,0.7099023709902371,80121167,933,258
1,152,0.2796208530805687,0.5748218527315915,74445413,211,59
0,613,0.1738544474393531,0.29076396807297605,80125339,742,129
0,873,0.1507782101167315,0.22535211267605634,80125343,1028,155
1,301,0.34989200863930886,0.7882882882882883,70348026,463,162
1,104,0.391812865497076,0.8170212765957446,69482924,171,67
0,1351,0.24525139664804468,0.4903529411764706,74265373,1790,439
1,363,0.30725190839694655,0.6151241534988713,77551054,524,161
1,426,0.30049261083743845,0.6875,70686854,609,183
0,1087,0.14745098039215687,0.23576423576423577,72900366,1275,188
1,278,0.2299168975069252,0.5403111739745403,82008915,361,83
1,1718,0.41144227475162726,0.8799444829979182,80136855,2919,1201
1,304,0.34763948497854075,0.7952380952380952,67552513,466,162
0,1956,0.15397923875432526,0.24029640084685958,67703363,2312,356
1,183,0.3272058823529412,0.8157389635316699,82126721,272,89
1,224,0.3353115727002967,0.8078602620087336,67555446,337,113
1,118,0.2670807453416149,0.5857740585774058,72393384,161,43
1,328,0.46579804560260585,0.9146341463414634,72801085,614,286
1,271,0.42462845010615713,0.8863636363636364,70655221,471,200
0,66,0.14285714285714285,0.22897196261682243,70217413,77,11
0,1361,0.20455873758036236,0.40701497990500546,82000071,1711,350
0,947,0.16268788682581786,0.2737603305785124,82039207,1131,184
1,144,0.34841628959276016,0.8155339805825242,66857105,221,77
1,268,0.4004474272930649,0.8371335504885994,80089331,447,179
0,187,0.08780487804878048,0.07142857142857142,72493736,205,18
1,890,0.3392724573125464,0.7701641684511064,80107643,1347,457
0,401,0.10888888888888888,0.15940054495912806,67285736,450,49
1,541,0.2699055330634278,0.6637795275590551,80121212,741,200
1,65,0.3627450980392157,0.8333333333333334,65100000,102,37
1,236,0.2555205047318612,0.6149425287356322,76694954,317,81
0,24,0.1111111111111111,0.06315789473684211,76779262,27,3
0,1578,0.15884861407249468,0.24604430379746836,69240206,1876,298
1,78,0.2972972972972973,0.6074380165289256,80167080,111,33
0,581,0.18854748603351956,0.3794642857142857,63279720,716,135
1,1448,0.32838589981447125,0.7886284722222222,80124644,2156,708
0,718,0.16801853997682503,0.3181818181818182,69240031,863,145
0,147,0.20108695652173914,0.26720647773279355,62497141,184,37
0,340,0.2608695652173913,0.49464285714285716,62497435,460,120
1,480,0.2727272727272727,0.5316946959896507,70606921,660,180
0,936,0.22,0.4511691884456671,72393433,1200,264
1,440,0.43005181347150256,0.9330855018587361,69072843,772,332
1,201,0.42735042735042733,0.9063545150501672,81971149,351,150
0,53,0.208955223880597,0.25675675675675674,67394040,67,14
0,875,0.17685794920037629,0.30778097982708935,77676284,1063,188
0,208,0.023474178403755867,0.04607046070460705,62839714,213,5
1,381,0.22718052738336714,0.5765472312703583,62840575,493,112
0,491,0.11371841155234658,0.14066852367688024,62958553,554,63
1,327,0.3158995815899582,0.7537190082644628,70646023,478,151
1,423,0.35419847328244275,0.8151862464183381,80111570,655,232
0,976,0.14385964912280702,0.17037470725995316,68533241,1140,164
0,884,0.19636363636363635,0.3932244404113733,68537364,1100,216
1,737,0.3293903548680619,0.6637096774193548,74347945,1099,362
1,112,0.4482758620689655,0.9479553903345725,65277884,203,91
0,649,0.18671679197994986,0.3669064748201439,77676445,798,149
1,17,0.45161290322580644,0.8478260869565217,79854110,31,14
0,129,0.03007518796992481,0.08914728682170543,62836291,133,4
0,547,0.07130730050933787,0.28211009174311924,67872784,589,42
1,59,0.37894736842105264,0.7377049180327869,57042405,95,36
0,479,0.05893909626719057,0.2536231884057971,66389372,509,30
1,681,0.3797814207650273,0.8497202238209433,72749131,1098,417
0,544,0.1406003159557662,0.19106317411402157,66423175,633,89
0,1072,0.11184755592377796,0.12720403022670027,68534445,1207,135
0,783,0.16702127659574467,0.3229228049499116,72900394,940,157
0,451,0.062370062370062374,0.19166666666666668,64251124,481,30
0,1041,0.22831727205337288,0.4885920979410128,80127419,1349,308
1,1035,0.2906100068540096,0.6372382569326542,67557931,1459,424
1,395,0.3094405594405594,0.7847222222222222,80135827,572,177
1,1928,0.32040888262248857,0.7602318000724375,68112590,2837,909
1,382,0.3391003460207612,0.77734375,68953885,578,196
0,144,0.03355704697986577,0.03864734299516908,70001064,149,5
0,984,0.08208955223880597,0.21134751773049645,70001393,1072,88
0,2883,0.07089912987431518,0.1304485154769425,70001792,3103,220
0,109,0.043859649122807015,0.3425925925925926,66024994,114,5
1,84,0.436241610738255,0.860655737704918,76983221,149,65
1,351,0.3223938223938224,0.676923076923077,74045426,518,167
2,10,0.6153846153846154,0.75,80176795,26,16
2,23,0.5106382978723404,0.9019607843137255,80174187,47,24
2,3,0.6666666666666666,0.8571428571428571,72801372,9,6
0,1042,0.15284552845528454,0.205685618729097,80141460,1230,188
1,62,0.46551724137931033,0.9058823529411765,80141496,116,54
2,43,0.6504065040650406,0.9727272727272728,73348842,123,80
1,152,0.403921568627451,0.8394160583941606,72390801,255,103
0,191,0.06372549019607843,0.14864864864864866,72392803,204,13
0,91,0.010869565217391304,0.0,73863895,92,1
0,160,0.13043478260869565,0.2427536231884058,80170986,184,24
2,26,0.5357142857142857,0.5945945945945946,67583936,56,30
2,107,0.8797752808988764,0.991869918699187,66991211,890,783
0,539,0.1362179487179487,0.22393472348141433,67703272,624,85
1,201,0.24719101123595505,0.5758683729433273,67555516,267,66
1,674,0.40195208518189884,0.9095276220976781,68200405,1127,453
0,26,0.16129032258064516,0.3088235294117647,79788352,31,5
0,203,0.12875536480686695,0.15789473684210525,81979789,233,30
1,396,0.2851985559566787,0.6236722306525038,80111556,554,158
0,661,0.11748998664886515,0.1325136612021858,72899260,749,88
1,506,0.26772793053545585,0.6449136276391555,72376290,691,185
1,1061,0.26268241834607364,0.6054664289958408,66930675,1439,378
1,525,0.2563739376770538,0.5930971843778383,63283332,706,181
1,112,0.3333333333333333,0.7032258064516129,69153791,168,56
0,637,0.15405046480743692,0.2586938083121289,69239975,753,116
1,4,0.3333333333333333,0.75,72523136,6,2
1,190,0.2692307692307692,0.5784543325526932,82126651,260,70
0,807,0.1540880503144654,0.29424943988050783,68536916,954,147
0,2000,0.0693345742205677,0.04712041884816754,68534410,2149,149
0,351,0.19310344827586207,0.40670859538784065,68561654,435,84
2,765,0.5096153846153846,0.9609140108238123,67993730,1560,795
0,470,0.2231404958677686,0.4530386740331492,66308963,605,135
0,507,0.1990521327014218,0.39020657995409336,72900422,633,126
0,398,0.10561797752808989,0.24344262295081967,81893584,445,47
0,1202,0.11356932153392331,0.11281265952016335,67963385,1356,154
0,449,0.07613168724279835,0.09018567639257294,69600965,486,37
1,192,0.3118279569892473,0.6833333333333333,70072471,279,87
0,867,0.09593326381647549,0.11678832116788321,73399606,959,92
0,549,0.11021069692058347,0.15303430079155672,74072656,617,68
1,564,0.27319587628865977,0.676555023923445,69621433,776,212
1,504,0.30482758620689654,0.7228426395939086,69622553,725,221
1,129,0.484,0.9301470588235294,66064684,250,121
1,94,0.36486486486486486,0.7488151658767772,68189674,148,54
1,180,0.38144329896907214,0.8044692737430168,70676970,291,111
1,309,0.3163716814159292,0.7354260089686099,70670635,452,143
1,1102,0.40108695652173915,0.8888888888888888,65825095,1840,738
1,437,0.2894308943089431,0.6904549509366636,82046885,615,178
1,186,0.4431137724550898,0.9360613810741688,70642551,334,148
1,172,0.33073929961089493,0.6897506925207756,65278493,257,85
0,780,0.03940886699507389,0.02747791952894995,80114615,812,32
0,401,0.1029082774049217,0.14712389380530974,70627872,447,46
1,423,0.2565905096660808,0.5966386554621849,70642341,569,146
0,293,0.12797619047619047,0.23741007194244604,69416725,336,43
0,170,0.20930232558139536,0.48879837067209775,69417201,215,45
1,186,0.31365313653136534,0.6808988764044944,69176751,271,85
1,138,0.3920704845814978,0.8873239436619719,69177094,227,89
0,834,0.03360370799536501,0.014144271570014143,82011853,863,29
0,510,0.017341040462427744,0.008333333333333333,82011854,519,9
1,285,0.3804347826086957,0.8832997987927566,66423434,460,175
1,523,0.25920679886685555,0.5751633986928104,67556832,706,183
1,126,0.2631578947368421,0.5454545454545454,70487452,171,45
0,151,0.21354166666666666,0.41812865497076024,67551981,192,41
1,69,0.3490566037735849,0.8241758241758241,68112646,106,37
0,1167,0.20232399179767602,0.3125393824826717,70207403,1463,296
1,796,0.31790916880891174,0.6425725668753557,80150381,1167,371
2,325,0.8801622418879056,0.9917695473251029,80180294,2712,2387
0,682,0.04748603351955307,0.0920138888888889,63780710,716,34
0,3,0.0,0.0,67982145,3,0
1,147,0.3033175355450237,0.7411764705882353,81967331,211,64
1,64,0.24705882352941178,0.5151515151515151,70638925,85,21
1,839,0.36726998491704377,0.8234106962663976,80002902,1326,487
1,94,0.2878787878787879,0.5792079207920792,80117752,132,38
0,1378,0.12950094756790903,0.1416171767930562,66413844,1583,205
0,826,0.18940137389597644,0.3791113675706867,68534655,1019,193
1,380,0.43283582089552236,0.9033613445378151,80128028,670,290
0,395,0.05275779376498801,0.12640801001251564,60028262,417,22
1,157,0.29910714285714285,0.6931034482758621,69165593,224,67
1,568,0.2727272727272727,0.6796949475691134,80112340,781,213
1,400,0.33993399339933994,0.815403422982885,80121300,606,206
1,939,0.27321981424148606,0.5793470007593015,67552555,1292,353
0,105,0.19230769230769232,0.30538922155688625,74886294,130,25
0,299,0.14080459770114942,0.28896473265073946,81893581,348,49
2,137,0.5018181818181818,0.963963963963964,82095525,275,138
1,1354,0.4853667806917522,0.9540795407954079,66010504,2631,1277
1,257,0.3054054054054054,0.6281690140845071,62744542,370,113
0,437,0.14145383104125736,0.15598885793871867,62901391,509,72
1,1233,0.26123427201917315,0.5887050770108385,67555411,1669,436
0,1203,0.1691988950276243,0.2814814814814815,68006575,1448,245
0,707,0.18828932261768083,0.3518648838845883,68543300,871,164
0,100,0.038461538461538464,0.06938775510204082,69508894,104,4
1,440,0.24528301886792453,0.5844660194174758,82002086,583,143
1,225,0.44717444717444715,0.8984615384615384,70417403,407,182
1,313,0.27209302325581397,0.6446629213483146,68542530,430,117
1,625,0.3154435925520263,0.6934673366834171,76694975,913,288
1,45,0.3918918918918919,0.896551724137931,66856244,74,29
0,35,0.2857142857142857,0.41379310344827586,66856972,49,14
0,603,0.027419354838709678,0.019553072625698324,67838001,620,17
0,412,0.03058823529411765,0.028967254408060455,70001645,425,13
0,523,0.0743362831858407,0.19842053307008883,70001750,565,42
1,621,0.24175824175824176,0.6199021207177814,66931662,819,198
0,114,0.20833333333333334,0.44314868804664725,70040873,144,30
1,207,0.33653846153846156,0.7689161554192229,67995522,312,105
1,285,0.4612476370510397,0.9277566539923955,70645624,529,244
0,535,0.21323529411764705,0.45956607495069035,80111836,680,145
1,265,0.2659279778393352,0.6433691756272402,80111892,361,96
1,603,0.26552984165651644,0.6269621421975993,68532051,821,218
1,650,0.38505203405865657,0.8982630272952854,66410232,1057,407
1,907,0.2875098193244305,0.646112600536193,80180454,1273,366
2,104,0.5720164609053497,0.9473684210526315,80062150,243,139
1,558,0.3007518796992481,0.6988929889298893,68212200,798,240
0,100,0.09090909090909091,0.1457725947521866,69415920,110,10
1,357,0.2404255319148936,0.5207715133531158,70642180,470,113
1,559,0.36041189931350115,0.8525073746312685,68200356,874,315
1,379,0.26120857699805067,0.5888051668460711,69169422,513,134
1,162,0.2097560975609756,0.5472222222222223,63770084,205,43
0,248,0.12982456140350876,0.3924050632911392,63771344,285,37
1,233,0.24838709677419354,0.6539379474940334,68537910,310,77
1,128,0.25146198830409355,0.6464285714285715,68533794,171,43
0,80,0.2,0.4319526627218935,80056655,100,20
0,1291,0.19613947696139478,0.3403361344537815,80117759,1606,315
0,151,0.04430379746835443,0.1801470588235294,62840260,158,7
0,538,0.016453382084095063,0.023391812865497075,68798324,547,9
0,673,0.19401197604790418,0.387409200968523,68535621,835,162
1,327,0.35502958579881655,0.7697160883280757,70586026,507,180
0,379,0.16150442477876106,0.3088718510405257,69549431,452,73
0,423,0.20934579439252338,0.4782051282051282,68541431,535,112
0,444,0.2127659574468085,0.4443069306930693,68541445,564,120
1,1161,0.27392120075046905,0.6075268817204301,80109911,1599,438
1,925,0.3638239339752407,0.7646017699115044,68401326,1454,529
0,452,0.1781818181818182,0.31221719457013575,80104605,550,98
0,226,0.08502024291497975,0.10714285714285714,82036711,247,21
1,450,0.3023255813953488,0.6824324324324325,69101662,645,195
0,1541,0.20031136481577583,0.38671726755218216,68534816,1927,386
0,560,0.18128654970760233,0.27342888643880925,72393363,684,124
1,1003,0.313013698630137,0.7275132275132276,80109141,1460,457
0,1270,0.2174984596426371,0.4509151414309484,80110331,1623,353
2,55,0.6180555555555556,0.979381443298969,80152997,144,89
1,67,0.49242424242424243,0.9174311926605505,80175637,132,65
2,1068,0.7495309568480301,0.9855358316896778,80181915,4264,3196
1,90,0.3181818181818182,0.5555555555555556,70879634,132,42
2,80,0.6638655462184874,0.9652777777777778,69975185,238,158
1,70,0.4017094017094017,0.8976377952755905,70197631,117,47
2,621,0.5672473867595819,0.9768745620182201,80137021,1435,814
1,491,0.3930778739184178,0.8584905660377359,74091500,809,318
0,585,0.1690340909090909,0.3068181818181818,70182616,704,119
2,5,0.75,0.9,82049154,20,15
2,92,0.8474295190713101,0.9624413145539906,70596484,603,511
2,22,0.5111111111111111,0.8823529411764706,70717941,45,23
1,28,0.3488372093023256,0.813953488372093,73313856,43,15
2,22,0.5510204081632653,0.9848484848484849,72198343,49,27
2,37,0.5256410256410257,0.9523809523809523,69162611,78,41
1,166,0.2813852813852814,0.5277777777777778,69550201,231,65
2,1505,0.5969469737546866,0.980431510286001,80137789,3734,2229
1,155,0.39215686274509803,0.8070652173913043,82138823,255,100
2,187,0.557919621749409,0.9616161616161616,70395416,423,236
1,423,0.3742603550295858,0.8693045563549161,69603261,676,253
1,609,0.2852112676056338,0.681360201511335,63115591,852,243
0,256,0.09859154929577464,0.18052738336713997,63769734,284,28
1,433,0.40846994535519127,0.8230240549828178,74955475,732,299
1,766,0.43635025754231055,0.9108225108225109,80152612,1359,593
0,629,0.0988538681948424,0.13067655236329936,72899834,698,69
0,167,0.15656565656565657,0.1780821917808219,69056806,198,31
1,296,0.2798053527980535,0.5371900826446281,68943091,411,115
0,253,0.209375,0.2673992673992674,80126989,320,67
1,817,0.3225538971807628,0.7985074626865671,68535082,1206,389
1,661,0.28771551724137934,0.6537585421412301,69184094,928,267
0,1538,0.21968543886352104,0.38761061946902653,65983953,1971,433
2,37,0.704,0.9803921568627451,80117739,125,88
1,275,0.2948717948717949,0.6111111111111112,67995333,390,115
0,1136,0.13808801213960548,0.20527859237536658,68537042,1318,182
1,472,0.3604336043360434,0.7715780296425457,65877252,738,266
0,268,0.21176470588235294,0.4423728813559322,68537413,340,72
1,394,0.3287904599659284,0.7341954022988506,80109421,587,193
0,49,0.15517241379310345,0.2953020134228188,69416872,58,9
1,269,0.2670299727520436,0.6038062283737025,54564132,367,98
0,55,0.19117647058823528,0.3170731707317073,69724431,68,13
1,97,0.2595419847328244,0.7811447811447811,69638590,131,34
0,356,0.18906605922551253,0.375,68642364,439,83
1,311,0.48848684210526316,0.9362139917695473,63495271,608,297
0,1178,0.0768025078369906,0.0704656862745098,68743633,1276,98
0,872,0.013574660633484163,0.007957559681697613,68743682,884,12
0,72,0.16279069767441862,0.3674698795180723,70252966,86,14
0,326,0.12834224598930483,0.25732899022801303,80155259,374,48
1,502,0.3455019556714472,0.7731421121251629,70644812,767,265
0,1002,0.22863741339491916,0.49620390455531455,67291903,1299,297
1,629,0.2608695652173913,0.5061494796594135,81967312,851,222
2,142,0.5835777126099707,0.9641434262948207,81968064,341,199
0,439,0.03938730853391685,0.11168831168831168,62839203,457,18
0,652,0.15870967741935485,0.40103492884864167,69578145,775,123
0,377,0.05513784461152882,0.23440285204991088,82049091,399,22
1,471,0.29701492537313434,0.7362525458248472,70618345,670,199
0,735,0.18963616317530319,0.37774984286612195,62766802,907,172
0,458,0.18505338078291814,0.381936887921654,80117905,562,104
0,629,0.11408450704225352,0.14585079631181894,80119320,710,81
0,969,0.05830903790087463,0.036607687614399025,80119380,1029,60
1,267,0.337468982630273,0.7625231910946196,67552303,403,136
1,155,0.2619047619047619,0.6214511041009464,67942833,210,55
1,291,0.36323851203501095,0.7540983606557377,71478295,457,166
1,485,0.2750373692077728,0.6455938697318008,82113175,669,184
0,547,0.11916264090177134,0.1438721136767318,80118141,621,74
0,1933,0.09630668536699392,0.07641079565369786,70207592,2139,206
1,523,0.24421965317919075,0.58298755186722,80181643,692,169
1,233,0.44655581947743467,0.9152542372881356,69089706,421,188
1,138,0.29591836734693877,0.7178841309823678,80168515,196,58
1,162,0.3886792452830189,0.8053435114503816,67148935,265,103
0,2604,0.1685823754789272,0.2784952274003369,70643363,3132,528
1,594,0.24714828897338403,0.5177895533686601,69057821,789,195
0,84,0.17647058823529413,0.4166666666666667,62940430,102,18
0,398,0.17598343685300208,0.30818414322250637,68530770,483,85
0,573,0.17553956834532375,0.28433268858800775,68530791,695,122
0,904,0.16605166051660517,0.29557216791259344,63279034,1084,180
1,314,0.2943820224719101,0.6461295418641391,69176905,445,131
0,1,0.0,0.0,69517700,1,0
2,429,0.6637931034482759,0.9760900140646976,70543375,1276,847
0,186,0.11004784688995216,0.16620498614958448,66427403,209,23
1,1587,0.2946666666666667,0.6400171013253527,82134184,2250,663
1,339,0.3273809523809524,0.7762237762237763,70626941,504,165
1,1137,0.3037354562155542,0.7337429595494112,68203583,1633,496
1,167,0.32661290322580644,0.8661971830985915,68540794,248,81
1,635,0.3149946062567422,0.7471264367816092,64155385,927,292
0,408,0.10526315789473684,0.23415492957746478,63772051,456,48
0,850,0.06798245614035088,0.18869309838472834,70001540,912,62
0,586,0.2070365358592693,0.35856573705179284,80181322,739,153
0,245,0.02,0.07048458149779736,62838874,250,5
0,838,0.04337899543378995,0.128698224852071,62839112,876,38
0,493,0.03522504892367906,0.0945479641131815,62839224,511,18
2,30,0.53125,0.9545454545454546,82054004,64,34
0,677,0.2376126126126126,0.4539568345323741,70179515,888,211
1,225,0.34593023255813954,0.809106830122592,70633563,344,119
0,243,0.25,0.4244604316546763,80180381,324,81
1,588,0.3287671232876712,0.6824817518248175,82033202,876,288
1,341,0.328740157480315,0.7548476454293629,67281781,508,167
1,168,0.43434343434343436,0.8571428571428571,66859940,297,129
2,145,0.536741214057508,0.972972972972973,70602644,313,168
0,664,0.22157092614302462,0.4321880650994575,68543636,853,189
0,381,0.15333333333333332,0.2599009900990099,70626906,450,69
0,787,0.2122122122122122,0.46480659480025366,70626990,999,212
0,415,0.20192307692307693,0.4117647058823529,68537322,520,105
1,266,0.43283582089552236,0.90020366598778,65008573,469,203
1,170,0.3486590038314176,0.8390804597701149,66383310,261,91
0,511,0.1978021978021978,0.39090909090909093,67159260,637,126
0,247,0.008032128514056224,0.0024509803921568627,68743444,249,2
0,94,0.17543859649122806,0.3347826086956522,68299735,114,20
2,354,0.5103734439834025,0.9539052496798975,73321241,723,369
0,223,0.030434782608695653,0.0948509485094851,62839000,230,7
1,502,0.3693467336683417,0.7920353982300885,80128483,796,294
0,668,0.18635809987819732,0.4235905044510386,69240290,821,153
1,204,0.2765957446808511,0.7073170731707317,80121247,282,78
0,2409,0.21937783538561245,0.4728065674704977,82000063,3086,677
0,816,0.17408906882591094,0.29634073185362925,82011782,988,172
1,55,0.3888888888888889,0.8359375,68496925,90,35
0,820,0.0858416945373467,0.3043701799485861,62838944,897,77
1,446,0.19494584837545126,0.5199115044247787,62909861,554,108
1,1066,0.3802325581395349,0.8141592920353983,68993645,1720,654
1,37,0.27450980392156865,0.5789473684210527,69864151,51,14
0,2676,0.16191669276542436,0.2631578947368421,73637501,3193,517
0,392,0.18333333333333332,0.3875,82012545,480,88
0,1277,0.16916070266753416,0.26644182124789206,68668992,1537,260
1,821,0.4609323703217334,0.8913043478260869,73937031,1523,702
1,299,0.35560344827586204,0.7553956834532374,68401060,464,165
2,130,0.5075757575757576,0.9497041420118343,64975631,264,134
0,3,0.25,0.125,69736275,4,1
2,327,0.5368271954674221,0.9325842696629213,76571866,706,379
2,41,0.7484662576687117,0.9454545454545454,67321254,163,122
2,18,0.6170212765957447,0.8181818181818182,69401164,47,29
0,290,0.05537459283387622,0.04691358024691358,80119331,307,17
2,49,0.51,0.9261363636363636,72390836,100,51
2,2,0.8333333333333334,0.9,80176660,12,10
1,259,0.268361581920904,0.585635359116022,80096352,354,95
2,0,1.0,1.0,73588963,7,7
0,77,0.18085106382978725,0.32599118942731276,74478033,94,17
1,4,0.2,0.7333333333333333,67715634,5,1
0,1006,0.1841038118410381,0.37591776798825255,65832571,1233,227
0,510,0.21779141104294478,0.4768211920529801,70604632,652,142
1,194,0.40672782874617736,0.8953722334004024,62804175,327,133
0,65,0.057971014492753624,0.017543859649122806,74361805,69,4
0,115,0.06504065040650407,0.11374407582938388,73245536,123,8
2,388,0.5032010243277849,0.9705882352941176,70349153,781,393
2,162,0.5120481927710844,0.9649122807017544,80163511,332,170
2,1,0.5,0.6666666666666666,82010325,2,1
0,919,0.06700507614213198,0.08281573498964803,80114566,985,66
0,41,0.14583333333333334,0.4583333333333333,72669233,48,7
0,68,0.13924050632911392,0.4645669291338583,68256993,79,11
0,267,0.05653710247349823,0.09482758620689655,80124164,283,16
0,216,0.18796992481203006,0.41247002398081534,69314056,266,50
2,19,0.7205882352941176,0.9863013698630136,82018850,68,49
2,24,0.8857142857142857,0.96875,65068801,210,186
1,206,0.35625,0.8752475247524752,62027532,320,114
1,32,0.3191489361702128,0.7175572519083969,69309226,47,15
0,685,0.0577716643741403,0.1437435367114788,69625661,727,42
1,448,0.4066225165562914,0.8627027027027027,69055056,755,307
1,824,0.23134328358208955,0.5708978328173374,80118439,1072,248
1,560,0.30864197530864196,0.7816826411075612,70627634,810,250
1,501,0.3468057366362451,0.676056338028169,67657170,767,266
0,75,0.013157894736842105,0.015873015873015872,73245480,76,1
0,22,0.18518518518518517,0.34782608695652173,70605542,27,5
1,25,0.46808510638297873,0.9315068493150684,69666625,47,22
1,1646,0.2605570530098832,0.59400826446281,67336661,2226,580
0,799,0.05778301886792453,0.14352941176470588,70001225,848,49
1,2097,0.308377308707124,0.7106684672518568,80105816,3032,935
1,339,0.3247011952191235,0.7283549783549783,80128501,502,163
0,353,0.16152019002375298,0.19391634980988592,70646485,421,68
0,275,0.0924092409240924,0.07058823529411765,79822470,303,28
1,1136,0.3444893248701673,0.7998022738507168,774256,1733,597
1,463,0.4183417085427136,0.8590909090909091,72932923,796,333
1,384,0.2808988764044944,0.6769025367156208,69621636,534,150
1,260,0.2972972972972973,0.6285266457680251,70676893,370,110
2,71,0.7880597014925373,0.9849246231155779,70604856,335,264
2,245,0.5970394736842105,0.9632352941176471,80137991,608,363
0,230,0.16363636363636364,0.4221824686940966,80128494,275,45
1,210,0.27335640138408307,0.5294117647058824,82005341,289,79
0,631,0.21125,0.3983122362869198,67170705,800,169
0,613,0.1880794701986755,0.2980456026058632,70528122,755,142
0,199,0.18106995884773663,0.47912524850894633,82009728,243,44
0,1014,0.022179363548698167,0.005454545454545455,73245501,1037,23
0,1087,0.09265442404006678,0.09805045871559633,73245676,1198,111
0,1323,0.1918142944410507,0.3397879207007838,82011411,1637,314
0,607,0.04409448818897638,0.027548209366391185,82011859,635,28
2,173,0.5,0.9463722397476341,80158082,346,173
1,106,0.38011695906432746,0.7365591397849462,80158083,171,65
0,1120,0.20454545454545456,0.3962466487935657,68115453,1408,288
1,2486,0.3224311801580812,0.7779066396056828,68171334,3669,1183
2,41,0.5176470588235295,0.9146341463414634,54291223,85,44
1,839,0.2735930735930736,0.6346456692913386,73176852,1155,316
0,335,0.18689320388349515,0.2550607287449393,72899274,412,77
1,958,0.3767078724788549,0.8492527615334633,69572930,1537,579
1,772,0.24535679374389052,0.5019011406844106,67551995,1023,251
0,1054,0.19725818735719725,0.3525252525252525,69145545,1313,259
1,120,0.34065934065934067,0.7070063694267515,70867965,182,62
1,241,0.4064039408866995,0.8514492753623188,70866481,406,165
1,119,0.23225806451612904,0.5106382978723404,67344592,155,36
2,379,0.5320987654320988,0.9487704918032787,80169879,810,431
1,1370,0.2166952544311035,0.550018733608093,67328275,1749,379
0,228,0.17689530685920576,0.27843803056027167,77065114,277,49
1,188,0.25396825396825395,0.5571142284569138,67514146,252,64
1,655,0.2689732142857143,0.6400986031224322,67557623,896,241
1,26,0.3333333333333333,0.6538461538461539,70071344,39,13
0,404,0.16872427983539096,0.248868778280543,67553122,486,82
1,12,0.3333333333333333,0.7105263157894737,65279095,18,6
1,491,0.28840579710144926,0.7145708582834331,68536370,690,199
0,130,0.10344827586206896,0.08292682926829269,63779702,145,15
1,39,0.1702127659574468,0.6666666666666666,80135174,47,8
0,587,0.11060606060606061,0.1917494270435447,82011847,660,73
1,365,0.23799582463465555,0.6172839506172839,82016322,479,114
0,937,0.19914529914529913,0.3445491251682369,70037590,1170,233
1,705,0.3783068783068783,0.8412302576891105,70658462,1134,429
1,502,0.2808022922636103,0.5417142857142857,70628971,698,196
0,469,0.09980806142034548,0.14573991031390135,70617554,521,52
1,1271,0.29662423907028224,0.7274313126907981,80121132,1807,536
1,137,0.41702127659574467,0.8309859154929577,61104806,235,98
1,1332,0.24660633484162897,0.6426811237062593,80119199,1768,436
1,215,0.2785234899328859,0.6588021778584392,67553423,298,83
1,717,0.24763903462749212,0.5564663023679417,69165642,953,236
0,705,0.22697368421052633,0.46860986547085204,67435851,912,207
1,202,0.3355263157894737,0.8158508158508159,69165572,304,102
1,355,0.4418238993710692,0.93296853625171,80120467,636,281
1,435,0.4759036144578313,0.9544103072348861,67661426,830,395
1,313,0.3727454909819639,0.8511821974965229,63259266,499,186
0,209,0.10683760683760683,0.29135338345864664,65683702,234,25
0,674,0.06906077348066299,0.24617196702002356,62840092,724,50
0,440,0.07172995780590717,0.28708133971291866,62841135,474,34
1,667,0.2757871878393051,0.6385991058122206,68535936,921,254
0,233,0.08267716535433071,0.1497584541062802,75283243,254,21
1,670,0.32323232323232326,0.7335473515248796,70599466,990,320
1,354,0.3843478260869565,0.8922852983988355,73738952,575,221
1,861,0.29771615008156604,0.6776355880560634,67556461,1226,365
1,765,0.3795620437956204,0.8719590268886044,69509132,1233,468
0,300,0.1712707182320442,0.32710280373831774,67705960,362,62
2,336,0.515850144092219,0.9608150470219435,82023515,694,358
0,465,0.0970873786407767,0.12828947368421054,67598020,515,50
0,1401,0.21512605042016808,0.4645261522527188,68544560,1785,384
1,448,0.2808988764044944,0.6946902654867256,70573181,623,175
1,623,0.3093126385809313,0.7564102564102564,80125360,902,279
0,611,0.14064697609001406,0.21487603305785125,71567881,711,100
0,2598,0.16996805111821087,0.2943374532911756,68544441,3130,532
1,100,0.3710691823899371,0.8841698841698842,69152132,159,59
1,413,0.23800738007380073,0.5256588072122053,67942700,542,129
2,166,0.5202312138728323,0.9695550351288056,80123460,346,180
2,58,0.5245901639344263,0.9541984732824428,73869866,122,64
1,1262,0.28740824392998304,0.6829493087557603,68532086,1771,509
1,187,0.277992277992278,0.6650943396226415,80121126,259,72
0,232,0.2027491408934708,0.3625254582484725,70207004,291,59
1,350,0.30417495029821073,0.7667525773195877,70626773,503,153
1,341,0.48411497730711045,0.9571428571428572,69628811,661,320
1,850,0.3128536782538399,0.7121982210927573,69183394,1237,387
1,871,0.2568259385665529,0.584375,69073571,1172,301
1,236,0.424390243902439,0.8532731376975169,82007156,410,174
1,836,0.3225283630470016,0.7569850552306693,65267041,1234,398
1,338,0.38768115942028986,0.8510204081632653,80180339,552,214
2,41,0.5494505494505495,0.9782608695652174,80177414,91,50
0,953,0.18127147766323023,0.28154205607476634,67513145,1164,211
0,660,0.20481927710843373,0.43302443133951135,68535901,830,170
0,252,0.18446601941747573,0.3345029239766082,68563572,309,57
0,739,0.15639269406392695,0.26258992805755393,54609674,876,137
1,382,0.2977941176470588,0.672289156626506,69176702,544,162
0,559,0.08809135399673736,0.04883227176220807,67557042,613,54
2,16,0.5151515151515151,0.8709677419354839,80136623,33,17
0,798,0.20040080160320642,0.36217303822937624,67170691,998,200
0,383,0.1373873873873874,0.21631644004944375,80119319,444,61
0,867,0.22032374100719423,0.47961452928094883,68171355,1112,245
0,115,0.07258064516129033,0.4793388429752066,62840736,124,9
0,198,0.07476635514018691,0.39920948616600793,62840855,214,16
0,1618,0.10607734806629834,0.11474358974358974,73700592,1810,192
0,813,0.07508532423208192,0.07343550446998723,82011779,879,66
0,987,0.0436046511627907,0.012202562538133009,82011781,1032,45
1,729,0.3360655737704918,0.7127746135069162,81966308,1098,369
1,53,0.32051282051282054,0.5128205128205128,81975749,78,25
1,356,0.3087378640776699,0.6323119777158774,70585914,515,159
1,69,0.4772727272727273,0.8865979381443299,72555616,132,63
0,219,0.07203389830508475,0.33065595716198126,62839245,236,17
0,81,0.05813953488372093,0.35119047619047616,62839490,86,5
0,304,0.06748466257668712,0.3156708004509583,62840904,326,22
1,373,0.3180987202925046,0.6295180722891566,80180186,547,174
0,239,0.19528619528619529,0.3673469387755102,70347515,297,58
0,204,0.05116279069767442,0.26907630522088355,62838902,215,11
0,324,0.04424778761061947,0.15991692627206647,62840120,339,15
0,55,0.09836065573770492,0.49836065573770494,82049127,61,6
1,717,0.3446069469835466,0.8152969894222946,80128259,1094,377
0,871,0.13762376237623763,0.262287104622871,80140167,1010,139
0,140,0.1907514450867052,0.4367816091954023,70841631,173,33
0,1085,0.0935672514619883,0.08383685800604229,70646310,1197,112
0,566,0.09149277688603531,0.09513513513513513,73199994,623,57
1,175,0.30278884462151395,0.780327868852459,67620434,251,76
0,517,0.10398613518197573,0.09725685785536159,68791163,577,60
2,13,0.6176470588235294,0.84375,67872350,34,21
1,208,0.2676056338028169,0.5957446808510638,80176781,284,76
0,1059,0.1989409984871407,0.3610280932456665,70207571,1322,263
0,775,0.1833508956796628,0.48552338530066813,81965795,949,174
0,1247,0.05744520030234316,0.10589727330374128,69098225,1323,76
1,313,0.4765886287625418,0.925984251968504,68028156,598,285
1,14,0.3,0.684931506849315,67793481,20,6
2,9,0.8392857142857143,0.9375,70700693,56,47
1,181,0.45317220543806647,0.9083557951482479,82088788,331,150
0,172,0.09473684210526316,0.24766355140186916,80067561,190,18
1,236,0.4485981308411215,0.9076704545454546,69162576,428,192
0,158,0.26851851851851855,0.4959785522788204,69308400,216,58
1,74,0.4307692307692308,0.7346938775510204,80056431,130,56
1,39,0.2641509433962264,0.5616438356164384,70186403,53,14
2,125,0.659400544959128,0.7413793103448276,70121891,367,242
2,109,0.7054054054054054,0.9015151515151515,69171340,370,261
0,270,0.20821114369501467,0.4782608695652174,75459055,341,71
1,1563,0.44038668098818473,0.9059090909090909,70795123,2793,1230
0,276,0.20689655172413793,0.36769759450171824,69974716,348,72
0,337,0.15326633165829145,0.29488574537540807,72900674,398,61
0,373,0.15227272727272728,0.34282178217821785,82011835,440,67
0,323,0.22541966426858512,0.4681404421326398,68532856,417,94
0,445,0.21238938053097345,0.3945355191256831,68532926,565,120
2,744,0.5341264871634315,0.9650613786591123,68342106,1597,853
1,151,0.24120603015075376,0.5255474452554745,82129381,199,48
0,2422,0.18996655518394648,0.3822164948453608,80180133,2990,568
1,621,0.30614525139664805,0.6452064380685795,82009284,895,274
0,102,0.06422018348623854,0.18930041152263374,68743514,109,7
0,1217,0.23266078184110972,0.4654161781946073,72467514,1586,369
0,402,0.13733905579399142,0.1672473867595819,68537154,466,64
1,605,0.431924882629108,0.8592132505175983,66695622,1065,460
0,302,0.1246376811594203,0.2037735849056604,80121262,345,43
1,618,0.4202626641651032,0.8858939802336029,70202153,1066,448
1,118,0.32571428571428573,0.6935483870967742,66119753,175,57
1,246,0.3492063492063492,0.7209302325581395,68254354,378,132
1,481,0.324438202247191,0.7575757575757576,69089636,712,231
1,732,0.25760649087221094,0.5582595870206489,69586356,986,254
1,459,0.27716535433070866,0.6503642039542143,80108756,635,176
1,326,0.2771618625277162,0.6192052980132451,80108826,451,125
1,348,0.4963820549927641,0.9051094890510949,68413205,691,343
1,564,0.32857142857142857,0.7912488605287147,75892915,840,276
0,1540,0.1760299625468165,0.2873665480427046,68545470,1869,329
0,776,0.19334719334719336,0.29681647940074907,70644896,962,186
0,68,0.17073170731707318,0.14130434782608695,70719691,82,14
0,35,0.14634146341463414,0.23076923076923078,70812896,41,6
0,290,0.23684210526315788,0.44189852700491,80150404,380,90
0,46,0.22033898305084745,0.41284403669724773,73200050,59,13
1,142,0.39574468085106385,0.889196675900277,65278542,235,93
1,1010,0.2691751085383502,0.5500736377025037,80110961,1382,372
1,554,0.31857318573185733,0.7464940668824164,67551834,813,259
1,766,0.28142589118198874,0.6819221967963387,67554466,1066,300
0,49,0.15517241379310345,0.24242424242424243,70486052,58,9
2,140,0.5104895104895105,0.9592476489028213,69585656,286,146
1,894,0.2707993474714519,0.5654952076677316,67995025,1226,332
0,1456,0.19111111111111112,0.38893188854489164,73816141,1800,344
2,267,0.5249110320284698,0.9501915708812261,66078565,562,295
0,1,0.0,0.0,61364436,1,0
1,144,0.3739130434782609,0.8728179551122195,68536405,230,86
1,151,0.28095238095238095,0.5846153846153846,68784884,210,59
2,24,0.6307692307692307,0.9696969696969697,64854692,65,41
1,219,0.4144385026737968,0.8871681415929203,93191,374,155
1,139,0.31862745098039214,0.6490566037735849,70639751,204,65
1,655,0.30319148936170215,0.6357012750455373,73524640,940,285
1,547,0.4589515331355094,0.9263803680981595,65787435,1011,464
0,1009,0.15635451505016723,0.32829131652661064,61948173,1196,187
0,804,0.07586206896551724,0.07426054122089365,72522751,870,66
1,323,0.3448275862068966,0.7340425531914894,70654710,493,170
0,59,0.24358974358974358,0.47297297297297297,67067392,78,19
0,646,0.15223097112860892,0.23983739837398374,68537574,762,116
1,829,0.2531531531531532,0.527797833935018,80109414,1110,281
2,207,0.5792682926829268,0.9873417721518988,70599851,492,285
0,1108,0.23427781617138907,0.38290788013318533,66471524,1447,339
1,472,0.36813922356091033,0.8276299112801014,265573,747,275
0,1325,0.09925220938137322,0.15427927927927929,66394482,1471,146
0,628,0.14789687924016282,0.206,67557364,737,109
1,65,0.35,0.7950819672131147,80131303,100,35
0,377,0.1822125813449024,0.29372937293729373,67553115,461,84
0,1041,0.18544600938967137,0.35106382978723405,68537161,1278,237
0,376,0.12354312354312354,0.21435897435897436,81979696,429,53
1,135,0.27807486631016043,0.5815384615384616,82116885,187,52
1,285,0.3132530120481928,0.7371349095966621,68210821,415,130
1,22,0.3888888888888889,0.796875,67922834,36,14
0,186,0.1267605633802817,0.3130630630630631,70643006,213,27
0,897,0.13416988416988418,0.23174411587205793,70643482,1036,139
0,988,0.15555555555555556,0.24603608529250956,77676431,1170,182
0,813,0.0771850170261067,0.06586021505376344,82011861,881,68
1,500,0.25037481259370314,0.5678899082568807,70597674,667,167
0,267,0.10101010101010101,0.12853470437017994,70748412,297,30
1,415,0.41134751773049644,0.9209245742092458,69165712,705,290
1,96,0.3885350318471338,0.8451882845188284,67285470,157,61
1,406,0.4072992700729927,0.925531914893617,65290442,685,279
1,291,0.33256880733944955,0.7098121085594989,68254466,436,145
1,47,0.37333333333333335,0.8666666666666667,68962572,75,28
1,515,0.27871148459383754,0.5497237569060773,74228903,714,199
1,366,0.2129032258064516,0.5193312434691745,70524573,465,99
0,308,0.12,0.20676691729323307,68743360,350,42
0,663,0.08677685950413223,0.1108058608058608,68743423,726,63
1,308,0.45195729537366547,0.8930581613508443,72364320,562,254
0,301,0.1615598885793872,0.25167336010709507,70686574,359,58
0,312,0.034055727554179564,0.02337228714524207,73245515,323,11
0,775,0.051407588739290085,0.10224948875255624,66111276,817,42
1,443,0.36623748211731044,0.8251572327044026,66111374,699,256
0,856,0.047830923248053395,0.119960668633235,66227042,899,43
0,1229,0.05388760585065435,0.12568306010928962,66227056,1299,70
0,975,0.09217877094972067,0.20722269991401548,68526304,1074,99
0,336,0.13846153846153847,0.2807017543859649,69965154,390,54
0,5,0.0,0.0,70509446,5,0
2,4,0.5,0.9166666666666666,68191095,8,4
1,240,0.3893129770992366,0.8074534161490683,79787001,393,153
0,69,0.19767441860465115,0.48672566371681414,69575723,86,17
1,682,0.32139303482587067,0.7410207939508506,70243096,1005,323
1,244,0.3203342618384401,0.7721280602636534,80121224,359,115
1,77,0.2524271844660194,0.5873015873015873,60763493,103,26
0,582,0.1871508379888268,0.3895161290322581,70634431,716,134
1,204,0.27402135231316727,0.5559105431309904,66897614,281,77
0,249,0.17,0.254278728606357,66897656,300,51
1,453,0.4139715394566624,0.9290540540540541,68531596,773,320
0,1206,0.1434659090909091,0.20081342145399084,69240255,1408,202
0,547,0.18962962962962962,0.3411644535240041,69668816,675,128
0,691,0.2057471264367816,0.38072289156626504,69668830,870,179
0,158,0.04819277108433735,0.1791530944625407,69946884,166,8
2,17,0.8089887640449438,0.9411764705882353,80128758,89,72
0,516,0.20615384615384616,0.42769500438212094,66930983,650,134
1,389,0.27153558052434457,0.5671819262782402,67553416,534,145
1,536,0.38461538461538464,0.8693361433087461,69183163,871,335
1,273,0.41163793103448276,0.9354243542435424,67833724,464,191
2,353,0.620021528525296,0.966374269005848,70823424,929,576
0,320,0.23627684964200477,0.4264705882352941,70713146,419,99
2,20,0.5121951219512195,0.8148148148148148,70610484,41,21
1,34,0.30612244897959184,0.5151515151515151,70610491,49,15
0,29,0.03333333333333333,0.1896551724137931,80124287,30,1
0,216,0.03571428571428571,0.09174311926605505,80124410,224,8
1,336,0.3142857142857143,0.6990496304118268,68952296,490,154
0,325,0.06069364161849711,0.057692307692307696,73406753,346,21
1,585,0.25477707006369427,0.5249221183800623,70286552,785,200
0,198,0.12,0.3063209076175041,75901203,225,27
1,351,0.30495049504950494,0.7057142857142857,67304041,505,154
1,539,0.4837164750957854,0.9163722025912838,70576723,1044,505
0,820,0.21229586935638808,0.44286636539703034,65355346,1041,221
0,911,0.09801980198019802,0.391304347826087,65925783,1010,99
1,587,0.3715203426124197,0.8502722323049002,66826382,934,347
1,295,0.21957671957671956,0.6163434903047091,67049591,378,83
1,50,0.20634920634920634,0.6754966887417219,70908292,63,13
1,1365,0.31338028169014087,0.7466534457114526,75943070,1988,623
1,1609,0.30466724286949004,0.6709534368070953,80150406,2314,705
0,11,0.0,0.0,80154087,11,0
0,301,0.21204188481675393,0.4519230769230769,75765025,382,81
1,445,0.2457627118644068,0.5417142857142857,67511423,590,145
0,486,0.21359223300970873,0.3939393939393939,80114972,618,132
1,318,0.23557692307692307,0.6112,79145962,416,98
1,127,0.38349514563106796,0.8326996197718631,63767816,206,79
0,332,0.011904761904761904,0.086,63631785,336,4
0,509,0.02676864244741874,0.1728024042073629,63631813,523,14
0,178,0.011111111111111112,0.11613876319758673,65132536,180,2
1,177,0.11940298507462686,0.5590828924162258,70467096,201,24
0,474,0.05765407554671968,0.2684887459807074,82134964,503,29
1,39,0.3157894736842105,0.8090909090909091,19277790,57,18
1,584,0.16690442225392296,0.5892725936811168,72556330,701,117
1,348,0.2532188841201717,0.572234762979684,69736331,466,118
1,28,0.2222222222222222,0.6728971962616822,70474985,36,8
1,982,0.24228395061728394,0.5305755395683454,68541004,1296,314
1,190,0.22764227642276422,0.5677655677655677,67882395,246,56
0,710,0.18764302059496568,0.49666666666666665,70233765,874,164
0,1754,0.06353443673251469,0.1511577107907383,73366146,1873,119
0,1986,0.03263516804676084,0.046097856854023456,73366181,2053,67
1,324,0.4234875444839858,0.8805031446540881,67846541,562,238
1,20,0.25925925925925924,0.5714285714285714,70760263,27,7
0,305,0.1527777777777778,0.4274300932090546,81965794,360,55
1,135,0.3147208121827411,0.750733137829912,80134713,197,62
0,301,0.17534246575342466,0.2733446519524618,80150403,365,64
0,157,0.15135135135135136,0.4289544235924933,70909104,185,28
0,215,0.09282700421940929,0.20038910505836577,78763482,237,22
2,255,0.5677966101694916,0.9593147751605996,72077775,590,335
1,231,0.247557003257329,0.6,70627683,307,76
1,285,0.37636761487964987,0.8156934306569343,66098102,457,172
0,251,0.027131782945736434,0.08191126279863481,66877006,258,7
1,131,0.3878504672897196,0.9136490250696379,80127346,214,83
0,83,0.1941747572815534,0.3811659192825112,70242690,103,20
1,986,0.2886002886002886,0.6347390993566834,80111094,1386,400
1,928,0.27782101167315176,0.6172432729269632,69998173,1285,357
1,1490,0.33123877917414724,0.7267967634459781,70463771,2228,738
1,99,0.38509316770186336,0.8705882352941177,67551435,161,62
0,1021,0.1391231028667791,0.21539456662354464,70615692,1186,165
1,125,0.31693989071038253,0.6843575418994413,70742133,183,58
0,4,0.2,0.25,82102807,5,1
0,490,0.08921933085501858,0.08208092485549133,68536286,538,48
0,798,0.20675944333996024,0.41647770219198793,68541410,1006,208
1,86,0.3582089552238806,0.759493670886076,69506801,134,48
0,893,0.20196604110813227,0.2951854775059195,74320113,1119,226
1,971,0.2525019245573518,0.6387620497209539,69898262,1299,328
1,17,0.19047619047619047,0.6212121212121212,70246281,21,4
1,318,0.21674876847290642,0.5204460966542751,82036701,406,88
0,1310,0.15483870967741936,0.20308731307284128,63264306,1550,240
1,661,0.31145833333333334,0.7450980392156863,67553206,960,299
0,268,0.17027863777089783,0.19748653500897667,69056470,323,55
0,442,0.057569296375266525,0.2290909090909091,82134962,469,27
2,3,0.7,0.9,64473220,10,7
0,629,0.1935897435897436,0.3206256109481916,70645904,780,151
2,467,0.5099685204616999,0.9489932885906041,73850763,953,486
1,292,0.3652173913043478,0.8489208633093526,69154085,460,168
1,237,0.27076923076923076,0.6148148148148148,69177024,325,88
1,395,0.335016835016835,0.8143053645116919,66470810,594,199
1,176,0.3282442748091603,0.7222222222222222,66470824,262,86
1,777,0.3347602739726027,0.7570175438596491,74091430,1168,391
0,687,0.18890200708382526,0.3349900596421471,70190554,847,160
0,573,0.237017310252996,0.46039035591274396,65365790,751,178
0,667,0.2021531100478469,0.3599290780141844,65367512,836,169
1,346,0.2445414847161572,0.5133136094674556,67940544,458,112
0,711,0.23218142548596113,0.417910447761194,69184416,926,215
1,173,0.36162361623616235,0.8828633405639913,68357702,271,98
1,159,0.37890625,0.8076923076923077,80136473,256,97
0,10,0.23076923076923078,0.23809523809523808,80154128,13,3
1,346,0.3107569721115538,0.7746031746031746,62140750,502,156
0,466,0.2348111658456486,0.4686868686868687,67244653,609,143
1,456,0.2425249169435216,0.5816242821985234,68908161,602,146
0,456,0.2425249169435216,0.4443037974683544,70645232,602,146
0,515,0.1315345699831366,0.17138599105812222,68539856,593,78
1,64,0.2967032967032967,0.5384615384615384,69964671,91,27
1,38,0.4722222222222222,0.9339622641509434,64470672,72,34
1,172,0.34099616858237547,0.7944325481798715,62478241,261,89
1,161,0.28125,0.6428571428571429,63681611,224,63
1,155,0.29545454545454547,0.6828703703703703,68579182,220,65
1,296,0.25252525252525254,0.6531468531468532,80121253,396,100
1,892,0.4267352185089974,0.8901185770750988,69668942,1556,664
1,296,0.2691358024691358,0.6386666666666667,70252840,405,109
0,259,0.16987179487179488,0.4890190336749634,54421521,312,53
0,532,0.14743589743589744,0.35571878279118574,61949034,624,92
1,82,0.18811881188118812,0.6875,63525581,101,19
0,127,0.05223880597014925,0.13029315960912052,65303413,134,7
0,222,0.04721030042918455,0.11801242236024845,65839382,233,11
0,143,0.08333333333333333,0.256797583081571,65839606,156,13
0,211,0.09051724137931035,0.31901840490797545,65839613,232,21
0,223,0.04700854700854701,0.10972568578553615,65839872,234,11
0,146,0.033112582781456956,0.05291005291005291,65840005,151,5
1,186,0.15454545454545454,0.5942350332594235,66738140,220,34
0,170,0.10526315789473684,0.3675799086757991,67796400,190,20
1,47,0.24193548387096775,0.855072463768116,68211290,62,15
1,137,0.19883040935672514,0.6619318181818182,68350744,171,34
1,56,0.2727272727272727,0.8795811518324608,68358633,77,21
1,34,0.34615384615384615,0.7368421052631579,70637861,52,18
1,360,0.3023255813953488,0.7424,70626962,516,156
1,695,0.43218954248366015,0.8705281090289608,80172015,1224,529
0,65,0.08450704225352113,0.2727272727272727,80128182,71,6
1,363,0.3202247191011236,0.6947368421052632,74576796,534,171
1,916,0.3691460055096419,0.8445945945945946,69668781,1452,536
1,389,0.14317180616740088,0.6152073732718893,63632576,454,65
0,831,0.03596287703016241,0.18769043266301036,65132704,862,31
0,2583,0.14555077737347005,0.48749198203976907,67774994,3023,440
0,835,0.09140369967355821,0.10072992700729927,69101466,919,84
2,176,0.5217391304347826,0.8421052631578947,72474122,368,192
0,647,0.21097560975609755,0.46632124352331605,68541193,820,173
2,18,0.5135135135135135,0.9629629629629629,64333864,37,19
2,138,0.5445544554455446,0.959409594095941,63767753,303,165
2,2116,0.5478632478632479,0.9758713136729222,68342071,4680,2564
0,1513,0.1476056338028169,0.19279519679786525,69839581,1775,262
0,407,0.1843687374749499,0.34705882352941175,70760641,499,92
0,1785,0.03669724770642202,0.17597765363128492,63265146,1853,68
0,553,0.036585365853658534,0.20495646349631613,67004700,574,21
1,55,0.45544554455445546,0.7962962962962963,70614292,101,46
0,155,0.15760869565217392,0.21818181818181817,80176722,184,29
0,22,0.18518518518518517,0.4166666666666667,82053033,27,5
0,793,0.11594202898550725,0.09936575052854123,80181304,897,104
0,48,0.12727272727272726,0.22994652406417113,69734000,55,7
0,114,0.10236220472440945,0.23255813953488372,72866633,127,13
2,272,0.5342465753424658,0.9656488549618321,82009342,584,312
1,419,0.4420772303595206,0.90625,82007147,751,332
1,731,0.42486231313926043,0.8982161594963274,79787022,1271,540
1,494,0.2515151515151515,0.5358695652173913,70207340,660,166
0,842,0.10042735042735043,0.32567237163814183,62839966,936,94
1,1820,0.2504118616144975,0.5733961580282712,66409665,2428,608
0,544,0.16307692307692306,0.27899686520376177,63684425,650,106
0,347,0.0987012987012987,0.09951060358890701,75551420,385,38
0,172,0.12690355329949238,0.22279792746113988,80181302,197,25
1,221,0.21352313167259787,0.6582809224318659,68386605,281,60
0,576,0.1111111111111111,0.12857142857142856,67215722,648,72
0,548,0.08207705192629816,0.08612873980054397,67215743,597,49
1,346,0.2606837606837607,0.6651532349602725,70242753,468,122
2,191,0.5115089514066496,0.905982905982906,80089961,391,200
0,211,0.23272727272727273,0.4936708860759494,73734570,275,64
1,407,0.3689922480620155,0.8425287356321839,68785556,645,238
1,125,0.34210526315789475,0.7960339943342776,70760886,190,65
0,139,0.060810810810810814,0.2518518518518518,788151,148,9
0,856,0.04143337066069429,0.11723795330352707,68356505,893,37
0,250,0.027237354085603113,0.11880165289256199,68356834,257,7
1,572,0.3796095444685466,0.7752489331436699,80176775,922,350
1,389,0.3041144901610018,0.6914778856526429,68563481,559,170
1,283,0.2493368700265252,0.5264705882352941,70179410,377,94
1,654,0.3420523138832998,0.8357015985790408,70207200,994,340
1,188,0.3037037037037037,0.70625,69177031,270,82
1,312,0.2827586206896552,0.6630434782608695,69152034,435,123
1,631,0.29497206703910617,0.7220367278797997,80124649,895,264
0,506,0.03802281368821293,0.0473313192346425,63336875,526,20
0,132,0.022222222222222223,0.06069364161849711,63337085,135,3
1,383,0.31607142857142856,0.739524348810872,69176695,560,177
1,150,0.25,0.5849802371541502,70802844,200,50
0,287,0.030405405405405407,0.09569377990430622,70848414,296,9
0,241,0.10408921933085502,0.43353293413173655,80128653,269,28
1,1348,0.2388481084133258,0.5040680473372781,67215330,1771,423
1,664,0.29436769394261425,0.6338694418164617,80107860,941,277
0,794,0.15978835978835979,0.2785630153121319,81979707,945,151
1,399,0.353322528363047,0.7588466579292268,67199342,617,218
1,134,0.3399014778325123,0.6613418530351438,73435250,203,69
1,577,0.3795698924731183,0.8865313653136532,68210856,930,353
1,992,0.2764405543398979,0.6595860566448801,73735424,1371,379
0,1900,0.11627906976744186,0.10669456066945607,70871101,2150,250
0,1089,0.1377672209026128,0.18465227817745802,66359020,1263,174
1,1482,0.31484049930651875,0.759799453053783,80125500,2163,681
1,731,0.16457142857142856,0.5610290093048714,68405575,875,144
1,508,0.1910828025477707,0.5661881977671451,69084484,628,120
0,17,0.15,0.4666666666666667,70474712,20,3
1,1402,0.1679525222551929,0.5168220510741791,70691180,1685,283
1,459,0.29057187017001546,0.6568825910931174,81967283,647,188
1,1073,0.29174917491749175,0.6945156330087134,69607916,1515,442
1,390,0.19421487603305784,0.6134347275031685,72866934,484,94
1,194,0.3333333333333333,0.7367021276595744,82007299,291,97
0,934,0.0914396887159533,0.22535211267605634,69575506,1028,94
1,1060,0.2984778292521509,0.621438263229308,69482203,1511,451
1,315,0.4155844155844156,0.8943577430972389,71497685,539,224
2,508,0.594896331738437,0.9876777251184834,80096002,1254,746
1,10,0.375,0.9310344827586207,70181146,16,6
1,466,0.37783711615487314,0.8110169491525424,62687394,749,283
1,27,0.2702702702702703,0.6693548387096774,70693140,37,10
0,1359,0.08669354838709678,0.2117090479006505,69625682,1488,129
1,14,0.391304347826087,0.6923076923076923,69577585,23,9
1,63,0.475,0.8858695652173914,69162653,120,57
0,498,0.2302936630602782,0.49282296650717705,67726841,647,149
1,75,0.23469387755102042,0.564625850340136,72758763,98,23
2,205,0.6507666098807495,0.759493670886076,57193696,587,382
1,611,0.33659066232356133,0.7540983606557377,80140047,921,310
1,1498,0.3315484158857653,0.6248715313463515,69220473,2241,743
2,29,0.7128712871287128,0.8709677419354839,68171901,101,72
0,2375,0.06015037593984962,0.033117932148626815,68018216,2527,152
1,612,0.3677685950413223,0.8634453781512605,69073641,968,356
1,33,0.4,0.855072463768116,70002114,55,22
2,79,0.6069651741293532,0.9534883720930233,69954010,201,122
1,220,0.22535211267605634,0.6225490196078431,68709970,284,64
2,0,1.0,1.0,70493024,1,1
0,470,0.13443830570902393,0.22139830508474576,54609821,543,73
0,981,0.20823244552058112,0.3957250144425188,68534802,1239,258
0,847,0.22293577981651377,0.4280155642023346,80127900,1090,243
1,329,0.32581967213114754,0.7254901960784313,66906952,488,159
0,40,0.09090909090909091,0.15441176470588236,64982330,44,4
1,1056,0.415929203539823,0.8953866146848602,66633770,1808,752
0,2830,0.2359611231101512,0.4936772888214466,71777153,3704,874
1,42,0.3,0.5888888888888889,80124704,60,18
1,927,0.29772727272727273,0.7306610407876231,80121186,1320,393
1,1243,0.3008998875140607,0.7067159581022797,67557035,1778,535
1,450,0.4880546075085324,0.9515151515151515,774235,879,429
1,91,0.3208955223880597,0.8235294117647058,67435921,134,43
2,101,0.5,0.9411764705882353,66842566,202,101
1,396,0.28,0.6196078431372549,69176562,550,154
1,150,0.2537313432835821,0.5840909090909091,80168514,201,51
1,596,0.3612004287245445,0.8227665706051873,80180343,933,337
0,498,0.18360655737704917,0.32603092783505155,74326371,610,112
1,130,0.23529411764705882,0.5313531353135313,70633584,170,40
2,321,0.58203125,0.9844357976653697,68040196,768,447
1,1077,0.48616412213740456,0.9229559748427673,80118369,2096,1019
0,200,0.12663755458515283,0.49189985272459497,62850340,229,29
0,900,0.1270611057225994,0.14570552147239263,68533962,1031,131
0,638,0.2103960396039604,0.41382575757575757,67804051,808,170
1,293,0.23697916666666666,0.5333333333333333,69622196,384,91
0,202,0.17551020408163265,0.20588235294117646,70525336,245,43
0,297,0.12130177514792899,0.1950509461426492,69159902,338,41
0,157,0.08187134502923976,0.10849056603773585,72900632,171,14
0,250,0.09420289855072464,0.15337423312883436,72900646,276,26
0,789,0.1597444089456869,0.20617816091954022,70645925,939,150
1,84,0.373134328358209,0.8549222797927462,66856230,134,50
1,500,0.2753623188405797,0.601025641025641,69607160,690,190
1,868,0.38,0.8509234828496042,70627242,1400,532
0,1258,0.07227138643067847,0.06313364055299539,80114405,1356,98
0,1524,0.07859733978234583,0.08156329651656755,80118146,1654,130
1,531,0.24787535410764872,0.5927750410509032,81979703,706,175
0,1357,0.1745742092457421,0.3067484662576687,69240073,1644,287
1,419,0.3349206349206349,0.8274285714285714,68531134,630,211
1,408,0.23452157598499063,0.58274231678487,67160562,533,125
1,731,0.22481442205726404,0.5482071713147411,68534291,943,212
1,535,0.22351233671988388,0.5277777777777778,68534305,689,154
1,88,0.4358974358974359,0.9620853080568721,66856706,156,68
0,443,0.21453900709219859,0.41818181818181815,70527485,564,121
0,1004,0.21254901960784314,0.4175824175824176,66622542,1275,271
0,50,0.09090909090909091,0.27972027972027974,67793362,55,5
0,327,0.2323943661971831,0.4847161572052402,68533465,426,99
1,927,0.33832976445396146,0.8185579196217494,68535992,1401,474
0,687,0.21305841924398625,0.4721337579617834,68542481,873,186
0,111,0.22377622377622378,0.43564356435643564,66055101,143,32
1,1421,0.2591240875912409,0.6032289628180039,80110520,1918,497
1,458,0.3700137551581843,0.8026796589524969,74046616,727,269
0,903,0.09519038076152304,0.09155429382540808,68539863,998,95
1,633,0.334384858044164,0.7619408642911296,69166615,951,318
1,140,0.29292929292929293,0.7598684210526315,80135832,198,58
1,1264,0.29464285714285715,0.6453143534994069,80107363,1792,528
1,675,0.2407199100112486,0.5903829029385574,68541676,889,214
1,1183,0.2464968152866242,0.5182211241507103,67597964,1570,387
2,177,0.5461538461538461,0.9829059829059829,69868141,390,213
0,513,0.2191780821917808,0.47652347652347654,66931732,657,144
0,296,0.1518624641833811,0.25034770514603616,68538540,349,53
1,221,0.4090909090909091,0.8734177215189873,80180352,374,153
1,692,0.4538279400157853,0.9260355029585798,68185460,1267,575
2,193,0.5210918114143921,0.9224806201550387,67753672,403,210
0,681,0.1664626682986536,0.28869047619047616,70604912,817,136
1,376,0.42857142857142855,0.8598265895953757,69168575,658,282
0,321,0.05865102639296188,0.057534246575342465,67333784,341,20
0,428,0.07956989247311828,0.08393782383419689,74667432,465,37
0,37,0.0,0.0,69508992,37,0
0,289,0.15743440233236153,0.30993377483443707,80098515,343,54
0,742,0.12808460634547592,0.19657534246575342,70641550,851,109
0,629,0.10014306151645208,0.14703675918979744,70641781,699,70
1,560,0.27741935483870966,0.5881753312945973,80107594,775,215
1,67,0.4322033898305085,0.9401197604790419,65277674,118,51
1,131,0.33163265306122447,0.7387387387387387,82041253,196,65
1,343,0.2623655913978495,0.5166858457997698,67842110,465,122
0,532,0.15955766192733017,0.25870646766169153,68791226,633,101
1,236,0.26479750778816197,0.5148809523809523,69176604,321,85
1,31,0.3541666666666667,0.631578947368421,75550944,48,17
0,350,0.22566371681415928,0.49777777777777776,69536355,452,102
1,318,0.3776908023483366,0.7659137577002053,70324863,511,193
2,38,0.5365853658536586,0.8985507246376812,79005290,82,44
1,241,0.382051282051282,0.7864583333333334,82047589,390,149
1,744,0.3142857142857143,0.5937122128174124,72426354,1085,341
0,1315,0.03379867744305658,0.015822784810126583,62409130,1361,46
1,1131,0.25592105263157894,0.5208,62409326,1520,389
0,676,0.21395348837209302,0.44508255563531945,62687366,860,184
0,972,0.09916589434661724,0.11848341232227488,67478733,1079,107
0,66,0.15384615384615385,0.27403846153846156,68497233,78,12
0,552,0.17979197622585438,0.3687315634218289,68534200,673,121
0,381,0.20625,0.46875,68534221,480,99
0,617,0.18708827404479578,0.37206178643384824,80116582,759,142
1,97,0.27611940298507465,0.6383763837638377,65312716,134,37
2,111,0.5795454545454546,0.9839357429718876,69056463,264,153
1,155,0.23267326732673269,0.5607476635514018,80156771,202,47
1,192,0.24110671936758893,0.5784499054820416,81980450,253,61
1,136,0.2765957446808511,0.6,68763590,188,52
1,65,0.4715447154471545,0.9012345679012346,67080055,123,58
0,10,0.16666666666666666,0.2413793103448276,69498961,12,2
2,8,0.5555555555555556,0.9555555555555556,69007904,18,10
0,448,0.1971326164874552,0.32641921397379914,67552044,558,110
1,11,0.15384615384615385,0.5172413793103449,141631,13,2
0,1046,0.0840630472854641,0.177007299270073,66226972,1142,96
0,690,0.14814814814814814,0.29633300297324083,66227014,810,120
0,729,0.06896551724137931,0.1681614349775785,67569173,783,54
1,86,0.4342105263157895,0.8884615384615384,68519913,152,66
1,210,0.24731182795698925,0.528957528957529,69469092,279,69
0,158,0.14594594594594595,0.46236559139784944,69482903,185,27
1,15,0.21052631578947367,0.6144578313253012,70238742,19,4
2,35,0.5512820512820513,0.9836065573770492,70509432,78,43
1,11,0.26666666666666666,0.7903225806451613,70581903,15,4
0,87,0.13861386138613863,0.4743083003952569,70582043,101,14
2,2,0.6,0.8,80118184,5,3
0,1,0.0,0.0,70702723,1,0
0,3,0.0,0.0,70702926,3,0
0,15,0.16666666666666666,0.4727272727272727,80126802,18,3
2,18,0.5,0.9322033898305084,82002223,36,18
0,306,0.0755287009063444,0.3166023166023166,80049585,331,25
1,19,0.3448275862068966,0.8648648648648649,70693315,29,10
0,4,0.0,0.0,70702751,4,0
1,4,0.42857142857142855,0.9090909090909091,70704340,7,3
0,58,0.15942028985507245,0.4682926829268293,72773225,69,11
0,255,0.05204460966542751,0.1527777777777778,70600621,269,14
2,258,0.6618610747051114,0.7823529411764706,65940210,763,505
0,1175,0.14233576642335766,0.43013578624616733,62743996,1370,195
0,355,0.18949771689497716,0.41162514827995256,77676774,438,83
0,2332,0.17568045245669847,0.271889400921659,63099295,2829,497
1,453,0.33771929824561403,0.8027366020524516,70641620,684,231
1,462,0.43243243243243246,0.7996389891696751,72426452,814,352
1,405,0.3029259896729776,0.7818181818181819,70626752,581,176
1,336,0.3812154696132597,0.8035190615835777,70892024,543,207
1,1649,0.25653742110009015,0.5454073689673067,81989970,2218,569
0,239,0.1371841155234657,0.3620253164556962,69965175,277,38
0,813,0.08754208754208755,0.04668470906630582,67963406,891,78
1,12,0.45454545454545453,0.9,70720923,22,10
2,71,0.6203208556149733,0.9797979797979798,73372922,187,116
1,410,0.44966442953020136,0.9323017408123792,69073634,745,335
0,170,0.21658986175115208,0.3415730337078652,68671792,217,47
1,420,0.27586206896551724,0.6209068010075567,80118959,580,160
1,61,0.42452830188679247,0.9090909090909091,66272052,106,45
1,294,0.2898550724637681,0.5377358490566038,66272171,414,120
1,214,0.37058823529411766,0.8197802197802198,67149040,340,126
0,284,0.08681672025723473,0.31597845601436264,61704146,311,27
0,751,0.17381738173817382,0.34101382488479265,81979982,909,158
1,920,0.4778660612939841,0.9349112426035503,80127855,1762,842
0,129,0.03731343283582089,0.1003584229390681,63336903,134,5
1,186,0.32116788321167883,0.7436893203883496,67252871,274,88
0,564,0.2111888111888112,0.4487767584097859,73266382,715,151
1,194,0.4121212121212121,0.8306636155606407,67411862,330,136
0,418,0.1803921568627451,0.375366568914956,69240115,510,92
1,538,0.21688500727802038,0.5078260869565218,69240150,687,149
1,830,0.27510917030567683,0.6339285714285714,70597744,1145,315
0,525,0.1732283464566929,0.22148394241417496,70609182,635,110
1,245,0.307909604519774,0.7774390243902439,80121134,354,109
1,166,0.4557377049180328,0.9078651685393259,69531525,305,139
2,74,0.7533333333333333,0.9875776397515528,70567826,300,226
0,718,0.20222222222222222,0.44783715012722647,68541116,900,182
0,2,0.0,0.0,80161518,2,0
1,561,0.30996309963099633,0.725925925925926,68531442,813,252
0,438,0.21364452423698385,0.3784246575342466,70644910,557,119
1,295,0.33856502242152464,0.7916666666666666,82113162,446,151
1,196,0.25475285171102663,0.5803108808290155,70760774,263,67
0,242,0.21428571428571427,0.49390243902439024,70760781,308,66
0,676,0.17560975609756097,0.385070214338507,64231804,820,144
1,566,0.3972310969116081,0.8873239436619719,80121237,939,373
0,66,0.2235294117647059,0.39473684210526316,69138671,85,19
1,71,0.3364485981308411,0.7903225806451613,80079762,107,36
1,86,0.3333333333333333,0.8059701492537313,80135431,129,43
1,810,0.2682926829268293,0.5565891472868217,70658224,1107,297
1,602,0.28672985781990523,0.7329842931937173,80121121,844,242
0,238,0.21710526315789475,0.45288753799392095,81979803,304,66
1,364,0.33088235294117646,0.772020725388601,69177514,544,180
1,107,0.2866666666666667,0.6698564593301436,67557273,150,43
1,38,0.2692307692307692,0.5865384615384616,67557392,52,14
1,51,0.25,0.5660377358490566,73668553,68,17
0,42,0.14285714285714285,0.366412213740458,69216042,49,7
0,1138,0.04769874476987448,0.15515695067264573,62836172,1195,57
1,301,0.37938144329896906,0.8786610878661087,69180321,485,184
1,423,0.2973421926910299,0.5850439882697948,80162920,602,179
1,27,0.4375,0.9294117647058824,62795530,48,21
0,49,0.18333333333333332,0.33519553072625696,70197463,60,11
1,232,0.26582278481012656,0.7182741116751269,68533633,316,84
0,384,0.10697674418604651,0.1859185918591859,70349111,430,46
0,269,0.18731117824773413,0.27765237020316025,74549153,331,62
1,400,0.35379644588045234,0.7444005270092227,70628796,619,219
1,133,0.3282828282828283,0.8006756756756757,80137370,198,65
0,1659,0.18516699410609036,0.34637561779242176,80119296,2036,377
1,637,0.30306345733041573,0.6390532544378699,81966309,914,277
1,69,0.25806451612903225,0.6222222222222222,70761110,93,24
0,51,0.203125,0.23853211009174313,70646653,64,13
2,211,0.5093023255813953,0.9737302977232924,67924976,430,219
1,357,0.3187022900763359,0.7351828499369483,66857021,524,167
0,485,0.05642023346303502,0.02295552367288379,79788184,514,29
1,733,0.38195615514333897,0.9002557544757033,69031123,1186,453
1,65,0.30851063829787234,0.7358490566037735,70601391,94,29
1,310,0.2757009345794392,0.6406685236768802,67598496,428,118
1,44,0.4430379746835443,0.9157894736842105,80066350,79,35
1,343,0.37749546279491836,0.8301886792452831,67766706,551,208
1,1315,0.4678267907729664,0.91125,80124977,2471,1156
0,547,0.16615853658536586,0.32616753150481836,81979733,656,109
0,457,0.1311787072243346,0.22929936305732485,69534500,526,69
1,105,0.3181818181818182,0.6761904761904762,964453,154,49
1,64,0.3333333333333333,0.746031746031746,60641742,96,32
1,183,0.47413793103448276,0.8955223880597015,80127281,348,165
1,725,0.2579324462640737,0.5833333333333334,66931200,977,252
0,259,0.03717472118959108,0.05555555555555555,82138811,269,10
0,1454,0.19311875693673697,0.4422487223168654,70330554,1802,348
0,1274,0.16459016393442624,0.2373560340510766,63264320,1525,251
1,1113,0.2156448202959831,0.6096153846153847,70173614,1419,306
1,23,0.3783783783783784,0.7058823529411765,79251900,37,14
1,703,0.3514760147601476,0.721881390593047,68401340,1084,381
1,159,0.3614457831325301,0.7341269841269841,68401424,249,90
0,39,0.3275862068965517,0.4868421052631579,68400976,58,19
1,464,0.36,0.7288135593220338,68401480,725,261
0,1059,0.12334437086092716,0.2293859649122807,66058783,1208,149
1,516,0.2833333333333333,0.7286432160804021,68540052,720,204
1,279,0.29545454545454547,0.7430406852248393,68533675,396,117
0,501,0.009881422924901186,0.008403361344537815,63336931,506,5
0,496,0.17333333333333334,0.357429718875502,70617071,600,104
1,858,0.3228097868981847,0.6988255033557047,66190740,1267,409
1,674,0.2993762993762994,0.6836653386454183,66857644,962,288
0,681,0.21724137931034482,0.3890625,66857665,870,189
0,231,0.17204301075268819,0.26103646833013433,69183366,279,48
0,604,0.24120603015075376,0.49318364073777066,69183702,796,192
0,60,0.1891891891891892,0.26380368098159507,70005922,74,14
1,105,0.2553191489361702,0.5352564102564102,65308243,141,36
0,546,0.25205479452054796,0.439873417721519,80119200,730,184
1,676,0.3059548254620123,0.7025151777970512,80125380,974,298
1,378,0.3274021352313167,0.7858032378580324,67304125,562,184
2,25,0.6666666666666666,0.98,78358483,75,50
1,389,0.28884826325411334,0.5526315789473685,67662462,547,158
1,320,0.3939393939393939,0.8509142053445851,73435243,528,208
1,612,0.28337236533957844,0.6427444794952681,69574330,854,242
1,176,0.2845528455284553,0.6192893401015228,65264850,246,70
0,723,0.09170854271356783,0.15338645418326693,82028899,796,73
2,297,0.5625920471281296,0.9749058971141782,80126322,679,382
1,452,0.2733118971061093,0.6156626506024097,67940523,622,170
1,690,0.2759706190975866,0.6663879598662207,67942672,953,263
1,59,0.2804878048780488,0.7389162561576355,70121191,82,23
2,8,0.5555555555555556,0.9523809523809523,75338333,18,10
1,629,0.3214670981661273,0.6826741996233522,70713111,927,298
1,763,0.3699421965317919,0.7541118421052632,70713125,1211,448
1,585,0.3592552026286966,0.8263829787234043,63468125,913,328
0,1888,0.17192982456140352,0.2325983571119758,70601475,2280,392
0,767,0.20435684647302904,0.426344505066251,70642950,964,197
1,64,0.42857142857142855,0.891156462585034,66271933,112,48
1,196,0.3310580204778157,0.627177700348432,72077866,293,97
1,284,0.30900243309002434,0.707635009310987,77485520,411,127
0,979,0.21302250803858522,0.48659217877094973,66765335,1244,265
1,405,0.2857142857142857,0.6933333333333334,80125374,567,162
0,1345,0.03445800430725054,0.04592186429061001,80124391,1393,48
2,95,0.5581395348837209,0.9880239520958084,81971172,215,120
1,550,0.40668824163969797,0.8367593712212817,69990165,927,377
0,503,0.2343987823439878,0.4302788844621514,80019660,657,154
1,239,0.37270341207349084,0.83984375,70179753,381,142
0,417,0.25,0.4861788617886179,66964310,556,139
0,429,0.09873949579831932,0.16586921850079744,67747281,476,47
2,39,0.5517241379310345,0.7777777777777778,70660940,87,48
1,148,0.45985401459854014,0.7660818713450293,70906535,274,126
1,53,0.4803921568627451,0.9395973154362416,80125953,102,49
1,60,0.4690265486725664,0.9312169312169312,80125546,113,53
1,435,0.3829787234042553,0.7450980392156863,80131104,705,270
0,654,0.12096774193548387,0.16857142857142857,79471280,744,90
2,0,1.0,1.0,70494025,1,1
0,106,0.12396694214876033,0.26,68754665,121,15
0,25,0.07407407407407407,0.18032786885245902,70568211,27,2
0,47,0.020833333333333332,0.03333333333333333,70568414,48,1
1,585,0.46866485013623976,0.8568935427574171,69708562,1101,516
2,282,0.7424657534246575,0.952755905511811,66181353,1095,813
1,79,0.2882882882882883,0.6936936936936937,60546150,111,32
0,103,0.2426470588235294,0.49122807017543857,63831726,136,33
0,213,0.06986899563318777,0.1276595744680851,63141862,229,16
0,72,0.15294117647058825,0.3352272727272727,63141995,85,13
1,351,0.3776595744680851,0.8356401384083045,64158934,564,213
0,722,0.17861205915813425,0.31909028256374916,63279125,879,157
1,201,0.32094594594594594,0.7799145299145299,80133428,296,95
1,209,0.3888888888888889,0.8569078947368421,80117926,342,133
1,132,0.2864864864864865,0.6750788643533123,69165985,185,53
1,408,0.48936170212765956,0.9285714285714286,80137022,799,391
0,922,0.13751169317118803,0.1855595667870036,70614670,1069,147
1,492,0.28592162554426703,0.7125803489439853,70642523,689,197
0,954,0.11584800741427248,0.125,68536195,1079,125
1,48,0.3924050632911392,0.75,70612311,79,31
2,159,0.647450110864745,0.9836065573770492,68449850,451,292
0,381,0.1514476614699332,0.33910533910533913,75283460,449,68
1,100,0.35064935064935066,0.8009259259259259,70711130,154,54
1,220,0.25675675675675674,0.5578446909667195,72135371,296,76
1,497,0.42609699769053117,0.9265010351966874,67558071,866,369
1,191,0.32269503546099293,0.7577464788732394,64361864,282,91
1,207,0.32131147540983607,0.7351247600767754,69607391,305,98
1,212,0.43315508021390375,0.9090909090909091,65008384,374,162
1,465,0.2745709828393136,0.650984682713348,68545141,641,176
1,405,0.2314990512333966,0.5594771241830065,68537441,527,122
0,700,0.15458937198067632,0.22771474878444084,68542110,828,128
1,322,0.3192389006342495,0.7337662337662337,80180125,473,151
0,251,0.2347560975609756,0.4082687338501292,80126987,328,77
1,868,0.3338449731389102,0.828752642706131,80103044,1303,435
0,524,0.22485207100591717,0.4498539435248296,69027805,676,152
1,622,0.22443890274314215,0.5215686274509804,68540045,802,180
2,575,0.5089666951323655,0.9341199606686332,72657592,1171,596
1,174,0.28688524590163933,0.5567567567567567,82005361,244,70
1,626,0.28944381384790013,0.6766101694915254,68763520,881,255
1,188,0.45507246376811594,0.9166666666666666,67154416,345,157
0,456,0.15555555555555556,0.1890380313199105,69637106,540,84
1,310,0.2688679245283019,0.6083213773314203,70234780,424,114
1,502,0.3403416557161629,0.7922932330827067,81967271,761,259
0,243,0.09328358208955224,0.06237424547283702,66015530,268,25
0,9,0.1,0.3157894736842105,69416004,10,1
0,136,0.08108108108108109,0.16085790884718498,69417131,148,12
0,1136,0.145221971407073,0.22706935123042504,68542901,1329,193
0,376,0.08737864077669903,0.10930576070901034,68743381,412,36
1,124,0.4439461883408072,0.9322033898305084,80150462,223,99
1,87,0.3695652173913043,0.9045643153526971,62795222,138,51
1,241,0.42755344418052255,0.8949096880131363,67519354,421,180
2,19,0.5681818181818182,0.9428571428571428,80127018,44,25
1,804,0.3151618398637138,0.7342838626053143,70613473,1174,370
1,488,0.24691358024691357,0.5510670731707317,80160714,648,160
2,5,0.8076923076923077,0.9090909090909091,80175949,26,21
0,268,0.20238095238095238,0.37083993660855785,73668840,336,68
1,1120,0.3004372267332917,0.7304667016255899,80124641,1601,481
1,20,0.3548387096774194,0.6363636363636364,62510035,31,11
1,381,0.37846655791190864,0.8095676172953082,70909496,613,232
1,585,0.25096030729833546,0.5725118483412323,68545134,781,196
0,569,0.15703703703703703,0.23617511520737328,63720433,675,106
0,870,0.0625,0.05118694362017804,63720461,928,58
1,194,0.328719723183391,0.7469135802469136,70760900,289,95
0,429,0.19813084112149532,0.41140776699029125,66932040,535,106
1,484,0.2496124031007752,0.5757162346521146,65299752,645,161
0,1020,0.0718835304822566,0.04307116104868914,68539016,1099,79
0,356,0.01928374655647383,0.03368794326241135,68356344,363,7
0,183,0.25,0.4613935969868173,70676956,244,61
1,867,0.365764447695684,0.8149659863945579,80180306,1367,500
0,539,0.20618556701030927,0.452970297029703,68540696,679,140
1,576,0.25,0.6382978723404256,68541550,768,192
1,217,0.3463855421686747,0.7860262008733624,74372914,332,115
0,388,0.20816326530612245,0.43966547192353644,67324341,490,102
2,0,1.0,1.0,74320736,2,2
0,968,0.0674373795761079,0.060503059143439834,68743430,1038,70
2,111,0.5842696629213483,0.9411764705882353,80137023,267,156
0,133,0.15822784810126583,0.3062200956937799,80172877,158,25
1,158,0.20603015075376885,0.5034013605442177,70185325,199,41
0,158,0.1595744680851064,0.31521739130434784,70078190,188,30
0,279,0.18181818181818182,0.42730496453900707,70849506,341,62
1,371,0.4630969609261939,0.915129151291513,60315514,691,320
0,131,0.022388059701492536,0.08433734939759036,80049375,134,3
0,125,0.0,0.0,80049410,125,0
0,45,0.021739130434782608,0.08333333333333333,80049445,46,1
0,68,0.08108108108108109,0.42857142857142855,80049550,74,6
2,0,1.0,1.0,80132348,37,37
1,39,0.2777777777777778,0.5113636363636364,80180218,54,15
1,1198,0.25404732254047324,0.5092783505154639,67555222,1606,408
1,20,0.3103448275862069,0.7241379310344828,64166564,29,9
0,682,0.14321608040201006,0.160828025477707,67554284,796,114
0,334,0.165,0.4979508196721312,73194870,400,66
0,2095,0.12379757423672104,0.1660839160839161,80121141,2391,296
1,668,0.3084886128364389,0.6890681003584229,61365626,966,298
0,493,0.12588652482269502,0.17069701280227595,70645680,564,71
0,117,0.07874015748031496,0.07027027027027027,70748433,127,10
1,149,0.22395833333333334,0.5,68540136,192,43
1,1078,0.29357798165137616,0.6390658174097664,67552632,1526,448
1,1629,0.311787072243346,0.7165948275862069,62015842,2367,738
1,79,0.2882882882882883,0.65,68688011,111,32
1,134,0.25139664804469275,0.6465753424657534,70047586,179,45
1,100,0.4897959183673469,0.9230769230769231,64007972,196,96
1,557,0.2949367088607595,0.7127222982216143,69157214,790,233
1,1121,0.2868956743002545,0.6526128266033254,80109232,1572,451
1,843,0.24054054054054055,0.5124835742444153,80109491,1110,267
0,587,0.12257100149476831,0.12987012987012986,68421843,669,82
1,104,0.2777777777777778,0.6418439716312057,69176996,144,40
1,61,0.35789473684210527,0.8650793650793651,66423091,95,34
0,839,0.14994934143870314,0.2590412111017662,80121097,987,148
1,610,0.28487690504103164,0.7159904534606205,68540752,853,243
1,137,0.35377358490566035,0.8062015503875969,66411954,212,75
1,100,0.4897959183673469,0.9512195121951219,57209530,196,96
1,459,0.32894736842105265,0.785350966429298,68763975,684,225
0,605,0.22236503856041132,0.4469178082191781,68535124,778,173
0,725,0.16857798165137614,0.4646133682830931,68775280,872,147
1,256,0.22188449848024316,0.5480427046263345,80119348,329,73
0,306,0.13802816901408452,0.3247549019607843,80089576,355,49
1,198,0.3028169014084507,0.6771844660194175,13932891,284,86
0,354,0.2062780269058296,0.39827586206896554,67140206,446,92
0,397,0.1038374717832957,0.1536113936927772,73255091,443,46
1,608,0.2549019607843137,0.5094816687737042,69707155,816,208
1,1009,0.2843971631205674,0.6509758897818599,80130308,1410,401
2,23,0.5,0.94,80178113,46,23
1,420,0.4690265486725664,0.944233206590621,69072850,791,371
1,69,0.3893805309734513,0.8883720930232558,66856314,113,44
1,1085,0.29954809554551326,0.7167832167832168,80120441,1549,464
0,1288,0.05641025641025641,0.023557692307692307,68538911,1365,77
0,135,0.19161676646706588,0.41139240506329117,69501054,167,32
1,226,0.38082191780821917,0.8847826086956522,65330573,365,139
0,111,0.21830985915492956,0.3020833333333333,80145289,142,31
0,2169,0.1891588785046729,0.3144758735440932,74320176,2675,506
1,157,0.49517684887459806,0.9496644295302014,63129150,311,154
0,858,0.21212121212121213,0.4321608040201005,68535761,1089,231
0,377,0.19444444444444445,0.22023809523809523,62407870,468,91
0,241,0.10408921933085502,0.22950819672131148,300370,269,28
0,206,0.09649122807017543,0.2182741116751269,300412,228,22
1,128,0.16883116883116883,0.6170212765957447,61297096,154,26
0,308,0.04938271604938271,0.04778156996587031,63771183,324,16
1,160,0.2920353982300885,0.7765567765567766,66345713,226,66
0,706,0.10745891276864729,0.2789598108747045,66344362,791,85
1,274,0.4637964774951076,0.9508771929824561,67686150,511,237
1,955,0.30444282592862343,0.733125,68532065,1373,418
0,78,0.23529411764705882,0.494949494949495,80132272,102,24
1,40,0.4444444444444444,0.9306930693069307,66411940,72,32
1,294,0.36637931034482757,0.8599670510708401,70632100,464,170
1,633,0.40730337078651685,0.9195305951383068,68531981,1068,435
0,1004,0.09549549549549549,0.10326721120186698,80119350,1110,106
1,291,0.2885085574572127,0.6303142329020333,82126740,409,118
1,187,0.37666666666666665,0.9012875536480687,69180580,300,113
1,191,0.3778501628664495,0.7868020304568528,74649694,307,116
1,403,0.3643533123028391,0.7727272727272727,80127523,634,231
1,45,0.4,0.9259259259259259,66856076,75,30
0,35,0.125,0.2903225806451613,70568246,40,5
0,200,0.15254237288135594,0.36363636363636365,70568253,236,36
0,82,0.046511627906976744,0.18452380952380953,67620623,86,4
0,62,0.1506849315068493,0.4205128205128205,67620644,73,11
0,194,0.02512562814070352,0.1749271137026239,67620686,199,5
0,110,0.017857142857142856,0.11510791366906475,67620721,112,2
0,102,0.04672897196261682,0.17727272727272728,67620784,107,5
0,120,0.024390243902439025,0.12363636363636364,67620903,123,3
2,80,0.574468085106383,0.97,69469036,188,108
0,723,0.25463917525773194,0.4144736842105263,69489294,970,247
0,683,0.26082251082251084,0.4586046511627907,80131115,924,241
1,702,0.376,0.8022864828513786,80135362,1125,423
1,79,0.41911764705882354,0.8468468468468469,69167532,136,57
1,97,0.46408839779005523,0.9379310344827586,81971174,181,84
0,88,0.022222222222222223,0.1641025641025641,82021918,90,2
0,341,0.042134831460674156,0.14171656686626746,82021919,356,15
2,67,0.75,0.9305555555555556,80056585,268,201
2,12,0.7692307692307693,0.9166666666666666,61696516,52,40
2,1,0.8571428571428571,0.0,69598270,7,6
1,223,0.38904109589041097,0.8651685393258427,67995165,365,142
0,1410,0.18685121107266436,0.3753076292042658,70524531,1734,324
0,757,0.18162162162162163,0.34287709497206703,80114181,925,168
0,895,0.20089285714285715,0.3968253968253968,66930976,1120,225
2,39,0.5465116279069767,0.8888888888888888,80125807,86,47
1,95,0.26356589147286824,0.5898305084745763,72135336,129,34
1,770,0.29097605893186,0.6927631578947369,67305630,1086,316
2,36,0.5135135135135135,0.9333333333333333,80161909,74,38
0,542,0.20644216691068815,0.3908355795148248,69110573,683,141
1,238,0.38341968911917096,0.8568935427574171,69176653,386,148
1,386,0.32869565217391306,0.7153846153846154,67995284,575,189
0,102,0.22727272727272727,0.3771186440677966,69607342,132,30
1,456,0.3372093023255814,0.8187311178247734,82038330,688,232
0,266,0.04316546762589928,0.07622504537205081,67836860,278,12
0,11,0.08333333333333333,0.20930232558139536,70199696,12,1
0,30,0.03225806451612903,0.11764705882352941,70199724,31,1
0,40,0.09090909090909091,0.36538461538461536,80128803,44,4
0,132,0.2235294117647059,0.3994082840236686,80118948,170,38
0,553,0.2088698140200286,0.4413793103448276,81988936,699,146
1,776,0.39798293250581845,0.9009695290858726,69091603,1289,513
1,596,0.2651048088779285,0.6285495011511896,68235972,811,215
1,81,0.31932773109243695,0.8393782383419689,69621405,119,38
0,851,0.14127144298688193,0.13293310463121785,68112513,991,140
1,509,0.2738944365192582,0.661522633744856,80121092,701,192
0,356,0.22943722943722944,0.4498346196251378,73669071,462,106
1,46,0.3698630136986301,0.803921568627451,80134793,73,27
0,94,0.04081632653061224,0.22839506172839505,68356540,98,4
2,21,0.5227272727272727,0.9814814814814815,67485866,44,23
0,705,0.2227122381477398,0.46718480138169255,70642992,907,202
0,789,0.20303030303030303,0.36557282671272306,71358721,990,201
0,95,0.020618556701030927,0.014925373134328358,69703130,97,2
0,1378,0.11610006414368185,0.1483739837398374,70615251,1559,181
0,1062,0.05008944543828265,0.0869281045751634,70001106,1118,56
1,376,0.2945590994371482,0.66524064171123,68763884,533,157
1,709,0.32540437678401524,0.7321711568938193,71797530,1051,342
0,242,0.07279693486590039,0.10371517027863777,66058804,261,19
0,4568,0.07884654164145997,0.15143160127253447,69575156,4959,391
0,1108,0.08806584362139917,0.06905537459283388,66471363,1215,107
0,1027,0.17905675459632295,0.2785817655571635,67556895,1251,224
1,436,0.31338582677165355,0.7417218543046358,61565693,635,199
1,281,0.23013698630136986,0.5692307692307692,68709984,365,84
1,241,0.37402597402597404,0.8668478260869565,64237915,385,144
1,157,0.4766666666666667,0.9553072625698324,65353820,300,143
1,622,0.26823529411764707,0.614406779661017,68229441,850,228
0,629,0.17454068241469817,0.3137074517019319,82011412,762,133
1,531,0.252112676056338,0.5187793427230047,82134992,710,179
1,330,0.2948717948717949,0.7275449101796407,80121235,468,138
1,59,0.3854166666666667,0.8711656441717791,67554081,96,37
0,153,0.2153846153846154,0.3920863309352518,70645561,195,42
1,806,0.21057786483839372,0.5689238210399032,69575233,1021,215
2,215,0.532608695652174,0.819327731092437,72843603,460,245
1,6,0.3333333333333333,0.7142857142857143,82129400,9,3
0,160,0.19597989949748743,0.29873417721518986,82128657,199,39
0,893,0.16542056074766356,0.3583389149363697,80116715,1070,177
0,713,0.06060606060606061,0.10186915887850467,80124237,759,46
0,213,0.10126582278481013,0.14555256064690028,70748230,237,24
0,147,0.17415730337078653,0.3229166666666667,68563523,178,31
1,206,0.3087248322147651,0.7184466019417476,69183275,298,92
0,1268,0.15803452855245684,0.28013439731205375,72899792,1506,238
1,1104,0.3651523864289822,0.8286045165026057,69176926,1739,635
1,274,0.43621399176954734,0.8585858585858586,62472543,486,212
1,473,0.2778625954198473,0.6923076923076923,65791586,655,182
2,20,0.6153846153846154,0.9555555555555556,80152795,52,32
1,186,0.3404255319148936,0.7572383073496659,81967336,282,96
0,222,0.19272727272727272,0.3179650238473768,80118971,275,53
0,462,0.16152450090744103,0.25554484088717455,80119005,551,89
1,285,0.3262411347517731,0.7507788161993769,80128542,423,138
0,431,0.15490196078431373,0.27906976744186046,70615272,510,79
1,291,0.4947916666666667,0.9319938176197836,72321942,576,285
1,95,0.3581081081081081,0.6751592356687898,69530580,148,53
2,70,0.6744186046511628,0.9699248120300752,69069140,215,145
1,41,0.44594594594594594,0.8440366972477065,73871014,74,33
1,178,0.47337278106508873,0.9173228346456693,80062192,338,160
2,32,0.5076923076923077,0.9833333333333333,64195964,65,33
1,250,0.40476190476190477,0.9033232628398792,80120451,420,170
1,493,0.38985148514851486,0.8935226264418811,80125346,808,315
0,638,0.07936507936507936,0.07783018867924528,72900345,693,55
0,832,0.16381909547738693,0.29068396226415094,82011774,995,163
1,308,0.31403118040089084,0.7248908296943232,69180643,449,141
0,480,0.2,0.4008849557522124,74849796,600,120
0,443,0.08091286307053942,0.096,80176492,482,39
1,1059,0.2526464361326747,0.5455764075067024,65851044,1417,358
0,1025,0.06221408966148216,0.07652173913043478,10738631,1093,68
1,377,0.21784232365145229,0.5683615819209039,68558070,482,105
1,127,0.1962025316455696,0.5467128027681661,81965609,158,31
1,62,0.21518987341772153,0.6105769230769231,80128495,79,17
0,26,0.10344827586206896,0.40869565217391307,82103810,29,3
1,43,0.2833333333333333,0.7906976744186046,82109293,60,17
0,764,0.06027060270602706,0.2014218009478673,62836655,813,49
0,292,0.2,0.41865079365079366,67221175,365,73
1,915,0.44912703190848885,0.8809723386420788,66091746,1661,746
0,672,0.125,0.21058558558558557,70643146,768,96
1,302,0.40784313725490196,0.9442724458204335,70632114,510,208
1,325,0.2857142857142857,0.6689008042895442,72208626,455,130
2,200,0.54337899543379,0.9689922480620154,79884231,438,238
1,1091,0.27169559412550065,0.617579908675799,69586223,1498,407
1,78,0.30973451327433627,0.6601941747572816,67662455,113,35
1,35,0.46153846153846156,0.868421052631579,70688233,65,30
1,130,0.42731277533039647,0.900497512437811,82007145,227,97
0,616,0.07228915662650602,0.08024691358024691,73906021,664,48
1,297,0.3310810810810811,0.7142857142857143,74340903,444,147
1,679,0.30072090628218334,0.6837815810920945,68633544,971,292
1,190,0.3238434163701068,0.7163323782234957,80136846,281,91
1,391,0.31523642732049034,0.6568778979907264,68191445,571,180
0,383,0.09456264775413711,0.2345360824742268,65683716,423,40
1,1062,0.34806629834254144,0.7853761178327197,67994920,1629,567
1,153,0.3318777292576419,0.785234899328859,70070833,229,76
1,664,0.4424853064651553,0.8993055555555556,70860384,1191,527
1,341,0.2488986784140969,0.5013020833333334,69184052,454,113
0,693,0.17105263157894737,0.274385408406027,68644961,836,143
1,1029,0.234375,0.5192604006163328,81999993,1344,315
1,189,0.2559055118110236,0.5770114942528736,70048055,254,65
0,883,0.04643628509719223,0.0890092879256966,63780990,926,43
1,255,0.2877094972067039,0.6305732484076433,69183716,358,103
0,387,0.17484008528784648,0.4075520833333333,60800551,469,82
2,6,0.5384615384615384,0.7,62512163,13,7
1,41,0.22641509433962265,0.5040650406504065,67376526,53,12
0,58,0.06451612903225806,0.14351851851851852,69737332,62,4
0,121,0.16551724137931034,0.4444444444444444,74923961,145,24
0,108,0.11475409836065574,0.43902439024390244,62532330,122,14
0,1944,0.09665427509293681,0.17757009345794392,82028898,2152,208
2,233,0.5587121212121212,0.9534412955465587,82145142,528,295
0,838,0.05096262740656852,0.1094834232845027,70001386,883,45
1,225,0.47306791569086654,0.9425287356321839,60953606,427,202
1,199,0.30662020905923343,0.7556818181818182,80156766,287,88
1,99,0.45604395604395603,0.9035087719298246,82023518,182,83
1,258,0.46361746361746364,0.9529616724738676,65278514,481,223
1,679,0.3736162361623616,0.7654545454545455,80127522,1084,405
1,492,0.3333333333333333,0.8170377541142304,67552660,738,246
1,88,0.3383458646616541,0.6715328467153284,74046903,133,45
0,1805,0.05249343832020997,0.08731381612737545,60028283,1905,100
0,661,0.06506364922206506,0.25014819205690575,62838846,707,46
0,35,0.2857142857142857,0.4774774774774775,70934150,49,14
1,323,0.4634551495016611,0.933649289099526,65787330,602,279
0,695,0.05570652173913043,0.0346494762288477,80119321,736,41
0,130,0.24855491329479767,0.4011299435028249,71458506,173,43
0,738,0.18,0.3197969543147208,65853214,900,162
1,583,0.2864137086903305,0.5756302521008403,79787050,817,234
1,264,0.2605042016806723,0.5538793103448276,69152076,357,93
1,549,0.37542662116040953,0.7611940298507462,79838745,879,330
0,413,0.15368852459016394,0.29155672823219,68536965,488,75
1,313,0.2918552036199095,0.599476439790576,67752664,442,129
0,134,0.11258278145695365,0.12601626016260162,70748251,151,17
0,149,0.06875,0.05,70748286,160,11
0,110,0.10569105691056911,0.0970464135021097,70748405,123,13
1,184,0.3543859649122807,0.7648114901256733,80067211,285,101
1,5,0.16666666666666666,0.6666666666666666,72804634,6,1
2,15,0.5833333333333334,0.9803921568627451,82009600,36,21
0,1890,0.0449722081859525,0.10993717875499714,68130503,1979,89
0,405,0.05152224824355972,0.18403115871470302,68798352,427,22
0,147,0.14035087719298245,0.22797927461139897,68621714,171,24
1,204,0.40869565217391307,0.9130434782608695,65268140,345,141
1,441,0.4562268803945746,0.9070735090152566,65690065,811,370
2,173,0.5181058495821727,0.9554973821989529,80163512,359,186
0,844,0.16683119447186576,0.26964285714285713,70200431,1013,169
2,629,0.5516749821810406,0.9685589519650655,82062259,1403,774
1,186,0.256,0.5819397993311036,66383373,250,64
2,209,0.5708418891170431,0.9739336492890995,69100654,487,278
0,147,0.10909090909090909,0.14651162790697675,80071096,165,18
0,200,0.07407407407407407,0.07677902621722846,80071103,216,16
1,38,0.3559322033898305,0.8181818181818182,69140883,59,21
0,760,0.1774891774891775,0.36439966414777497,70617064,924,164
0,430,0.19172932330827067,0.39941690962099125,70643153,532,102
2,74,0.6021505376344086,0.9300699300699301,80137025,186,112
0,557,0.20768136557610242,0.38335046248715315,69165810,703,146
1,491,0.2279874213836478,0.5145317545748116,80119197,636,145
0,529,0.08635578583765112,0.07920792079207921,72900331,579,50
0,698,0.1529126213592233,0.25306416726748376,80119344,824,126
0,574,0.08888888888888889,0.09067579127459367,82036709,630,56
0,769,0.21209016393442623,0.4535211267605634,68540731,976,207
1,263,0.32216494845360827,0.5665529010238908,80176747,388,125
0,494,0.13485113835376533,0.19810326659641728,80181301,571,77
1,1317,0.18853974121996303,0.5412919051512673,64179892,1623,306
1,917,0.35739313244569026,0.8465473145780051,80124646,1427,510
0,533,0.07142857142857142,0.0544280442804428,69101494,574,41
1,220,0.4527363184079602,0.9383983572895277,69622252,402,182
1,44,0.30158730158730157,0.6528925619834711,69896820,63,19
1,90,0.3706293706293706,0.7802690582959642,67627651,143,53
1,67,0.3963963963963964,0.9107142857142857,80133427,111,44
1,209,0.2640845070422535,0.5995260663507109,72293816,284,75
0,1031,0.1542247744052502,0.23666666666666666,82000091,1219,188
1,421,0.38629737609329445,0.8897435897435897,69607433,686,265
1,465,0.46118192352259557,0.9174573055028463,80125401,863,398
0,545,0.077834179357022,0.09641255605381166,70200375,591,46
0,189,0.06896551724137931,0.1349862258953168,70200403,203,14
1,221,0.3649425287356322,0.8523002421307506,69621461,348,127
1,821,0.31583333333333335,0.6510757717492984,67286772,1200,379
2,274,0.5063063063063064,0.9621848739495799,65909515,555,281
0,73,0.23958333333333334,0.49324324324324326,70179760,96,23
0,1767,0.16057007125890738,0.29895287958115185,80135746,2105,338
1,11,0.35294117647058826,0.8285714285714286,71010044,17,6
0,576,0.15169366715758467,0.2598984771573604,70617043,679,103
0,1364,0.2174411933448078,0.4797008547008547,80112186,1743,379
1,344,0.4129692832764505,0.9024707412223667,69573245,586,242
1,159,0.44405594405594406,0.8707482993197279,80125108,286,127
0,439,0.1392156862745098,0.18824701195219123,67554613,510,71
1,25,0.2857142857142857,0.5070422535211268,79788436,35,10
0,431,0.21062271062271062,0.40043763676148797,68534970,546,115
1,610,0.36853002070393376,0.8719923002887392,69607482,966,356
1,829,0.26179875333926983,0.62283044058745,68542621,1123,294
0,344,0.1134020618556701,0.173053152039555,54609814,388,44
1,5,0.375,0.7714285714285715,80150326,8,3
2,29,0.7786259541984732,0.9880952380952381,73407215,131,102
2,48,0.6666666666666666,0.9672131147540983,70690942,144,96
1,84,0.35877862595419846,0.8072289156626506,80117927,131,47
0,466,0.023060796645702306,0.04990403071017274,80124334,477,11
0,464,0.04722792607802875,0.11553784860557768,80124419,487,23
2,37,0.5697674418604651,0.9826086956521739,80158341,86,49
0,842,0.07574094401756312,0.04241435562805873,82001894,911,69
2,0,1.0,1.0,74442942,17,17
0,1170,0.2083897158322057,0.4540106951871658,68537980,1478,308
1,151,0.25980392156862747,0.7080459770114943,80097563,204,53
1,105,0.2953020134228188,0.654320987654321,69183205,149,44
0,123,0.08208955223880597,0.09635416666666667,80176480,134,11
0,239,0.07722007722007722,0.11654676258992806,80176490,259,20
1,287,0.30339805825242716,0.5992844364937389,80066406,412,125
1,433,0.31160572337042924,0.7617977528089888,69180461,629,196
0,143,0.20555555555555555,0.4420849420849421,70120015,180,37
2,217,0.5450733752620545,0.9366197183098591,72077782,477,260
1,366,0.2694610778443114,0.6424581005586593,80124677,501,135
1,723,0.2711693548387097,0.6179123711340206,68044956,992,269
0,467,0.05846774193548387,0.10569105691056911,68318362,496,29
1,335,0.296218487394958,0.6858054226475279,68532394,476,141
1,450,0.3644067796610169,0.8191489361702128,66111360,708,258
1,490,0.3813131313131313,0.8918640576725025,68535964,792,302
0,1022,0.13827993254637436,0.15602836879432624,80121131,1186,164
0,1365,0.018691588785046728,0.0030004286326618087,70604835,1391,26
0,1442,0.02633355840648211,0.005363036303630363,70604842,1481,39
0,32,0.30434782608695654,0.2702702702702703,80176623,46,14
0,15,0.16666666666666666,0.18421052631578946,70509453,18,3
1,460,0.26517571884984026,0.6537698412698413,70626703,626,166
0,1828,0.05137519460300986,0.0265914585012087,70643013,1927,99
1,99,0.41420118343195267,0.7569444444444444,60240152,169,70
1,56,0.43434343434343436,0.7307692307692307,61706183,99,43
2,68,0.5211267605633803,0.8645833333333334,61708906,142,74
0,1116,0.1757754800590842,0.3344324069712671,68534683,1354,238
1,461,0.33285094066570187,0.7087378640776699,66355212,691,230
1,331,0.3366733466933868,0.7422839506172839,67148942,499,168
1,260,0.2676056338028169,0.5285451197053407,80109211,355,95
0,137,0.17964071856287425,0.32275132275132273,72523283,167,30
1,286,0.39915966386554624,0.9052631578947369,81967342,476,190
0,355,0.05585106382978723,0.03241491085899514,80181314,376,21
0,148,0.12941176470588237,0.13452914798206278,62901454,170,22
1,461,0.2796875,0.640926640926641,70802235,640,179
0,1005,0.09784560143626571,0.1054354944335298,80104640,1114,109
1,206,0.29692832764505117,0.5873015873015873,61078101,293,87
1,469,0.22093023255813954,0.5140449438202247,62234165,602,133
1,159,0.34024896265560167,0.7494866529774127,69473425,241,82
1,455,0.27892234548335976,0.6453608247422681,71358973,631,176
1,49,0.3,0.668918918918919,74095980,70,21
1,32,0.30434782608695654,0.6666666666666666,70286594,46,14
2,36,0.5135135135135135,0.8735632183908046,80160403,74,38
1,857,0.2780117944397641,0.6753623188405797,63100933,1187,330
0,418,0.12916666666666668,0.25790513833992096,69416354,480,62
0,32,0.13513513513513514,0.2962962962962963,19838140,37,5
0,317,0.116991643454039,0.25795644891122277,70659974,359,42
1,840,0.3660377358490566,0.8123167155425219,67994241,1325,485
1,803,0.35708566853482787,0.7690397350993378,73599736,1249,446
0,97,0.18487394957983194,0.325,82011791,119,22
1,185,0.48467966573816157,0.9293478260869565,63461601,359,174
0,363,0.17873303167420815,0.3338235294117647,66808945,442,79
0,162,0.23943661971830985,0.47289156626506024,69607384,213,51
1,345,0.4269102990033223,0.8711819389110226,68189723,602,257
1,108,0.47058823529411764,0.9575289575289575,68210583,204,96
2,121,0.6666666666666666,0.9226804123711341,72745470,363,242
1,508,0.21362229102167182,0.529082774049217,74020352,646,138
0,110,0.19117647058823528,0.3426294820717131,68534102,136,26
0,352,0.2054176072234763,0.32894736842105265,74046910,443,91
1,300,0.32432432432432434,0.7705479452054794,69608273,444,144
0,1388,0.025964912280701753,0.015448603683897801,69098232,1425,37
0,1195,0.08218125960061444,0.19529938444320089,70001554,1302,107
0,1140,0.11284046692607004,0.15017757483510907,70641984,1285,145
1,299,0.3783783783783784,0.8630849220103987,80107902,481,182
1,251,0.215625,0.5050301810865191,67159246,320,69
0,239,0.18983050847457628,0.4289044289044289,68543223,295,56
1,168,0.43243243243243246,0.9186813186813186,80117928,296,128
1,760,0.36401673640167365,0.829450915141431,80108091,1195,435
1,366,0.43167701863354035,0.8094435075885329,80124829,644,278
0,1327,0.12869336835193695,0.18126428027418126,80180388,1523,196
1,42,0.3,0.6666666666666666,69183436,60,18
0,930,0.04024767801857585,0.12602880658436214,62834212,969,39
0,121,0.0546875,0.2511111111111111,64182692,128,7
0,452,0.05241090146750524,0.20446735395189003,66389316,477,25
0,175,0.08376963350785341,0.4318181818181818,74607330,191,16
2,103,0.5296803652968036,0.9748953974895398,72315012,219,116
1,588,0.2722772277227723,0.6619090098126673,80121175,808,220
0,618,0.20258064516129032,0.4173063503140265,80114433,775,157
0,97,0.13392857142857142,0.1348314606741573,63051520,112,15
1,798,0.41836734693877553,0.9022556390977443,61439833,1372,574
0,79,0.15053763440860216,0.4266666666666667,66226881,93,14
0,55,0.12698412698412698,0.302158273381295,67756402,63,8
1,11,0.21428571428571427,0.6507936507936508,70488971,14,3
1,1307,0.4029237094563728,0.6459709379128138,66280746,2189,882
1,12,0.4,0.8,69870234,20,8
1,363,0.27976190476190477,0.6475826972010178,70643300,504,141
1,213,0.2755102040816326,0.5170454545454546,65930886,294,81
0,123,0.07518796992481203,0.09333333333333334,69415780,133,10
1,266,0.30548302872062666,0.6602658788774003,67657464,383,117
2,333,0.563564875491481,0.9380692167577414,80062185,763,430
0,247,0.18211920529801323,0.2696629213483146,69021393,302,55
1,204,0.2867132867132867,0.5882352941176471,69021414,286,82
1,314,0.24700239808153476,0.5383480825958702,69636931,417,103
0,1230,0.14937759336099585,0.22217255252570406,69239891,1446,216
1,381,0.3971518987341772,0.7736720554272517,62511463,632,251
1,1027,0.2897648686030429,0.6865329512893983,64275736,1446,419
1,660,0.23963133640552994,0.5730421686746988,66931403,868,208
0,154,0.14444444444444443,0.22580645161290322,77676291,180,26
1,121,0.2754491017964072,0.5871212121212122,68784870,167,46
2,149,0.5565476190476191,0.9591836734693877,68290922,336,187
1,703,0.3207729468599034,0.7219512195121951,69573161,1035,332
0,1011,0.08506787330316742,0.26222826086956524,73366314,1105,94
0,1061,0.07899305555555555,0.22700198544010589,73366321,1152,91
0,157,0.24154589371980675,0.43231441048034935,80051671,207,50
2,26,0.5272727272727272,0.9354838709677419,80137604,55,29
2,39,0.6422018348623854,0.9906542056074766,69539204,109,70
0,62,0.18421052631578946,0.4276315789473684,69280946,76,14
1,99,0.4107142857142857,0.8517241379310345,72390892,168,69
1,495,0.36619718309859156,0.7216748768472906,80180241,781,286
1,86,0.41496598639455784,0.8555555555555555,80028494,147,61
1,1039,0.29415760869565216,0.6359088382434686,67995263,1472,433
1,2690,0.218931475029036,0.5362734864300627,67809994,3444,754
1,234,0.31378299120234604,0.7474402730375427,69180244,341,107
1,214,0.37790697674418605,0.8852459016393442,81967346,344,130
1,134,0.3881278538812785,0.8267148014440433,68671652,219,85
0,2,0.0,0.0,67657695,2,0
1,200,0.36908517350157727,0.8867469879518072,81967274,317,117
1,231,0.3,0.6563636363636364,66191860,330,99
1,345,0.22991071428571427,0.5185185185185185,68680654,448,103
0,742,0.21729957805907174,0.44261168384879723,66931851,948,206
1,121,0.23417721518987342,0.5780346820809249,82036692,158,37
1,380,0.22448979591836735,0.5017964071856288,67159141,490,110
1,346,0.2622601279317697,0.5762483130904184,70760606,469,123
1,109,0.35502958579881655,0.8166666666666667,67555901,169,60
1,138,0.4588235294117647,0.9147058823529411,82023522,255,117
1,259,0.33589743589743587,0.8121212121212121,63445753,390,131
0,168,0.125,0.3582089552238806,68317865,192,24
0,213,0.18076923076923077,0.32335329341317365,67421732,260,47
1,493,0.24847560975609756,0.5912698412698413,63264250,656,163
2,96,0.5317073170731708,0.8939393939393939,82009595,205,109
1,500,0.26362297496318116,0.6669699727024567,82014185,679,179
2,77,0.5389221556886228,0.9060402684563759,72425584,167,90
0,1203,0.12509090909090909,0.13675213675213677,69240003,1375,172
1,591,0.30552291421856637,0.716105550500455,80111465,851,260
0,440,0.1217564870259481,0.28233151183970856,69628720,501,61
1,553,0.3737259343148358,0.7488514548238897,74809343,883,330
2,69,0.5306122448979592,0.9361702127659575,80152710,147,78
0,346,0.05722070844686648,0.22859830667920977,80128639,367,21
1,143,0.4392156862745098,0.8385416666666666,80062472,255,112
1,649,0.24447031431897556,0.523534269199009,68783596,859,210
1,443,0.30126182965299686,0.6254589963280294,70891905,634,191
1,1147,0.29588704726826276,0.7231578947368421,80124639,1629,482
0,313,0.07396449704142012,0.295906432748538,68811456,338,25
1,359,0.210989010989011,0.5501193317422435,70627690,455,96
1,894,0.3947190250507786,0.8419847328244274,70865410,1477,583
0,344,0.04709141274238227,0.028901734104046242,77182252,361,17
0,937,0.1929371231696813,0.3384615384615385,72293844,1161,224
1,350,0.21171171171171171,0.659217877094972,66830414,444,94
1,560,0.4584139264990329,0.9240837696335078,73226510,1034,474
0,321,0.06140350877192982,0.050340136054421766,68047693,342,21
0,1145,0.19024045261669023,0.39989680082559337,68536636,1414,269
0,189,0.2190082644628099,0.48,66892406,242,53
1,366,0.268,0.6606498194945848,68391904,500,134
2,316,0.5979643765903307,0.968013468013468,68521544,786,470
1,266,0.17901234567901234,0.5905383360522023,69597962,324,58
1,121,0.3423913043478261,0.7568627450980392,67553696,184,63
1,308,0.23950617283950618,0.5749235474006116,70633444,405,97
1,334,0.3539651837524178,0.8492935635792779,70632093,517,183
0,539,0.1870286576168929,0.38461538461538464,70643020,663,124
0,711,0.052,0.024124513618677044,68539576,750,39
0,758,0.16703296703296702,0.2632331902718169,66932054,910,152
1,41,0.3492063492063492,0.7864077669902912,70748342,63,22
1,275,0.3735763097949886,0.8168724279835391,65931005,439,164
1,58,0.3176470588235294,0.8040540540540541,69948781,85,27
1,552,0.24175824175824176,0.6644664466446645,60028346,728,176
1,182,0.3132075471698113,0.7518072289156627,69176821,265,83
1,415,0.34850863422291994,0.8157589803012746,80120462,637,222
1,55,0.4387755102040816,0.9202898550724637,70252385,98,43
0,784,0.15608180839612487,0.27801120448179273,70524510,929,145
0,1046,0.1143099068585944,0.1429353778751369,70532826,1181,135
0,205,0.10480349344978165,0.12298387096774194,75551840,229,24
1,717,0.3171428571428571,0.7208303507516106,70182770,1050,333
1,209,0.31699346405228757,0.7043701799485861,82126642,306,97
0,1156,0.096875,0.195,69575212,1280,124
1,265,0.499054820415879,0.9539594843462247,68640726,529,264
1,599,0.33221850613154963,0.7217391304347827,67411855,897,298
1,534,0.3382899628252788,0.8003992015968064,82008903,807,273
0,856,0.18553758325404376,0.3508771929824561,68540402,1051,195
2,284,0.5456,0.9618055555555556,82059486,625,341
0,164,0.13227513227513227,0.34049586776859503,80135241,189,25
1,758,0.22176591375770022,0.5660714285714286,80118412,974,216
1,494,0.24233128834355827,0.5907723169508525,80112074,652,158
1,34,0.41379310344827586,0.8292682926829268,70925554,58,24
0,257,0.24188790560471976,0.41586538461538464,72077852,339,82
0,204,0.16393442622950818,0.39356814701378257,80135242,244,40
1,114,0.44390243902439025,0.9342560553633218,65278500,205,91
0,1254,0.22972972972972974,0.32531824611032534,80173005,1628,374
1,451,0.3050847457627119,0.7511520737327189,66931214,649,198
0,387,0.2069672131147541,0.3923444976076555,69073431,488,101
2,72,0.5636363636363636,0.9577464788732394,69388081,165,93
1,425,0.31006493506493504,0.6886363636363636,66064586,616,191
2,159,0.5323529411764706,0.945619335347432,82059492,340,181
1,224,0.2607260726072607,0.5461346633416458,54552183,303,79
0,300,0.047619047619047616,0.17162162162162162,66877090,315,15
1,745,0.24899193548387097,0.5919377652050919,68350821,992,247
0,675,0.1444866920152091,0.21529509559434745,68542712,789,114
0,584,0.13737075332348597,0.2198364008179959,68542733,677,93
1,378,0.3225806451612903,0.7364341085271318,66470782,558,180
2,97,0.657243816254417,0.9380952380952381,72472561,283,186
0,1345,0.11861074705111402,0.2589622641509434,81965665,1526,181
2,41,0.5773195876288659,0.9887640449438202,69205234,97,56
1,887,0.3618705035971223,0.846875,68224954,1390,503
1,337,0.3037190082644628,0.7465564738292011,80159042,484,147
0,280,0.027777777777777776,0.08594815825375171,76805554,288,8
2,539,0.6152748037116346,0.9853709508881923,69969144,1401,862
2,168,0.6216216216216216,0.9395770392749244,69972714,444,276
1,153,0.3952569169960474,0.7854077253218884,82045533,253,100
0,875,0.08759124087591241,0.06290471785383904,79788093,959,84
0,602,0.05345911949685535,0.010403120936280884,79788121,636,34
2,57,0.5,0.9628099173553719,82022547,114,57
0,462,0.1735241502683363,0.34637964774951074,70641830,559,97
0,115,0.2013888888888889,0.18253968253968253,82009535,144,29
1,19,0.24,0.6666666666666666,60579064,25,6
0,161,0.15706806282722513,0.45112781954887216,70480200,191,30
0,82,0.05747126436781609,0.03571428571428571,72785895,87,5
0,323,0.0471976401179941,0.17145899893503727,66876614,339,16
0,125,0.031007751937984496,0.10311750599520383,66876663,129,4
0,223,0.08979591836734693,0.32642487046632124,66877202,245,22
0,16,0.30434782608695654,0.35714285714285715,79450161,23,7
2,498,0.5248091603053435,0.8333333333333334,80089933,1048,550
0,529,0.19726858877086495,0.3605313092979127,66892630,659,130
0,210,0.03669724770642202,0.11774461028192372,68343310,218,8
1,518,0.30563002680965146,0.6463157894736842,69470891,746,228
1,385,0.27631578947368424,0.6929223744292238,80118444,532,147
2,15,0.6739130434782609,0.9655172413793104,80151036,46,31
1,441,0.29213483146067415,0.5422647527910686,80176765,623,182
2,117,0.5951557093425606,0.9732620320855615,70632121,289,172
2,137,0.5054151624548736,0.9293193717277487,74443810,277,140
1,394,0.46321525885558584,0.889196675900277,80180196,734,340
0,425,0.08798283261802575,0.06306306306306306,67766853,466,41
0,215,0.03587443946188341,0.02364864864864865,69106996,223,8
0,323,0.14095744680851063,0.24517906336088155,69534514,376,53
0,96,0.11926605504587157,0.18456375838926176,69534570,109,13
0,359,0.1572769953051643,0.3134962805526036,80098844,426,67
0,720,0.1919191919191919,0.4082125603864734,66058762,891,171
1,491,0.29454022988505746,0.6452702702702703,68159413,696,205
0,1147,0.1170130869899923,0.15355805243445692,73346791,1299,152
1,609,0.24535315985130113,0.5825991189427313,70641746,807,198
1,387,0.35392320534223703,0.6900452488687783,80135372,599,212
0,356,0.16822429906542055,0.28209459459459457,66206434,428,72
0,231,0.21428571428571427,0.3660477453580902,70179060,294,63
0,328,0.06017191977077364,0.2787769784172662,65498552,349,21
0,68,0.11688311688311688,0.3088235294117647,69691916,77,9
1,363,0.37735849056603776,0.7476808905380334,72320976,583,220
0,1392,0.09669046073977937,0.11669829222011385,54609590,1541,149
0,434,0.08438818565400844,0.08816120906801007,54609695,474,40
0,1076,0.14399363564041368,0.41586538461538464,67924745,1257,181
1,62,0.38613861386138615,0.8481675392670157,80134998,101,39
1,340,0.4117647058823529,0.8732394366197183,80180313,578,238
1,174,0.41216216216216217,0.8960739030023095,65191133,296,122
1,22,0.26666666666666666,0.6825396825396826,80154127,30,8
0,261,0.10309278350515463,0.15,80141500,291,30
0,749,0.1723756906077348,0.311336717428088,80152998,905,156
2,118,0.6346749226006192,0.9783783783783784,80061982,323,205
1,476,0.2040133779264214,0.6853146853146853,63715470,598,122
0,654,0.07757404795486601,0.351575456053068,65121581,709,55
0,598,0.06708268330733229,0.3113651647612643,67978246,641,43
0,581,0.17,0.4107008289374529,77688212,700,119
0,243,0.054474708171206226,0.26995645863570394,64076754,257,14
0,127,0.1056338028169014,0.42813455657492355,67122181,142,15
0,95,0.10377358490566038,0.4670487106017192,67978491,106,11
1,80,0.13043478260869565,0.5622895622895623,68213614,92,12
1,13,0.3157894736842105,0.7843137254901961,70059465,19,6
1,112,0.2483221476510067,0.6142506142506142,80128676,149,37
0,54,0.16923076923076924,0.37142857142857144,70466144,65,11
0,1110,0.12872841444270017,0.4275109170305677,66502611,1274,164
0,2521,0.043989381873340914,0.18423711687436847,82205870,2637,116
0,2138,0.0493552690084482,0.14415619149505216,62838153,2249,111
0,362,0.04736842105263158,0.31982942430703626,64026844,380,18
0,485,0.014227642276422764,0.09733124018838304,67327435,492,7
0,112,0.05084745762711865,0.4423963133640553,69024242,118,6
0,395,0.0125,0.10366398570151922,70468391,400,5
0,469,0.04480651731160896,0.21330089213300893,82134956,491,22
0,714,0.0834403080872914,0.3657858136300417,63632520,779,65
0,335,0.028985507246376812,0.22339304531085352,67004280,345,10
0,43,0.06521739130434782,0.2517985611510791,67359691,46,3
0,160,0.012345679012345678,0.14154411764705882,69858040,162,2
0,411,0.030660377358490566,0.2217391304347826,70467075,424,13
0,367,0.0160857908847185,0.13039014373716631,80149997,373,6
0,94,0.010526315789473684,0.12304250559284116,80150920,95,1
0,599,0.07275541795665634,0.30494296577946767,64076915,646,47
0,890,0.047109207708779445,0.21559362079149438,70923342,934,44
0,75,0.08536585365853659,0.4735376044568245,62849983,82,7
1,10,0.16666666666666666,0.7096774193548387,67435074,12,2
1,403,0.16390041493775934,0.5397350993377483,70228935,482,79
1,324,0.2910284463894967,0.7268170426065163,80124657,457,133
0,58,0.03333333333333333,0.21428571428571427,67682433,60,2
1,118,0.2080536912751678,0.6982543640897756,18370695,149,31
1,206,0.3087248322147651,0.6944444444444444,67017461,298,92
0,381,0.12814645308924486,0.3268733850129199,67343325,437,56
0,92,0.061224489795918366,0.3392857142857143,66512726,98,6
0,63,0.05970149253731343,0.3130081300813008,67900903,67,4
1,131,0.19135802469135801,0.6838046272493573,68227922,162,31
1,12,0.07692307692307693,0.5,80150511,13,1
0,5,0.0,0.0,80150553,5,0
0,4,0.0,0.0,80150554,4,0
0,5,0.0,0.0,80150555,5,0
0,2,0.0,0.0,80150683,2,0
0,492,0.16326530612244897,0.39443155452436196,69697866,588,96
1,382,0.1906779661016949,0.6818642350557245,64359736,472,90
0,303,0.04716981132075472,0.3218514531754575,67758943,318,15
0,302,0.11436950146627566,0.3939828080229226,68635462,341,39
2,30,0.8654708520179372,0.9692307692307692,72635605,223,193
0,112,0.02608695652173913,0.09213051823416507,68356932,115,3
1,957,0.15978928884986832,0.5492505353319058,69389320,1139,182
0,30,0.0625,0.2545454545454545,64234751,32,2
0,33,0.08333333333333333,0.35766423357664234,67584265,36,3
0,680,0.12483912483912483,0.4186765615337044,67722291,777,97
1,31,0.16216216216216217,0.5735294117647058,70069944,37,6
2,31,0.5507246376811594,0.9215686274509803,70563521,69,38
2,197,0.7573891625615764,0.9836956521739131,70563535,812,615
1,289,0.37310195227765725,0.7897623400365631,70822353,461,172
0,124,0.25301204819277107,0.4402730375426621,73514042,166,42
1,15,0.34782608695652173,0.8727272727272727,64129926,23,8
0,378,0.06435643564356436,0.26248864668483196,68798205,404,26
1,391,0.25665399239543724,0.5897435897435898,80124679,526,135
0,219,0.14785992217898833,0.41312741312741313,64001952,257,38
0,573,0.10188087774294671,0.3561020036429873,69133603,638,65
0,643,0.07747489239598278,0.3639240506329114,69890625,697,54
0,420,0.06040268456375839,0.31390134529147984,64027110,447,27
1,2,0.3333333333333333,0.75,69133680,3,1
1,7,0.125,0.625,82090184,8,1
0,6,0.0,0.0,82090185,6,0
0,7,0.0,0.0,82090186,7,0
0,6,0.0,0.0,82090187,6,0
0,7,0.0,0.0,82090188,7,0
0,7,0.0,0.0,82090189,7,0
1,7,0.125,0.7,82090190,8,1
1,319,0.158311345646438,0.7079530638852672,65658026,379,60
1,200,0.19678714859437751,0.7901234567901234,69005832,249,49
0,65,0.1875,0.1875,80176060,80,15
2,25,0.5283018867924528,0.98,80118190,53,28
0,36,0.05263157894736842,0.3181818181818182,67379711,38,2
0,9,0.1,0.4,68234432,10,1
1,9,0.4375,0.6666666666666666,69189204,16,7
0,80,0.14893617021276595,0.3639705882352941,65018492,94,14
0,755,0.014360313315926894,0.10512129380053908,65675596,766,11
0,340,0.052924791086350974,0.2596491228070175,67454786,359,19
0,210,0.014084507042253521,0.10555555555555556,67468240,213,3
0,592,0.08923076923076922,0.36845827439886847,69024123,650,58
1,148,0.12941176470588237,0.6625,69024270,170,22
0,876,0.0457516339869281,0.2432975871313673,80149796,918,42
0,1752,0.03364589078874793,0.1476001443522194,63265160,1813,61
0,277,0.02464788732394366,0.17660550458715596,64502032,284,7
0,160,0.047619047619047616,0.4357976653696498,65675162,168,8
0,450,0.03017241379310345,0.18689320388349515,69006266,464,14
0,300,0.009900990099009901,0.07411385606874328,70467740,303,3
0,611,0.07424242424242425,0.36209813874788493,70923391,660,49
0,213,0.018433179723502304,0.17084639498432602,80135356,217,4
0,295,0.006734006734006734,0.05629477993858751,80149996,297,2
0,318,0.024539877300613498,0.19874476987447698,80150047,326,8
0,94,0.030927835051546393,0.32923832923832924,80150050,97,3
0,114,0.0,0.0,80150896,114,0
0,47,0.04081632653061224,0.3693181818181818,82116594,49,2
1,545,0.18290854572713644,0.5943526170798898,70173600,667,122
0,882,0.0944558521560575,0.3888888888888889,63628222,974,92
0,252,0.09025270758122744,0.3241830065359477,64076964,277,25
0,341,0.07084468664850137,0.2886178861788618,64230845,367,26
0,96,0.07692307692307693,0.41946308724832215,70463631,104,8
0,555,0.05612244897959184,0.3270588235294118,63628852,588,33
0,170,0.06593406593406594,0.26003824091778205,64235920,182,12
1,22,0.37142857142857144,0.74,67328716,35,13
0,428,0.01834862385321101,0.15096065873741996,65133642,436,8
0,125,0.007936507936507936,0.08171206225680934,80150910,126,1
0,1069,0.15959119496855345,0.46861702127659577,80135444,1272,203
0,551,0.05650684931506849,0.27184466019417475,65121616,584,33
0,385,0.081145584725537,0.4179278230500582,67900210,419,34
1,993,0.28766140602582496,0.6971235194585449,70690991,1394,401
0,332,0.0647887323943662,0.325,70922341,355,23
0,839,0.04114285714285714,0.2058252427184466,70922502,875,36
0,392,0.012594458438287154,0.12038014783526928,65132585,397,5
0,150,0.03225806451612903,0.27886323268206037,69857725,155,5
0,105,0.009433962264150943,0.09745762711864407,69858215,106,1
0,128,0.022900763358778626,0.22964509394572025,80149999,131,3
0,58,0.0,0.0,80150000,58,0
0,216,0.0136986301369863,0.13687150837988826,82205865,219,3
0,728,0.08427672955974842,0.35446859903381644,64399454,795,67
0,1165,0.05207485760781123,0.2419855222337125,70923041,1229,64
0,256,0.058823529411764705,0.2397163120567376,82095488,272,16
0,519,0.04066543438077634,0.1614114114114114,64016330,541,22
0,892,0.06302521008403361,0.23004201680672268,68199173,952,60
1,233,0.1909722222222222,0.7221297836938436,67359404,288,55
0,96,0.058823529411764705,0.2987012987012987,69879215,102,6
0,305,0.0701219512195122,0.3239277652370203,70476343,328,23
0,423,0.04943820224719101,0.23534715960324618,70923006,445,22
0,192,0.09859154929577464,0.4073275862068966,82206192,213,21
1,90,0.22413793103448276,0.7326732673267327,64149715,116,26
0,476,0.12338858195211787,0.4634920634920635,67887603,543,67
0,502,0.12390924956369982,0.48273026315789475,68228195,573,71
0,145,0.03333333333333333,0.31610337972166996,70467355,150,5
0,84,0.0,0.0,70468636,84,0
0,286,0.01718213058419244,0.13058823529411764,70917294,291,5
0,386,0.03980099502487562,0.2556179775280899,80150048,402,16
0,307,0.025396825396825397,0.21875,82205864,315,8
0,395,0.0025252525252525255,0.061930783242258654,64360114,396,1
0,356,0.06068601583113457,0.30789946140035906,66025750,379,23
0,31,0.06060606060606061,0.1348314606741573,68226984,33,2
0,276,0.04498269896193772,0.3266509433962264,67468205,289,13
0,333,0.020588235294117647,0.1452513966480447,67468212,340,7
0,340,0.011627906976744186,0.07772020725388601,67468226,344,4
0,148,0.013333333333333334,0.10912343470483005,67468331,150,2
0,498,0.013861386138613862,0.0944822373393802,67468366,505,7
0,217,0.04405286343612335,0.24662576687116564,69645296,227,10
0,482,0.036,0.25576730190571717,70467614,500,18
0,220,0.022222222222222223,0.18376068376068377,65671550,225,5
1,319,0.4114391143911439,0.8972895863052782,61450662,542,223
0,118,0.06349206349206349,0.4666666666666667,70467376,126,8
2,149,0.5016722408026756,0.9635922330097088,62563242,299,150
0,535,0.04634581105169341,0.18168279970215934,64391096,561,26
0,84,0.06666666666666667,0.3968253968253968,70923461,90,6
0,354,0.09462915601023018,0.4097452934662237,67042591,391,37
0,175,0.09326424870466321,0.3879003558718861,67122111,193,18
0,265,0.19939577039274925,0.41729323308270677,80131187,331,66
0,56,0.13846153846153847,0.3020408163265306,82050498,65,9
0,1466,0.031704095112285335,0.15550847457627118,82205871,1514,48
1,160,0.2079207920792079,0.6843267108167771,65276344,202,42
0,163,0.07386363636363637,0.29865125240847784,70915425,176,13
0,50,0.07407407407407407,0.2995391705069124,70917112,54,4
0,1557,0.0631768953068592,0.28983634797588287,70923426,1662,105
0,168,0.017543859649122806,0.1917808219178082,69006224,171,3
0,187,0.041025641025641026,0.2943786982248521,70917126,195,8
0,82,0.023809523809523808,0.25396825396825395,80150905,84,2
0,98,0.04854368932038835,0.40555555555555556,80150906,103,5
0,127,0.0078125,0.11961722488038277,82206171,128,1
0,104,0.018867924528301886,0.10158730158730159,80135359,106,2
1,363,0.2484472049689441,0.6853503184713375,66390835,483,120
0,384,0.017902813299232736,0.13339466421343146,64360121,391,7
1,299,0.13583815028901733,0.6315151515151515,64359694,346,47
0,59,0.1323529411764706,0.3632075471698113,70621362,68,9
1,164,0.11827956989247312,0.5262267343485617,82116592,186,22
0,291,0.049019607843137254,0.3904899135446686,63631862,306,15
1,181,0.14622641509433962,0.657243816254417,69005895,212,31
0,35,0.125,0.41007194244604317,69532253,40,5
1,574,0.18926553672316385,0.5668491008600469,70659113,708,134
0,125,0.06015037593984962,0.2577092511013216,69497750,133,8
1,261,0.2627118644067797,0.7732142857142857,64002064,354,93
1,575,0.30133657351154314,0.6780487804878049,80124680,823,248
0,863,0.09633507853403141,0.37521917007597894,67810330,955,92
1,425,0.10714285714285714,0.5010940919037199,63628201,476,51
0,485,0.04339250493096647,0.25,63633570,507,22
1,45,0.1,0.5546875,69463772,50,5
0,214,0.13709677419354838,0.42446941323345816,70687610,248,34
0,277,0.014234875444839857,0.13896103896103895,80150003,281,4
0,82,0.023809523809523808,0.17073170731707318,80150874,84,2
1,696,0.1811764705882353,0.5126329787234043,65925636,850,154
1,232,0.23432343234323433,0.631578947368421,69234865,303,71
1,51,0.1774193548387097,0.524822695035461,74924346,62,11
1,10,0.23076923076923078,0.6714285714285714,74924353,13,3
0,273,0.06506849315068493,0.3356741573033708,63981820,292,19
0,291,0.09627329192546584,0.3991291727140784,65634114,322,31
0,437,0.07021276595744681,0.3751399776035834,67900105,470,33
0,78,0.04878048780487805,0.1125,69204870,82,4
1,86,0.21818181818181817,0.6382978723404256,70629384,110,24
1,106,0.152,0.6037735849056604,65201703,125,19
0,29,0.06451612903225806,0.46113989637305697,80150875,31,2
0,188,0.020833333333333332,0.21869782971619364,64359652,192,4
0,187,0.015789473684210527,0.15204678362573099,65675554,190,3
0,151,0.013071895424836602,0.15053763440860216,67004602,153,2
1,62,0.1506849315068493,0.5333333333333333,64967875,73,11
2,123,0.5305343511450382,0.8662790697674418,70567091,262,139
1,411,0.1629327902240326,0.6887550200803213,63632583,491,80
0,311,0.0220125786163522,0.15809768637532134,63632604,318,7
0,292,0.013513513513513514,0.12370062370062371,64501542,296,4
0,338,0.008797653958944282,0.08181818181818182,65132431,341,3
0,291,0.07911392405063292,0.2838468720821662,65467164,316,25
1,288,0.12462006079027356,0.571072319201995,67327330,329,41
0,157,0.1989795918367347,0.49141630901287553,67814222,196,39
0,258,0.007692307692307693,0.08684863523573201,70467166,260,2
0,349,0.008522727272727272,0.08333333333333333,70467264,352,3
0,29,0.03333333333333333,0.3563636363636364,70467460,30,1
0,214,0.02727272727272727,0.21658415841584158,70467544,220,6
0,336,0.01466275659824047,0.1218274111675127,70468335,341,5
0,237,0.0125,0.11473272490221642,70917280,240,3
0,78,0.04878048780487805,0.48507462686567165,80149915,82,4
0,83,0.011904761904761904,0.1488095238095238,82205867,84,1
0,57,0.06557377049180328,0.2676056338028169,64234450,61,4
0,21,0.045454545454545456,0.16842105263157894,69527864,22,1
1,13,0.07142857142857142,0.5,69528130,14,1
0,87,0.011363636363636364,0.13896457765667575,70917385,88,1
0,106,0.027522935779816515,0.20588235294117646,82134951,109,3
0,82,0.012048192771084338,0.07238605898123325,82134952,83,1
2,396,0.6203259827420902,0.7031963470319634,65950304,1043,647
1,63,0.4424778761061947,0.8292682926829268,73653412,113,50
1,289,0.37310195227765725,0.6504854368932039,590842,461,172
2,437,0.6087735004476276,0.7634854771784232,590933,1117,680
2,190,0.6339113680154143,0.6504854368932039,57193731,519,329
1,116,0.4703196347031963,0.6612903225806451,73442320,219,103
1,121,0.1986754966887417,0.6507936507936508,64400574,151,30
1,13,0.38095238095238093,0.75,80056242,21,8
0,31,0.0,0.0,66025274,31,0
1,29,0.06451612903225806,0.5411764705882353,66025344,31,2
0,152,0.07878787878787878,0.30752688172043013,63728791,165,13
0,40,0.047619047619047616,0.23756906077348067,70468363,42,2
0,258,0.011494252873563218,0.10394736842105264,70468566,261,3
0,339,0.18705035971223022,0.3218390804597701,73524710,417,78
0,57,0.0,0.0,80149969,57,0
1,88,0.22123893805309736,0.6057971014492753,68162472,113,25
0,74,0.03896103896103896,0.41114058355437666,80150907,77,3
0,66,0.014925373134328358,0.1894150417827298,80150912,67,1
0,131,0.10884353741496598,0.14150943396226415,80181293,147,16
2,144,0.556923076923077,0.9705882352941176,82007554,325,181
1,226,0.3430232558139535,0.6324110671936759,75277426,344,118
0,55,0.21428571428571427,0.36363636363636365,82046913,70,15
0,99,0.1,0.06726457399103139,80051972,110,11
0,136,0.1337579617834395,0.16417910447761194,80137610,157,21
0,260,0.029850746268656716,0.2237017310252996,80135355,268,8
0,10,0.0,0.0,80162907,10,0
0,4,0.0,0.0,82118288,4,0
1,775,0.39641744548286606,0.8567164179104477,68384211,1284,509
0,174,0.005714285714285714,0.06258322237017311,69006126,175,1
0,114,0.008695652173913044,0.09853249475890985,69858173,115,1
0,71,0.0,0.0,82206141,71,0
0,169,0.06629834254143646,0.4029574861367837,70923412,181,12
1,57,0.47706422018348627,0.9304347826086956,77536151,109,52
1,305,0.20365535248041775,0.5245098039215687,81965819,383,78
1,349,0.16105769230769232,0.5755627009646302,80168109,416,67
1,62,0.20512820512820512,0.7461928934010152,67888065,78,16
2,87,0.6588235294117647,0.9845360824742269,67085543,255,168
0,358,0.040214477211796246,0.20727673649393605,63628901,373,15
1,515,0.3586550435865504,0.7455197132616488,68741554,803,288
0,20,0.16666666666666666,0.3673469387755102,72844093,24,4
0,5,0.0,0.0,80163404,5,0
2,25,0.5901639344262295,0.9619047619047619,82059797,61,36
1,359,0.2567287784679089,0.8163522012578617,67327232,483,124
0,425,0.09381663113006397,0.4009216589861751,67722235,469,44
1,366,0.14685314685314685,0.5757250268528464,70922712,429,63
0,82,0.15463917525773196,0.4751131221719457,69886362,97,15
0,158,0.10227272727272728,0.3422330097087379,64099924,176,18
1,17,0.22727272727272727,0.7755102040816326,67976181,22,5
0,49,0.057692307692307696,0.16494845360824742,70463505,52,3
0,438,0.11156186612576065,0.49340369393139843,70922803,493,55
2,135,0.6164772727272727,0.9755351681957186,66072510,352,217
0,32,0.08571428571428572,0.3404255319148936,70463435,35,3
0,25,0.038461538461538464,0.2988505747126437,65542981,26,1
0,245,0.10909090909090909,0.10625,69536376,275,30
1,416,0.32247557003257327,0.6452513966480447,69979574,614,198
0,25,0.038461538461538464,0.2302158273381295,67467526,26,1
0,41,0.023809523809523808,0.1624548736462094,67467582,42,1
0,39,0.0,0.0,67467624,39,0
0,8,0.0,0.0,67468002,8,0
0,262,0.09655172413793103,0.47417840375586856,69527780,290,28
0,1,0.0,0.0,71619730,1,0
0,130,0.029850746268656716,0.2776659959758551,80150902,134,4
1,617,0.41069723018147086,0.8155241935483871,66009286,1047,430
1,363,0.21935483870967742,0.5242566510172144,62896911,465,102
1,35,0.2708333333333333,0.7789473684210526,67985386,48,13
0,35,0.05405405405405406,0.3162393162393162,70923314,37,2
2,42,0.5757575757575758,0.8518518518518519,69973484,99,57
1,166,0.22790697674418606,0.5523809523809524,70816620,215,49
1,214,0.14056224899598393,0.5091185410334347,64076901,249,35
1,160,0.26605504587155965,0.7480314960629921,64259384,218,58
0,26,0.10344827586206896,0.3853211009174312,69910302,29,3
1,117,0.10687022900763359,0.5438066465256798,70923580,131,14
1,131,0.32124352331606215,0.774798927613941,82053049,193,62
1,420,0.2459605026929982,0.5683890577507599,70760550,557,137
0,335,0.06685236768802229,0.33034571062740076,63628453,359,24
0,62,0.046153846153846156,0.45901639344262296,64026865,65,3
0,120,0.008264462809917356,0.0776255707762557,82205857,121,1
0,10,0.0,0.0,80150598,10,0
0,192,0.035175879396984924,0.166383701188455,82103944,199,7
0,91,0.021505376344086023,0.08250825082508251,69320566,93,2
1,7,0.125,0.6521739130434783,80150564,8,1
0,359,0.17471264367816092,0.4452690166975881,64929641,435,76
1,14,0.3,0.7924528301886793,64472681,20,6
0,19,0.05,0.25,65716490,20,1
0,237,0.17132867132867133,0.35671342685370744,60296516,286,49
0,801,0.12459016393442623,0.47123623011015914,69389341,915,114
0,77,0.07228915662650602,0.3424657534246575,69911905,83,6
1,308,0.40425531914893614,0.8443708609271523,80124978,517,209
0,387,0.06971153846153846,0.2954822954822955,64014874,416,29
1,142,0.11801242236024845,0.5367647058823529,64076831,161,19
0,101,0.0380952380952381,0.125,69910323,105,4
1,45,0.23728813559322035,0.6846153846153846,73650374,59,14
1,326,0.11413043478260869,0.5028089887640449,80149817,368,42
1,458,0.22504230118443316,0.6354941551540914,63767900,591,133
1,42,0.23636363636363636,0.6778523489932886,82109295,55,13
0,45,0.021739130434782608,0.041666666666666664,80155860,46,1
0,295,0.03908794788273615,0.2916160388821385,64026900,307,12
0,440,0.037199124726477024,0.2618825722273998,65132501,457,17
0,321,0.012307692307692308,0.11292200232828871,67469850,325,4
2,190,0.6752136752136753,0.96,69512492,585,395
2,448,0.5,0.9273504273504274,72322201,896,448
1,378,0.47058823529411764,0.951764705882353,69313930,714,336
0,74,0.075,0.26,70621803,80,6
1,67,0.1518987341772152,0.5,73650353,79,12
1,130,0.2073170731707317,0.6098191214470284,78763286,164,34
0,7,0.0,0.0,70918232,7,0
0,5,0.0,0.0,70918526,5,0
0,207,0.1446280991735537,0.38860971524288107,80135244,242,35
1,94,0.14545454545454545,0.5,60551785,110,16
1,48,0.22580645161290322,0.6,70635033,62,14
2,35,0.5070422535211268,0.8585858585858586,80180180,71,36
2,345,0.5133991537376587,0.944558521560575,80181007,709,364
0,125,0.038461538461538464,0.09290953545232274,69638520,130,5
1,101,0.495,0.9718875502008032,70212345,200,99
0,63,0.18181818181818182,0.42916666666666664,70769825,77,14
0,476,0.19185059422750425,0.45461658841940533,67809861,589,113
2,16,0.5555555555555556,0.9534883720930233,69577634,36,20
1,68,0.24444444444444444,0.5299145299145299,80118397,90,22
2,58,0.7211538461538461,0.9298245614035088,69981436,208,150
2,20,0.5348837209302325,0.8727272727272727,80172008,43,23
0,4,0.0,0.0,80163201,4,0
0,213,0.022935779816513763,0.20476858345021037,69638562,218,5
1,30,0.14285714285714285,0.6178343949044586,69878774,35,5
0,406,0.01694915254237288,0.11141060197663971,70468321,413,7
0,52,0.07142857142857142,0.45454545454545453,70916720,56,4
0,79,0.036585365853658534,0.39950980392156865,80149959,82,3
0,121,0.0,0.0,80150909,121,0
0,68,0.0,0.0,80150914,68,0
0,76,0.0,0.0,80150916,76,0
1,67,0.45081967213114754,0.901840490797546,69074642,122,55
0,70,0.14634146341463414,0.4319526627218935,82103878,82,12
1,91,0.14150943396226415,0.5327868852459017,70482433,106,15
1,80,0.14893617021276595,0.5665236051502146,67900371,94,14
1,207,0.26855123674911663,0.6164623467600701,70760613,283,76
0,465,0.13568773234200743,0.27979274611398963,68476723,538,73
2,19,0.5128205128205128,0.98,70587951,39,20
1,75,0.1935483870967742,0.6829268292682927,63702254,93,18
1,179,0.24472573839662448,0.7846153846153846,66395693,237,58
1,89,0.20535714285714285,0.5400593471810089,80180166,112,23
0,136,0.09333333333333334,0.2672672672672673,72866864,150,14
0,2406,0.13109425785482123,0.180566182096404,70812812,2769,363
2,210,0.5679012345679012,0.9318181818181818,75417454,486,276
1,48,0.4,0.9136690647482014,70634655,80,32
1,66,0.15384615384615385,0.658703071672355,63169036,78,12
0,150,0.0196078431372549,0.20378457059679767,64026501,153,3
0,194,0.049019607843137254,0.39849624060150374,64501486,204,10
0,461,0.043568464730290454,0.10460992907801418,67796575,482,21
0,419,0.06473214285714286,0.18324022346368715,67800432,448,29
1,52,0.11864406779661017,0.6464285714285715,69002640,59,7
0,108,0.04424778761061947,0.43320610687022904,70467012,113,5
0,88,0.011235955056179775,0.12211981566820276,80149971,89,1
0,409,0.13530655391120508,0.419838523644752,64001091,473,64
0,554,0.1490015360983103,0.4675572519083969,67049080,651,97
1,297,0.15625,0.6960193003618818,67758852,352,55
0,835,0.10980810234541578,0.1319796954314721,69587756,938,103
1,462,0.22483221476510068,0.6319587628865979,69704544,596,134
1,171,0.44299674267100975,0.8715953307392996,79682505,307,136
1,707,0.27783452502553624,0.6624815361890695,73739064,979,272
2,25,0.7252747252747253,0.9591836734693877,72410660,91,66
0,36,0.02702702702702703,0.12244897959183673,67782421,37,1
1,6,0.14285714285714285,0.7666666666666667,80150656,7,1
0,403,0.026570048309178744,0.15896188158961883,69006133,414,11
0,96,0.030303030303030304,0.3483709273182957,82206120,99,3
0,24,0.1724137931034483,0.48,69559952,29,5
1,170,0.31451612903225806,0.8227848101265823,69660311,248,78
0,194,0.05825242718446602,0.28160919540229884,64183623,206,12
1,756,0.180931744312026,0.5965494359654944,67814173,923,167
1,19,0.13636363636363635,0.5714285714285714,65209683,22,3
0,70,0.06666666666666667,0.4169278996865204,70918113,75,5
0,78,0.04878048780487805,0.42042755344418054,80149926,82,4
1,517,0.16747181964573268,0.5494505494505495,69548290,621,104
0,240,0.10780669144981413,0.43032159264931086,70474803,269,29
2,128,0.5241635687732342,0.8988095238095238,69992160,269,141
0,519,0.02626641651031895,0.15636363636363637,64501941,533,14
0,267,0.014760147601476014,0.14391143911439114,65671655,271,4
0,66,0.05714285714285714,0.4326647564469914,66025330,70,4
0,236,0.036734693877551024,0.1927346115035318,66025883,245,9
0,128,0.022900763358778626,0.18565400843881857,67886980,131,3
0,29,0.0,0.0,67896304,29,0
0,161,0.012269938650306749,0.11916264090177134,69638506,163,2
0,138,0.03496503496503497,0.3403441682600382,70467796,143,5
0,336,0.042735042735042736,0.22639780018331807,63633591,351,15
0,616,0.0680786686838124,0.3524590163934426,80149785,661,45
0,747,0.053231939163498096,0.27351097178683387,80149797,789,42
1,140,0.46360153256704983,0.8888888888888888,12162535,261,121
0,111,0.017699115044247787,0.1780821917808219,80149920,113,2
1,424,0.31280388978930307,0.7361809045226131,66931221,617,193
1,62,0.4205607476635514,0.9415584415584416,70629286,107,45
1,73,0.27722772277227725,0.8846153846153846,65206190,101,28
2,509,0.7011156782149148,0.9576354679802955,71571843,1703,1194
1,102,0.13559322033898305,0.5255972696245734,69912045,118,16
0,5,0.0,0.0,82006757,5,0
0,28,0.0967741935483871,0.3761467889908257,82103799,31,3
0,39,0.025,0.3130434782608696,70468475,40,1
0,162,0.024096385542168676,0.24664429530201343,80149948,166,4
0,301,0.1497175141242938,0.46380697050938335,81965796,354,53
1,105,0.375,0.8518518518518519,68274745,168,63
0,99,0.16806722689075632,0.26521739130434785,68318236,119,20
0,360,0.14691943127962084,0.23140495867768596,73346994,422,62
1,257,0.3016304347826087,0.7337110481586402,69169555,368,111
1,257,0.33419689119170987,0.7763532763532763,80135248,386,129
0,229,0.029661016949152543,0.2436472346786248,65671522,236,7
0,242,0.028112449799196786,0.2430453879941435,70466991,249,7
0,214,0.0228310502283105,0.17355371900826447,70467586,219,5
0,468,0.056451612903225805,0.38966202783300197,70467642,496,28
1,19,0.17391304347826086,0.5555555555555556,64231174,23,4
0,146,0.09876543209876543,0.4041353383458647,69497764,162,16
2,41,0.5060240963855421,0.8846153846153846,69129935,83,42
0,356,0.06561679790026247,0.2975557917109458,66512712,381,25
0,670,0.09703504043126684,0.46075085324232085,67900154,742,72
0,98,0.10909090909090909,0.4984709480122324,70543053,110,12
1,36,0.14285714285714285,0.5652173913043478,82009588,42,6
1,87,0.13861386138613863,0.5676392572944297,82009591,101,14
0,288,0.06493506493506493,0.2998745294855709,67858875,308,20
1,59,0.14492753623188406,0.5191256830601093,80135206,69,10
1,390,0.25430210325047803,0.6198125836680054,82008905,523,133
0,790,0.1532690246516613,0.40525672371638144,67299596,933,143
0,82,0.08888888888888889,0.4475920679886686,70173712,90,8
0,61,0.046875,0.3063973063973064,70922334,64,3
0,249,0.053231939163498096,0.2961832061068702,70923125,263,14
0,48,0.07692307692307693,0.45726495726495725,70923265,52,4
0,223,0.18613138686131386,0.4174573055028463,67513943,274,51
0,141,0.20786516853932585,0.3805970149253731,80140110,178,37
0,12,0.07692307692307693,0.08571428571428572,70760466,13,1
1,370,0.25553319919517103,0.6157354618015963,72522121,497,127
0,94,0.1826086956521739,0.37662337662337664,80135280,115,21
0,69,0.028169014084507043,0.17972350230414746,67040722,71,2
0,25,0.0,0.0,67051474,25,0
0,697,0.059379217273954114,0.2306855277475517,62835850,741,44
0,28,0.125,0.4854368932038835,80155853,32,4
1,61,0.1643835616438356,0.6270270270270271,80155854,73,12
0,274,0.1189710610932476,0.41531664212076586,64099364,311,37
0,45,0.1,0.44508670520231214,67900133,50,5
0,76,0.10588235294117647,0.38461538461538464,70474411,85,9
0,59,0.24358974358974358,0.44171779141104295,61611606,78,19
0,381,0.11600928074245939,0.47177848775292863,64150156,431,50
1,189,0.14864864864864866,0.6528735632183909,70923244,222,33
0,5,0.16666666666666666,0.3684210526315789,80167273,6,1
0,12,0.0,0.0,69481286,12,0
1,138,0.17857142857142858,0.5281501340482574,78166326,168,30
0,841,0.06555555555555556,0.2517114270668773,62838853,900,59
0,653,0.05635838150289017,0.21993127147766323,62839385,692,39
0,130,0.057971014492753624,0.33547008547008544,62840050,138,8
0,378,0.043037974683544304,0.13236549957301452,62840253,395,17
0,280,0.10828025477707007,0.4169453734671126,67905593,314,34
0,25,0.0,0.0,78166053,25,0
0,281,0.13803680981595093,0.31746031746031744,80118381,326,45
0,6,0.0,0.0,80150597,6,0
0,759,0.15946843853820597,0.4200700116686114,70174111,903,144
0,1622,0.19303482587064677,0.3997760358342665,709156,2010,388
0,28,0.034482758620689655,0.06896551724137931,62414100,29,1
0,971,0.07962085308056872,0.16135204081632654,62429493,1055,84
0,151,0.062111801242236024,0.40559440559440557,70173684,161,10
0,153,0.03773584905660377,0.07329842931937172,80149853,159,6
0,109,0.21014492753623187,0.49572649572649574,80180482,138,29
1,65,0.2073170731707317,0.6762295081967213,80135158,82,17
0,567,0.10142630744849446,0.40319715808170514,63166656,631,64
0,436,0.09355509355509356,0.19282051282051282,67792543,481,45
0,27,0.12903225806451613,0.2647058823529412,69886936,31,4
1,7,0.36363636363636365,0.8387096774193549,73533306,11,4
0,397,0.01488833746898263,0.12804328223624886,64026473,403,6
1,19,0.05,0.5448717948717948,64359043,20,1
0,200,0.033816425120772944,0.21951219512195122,64360065,207,7
0,153,0.0,0.0,69857921,153,0
0,63,0.0,0.0,80150031,63,0
0,30,0.0,0.0,82206163,30,0
0,238,0.11524163568773234,0.40540540540540543,70908173,269,31
0,56,0.125,0.42410714285714285,80153530,64,8
2,98,0.5739130434782609,0.9836956521739131,61888904,230,132
1,371,0.25201612903225806,0.5962025316455696,82143794,496,125
1,71,0.2755102040816326,0.6473684210526316,82143799,98,27
0,181,0.021621621621621623,0.18463810930576072,67004630,185,4
2,503,0.5107003891050583,0.9018232819074333,70225246,1028,525
0,686,0.09736842105263158,0.39035087719298245,80153516,760,74
0,33,0.08333333333333333,0.368,67067945,36,3
0,410,0.08277404921700224,0.35222319093286836,69857956,447,37
1,278,0.15757575757575756,0.5260273972602739,72866955,330,52
0,63,0.05970149253731343,0.19576719576719576,80149912,67,4
0,2,0.0,0.0,80172573,2,0
2,13,0.5666666666666667,0.95,68488336,30,17
0,362,0.1561771561771562,0.23433242506811988,69064772,429,67
1,95,0.4508670520231214,0.869281045751634,80062052,173,78
1,35,0.2222222222222222,0.5882352941176471,70013006,45,10
1,8,0.2,0.5135135135135135,70759220,10,2
1,223,0.21201413427561838,0.7025089605734767,67900455,283,60
0,141,0.06,0.2944915254237288,67886784,150,9
1,156,0.35,0.7142857142857143,67095973,240,84
1,16,0.42857142857142855,0.9024390243902439,69643294,28,12
1,130,0.336734693877551,0.698961937716263,82007134,196,66
1,227,0.46335697399527187,0.9336384439359268,82007298,423,196
0,146,0.21081081081081082,0.42857142857142855,13779332,185,39
0,2,0.0,0.0,80138893,2,0
0,35,0.05405405405405406,0.08571428571428572,69134065,37,2
1,102,0.25547445255474455,0.590027700831025,70761054,137,35
1,13,0.43478260869565216,0.9090909090909091,65859521,23,10
0,35,0.0,0.0,66803954,35,0
0,107,0.10084033613445378,0.42016806722689076,67122363,119,12
1,38,0.17391304347826086,0.6609195402298851,70468412,46,8
0,1512,0.24172517552657974,0.4823255813953488,73818115,1994,482
0,4,0.0,0.0,80150635,4,0
0,3,0.0,0.0,80150642,3,0
0,6,0.0,0.0,80150645,6,0
1,103,0.37575757575757573,0.8059071729957806,73975090,165,62
2,2,0.5,0.5,82102377,4,2
0,262,0.04727272727272727,0.21717171717171718,66876733,275,13
0,217,0.035555555555555556,0.14358974358974358,76805512,225,8
1,185,0.4606413994169096,0.9132653061224489,65602866,343,158
2,25,0.5689655172413793,0.8823529411764706,69733160,58,33
1,10,0.09090909090909091,0.5,68060405,11,1
1,76,0.3448275862068966,0.8641509433962264,69156556,116,40
0,83,0.07777777777777778,0.37065637065637064,80153519,90,7
1,8,0.3333333333333333,0.8571428571428571,70242655,12,4
0,116,0.12781954887218044,0.3740648379052369,70687582,133,17
1,81,0.22115384615384615,0.7683397683397684,70476350,104,23
0,6,0.0,0.0,80150517,6,0
0,8,0.0,0.0,80150684,8,0
0,220,0.11290322580645161,0.3713733075435203,64149442,248,28
1,4,0.3333333333333333,0.9,69910232,6,2
1,56,0.17647058823529413,0.5195530726256983,63188202,68,12
1,1282,0.18860759493670887,0.560183066361556,69712433,1580,298
0,93,0.1388888888888889,0.4583333333333333,80135204,108,15
1,101,0.12173913043478261,0.5279187817258884,63628950,115,14
1,47,0.21666666666666667,0.7225806451612903,67888814,60,13
1,697,0.22812846068660023,0.5749613601236476,73713213,903,206
0,116,0.072,0.2535612535612536,78762810,125,9
0,1013,0.12597066436583262,0.46469622331691296,80153517,1159,146
0,7,0.0,0.0,82006717,7,0
1,129,0.32105263157894737,0.8575342465753425,63844501,190,61
0,883,0.20522052205220523,0.2922222222222222,72425675,1111,228
1,108,0.42857142857142855,0.8540145985401459,80180183,189,81
0,98,0.010101010101010102,0.125,69006091,99,1
0,142,0.059602649006622516,0.4396135265700483,70467152,151,9
2,59,0.6549707602339181,0.972972972972973,80138987,171,112
1,20,0.13043478260869565,0.575,67403826,23,3
1,891,0.2989771833202203,0.7019748653500898,73701376,1271,380
0,104,0.018867924528301886,0.15991471215351813,80150873,106,2
1,16,0.36,0.85,69141142,25,9
0,196,0.07547169811320754,0.35753176043557167,68811484,212,16
1,40,0.3442622950819672,0.7887323943661971,73637725,61,21
0,12,0.07692307692307693,0.36538461538461536,70635152,13,1
0,128,0.09219858156028368,0.1111111111111111,67515042,141,13
0,1101,0.1752808988764045,0.31387181738366987,70841554,1335,234
1,3,0.25,0.8333333333333334,80165764,4,1
0,139,0.04794520547945205,0.1994535519125683,34609722,146,7
0,75,0.0625,0.33584905660377357,34609743,80,5
0,29,0.09375,0.4897959183673469,70481964,32,3
0,65,0.12162162162162163,0.4199134199134199,70621530,74,9
0,41,0.06818181818181818,0.29891304347826086,82150097,44,3
1,483,0.28761061946902655,0.6903283052351376,76116656,678,195
0,387,0.0325,0.21971252566735114,64026893,400,13
0,64,0.04477611940298507,0.27380952380952384,67467470,67,3
1,218,0.28052805280528054,0.592964824120603,67971085,303,85
0,197,0.03902439024390244,0.3073825503355705,70468286,205,8
0,642,0.06140350877192982,0.25601480567550894,82134974,684,42
0,197,0.024752475247524754,0.047435897435897434,62839763,202,5
0,275,0.05821917808219178,0.3351724137931035,70923272,292,17
0,41,0.08888888888888889,0.4258064516129032,67900910,45,4
1,78,0.1875,0.6331360946745562,65206176,96,18
1,171,0.3759124087591241,0.8884297520661157,82096420,274,103
0,102,0.02857142857142857,0.17627118644067796,63627830,105,3
0,216,0.23404255319148937,0.48169014084507045,82108564,282,66
1,204,0.30612244897959184,0.7277580071174378,80181594,294,90
0,268,0.01107011070110701,0.08397932816537468,65671662,271,3
0,440,0.1821561338289963,0.30228136882129275,69415094,538,98
0,245,0.07196969696969698,0.3878562577447336,69857984,264,19
0,113,0.05042016806722689,0.2032967032967033,67359572,119,6
0,33,0.0,0.0,67978295,33,0
0,82,0.10869565217391304,0.3610223642172524,80153596,92,10
1,29,0.21621621621621623,0.6785714285714286,65350894,37,8
1,471,0.32230215827338127,0.7362948960302458,69074866,695,224
1,439,0.24310344827586206,0.5433231396534148,67030355,580,141
1,643,0.35376884422110555,0.8226555246053854,63445746,995,352
1,78,0.22772277227722773,0.6908396946564885,65713053,101,23
0,831,0.12156448202959831,0.34379671150971597,68725545,946,115
1,202,0.26545454545454544,0.7577519379844961,67127571,275,73
0,155,0.07738095238095238,0.33455882352941174,64231090,168,13
1,11,0.15384615384615385,0.6481481481481481,64967826,13,2
0,109,0.00909090909090909,0.07296137339055794,65671585,110,1
0,361,0.05249343832020997,0.27086007702182285,80149792,381,20
1,184,0.1024390243902439,0.5750394944707741,82205860,205,21
1,13,0.38095238095238093,0.7647058823529411,68620972,21,8
2,11,0.5217391304347826,0.9393939393939394,69512366,23,12
0,729,0.07487309644670051,0.34465753424657536,66502604,788,59
0,22,0.0,0.0,67468324,22,0
0,44,0.08333333333333333,0.2976190476190476,67889605,48,4
0,374,0.06733167082294264,0.2816399286987522,67899615,401,27
0,247,0.06439393939393939,0.3530120481927711,70922733,264,17
0,141,0.0472972972972973,0.16121495327102803,64076985,148,7
1,58,0.23684210526315788,0.7735849056603774,64236466,76,18
0,59,0.06349206349206349,0.20833333333333334,67122153,63,4
0,173,0.059782608695652176,0.19569471624266144,69481335,184,11
0,37,0.0975609756097561,0.37168141592920356,70474404,41,4
0,169,0.155,0.46153846153846156,62413792,200,31
2,7,0.6956521739130435,0.9642857142857143,64475082,23,16
0,30,0.03225806451612903,0.2265625,67051460,31,1
1,48,0.26153846153846155,0.6052631578947368,70331366,65,17
1,409,0.3518225039619651,0.8176470588235294,73703840,631,222
0,917,0.2235393734123624,0.4968905472636816,82028910,1181,264
1,40,0.1836734693877551,0.5,73650381,49,9
0,54,0.1,0.2037914691943128,77688205,60,6
1,666,0.2164705882352941,0.6019563581640331,68155794,850,184
1,20,0.3939393939393939,0.8421052631578947,80137598,33,13
2,484,0.5701598579040853,0.9720588235294118,67421711,1126,642
0,1,0.0,0.0,66899126,1,0
1,284,0.1419939577039275,0.514367816091954,80118378,331,47
1,483,0.19900497512437812,0.5734870317002881,67922470,603,120
0,80,0.10112359550561797,0.48375451263537905,64399293,89,9
1,44,0.37142857142857144,0.8521739130434782,70760340,70,26
1,138,0.18823529411764706,0.608355091383812,70629846,170,32
1,5,0.2857142857142857,0.875,70630091,7,2
0,99,0.14655172413793102,0.4417808219178082,80128492,116,17
0,522,0.17405063291139242,0.48073836276083465,68161716,632,110
0,554,0.11217948717948718,0.3256059009483667,70001176,624,70
1,129,0.47560975609756095,0.8848167539267016,68199635,246,117
1,102,0.1206896551724138,0.5031446540880503,70916622,116,14
0,186,0.08823529411764706,0.40555555555555556,70916790,204,18
0,293,0.07570977917981073,0.35384615384615387,67068582,317,24
0,569,0.2030812324929972,0.4706413730803975,73194975,714,145
1,209,0.20833333333333334,0.5668549905838042,61772970,264,55
0,214,0.05309734513274336,0.29280397022332505,63169001,226,12
0,186,0.0,0.0,67469843,186,0
0,154,0.0375,0.2935323383084577,67887001,160,6
1,36,0.12195121951219512,0.575,70922495,41,5
0,136,0.014492753623188406,0.14724919093851133,80150021,138,2
1,706,0.2968127490039841,0.7319474835886215,63115612,1004,298
1,10,0.09090909090909091,0.5102040816326531,80163374,11,1
0,1,0.0,0.0,80165830,1,0
0,5,0.0,0.0,80165851,5,0
1,301,0.3370044052863436,0.8221884498480243,70818461,454,153
0,2,0.0,0.0,82102583,2,0
1,47,0.14545454545454545,0.5189873417721519,74924136,55,8
1,21,0.27586206896551724,0.8636363636363636,74924171,29,8
1,55,0.2028985507246377,0.7321428571428571,74436691,69,14
0,445,0.013303769401330377,0.10289115646258504,64026494,451,6
0,175,0.04371584699453552,0.35919540229885055,70917245,183,8
1,536,0.15987460815047022,0.5369340746624305,67810302,638,102
0,59,0.016666666666666666,0.1453900709219858,67434563,60,1
0,87,0.011363636363636364,0.018604651162790697,78540770,88,1
0,359,0.07474226804123711,0.24898785425101214,68647152,388,29
1,216,0.15953307392996108,0.5011820330969267,80165685,257,41
0,120,0.1891891891891892,0.41914191419141916,63615594,148,28
0,123,0.008064516129032258,0.08426966292134831,70467320,124,1
1,49,0.15517241379310345,0.5679012345679012,63991725,58,9
0,100,0.06542056074766354,0.35792349726775957,67455276,107,7
0,81,0.10989010989010989,0.3769633507853403,82040661,91,10
0,45,0.021739130434782608,0.07116104868913857,62836361,46,1
0,511,0.04307116104868914,0.13495575221238937,62838020,534,23
1,42,0.16,0.5389221556886228,82150093,50,8
0,1485,0.0547422024188415,0.09340369393139841,68242223,1571,86
1,26,0.1875,0.6549295774647887,70621796,32,6
0,166,0.13089005235602094,0.4604051565377532,78763510,191,25
0,1065,0.20164917541229385,0.3992673992673993,73816176,1334,269
0,27,0.06896551724137931,0.3173076923076923,82006675,29,2
1,523,0.23982558139534885,0.5252918287937743,69186915,688,165
0,743,0.2540160642570281,0.4577114427860697,70660576,996,253
0,99,0.14655172413793102,0.22660098522167488,80132315,116,17
0,624,0.1657754010695187,0.265770423991727,80137924,748,124
0,262,0.033210332103321034,0.1311706629055007,76805526,271,9
0,17,0.0,0.0,80150496,17,0
0,11,0.0,0.0,80150498,11,0
0,349,0.1382716049382716,0.3783783783783784,80118453,405,56
0,60,0.01639344262295082,0.1168091168091168,67467435,61,1
0,137,0.15950920245398773,0.1411764705882353,72425640,163,26
0,146,0.07006369426751592,0.342685370741483,67042584,157,11
0,5,0.0,0.0,80162861,5,0
0,4,0.0,0.0,80165768,4,0
1,87,0.25,0.7470355731225297,69704453,116,29
0,84,0.11578947368421053,0.36742424242424243,60909366,95,11
1,15,0.21052631578947367,0.6119402985074627,67792585,19,4
0,481,0.20627062706270627,0.4987320371935757,70686973,606,125
0,265,0.07665505226480836,0.3096446700507614,69497771,287,22
0,334,0.07734806629834254,0.44218551461245237,70923132,362,28
0,187,0.031088082901554404,0.06716417910447761,70001211,193,6
0,501,0.06355140186915888,0.20976116303219106,70001400,535,34
0,310,0.046153846153846156,0.12166172106824925,70001470,325,15
1,112,0.30864197530864196,0.601123595505618,80126444,162,50
1,51,0.3625,0.7411764705882353,82009538,80,29
0,67,0.11842105263157894,0.41118421052631576,69204695,76,9
0,113,0.07377049180327869,0.32186732186732187,69497792,122,9
1,326,0.32644628099173556,0.7957559681697612,80124656,484,158
0,186,0.1267605633802817,0.3010752688172043,70909356,213,27
0,17,0.0,0.0,67467463,17,0
0,114,0.20279720279720279,0.28187919463087246,70654682,143,29
1,25,0.24242424242424243,0.5084745762711864,70861854,33,8
0,103,0.046296296296296294,0.3090909090909091,82116588,108,5
0,101,0.019417475728155338,0.09046454767726161,82134978,103,2
0,111,0.02631578947368421,0.2737306843267108,69857746,114,3
0,79,0.0125,0.14420803782505912,70468622,80,1
1,80,0.4074074074074074,0.8523489932885906,73551772,135,55
1,918,0.32050333086602517,0.758694109297374,63445956,1351,433
1,30,0.2682926829268293,0.5816326530612245,65598036,41,11
0,106,0.061946902654867256,0.2692307692307692,73783542,113,7
1,49,0.4024390243902439,0.9640287769784173,70927801,82,33
1,14,0.2222222222222222,0.7096774193548387,75363715,18,4
0,762,0.09929078014184398,0.32079527135948416,68222546,846,84
1,46,0.16363636363636364,0.632768361581921,69890695,55,9
1,90,0.08163265306122448,0.511049723756906,70467971,98,8
1,487,0.26100151745068284,0.6688364524003255,68349176,659,172
1,259,0.24269005847953215,0.5780445969125214,70633542,342,83
0,139,0.09740259740259741,0.1490066225165563,70633696,154,15
1,313,0.3283261802575107,0.7350427350427351,80128484,466,153
1,8,0.2727272727272727,0.8947368421052632,70463491,11,3
0,75,0.0625,0.38153846153846155,82134982,80,5
1,56,0.16417910447761194,0.7224669603524229,82134986,67,11
0,149,0.1130952380952381,0.47843137254901963,70916895,168,19
1,2,0.3333333333333333,0.5714285714285714,80134770,3,1
0,9,0.0,0.0,80150575,9,0
0,1699,0.054535336672231496,0.13367830961621388,73366111,1797,98
1,469,0.22607260726072606,0.6056466302367942,80124655,606,137
1,126,0.37,0.9060913705583756,67509302,200,74
0,20,0.09090909090909091,0.15841584158415842,69510364,22,2
1,27,0.35714285714285715,0.8888888888888888,69887020,42,15
0,379,0.010443864229765013,0.07090464547677261,63633605,383,4
1,124,0.17880794701986755,0.5575221238938053,65713074,151,27
1,419,0.1988527724665392,0.5981912144702842,67049283,523,104
0,62,0.08823529411764706,0.3269230769230769,70908775,68,6
1,422,0.35176651305683565,0.736,74331775,651,229
0,142,0.2111111111111111,0.4720812182741117,80056641,180,38
1,184,0.38666666666666666,0.5757575757575758,72472883,300,116
0,152,0.3090909090909091,0.3194444444444444,72534693,220,68
1,229,0.43034825870646765,0.8442776735459663,72555651,402,173
0,835,0.215962441314554,0.47846515270164447,68533143,1065,230
0,47,0.04081632653061224,0.008620689655172414,65896936,49,2
0,28,0.0967741935483871,0.14084507042253522,65896964,31,3
1,52,0.2876712328767123,0.7081081081081081,70645673,73,21
1,361,0.28087649402390436,0.5558475689881734,66554383,502,141
1,436,0.34632683658170915,0.7236679058240396,70998312,667,231
2,27,0.5714285714285714,0.6,62829214,63,36
0,42,0.38235294117647056,0.13333333333333333,62829326,68,26
2,39,0.8354430379746836,0.96875,63205611,237,198
1,113,0.3391812865497076,0.7508417508417509,70349160,171,58
0,901,0.16186046511627908,0.23608247422680412,62510133,1075,174
1,106,0.46733668341708545,0.8980891719745223,62512086,199,93
1,238,0.2765957446808511,0.6228070175438597,70609203,329,91
0,72,0.1111111111111111,0.1509433962264151,63050785,81,9
0,51,0.08928571428571429,0.05319148936170213,63050792,56,5
1,68,0.3333333333333333,0.6502463054187192,80137161,102,34
1,208,0.2597864768683274,0.625968992248062,69622546,281,73
0,96,0.07692307692307693,0.0984251968503937,70659995,104,8
2,148,0.5147540983606558,0.9619771863117871,67154493,305,157
1,1117,0.3821902654867257,0.8494623655913979,66345104,1808,691
0,316,0.07331378299120235,0.21220527045769763,60509862,341,25
0,870,0.14789422135161606,0.41523809523809524,62530475,1021,151
1,69,0.3300970873786408,0.6318681318681318,70241150,103,34
1,161,0.45791245791245794,0.92,80180348,297,136
1,153,0.49,0.861878453038674,80042984,300,147
0,302,0.21558441558441557,0.419811320754717,80108595,385,83
1,621,0.3076923076923077,0.7306299782766111,68212144,897,276
1,247,0.2692307692307692,0.5462794918330308,82126796,338,91
1,232,0.44630071599045346,0.907843137254902,69383545,419,187
1,305,0.18230563002680966,0.544839255499154,63516460,373,68
1,210,0.42779291553133514,0.931350114416476,66379600,367,157
1,163,0.348,0.8024691358024691,80180346,250,87
1,886,0.2707818930041152,0.5554655870445344,67552562,1215,329
0,140,0.13580246913580246,0.2853881278538813,63141225,162,22
1,327,0.2482758620689655,0.5709677419354838,67942742,435,108
1,216,0.4965034965034965,0.9418604651162791,67736270,429,213
1,501,0.2110236220472441,0.5131868131868131,70618275,635,134
0,928,0.21819713563605728,0.4824654622741764,66931683,1187,259
0,422,0.15768463073852296,0.3094958968347011,68553632,501,79
1,583,0.3784648187633262,0.8089500860585198,65788625,938,355
1,394,0.3253424657534247,0.7672301690507152,69481846,584,190
0,103,0.176,0.3850267379679144,64164492,125,22
1,519,0.32421875,0.7901578458681523,69586104,768,249
1,126,0.19230769230769232,0.6266666666666667,54417566,156,30
0,962,0.08118433619866285,0.07875647668393783,69416424,1047,85
0,508,0.11188811188811189,0.13775065387968613,70627515,572,64
1,416,0.23105360443622922,0.5630712979890311,68540773,541,125
1,230,0.24092409240924093,0.5445859872611465,80114412,303,73
1,39,0.35,0.782051282051282,69948522,60,21
1,238,0.4251207729468599,0.8925438596491229,67552016,414,176
1,387,0.34071550255536626,0.7262872628726287,73524591,587,200
1,407,0.4931506849315068,0.9207650273224044,66993654,803,396
0,763,0.20850622406639005,0.37762669962917184,68238086,964,201
1,246,0.24074074074074073,0.6864608076009501,68534403,324,78
0,262,0.2492836676217765,0.4768976897689769,66390065,349,87
0,45,0.19642857142857142,0.3652173913043478,82150086,56,11
0,582,0.22913907284768212,0.49431230610134436,68543930,755,173
1,105,0.36363636363636365,0.8802816901408451,67557784,165,60
1,40,0.2857142857142857,0.6635514018691588,70660520,56,16
1,98,0.43023255813953487,0.8874172185430463,69154120,172,74
0,359,0.18594104308390022,0.3971518987341772,67226061,441,82
0,182,0.18385650224215247,0.2713347921225383,68338564,223,41
0,987,0.18497109826589594,0.372502937720329,70643111,1211,224
1,347,0.38035714285714284,0.8569725864123957,70613816,560,213
1,245,0.31564245810055863,0.6666666666666666,60449522,358,113
1,193,0.48118279569892475,0.8747203579418344,80043005,372,179
1,172,0.43973941368078173,0.7526501766784452,80176027,307,135
1,165,0.3037974683544304,0.6252983293556086,80180305,237,72
1,91,0.4887640449438202,0.8246753246753247,80174925,178,87
1,816,0.35748031496062993,0.6731927710843374,80172980,1270,454
1,218,0.4092140921409214,0.8198924731182796,72322103,369,151
2,86,0.7329192546583851,0.9870967741935484,67588031,322,236
1,69,0.28125,0.6582278481012658,82129379,96,27
0,29,0.09375,0.34615384615384615,61944904,32,3
1,24,0.1111111111111111,0.5526315789473685,61976222,27,3
1,117,0.35359116022099446,0.8622047244094488,61365605,181,64
0,154,0.16756756756756758,0.33915211970074816,82044809,185,31
1,771,0.32130281690140844,0.7493936944219887,68191053,1136,365
0,421,0.2071563088512241,0.337612323491656,70601342,531,110
0,298,0.10778443113772455,0.14098360655737704,80119375,334,36
0,120,0.16666666666666666,0.2557077625570776,63051723,144,24
0,132,0.12,0.2069767441860465,69417502,150,18
0,615,0.10218978102189781,0.12016293279022404,80104654,685,70
0,380,0.175704989154013,0.2957920792079208,69165901,461,81
0,781,0.15200868621064062,0.22433192686357242,74320204,921,140
0,1844,0.166741979213737,0.2734754956977179,82107803,2213,369
1,255,0.4151376146788991,0.9358178053830227,69165334,436,181
0,839,0.21072436500470368,0.28735632183908044,66471552,1063,224
1,1487,0.3489492119089317,0.7471590909090909,80145306,2284,797
1,370,0.3032015065913371,0.6798088410991637,66087630,531,161
0,487,0.15304347826086956,0.23835616438356164,69239786,575,88
1,1485,0.2801745031507513,0.6448362720403022,65312520,2063,578
1,1558,0.3157663592446201,0.790937640197398,80112396,2277,719
1,305,0.47322970639032813,0.8806818181818182,80062024,579,274
0,361,0.20659340659340658,0.33753943217665616,81956114,455,94
1,70,0.24731182795698925,0.6666666666666666,70042315,93,23
0,63,0.20253164556962025,0.47641509433962265,70042322,79,16
1,377,0.27079303675048355,0.6875,80121243,517,140
1,507,0.31486486486486487,0.749031007751938,63396865,740,233
1,484,0.41404358353510895,0.8660287081339713,70487816,826,342
2,44,0.580952380952381,0.9305555555555556,80062213,105,61
1,771,0.26919431279620853,0.5297723292469352,15841,1055,284
0,357,0.07751937984496124,0.09302325581395349,69903610,387,30
0,214,0.06140350877192982,0.13810741687979539,66111003,228,14
0,138,0.11538461538461539,0.25622775800711745,66111255,156,18
0,27,0.15625,0.3763440860215054,66224473,32,5
0,327,0.1865671641791045,0.4366013071895425,68241586,402,75
0,107,0.11570247933884298,0.24793388429752067,68558140,121,14
0,115,0.17857142857142858,0.416,82129397,140,25
0,1912,0.18948707079270877,0.34003407155025556,73266312,2359,447
0,772,0.21544715447154472,0.4261025029797378,81989526,984,212
1,623,0.22704714640198512,0.5077062556663645,68540031,806,183
1,173,0.34220532319391633,0.7742857142857142,82126720,263,90
1,195,0.3389830508474576,0.8369565217391305,66471370,295,100
2,9,0.8448275862068966,0.8823529411764706,63738822,58,49
2,63,0.671875,0.9504132231404959,80089520,192,129
2,8,0.6521739130434783,0.8461538461538461,70719845,23,15
2,64,0.7050691244239631,0.873015873015873,73956862,217,153
1,5,0.2857142857142857,0.8,69886670,7,2
1,378,0.3625632377740304,0.7894002789400278,73974971,593,215
0,396,0.27071823204419887,0.4857849196538937,64999816,543,147
0,98,0.19672131147540983,0.40764331210191085,69582765,122,24
1,456,0.24126455906821964,0.5783333333333334,66775891,601,145
0,479,0.20957095709570958,0.3565380997177799,70623742,606,127
1,149,0.3868312757201646,0.8364116094986808,70646065,243,94
0,778,0.1422271223814774,0.25500770416024654,74026183,907,129
1,437,0.34186746987951805,0.7989371124889283,65313024,664,227
0,237,0.11895910780669144,0.1488970588235294,66887240,269,32
0,31,0.03125,0.1368421052631579,69158082,32,1
0,38,0.09523809523809523,0.21052631578947367,69158145,42,4
1,647,0.381453154875717,0.8293172690763052,70486633,1046,399
1,249,0.3926829268292683,0.8671726755218216,80123785,410,161
1,124,0.46320346320346323,0.9578544061302682,80180002,231,107
0,199,0.20717131474103587,0.42091836734693877,68542432,251,52
1,1594,0.2761126248864669,0.5496062992125984,81956104,2202,608
1,266,0.39819004524886875,0.8364312267657993,67766671,442,176
0,636,0.11666666666666667,0.12935323383084577,67554893,720,84
2,452,0.5043859649122807,0.9476248477466505,70677082,912,460
2,617,0.5016155088852988,0.9545859305431879,64244264,1238,621
1,222,0.4351145038167939,0.9291044776119403,67556405,393,171
0,138,0.03496503496503497,0.016233766233766232,72900492,143,5
0,183,0.1201923076923077,0.205607476635514,72900506,208,25
0,258,0.1757188498402556,0.3617021276595745,66423105,313,55
0,83,0.12631578947368421,0.378698224852071,80124186,95,12
0,284,0.013888888888888888,0.017582417582417582,65400741,288,4
0,796,0.15767195767195769,0.24556795797767564,62793801,945,149
1,449,0.27697262479871176,0.6994047619047619,80121251,621,172
1,108,0.3374233128834356,0.7210682492581603,70057883,163,55
0,121,0.06201550387596899,0.33634719710669075,62840750,129,8
1,191,0.36333333333333334,0.8316633266533067,65835511,300,109
1,771,0.3236842105263158,0.674457429048414,70676375,1140,369
1,630,0.3564862104187947,0.8260869565217391,68230715,979,349
1,239,0.2364217252396166,0.5602716468590832,68785381,313,74
1,844,0.3848396501457726,0.8333333333333334,80118367,1372,528
1,1131,0.31078610603290674,0.632577754348972,68189702,1641,510
0,87,0.22321428571428573,0.4264705882352941,68353103,112,25
1,74,0.2815533980582524,0.7222222222222222,65299304,103,29
1,488,0.41346153846153844,0.8856209150326797,56175826,832,344
0,150,0.15730337078651685,0.46788990825688076,78763384,178,28
1,221,0.2961783439490446,0.6804915514592934,67414571,314,93
1,165,0.4745222929936306,0.9300699300699301,80129946,314,149
0,201,0.028985507246376812,0.0633693972179289,62835073,207,6
1,237,0.29673590504451036,0.6356382978723404,80180156,337,100
0,167,0.21962616822429906,0.44722222222222224,67160296,214,47
1,359,0.24101479915433405,0.5750332005312085,67160303,473,114
1,933,0.3438818565400844,0.762481089258699,67652200,1422,489
1,328,0.36923076923076925,0.8204334365325078,72896425,520,192
0,207,0.11538461538461539,0.22556390977443608,81965618,234,27
1,86,0.3008130081300813,0.6903765690376569,69176975,123,37
1,174,0.26582278481012656,0.578125,74576824,237,63
2,48,0.7922077922077922,0.9797979797979798,70546483,231,183
0,117,0.25,0.46153846153846156,68039384,156,39
0,87,0.17142857142857143,0.3717948717948718,80124181,105,18
0,189,0.05025125628140704,0.21549295774647886,62837096,199,10
0,185,0.04145077720207254,0.16591928251121077,62837936,193,8
0,670,0.056338028169014086,0.20341047503045068,64248772,710,40
0,1151,0.06877022653721683,0.2541461228148812,67498683,1236,85
0,303,0.06191950464396285,0.055226824457593686,62940325,323,20
0,384,0.1152073732718894,0.14689265536723164,68017985,434,50
2,1,0.6666666666666666,0.875,65277856,3,2
1,139,0.1524390243902439,0.5528846153846154,62530454,164,25
2,37,0.5432098765432098,0.8571428571428571,69973365,81,44
1,381,0.3304042179261863,0.7469879518072289,69177773,569,188
2,544,0.5198587819947044,0.9560853199498118,69167455,1133,589
1,47,0.4946236559139785,0.9493670886075949,70612570,93,46
0,754,0.04314720812182741,0.023890784982935155,82022545,788,34
0,7,0.125,0.2962962962962963,70678251,8,1
1,71,0.37168141592920356,0.7258064516129032,71288651,113,42
1,20,0.3939393939393939,0.7027027027027027,71288672,33,13
1,391,0.39001560062402496,0.883,70768075,641,250
2,1,0.9375,0.6666666666666666,70712432,16,15
1,366,0.4859550561797753,0.952755905511811,80125387,712,346
0,839,0.16183816183816183,0.2428285523682455,68544133,1001,162
1,595,0.2796610169491525,0.5697940503432495,81956108,826,231
1,138,0.28125,0.5625,67995193,192,54
1,182,0.39933993399339934,0.9113712374581939,81971173,303,121
2,9,0.7804878048780488,0.9333333333333333,80127843,41,32
2,57,0.5327868852459017,0.9259259259259259,70625835,122,65
2,198,0.6621160409556314,0.8407643312101911,70540694,586,388
2,62,0.7416666666666667,0.9294117647058824,80118340,240,178
0,184,0.17857142857142858,0.2755905511811024,69127534,224,40
2,64,0.5789473684210527,0.5681818181818182,70911393,152,88
1,311,0.4943089430894309,0.9686274509803922,70013993,615,304
0,15,0.0625,0.2815533980582524,69597892,16,1
0,68,0.04225352112676056,0.12437810945273632,60509505,71,3
0,325,0.07670454545454546,0.27936507936507937,60509526,352,27
0,443,0.11928429423459244,0.3634020618556701,63227150,503,60
0,119,0.048,0.13864306784660768,63237090,125,6
0,270,0.09698996655518395,0.3365695792880259,63237104,299,29
0,711,0.017955801104972375,0.006359300476947536,63426132,724,13
0,14,0.06666666666666667,0.328125,66225985,15,1
0,614,0.06259541984732825,0.1680327868852459,67796561,655,41
1,193,0.41515151515151516,0.8733031674208145,67982033,330,137
1,239,0.4025,0.9241573033707865,80125386,400,161
0,302,0.1881720430107527,0.4219269102990033,66423630,372,70
1,9,0.25,0.5238095238095238,69622483,12,3
1,69,0.3300970873786408,0.7931034482758621,69691412,103,34
1,124,0.3951219512195122,0.8888888888888888,82124935,205,81
0,346,0.06233062330623306,0.19734904270986744,60542384,369,23
0,1027,0.11541774332472007,0.2782485875706215,63226912,1161,134
0,66,0.0958904109589041,0.09865470852017937,70587006,73,7
1,168,0.3978494623655914,0.9203539823008849,67626972,279,111
1,257,0.2958904109589041,0.6335697399527187,67706856,365,108
0,1169,0.17849613492621222,0.2690288713910761,67706884,1423,254
0,109,0.2158273381294964,0.45390070921985815,67706030,139,30
1,286,0.4198782961460446,0.922272047832586,80120465,493,207
1,27,0.20588235294117646,0.6805555555555556,62841772,34,7
0,294,0.08695652173913043,0.2797319932998325,62841940,322,28
0,699,0.09689922480620156,0.13477975016436555,65995566,774,75
0,92,0.14814814814814814,0.27510917030567683,67554795,108,16
1,116,0.3409090909090909,0.6859504132231405,80163434,176,60
1,20,0.25925925925925924,0.92,60509540,27,7
1,237,0.3323943661971831,0.7685589519650655,81967322,355,118
0,671,0.18270401948842874,0.3092369477911647,72393426,821,150
0,782,0.24224806201550386,0.4467425025853154,62511001,1032,250
1,755,0.43991097922848665,0.9177888022678952,70072562,1348,593
1,441,0.2955271565495208,0.6452830188679245,70051191,626,185
1,92,0.3741496598639456,0.7926829268292683,79989623,147,55
2,207,0.6882530120481928,0.9963898916967509,66461563,664,457
0,1478,0.22373949579831934,0.43002114164904864,69607580,1904,426
1,317,0.28603603603603606,0.6751824817518248,80125347,444,127
1,115,0.24342105263157895,0.5151515151515151,63441483,152,37
0,59,0.04838709677419355,0.01910828025477707,67279954,62,3
1,225,0.3835616438356164,0.8461538461538461,67154423,365,140
0,638,0.1934260429835651,0.409009009009009,69736380,791,153
1,211,0.26223776223776224,0.5523255813953488,69176590,286,75
1,316,0.2834467120181406,0.5883333333333334,66906945,441,125
1,601,0.30680507497116494,0.5942982456140351,70605780,867,266
2,240,0.5330739299610895,0.951271186440678,66144785,514,274
1,347,0.2632696390658174,0.5901262916188289,65312366,471,124
1,60,0.24050632911392406,0.6181818181818182,70605451,79,19
1,700,0.2768595041322314,0.5941278065630398,70613711,968,268
0,884,0.11155778894472362,0.305019305019305,63237083,995,111
0,34,0.08108108108108109,0.11267605633802817,66110625,37,3
0,64,0.2,0.3333333333333333,66119676,80,16
1,228,0.2715654952076677,0.5523613963039015,54046503,313,85
0,38,0.17391304347826086,0.08235294117647059,67589116,46,8
0,684,0.16176470588235295,0.39106145251396646,74439876,816,132
1,224,0.3212121212121212,0.7728459530026109,78921430,330,106
0,482,0.08015267175572519,0.08637469586374696,68743402,524,42
0,360,0.21908893709327548,0.4876847290640394,69621293,461,101
1,556,0.30586766541822724,0.7331583552055994,70182756,801,245
1,389,0.2357563850687623,0.5748175182481752,64915263,509,120
0,921,0.06402439024390244,0.14676034348165495,67343276,984,63
0,557,0.162406015037594,0.2184873949579832,62745991,665,108
1,270,0.35714285714285715,0.8402597402597403,65944921,420,150
0,343,0.22573363431151242,0.38684719535783363,67652046,443,100
1,151,0.41015625,0.8870056497175142,70830123,256,105
1,736,0.4608058608058608,0.9131679389312977,72652223,1365,629
0,525,0.1796875,0.3783068783068783,80135426,640,115
0,650,0.21875,0.4418604651162791,68022416,832,182
2,56,0.6291390728476821,0.9681528662420382,80181566,151,95
1,176,0.4634146341463415,0.8533333333333334,73228302,328,152
0,367,0.21914893617021278,0.421978021978022,74338922,470,103
0,176,0.16981132075471697,0.3115079365079365,69723906,212,36
1,622,0.33547008547008544,0.7703349282296651,69839623,936,314
0,1163,0.19903581267217632,0.3843137254901961,70642922,1452,289
1,395,0.4795783926218709,0.9362363919129082,70475041,759,364
1,621,0.3584710743801653,0.8803165182987142,80121189,968,347
1,166,0.39416058394160586,0.6275862068965518,80176745,274,108
2,543,0.5013774104683195,0.9047013977128335,69979910,1089,546
0,216,0.05263157894736842,0.04054054054054054,67285652,228,12
0,49,0.0,0.0,67285666,49,0
0,31,0.03125,0.08421052631578947,73905944,32,1
1,37,0.32727272727272727,0.7532467532467533,66856111,55,18
1,560,0.2947103274559194,0.6768092105263158,66857315,794,234
1,728,0.36750651607298,0.8605166051660517,81967285,1151,423
1,557,0.24217687074829933,0.5125125125125125,67305574,735,178
1,776,0.298372513562387,0.6860313315926893,68235944,1106,330
1,601,0.21744791666666666,0.5053497942386831,80121046,768,167
1,82,0.3543307086614173,0.8493723849372385,70252805,127,45
1,259,0.2865013774104683,0.6334841628959276,67748863,363,104
1,337,0.1976190476190476,0.6301939058171745,67796421,420,83
0,37,0.075,0.3783783783783784,68357100,40,3
1,321,0.24113475177304963,0.5905077262693157,19856452,423,102
1,715,0.34643510054844606,0.7746358183376179,64193234,1094,379
0,901,0.18016378525932666,0.2690426275331936,65850890,1099,198
0,1555,0.12196499153020893,0.16693811074918566,68341420,1771,216
0,292,0.1536231884057971,0.1975806451612903,77677124,345,53
1,862,0.4214765100671141,0.9112964366944655,80125385,1490,628
1,49,0.2222222222222222,0.56,70769734,63,14
0,933,0.11647727272727272,0.176,72493701,1056,123
1,275,0.4270833333333333,0.9275568181818182,69056344,480,205
0,133,0.17901234567901234,0.3924050632911392,82135549,162,29
0,285,0.07766990291262135,0.11485451761102604,69416893,309,24
0,645,0.13189771197846567,0.22625698324022347,69417026,743,98
1,531,0.3201024327784891,0.7074829931972789,69512205,781,250
1,300,0.16666666666666666,0.531951640759931,60028472,360,60
0,531,0.10756302521008404,0.2829403606102635,63771246,595,64
2,179,0.8208208208208209,0.9743589743589743,80180300,999,820
1,118,0.3218390804597701,0.7391304347826086,69056554,174,56
0,120,0.1366906474820144,0.35384615384615387,70660401,139,19
1,243,0.41866028708133973,0.6985645933014354,80176796,418,175
2,225,0.6199324324324325,0.8656716417910447,69731592,592,367
1,18,0.28,0.7205882352941176,72759505,25,7
1,55,0.3373493975903614,0.7302631578947368,71761760,83,28
1,65,0.48,0.926605504587156,70646751,125,60
0,1008,0.22342064714946072,0.4932392710170488,66930871,1298,290
0,551,0.18851251840942562,0.2951002227171492,72393314,679,128
1,230,0.25806451612903225,0.6097560975609756,64030463,310,80
1,313,0.26869158878504673,0.6429548563611491,66425842,428,115
1,766,0.3055303717135086,0.7067796610169491,81967248,1103,337
1,497,0.3009845288326301,0.6601705237515225,81967250,711,214
1,132,0.2903225806451613,0.5905511811023622,81967257,186,54
1,893,0.25083892617449666,0.505564387917329,70645211,1192,299
0,797,0.17835051546391753,0.31650485436893205,68535502,970,173
0,559,0.13198757763975155,0.19140225179119755,68534382,644,85
1,887,0.25898078529657476,0.5453874538745388,80108875,1197,310
1,135,0.41304347826086957,0.9233716475095786,68536440,230,95
1,468,0.24758842443729903,0.5961538461538461,80121171,622,154
1,29,0.3695652173913043,0.9047619047619048,67591524,46,17
0,1012,0.11150131694468832,0.13339824732229796,70176260,1139,127
1,302,0.3406113537117904,0.8392857142857143,63100765,458,156
0,176,0.1065989847715736,0.1623931623931624,67598475,197,21
0,749,0.10406698564593302,0.08498896247240618,67706786,836,87
0,162,0.19,0.29577464788732394,67840234,200,38
1,117,0.25949367088607594,0.5304054054054054,69177045,158,41
1,503,0.31377899045020463,0.7595066803699897,80120463,733,230
1,180,0.305019305019305,0.7448132780082988,82126678,259,79
0,667,0.03473227206946455,0.020955574182732608,82011858,691,24
1,235,0.4431279620853081,0.8941176470588236,72322096,422,187
1,677,0.32837301587301587,0.7349480968858132,65924222,1008,331
0,434,0.22361359570661896,0.37343927355278095,70677040,559,125
1,185,0.27734375,0.6716791979949874,63099064,256,71
1,186,0.28185328185328185,0.6586345381526104,74158644,259,73
1,172,0.4723926380368098,0.9676724137931034,67557714,326,154
1,441,0.3717948717948718,0.8128400435255713,579411,702,261
1,508,0.23030303030303031,0.5324568611339359,81979691,660,152
0,368,0.03664921465968586,0.10535405872193437,68798401,382,14
1,7,0.46153846153846156,0.9032258064516129,68402012,13,6
0,691,0.1511056511056511,0.3113207547169811,70617645,814,123
1,158,0.3629032258064516,0.7926136363636364,69621720,248,90
1,996,0.24085365853658536,0.5319634703196348,80117893,1312,316
0,373,0.1961206896551724,0.27514231499051234,80180235,464,91
1,921,0.43600734843845684,0.9192307692307692,65808323,1633,712
2,202,0.5345622119815668,0.9639278557114228,66197691,434,232
2,400,0.5085995085995086,0.9495060373216246,80159810,814,414
1,711,0.30157170923379173,0.6946619217081851,73818472,1018,307
1,678,0.322,0.7576006573541495,64929123,1000,322
0,1251,0.21714643304130163,0.4201457919151756,80096142,1598,347
1,385,0.15011037527593818,0.5572782084409992,82049139,453,68
0,125,0.20382165605095542,0.38108882521489973,67556664,157,32
0,376,0.2150313152400835,0.4896551724137931,70850710,479,103
0,123,0.22641509433962265,0.38188976377952755,80180219,159,36
1,318,0.3470225872689938,0.8657342657342657,80150944,487,169
0,866,0.1243680485338726,0.15040106951871657,65906491,989,123
1,337,0.25442477876106195,0.5377094972067039,70207312,452,115
0,394,0.1740041928721174,0.2404255319148936,70658392,477,83
1,474,0.3238231098430813,0.771513353115727,70072240,701,227
0,793,0.1536819637139808,0.21271186440677967,69179005,937,144
0,452,0.2179930795847751,0.3879781420765027,70800373,578,126
1,483,0.41454545454545455,0.8891170431211499,69043443,825,342
0,780,0.056831922611850064,0.03688853247794707,73245690,827,47
1,252,0.40705882352941175,0.9131403118040089,69152503,425,173
1,398,0.3692551505546751,0.7722602739726028,68400605,631,233
1,713,0.36168307967770813,0.7795497185741088,68401354,1117,404
1,403,0.3111111111111111,0.7403846153846154,82126745,585,182
1,320,0.40298507462686567,0.9091928251121076,67661433,536,216
2,430,0.575098814229249,0.9608040201005025,82143534,1012,582
1,146,0.3652173913043478,0.8506944444444444,63767683,230,84
0,492,0.153184165232358,0.18054054054054053,68532982,581,89
1,210,0.3137254901960784,0.6350210970464135,70509166,306,96
1,623,0.3537344398340249,0.8006872852233677,67994381,964,341
0,334,0.09973045822102426,0.1038135593220339,80180230,371,37
0,193,0.18907563025210083,0.32786885245901637,80180233,238,45
1,445,0.3338323353293413,0.8063157894736842,80111780,668,223
0,497,0.20352564102564102,0.4559915164369035,70642761,624,127
1,81,0.3360655737704918,0.6274509803921569,69932422,122,41
0,188,0.248,0.45740740740740743,69147001,250,62
1,211,0.30363036303630364,0.6444444444444445,68943105,303,92
0,1061,0.18006182380216385,0.31412786108918705,67877110,1294,233
1,2799,0.3815731330092797,0.855515587529976,68311775,4526,1727
1,35,0.2553191489361702,0.5757575757575758,70634424,47,12
0,564,0.07236842105263158,0.09871244635193133,67120060,608,44
1,17,0.2916666666666667,0.6612903225806451,68567023,24,7
0,139,0.12578616352201258,0.2181208053691275,70489202,159,20
0,3,0.0,0.0,80167084,3,0
2,31,0.6219512195121951,0.5161290322580645,61843383,82,51
0,582,0.20600272851296045,0.3587140439932318,73940713,733,151
1,306,0.3867735470941884,0.7976190476190477,81989274,499,193
1,637,0.33088235294117646,0.7513134851138353,67552415,952,315
1,46,0.3698630136986301,0.8717948717948718,69183485,73,27
1,20,0.42857142857142855,0.7037037037037037,70646373,35,15
0,98,0.19672131147540983,0.4198895027624309,64163470,122,24
1,454,0.24584717607973422,0.5536529680365296,66930724,602,148
1,251,0.44222222222222224,0.905511811023622,82023523,450,199
1,104,0.30666666666666664,0.625,75660613,150,46
0,451,0.15858208955223882,0.3047977422389464,72522884,536,85
0,604,0.1881720430107527,0.29417879417879417,70206955,744,140
1,459,0.29709035222052066,0.6722797927461139,69703844,653,194
1,401,0.30139372822299654,0.6798365122615804,66856944,574,173
0,72,0.25773195876288657,0.4805194805194805,69183611,97,25
1,35,0.4444444444444444,0.8736842105263158,81989152,63,28
2,567,0.5517786561264822,0.9720744680851063,73430350,1265,698
1,515,0.3223684210526316,0.7571560480147738,80120424,760,245
1,693,0.3425047438330171,0.8124488124488124,80120447,1054,361
2,12,0.5384615384615384,0.9772727272727273,70612332,26,14
1,606,0.2140077821011673,0.5309446254071661,64222480,771,165
0,1241,0.14354727398205658,0.21686135093956324,70614761,1449,208
0,1036,0.13450292397660818,0.2195266272189349,70614775,1197,161
0,652,0.09192200557103064,0.13832599118942732,70642985,718,66
1,207,0.25806451612903225,0.5764705882352941,72906722,279,72
0,870,0.0861344537815126,0.09205903021784961,70617771,952,82
0,903,0.08417849898580122,0.08581235697940504,81980461,986,83
0,356,0.016574585635359115,0.0,81999951,362,6
0,570,0.08945686900958466,0.09822866344605476,82000078,626,56
1,343,0.330078125,0.7612809315866085,70676872,512,169
1,878,0.35912408759124087,0.8256041802743305,69184122,1370,492
0,694,0.14108910891089108,0.2872168284789644,70642852,808,114
1,539,0.23109843081312412,0.5,68542383,701,162
1,325,0.2793791574279379,0.626358695652174,65312394,451,126
1,85,0.44805194805194803,0.8405797101449275,80134784,154,69
1,288,0.2596401028277635,0.5261669024045261,69214264,389,101
0,485,0.16523235800344235,0.31448763250883394,66931725,581,96
1,165,0.4642857142857143,0.9269005847953217,80096380,308,143
0,1606,0.07113938692886061,0.06677079265911753,80121877,1729,123
0,344,0.12020460358056266,0.19710144927536233,82011413,391,47
0,489,0.07034220532319392,0.08006962576153177,72785720,526,37
0,488,0.08785046728971962,0.13644214162348878,80098760,535,47
0,351,0.10459183673469388,0.17370892018779344,80119044,392,41
0,1257,0.18057366362451108,0.3578995854444956,68535474,1534,277
0,269,0.21114369501466276,0.3944153577661431,69165950,341,72
2,254,0.594896331738437,0.9659367396593674,402591,627,373
1,344,0.3064516129032258,0.69901547116737,69177801,496,152
0,210,0.2808219178082192,0.47580645161290325,80118332,292,82
2,58,0.532258064516129,0.8441558441558441,80173002,124,66
2,23,0.6515151515151515,0.9259259259259259,69069294,66,43
1,698,0.40847457627118644,0.8426073131955485,70713132,1180,482
2,372,0.5344180225281602,0.9691289966923925,80123457,799,427
1,5,0.375,0.9,68241355,8,3
0,137,0.21714285714285714,0.4605678233438486,68641923,175,38
1,124,0.2392638036809816,0.6156941649899397,62795593,163,39
1,943,0.2807017543859649,0.6755555555555556,63283395,1311,368
1,466,0.38603425559947296,0.8748685594111462,80121236,759,293
1,186,0.3111111111111111,0.6766666666666666,80136389,270,84
1,503,0.2965034965034965,0.6680080482897385,69176814,715,212
1,876,0.2651006711409396,0.5613905325443787,71797544,1192,316
2,19,0.5,0.9444444444444444,61566281,38,19
0,507,0.21395348837209302,0.44079885877318115,67813585,645,138
1,409,0.3599374021909233,0.7732394366197183,67994374,639,230
1,933,0.35118219749652296,0.7870315288518739,69998222,1438,505
0,952,0.2086450540315877,0.36642238507661556,70207851,1203,251
1,12,0.29411764705882354,0.5,69666604,17,5
1,545,0.32213930348258707,0.6861252115059222,74335786,804,259
0,11,0.21428571428571427,0.2857142857142857,70013244,14,3
1,350,0.4166666666666667,0.8898007033997656,69057961,600,250
1,3,0.4,0.8888888888888888,76694961,5,2
0,325,0.04129793510324484,0.12511848341232226,62839994,339,14
0,258,0.12244897959183673,0.1875968992248062,80071026,294,36
0,127,0.16993464052287582,0.27459016393442626,67281914,153,26
0,566,0.12248062015503876,0.20150375939849624,80119327,645,79
0,123,0.21153846153846154,0.3387096774193548,82005337,156,33
0,504,0.2125,0.4616915422885572,70627725,640,136
1,1328,0.2556053811659193,0.5123751628310899,67556643,1784,456
1,414,0.4375,0.927536231884058,65008503,736,322
1,83,0.30833333333333335,0.672514619883041,65859563,120,37
1,305,0.25970873786407767,0.5266457680250783,67551806,412,107
0,794,0.23062015503875968,0.47257383966244726,68538743,1032,238
1,612,0.2765957446808511,0.5819158460161146,70628950,846,234
1,185,0.30970149253731344,0.6948228882833788,70642663,268,83
0,509,0.20094191522762953,0.4537878787878788,80180490,637,128
1,277,0.2671957671957672,0.5201793721973094,70690620,378,101
0,228,0.19434628975265017,0.3968253968253968,67252864,283,55
1,215,0.48687350835322196,0.9513888888888888,82023517,419,204
1,66,0.37142857142857144,0.8128654970760234,61439840,105,39
0,289,0.20604395604395603,0.45518453427065025,67428396,364,75
0,604,0.06501547987616099,0.05974025974025974,67706464,646,42
1,410,0.27943760984182775,0.6305931321540063,69177073,569,159
1,165,0.4169611307420495,0.9276315789473685,70207452,283,118
1,1445,0.31807456347333646,0.6897671900378993,82145552,2119,674
0,236,0.05220883534136546,0.017543859649122806,67159652,249,13
0,369,0.174496644295302,0.30952380952380953,68543321,447,78
0,580,0.10906298003072197,0.13087490961677511,67703461,651,71
1,41,0.4383561643835616,0.8983050847457628,74873652,73,32
0,489,0.2176,0.4547738693467337,66423581,625,136
1,657,0.22887323943661972,0.5497287522603979,68541543,852,195
2,38,0.5681818181818182,0.9772727272727273,76904324,88,50
0,1126,0.06942148760330578,0.0460205739036275,80119374,1210,84
1,110,0.34911242603550297,0.8034188034188035,70064162,169,59
0,465,0.05295315682281059,0.20454545454545456,62834835,491,26
1,109,0.2585034013605442,0.6463414634146342,74020373,147,38
0,219,0.10245901639344263,0.12636505460218408,63781354,244,25
1,144,0.3333333333333333,0.773109243697479,80180157,216,72
2,33,0.777027027027027,0.9848484848484849,80018680,148,115
1,167,0.3552123552123552,0.7635135135135135,74045405,259,92
1,46,0.3235294117647059,0.75,70078232,68,22
1,90,0.46107784431137727,0.9151943462897526,82002232,167,77
1,51,0.43956043956043955,0.8888888888888888,73071691,91,40
1,9,0.47058823529411764,0.8571428571428571,80141348,17,8
1,572,0.4175152749490835,0.8187403993855606,80174916,982,410
1,39,0.44285714285714284,0.82,66815532,70,31
0,524,0.16957210776545167,0.252400548696845,70566622,631,107
0,144,0.19553072625698323,0.2988505747126437,70566734,179,35
0,240,0.27492447129909364,0.4682926829268293,70566825,331,91
0,376,0.10688836104513064,0.17159763313609466,70566860,421,45
0,635,0.03201219512195122,0.028968713789107765,70566881,656,21
2,62,0.7660377358490567,0.9683544303797469,80181547,265,203
2,4,0.5555555555555556,0.9523809523809523,82002265,9,5
2,26,0.8074074074074075,0.96875,69058003,135,109
2,54,0.8050541516245487,0.9696969696969697,70893263,277,223
2,75,0.7685185185185185,0.9798994974874372,69179110,324,249
0,204,0.18072289156626506,0.3021276595744681,68657855,249,45
0,787,0.17331932773109243,0.3017241379310345,80118631,952,165
1,503,0.43035107587768967,0.8681818181818182,68553303,883,380
0,165,0.07303370786516854,0.060665362035225046,69416886,178,13
0,392,0.16059957173447537,0.29498164014687883,70627543,467,75
0,493,0.075046904315197,0.05,70642593,533,40
0,70,0.27835051546391754,0.4967741935483871,70673736,97,27
0,166,0.13541666666666666,0.2127659574468085,60800544,192,26
1,407,0.34248788368336025,0.7624521072796935,74091465,619,212
1,544,0.24444444444444444,0.5616083009079118,68540374,720,176
1,163,0.33739837398373984,0.7947598253275109,69183450,246,83
0,261,0.13,0.2292358803986711,73914442,300,39
0,321,0.08285714285714285,0.10497237569060773,74072670,350,29
1,143,0.32547169811320753,0.7162790697674418,80180102,212,69
1,136,0.2765957446808511,0.5724137931034483,69611262,188,52
1,239,0.23885350318471338,0.5569852941176471,70618380,314,75
1,67,0.2872340425531915,0.5874125874125874,69183583,94,27
1,699,0.4680365296803653,0.9351211072664359,79790844,1314,615
0,62,0.10144927536231885,0.10309278350515463,68784114,69,7
0,817,0.036556603773584904,0.024173027989821884,70606851,848,31
0,199,0.03864734299516908,0.03819444444444445,70607845,207,8
1,86,0.2711864406779661,0.7298387096774194,69559126,118,32
1,57,0.36666666666666664,0.8481012658227848,61835130,90,33
1,552,0.30038022813688214,0.667004048582996,66856930,789,237
1,74,0.3018867924528302,0.5898876404494382,66856986,106,32
1,314,0.25059665871121717,0.5375552282768777,69183625,419,105
1,197,0.3111888111888112,0.6888412017167382,69183786,286,89
0,724,0.20700985761226726,0.3518659558263519,69184374,913,189
0,658,0.1975609756097561,0.31546231546231546,69184430,820,162
1,201,0.3619047619047619,0.84,69608924,315,114
0,421,0.21161048689138576,0.442838370565046,68545582,534,113
0,320,0.20199501246882792,0.39448275862068966,77676641,401,81
2,287,0.5271828665568369,0.9720394736842105,80096394,607,320
0,216,0.16279069767441862,0.341421143847487,80098571,258,42
0,211,0.16600790513833993,0.36538461538461536,80098585,253,42
0,465,0.11764705882352941,0.15933098591549297,80119396,527,62
0,707,0.11069182389937107,0.1396457765667575,80119397,795,88
1,1267,0.39406982305117166,0.8243654822335026,74332251,2091,824
1,34,0.39285714285714285,0.8285714285714286,69183856,56,22
0,465,0.18848167539267016,0.3984375,68544203,573,108
0,665,0.24431818181818182,0.4908933217692975,74320211,880,215
1,121,0.4097560975609756,0.9377049180327869,67305665,205,84
1,206,0.4744897959183674,0.9553072625698324,65008622,392,186
1,65,0.4396551724137931,0.8373493975903614,81976033,116,51
1,347,0.31287128712871287,0.6926345609065155,69184766,505,158
1,93,0.29545454545454547,0.6336633663366337,82126618,132,39
1,314,0.29596412556053814,0.7265745007680492,69621692,446,132
1,546,0.29457364341085274,0.7230215827338129,68533444,774,228
1,215,0.36950146627565983,0.7814070351758794,67346790,341,126
1,323,0.3501006036217304,0.8062015503875969,67552282,497,174
0,313,0.1953727506426735,0.29806259314456035,68533101,389,76
1,844,0.2931323283082077,0.5614849187935035,80162919,1194,350
1,477,0.2880597014925373,0.693200663349917,67363492,670,193
0,628,0.11299435028248588,0.1424892703862661,69101522,708,80
0,261,0.14705882352941177,0.2737430167597765,80097136,306,45
1,108,0.4517766497461929,0.8641975308641975,82021233,197,89
1,249,0.3412698412698413,0.7303754266211604,60805080,378,129
1,425,0.29401993355481726,0.6504424778761062,81967295,602,177
1,545,0.2922077922077922,0.6939799331103679,63283290,770,225
1,664,0.3747645951035782,0.8340113913751017,67716733,1062,398
1,367,0.25557809330628806,0.5178268251273345,63959721,493,126
1,139,0.2760416666666667,0.6730038022813688,69154533,192,53
1,109,0.31446540880503143,0.6727272727272727,67087552,159,50
1,446,0.26885245901639343,0.6390197926484449,70760592,610,164
0,829,0.20972354623450906,0.4468242245199409,68540010,1049,220
0,643,0.10570236439499305,0.1466957153231663,80098354,719,76
1,29,0.3409090909090909,0.7543859649122807,65289735,44,15
2,207,0.649746192893401,0.9863760217983651,57042426,591,384
1,808,0.36477987421383645,0.7126137841352406,80055640,1272,464
0,396,0.17154811715481172,0.27161997563946405,70207585,478,82
1,270,0.31297709923664124,0.7536231884057971,80097941,393,123
1,9,0.4375,0.8,65708286,16,7
0,467,0.07524752475247524,0.06036446469248292,72603902,505,38
1,327,0.3326530612244898,0.755700325732899,68532786,490,163
0,554,0.10932475884244373,0.11352657004830918,79788191,622,68
0,203,0.20392156862745098,0.45151033386327505,19856060,255,52
2,108,0.5364806866952789,0.9432989690721649,82041321,233,125
1,456,0.29411764705882354,0.7175757575757575,67942630,646,190
1,111,0.22916666666666666,0.516260162601626,82091051,144,33
0,795,0.1945288753799392,0.3508902077151335,70215803,987,192
0,845,0.2050799623706491,0.39436619718309857,70215824,1063,218
0,208,0.1072961373390558,0.11483253588516747,67136916,233,25
1,530,0.2729766803840878,0.5735475896168108,70644826,729,199
0,114,0.18571428571428572,0.21495327102803738,70252343,140,26
0,1274,0.22079510703363914,0.41323461360481256,81971208,1635,361
1,51,0.2608695652173913,0.5714285714285714,65616355,69,18
1,54,0.28,0.5849056603773585,65616383,75,21
0,50,0.23076923076923078,0.37142857142857144,65616404,65,15
1,133,0.2692307692307692,0.5645161290322581,80027906,182,49
1,77,0.45,0.7610619469026548,70117152,140,63
1,183,0.48739495798319327,0.8987341772151899,80155222,357,174
2,302,0.5465465465465466,0.8438438438438438,69564663,666,364
1,475,0.35020519835841313,0.7666034155597723,80140048,731,256
1,154,0.2837209302325581,0.643979057591623,82047600,215,61
1,449,0.3781163434903047,0.8816234498308907,66931053,722,273
0,359,0.20222222222222222,0.4,66931970,450,91
0,369,0.2360248447204969,0.47523427041499333,80108686,483,114
0,844,0.1440162271805274,0.1727699530516432,70653870,986,142
1,655,0.3463073852295409,0.8167388167388168,81976677,1002,347
1,517,0.2082695252679939,0.593505039193729,65276470,653,136
0,414,0.18503937007874016,0.3700384122919334,73346812,508,94
0,13,0.07142857142857142,0.24324324324324326,62901433,14,1
0,109,0.035398230088495575,0.004975124378109453,73700732,113,4
0,320,0.1794871794871795,0.3213885778275476,80137641,390,70
0,397,0.2012072434607646,0.4042838018741633,68536496,497,100
0,237,0.21262458471760798,0.46653543307086615,68537525,301,64
1,382,0.27514231499051234,0.5280701754385965,66029565,527,145
1,688,0.4017391304347826,0.8851540616246498,63445690,1150,462
1,16,0.3333333333333333,0.6904761904761905,70562415,24,8
1,8,0.38461538461538464,0.6470588235294118,63686560,13,5
2,176,0.5056179775280899,0.9683972911963883,67149110,356,180
0,863,0.21115173674588666,0.411522633744856,70642446,1094,231
0,2215,0.23063563737408824,0.47513293712855803,76043380,2879,664
0,1044,0.13,0.13247863247863248,66931816,1200,156
0,415,0.05466970387243736,0.030425963488843813,72749110,439,24
1,412,0.49261083743842365,0.947136563876652,80159818,812,400
1,246,0.380352644836272,0.8306306306306306,67203871,397,151
0,964,0.20723684210526316,0.4980544747081712,68633516,1216,252
1,909,0.3683113273106324,0.7916666666666666,80124981,1439,530
0,298,0.06583072100313479,0.0547945205479452,79822463,319,21
1,90,0.25,0.5727699530516432,70641774,120,30
0,429,0.10438413361169102,0.11400651465798045,68539492,479,50
0,1075,0.20429311621021465,0.42462462462462464,68534165,1351,276
0,175,0.2584745762711864,0.49261083743842365,70645575,236,61
1,77,0.2803738317757009,0.6436781609195402,75892824,107,30
0,76,0.14606741573033707,0.16778523489932887,69498485,89,13
1,138,0.28865979381443296,0.7311827956989247,69421625,194,56
2,132,0.5875,0.8671875,80176777,320,188
1,530,0.3575757575757576,0.7280163599182005,69003361,825,295
0,215,0.11522633744855967,0.14747474747474748,70712166,243,28
0,396,0.029411764705882353,0.0033112582781456954,80181315,408,12
1,216,0.3394495412844037,0.6552706552706553,82108566,327,111
0,15,0.11764705882352941,0.4074074074074074,69416480,17,2
0,625,0.19768934531450577,0.4177215189873418,69701730,779,154
0,518,0.21036585365853658,0.4177570093457944,73266396,656,138
1,514,0.2006220839813375,0.629746835443038,69084491,643,129
1,2,0.3333333333333333,0.6666666666666666,68143824,3,1
1,181,0.3758620689655172,0.8397790055248618,82126640,290,109
1,493,0.2906474820143885,0.6714697406340058,80107580,695,202
1,148,0.3807531380753138,0.7950819672131147,68401676,239,91
1,434,0.31001589825119236,0.7222870478413069,70643104,629,195
1,17,0.2916666666666667,0.6551724137931034,67721143,24,7
1,61,0.2375,0.7,67812010,80,19
1,155,0.45229681978798586,0.868421052631579,70009632,283,128
1,1278,0.3564954682779456,0.8031914893617021,54046496,1986,708
1,394,0.2783882783882784,0.6552440290758048,72135301,546,152
1,621,0.3358288770053476,0.7961246840775064,70252294,935,314
1,15,0.25,0.8863636363636364,61286414,20,5
2,88,0.5510204081632653,0.9311926605504587,73993024,196,108
1,166,0.2782608695652174,0.5816091954022988,70509586,230,64
1,922,0.40516129032258064,0.9345870809484873,551432,1550,628
0,661,0.21121718377088305,0.46379170056956875,67554851,838,177
0,331,0.09562841530054644,0.09714285714285714,82178177,366,35
1,391,0.3733974358974359,0.7725563909774437,68401305,624,233
0,23,0.17857142857142858,0.03125,68401746,28,5
0,481,0.22042139384116693,0.46062992125984253,80098410,617,136
1,541,0.4358706986444213,0.749379652605459,75032433,959,418
1,1247,0.310287610619469,0.7047855811062772,67552604,1808,561
0,227,0.2007042253521127,0.328,72425682,284,57
1,171,0.29918032786885246,0.5849056603773585,72426340,244,73
1,338,0.3512476007677543,0.7903614457831325,68953864,521,183
0,748,0.16703786191536749,0.286109191430546,80117909,898,150
0,423,0.18023255813953487,0.23097112860892388,68191242,516,93
0,314,0.24154589371980675,0.4472934472934473,80145291,414,100
0,28,0.17647058823529413,0.3902439024390244,67636996,34,6
0,194,0.12612612612612611,0.16097560975609757,68637891,222,28
0,737,0.10449574726609964,0.20626780626780628,74789253,823,86
2,0,1.0,1.0,70536795,1,1
1,62,0.3333333333333333,0.7924528301886793,68942034,93,31
1,34,0.37037037037037035,0.847457627118644,73590153,54,20
0,221,0.22727272727272727,0.45219123505976094,80121225,286,65
1,164,0.2579185520361991,0.5206611570247934,70508571,221,57
0,124,0.17333333333333334,0.4327485380116959,67299680,150,26
1,228,0.3522727272727273,0.7194244604316546,82108565,352,124
1,236,0.2693498452012384,0.6333333333333333,70573160,323,87
1,819,0.30357142857142855,0.6007662835249042,70997003,1176,357
0,166,0.056818181818181816,0.1260053619302949,80124215,176,10
2,13,0.803030303030303,0.92,80118197,66,53
0,289,0.10248447204968944,0.21348314606741572,70219170,322,33
1,448,0.3253012048192771,0.6886792452830188,80096205,664,216
0,162,0.23222748815165878,0.4,70051121,211,49
1,104,0.20610687022900764,0.5758754863813229,70909076,131,27
0,34,0.1282051282051282,0.25,70909153,39,5
1,649,0.22646007151370678,0.5468644639244774,80098326,839,190
1,358,0.3048543689320388,0.6775631500742942,82126799,515,157
0,493,0.06981132075471698,0.2844378257632167,62839252,530,37
1,347,0.2694736842105263,0.615553121577218,69058024,475,128
0,414,0.03944315545243619,0.1240234375,62834800,431,17
1,190,0.14798206278026907,0.5202108963093146,62850333,223,33
0,39,0.11363636363636363,0.45,68255250,44,5
0,545,0.21469740634005763,0.4541176470588235,74446176,694,149
0,674,0.14249363867684478,0.16531365313653137,68530910,786,112
0,1005,0.18557536466774716,0.3857696030977735,82032804,1234,229
2,168,0.5029585798816568,0.9654255319148937,67532955,338,170
1,187,0.299625468164794,0.6621004566210046,82126789,267,80
1,213,0.49406175771971494,0.9653579676674365,69056456,421,208
1,639,0.30087527352297594,0.6540178571428571,69469071,914,275
2,284,0.5194585448392555,0.9415692821368948,80145399,591,307
0,258,0.2434017595307918,0.48518518518518516,70207116,341,83
1,55,0.367816091954023,0.8383838383838383,65972102,87,32
0,389,0.20449897750511248,0.39762219286657857,68535705,489,100
0,59,0.18055555555555555,0.32432432432432434,69538364,72,13
0,41,0.19607843137254902,0.4329896907216495,69538371,51,10
0,71,0.19318181818181818,0.423841059602649,69538385,88,17
1,104,0.43783783783783786,0.8901515151515151,70476392,185,81
1,344,0.3533834586466165,0.8269230769230769,69645534,532,188
2,462,0.5058823529411764,0.9821428571428571,68532604,935,473
0,602,0.21204188481675393,0.43094405594405594,68530644,764,162
0,41,0.21153846153846154,0.3302752293577982,72135385,52,11
0,98,0.17647058823529413,0.23465703971119134,72135504,119,21
1,104,0.4222222222222222,0.9596774193548387,69608035,180,76
1,481,0.33655172413793105,0.7741635687732342,66087826,725,244
1,568,0.40336134453781514,0.8569636135508155,68254431,952,384
1,705,0.3472222222222222,0.8421052631578947,80125356,1080,375
2,12,0.5714285714285714,0.96875,73635072,28,16
1,234,0.2732919254658385,0.6831896551724138,67558036,322,88
1,135,0.49814126394052044,0.9601226993865031,67993744,269,134
1,24,0.2,0.5411764705882353,67066566,30,6
1,36,0.3793103448275862,0.543859649122807,80175654,58,22
0,95,0.1810344827586207,0.4778481012658228,73421600,116,21
1,31,0.3541666666666667,0.8780487804878049,82124928,48,17
1,195,0.2471042471042471,0.5977011494252874,81979811,259,64
1,183,0.2795275590551181,0.5933333333333334,69180076,254,71
1,75,0.4186046511627907,0.9322033898305084,69183653,129,54
1,444,0.3094867807153966,0.7611548556430446,69621650,643,199
1,63,0.36363636363636365,0.8641975308641975,69057982,99,36
1,1024,0.3071718538565629,0.763430725730443,68164152,1478,454
1,500,0.47643979057591623,0.9466800804828974,80119010,955,455
0,43,0.31746031746031744,0.43478260869565216,68400563,63,20
1,879,0.26688907422852376,0.5449101796407185,70658210,1199,320
0,200,0.24528301886792453,0.44808743169398907,82126748,265,65
2,58,0.6685714285714286,0.9596774193548387,80137972,175,117
1,426,0.36701337295690933,0.8645569620253165,70632135,673,247
0,328,0.10382513661202186,0.1636060100166945,75283446,366,38
1,969,0.2511591962905719,0.5960874568469505,69869464,1294,325
1,210,0.3247588424437299,0.7799227799227799,82126725,311,101
0,321,0.02727272727272727,0.016420361247947456,69508964,330,9
0,142,0.04054054054054054,0.04672897196261682,69509125,148,6
2,434,0.5981481481481481,0.9873540856031129,64166872,1080,646
1,562,0.25166444740346205,0.5055658627087198,69585992,751,189
1,8,0.2727272727272727,0.6153846153846154,69943461,11,3
1,232,0.2990936555891239,0.7109929078014184,73148040,331,99
1,208,0.3268608414239482,0.7736220472440944,70687813,309,101
1,682,0.48489425981873113,0.9385560675883257,65938950,1324,642
2,10,0.5238095238095238,0.8571428571428571,79796892,21,11
0,185,0.16289592760180996,0.23384615384615384,70566636,221,36
0,52,0.1875,0.30708661417322836,70566895,64,12
1,87,0.31496062992125984,0.6258992805755396,82010233,127,40
2,41,0.7371794871794872,0.971830985915493,80056466,156,115
0,223,0.06694560669456066,0.2292134831460674,65840033,239,16
2,1,0.9333333333333333,0.6666666666666666,72802380,15,14
0,1147,0.2186648501362398,0.4509530450953045,73002692,1468,321
1,78,0.22772277227722773,0.5025125628140703,80123749,101,23
2,1,0.6666666666666666,0.8,80163441,3,2
0,556,0.19653179190751446,0.3844621513944223,63277634,692,136
1,41,0.4875,0.9532710280373832,69064632,80,39
1,1040,0.41043083900226757,0.8649180327868853,74554844,1764,724
1,631,0.2861990950226244,0.5744888023369036,67993884,884,253
1,923,0.334534967555876,0.7380796864794252,67994255,1387,464
1,412,0.3167495854063018,0.6580027359781122,67994423,603,191
0,843,0.23013698630136986,0.4671990872789504,70179396,1095,252
0,411,0.059496567505720827,0.05672969966629588,82012541,437,26
1,149,0.41796875,0.8693790149892934,82050117,256,107
1,1022,0.3600500939261115,0.8338226658837345,67552695,1597,575
0,164,0.14583333333333334,0.4410480349344978,70174132,192,28
0,705,0.2578947368421053,0.48743718592964824,70644644,950,245
0,1014,0.1174934725848564,0.23366214549938347,60308255,1149,135
0,436,0.1349206349206349,0.15264423076923078,65290211,504,68
0,346,0.09424083769633508,0.13284132841328414,82011819,382,36
2,233,0.5701107011070111,0.9784172661870504,70254975,542,309
1,443,0.37780898876404495,0.7848443843031123,65793903,712,269
0,113,0.16296296296296298,0.48125,68547164,135,22
0,1885,0.1187470780738663,0.29655822725129655,62413463,2139,254
0,1378,0.04768486523842433,0.08466548253404381,62427456,1447,69
1,100,0.42196531791907516,0.8375634517766497,68601211,173,73
1,95,0.36666666666666664,0.8514851485148515,68467910,150,55
0,515,0.13006756756756757,0.29079159935379645,72392775,592,77
1,274,0.2751322751322751,0.6186131386861314,67556594,378,104
0,133,0.21301775147928995,0.41124260355029585,69724354,169,36
1,368,0.3159851301115242,0.8067885117493473,64000986,538,170
1,14,0.44,0.9107142857142857,69205262,25,11
0,427,0.23885918003565063,0.49301143583227447,67940530,561,134
1,167,0.376865671641791,0.8482384823848238,69165166,268,101
0,39,0.22,0.4744525547445255,66616123,50,11
1,83,0.24545454545454545,0.5044642857142857,68603906,110,27
1,832,0.3185913185913186,0.7764920828258222,68457256,1221,389
2,26,0.5185185185185185,0.9122807017543859,68380151,54,28
1,473,0.2887218045112782,0.6814229249011857,82124904,665,192
0,256,0.2448377581120944,0.49658703071672355,69607650,339,83
0,1084,0.15707620528771385,0.2338257768721345,67766580,1286,202
0,50,0.07407407407407407,0.19473684210526315,74923835,54,4
0,34,0.05555555555555555,0.14189189189189189,74924241,36,2
1,354,0.4354066985645933,0.9595687331536388,70200333,627,273
1,179,0.24472573839662448,0.5661605206073753,71358903,237,58
1,542,0.3033419023136247,0.6096181046676096,69836963,778,236
1,729,0.328110599078341,0.7719830200121286,68257966,1085,356
1,226,0.40992167101827676,0.8934782608695652,82159168,383,157
0,722,0.18785151856017998,0.33612273361227335,62768160,889,167
1,820,0.3857677902621723,0.8485069191551348,64996372,1335,515
1,115,0.3313953488372093,0.8365384615384616,68531071,172,57
1,588,0.25757575757575757,0.5526315789473685,67215694,792,204
1,1023,0.3673469387755102,0.8273514851485149,69572916,1617,594
0,315,0.018691588785046728,0.03278688524590164,62840302,321,6
0,37,0.17777777777777778,0.25510204081632654,67134522,45,8
0,913,0.037934668071654375,0.0880952380952381,68254655,949,36
0,104,0.168,0.38414634146341464,70687106,125,21
0,1024,0.19560094265514533,0.32237228420434527,69607755,1273,249
0,815,0.12740899357601712,0.13001383125864455,70870961,934,119
1,116,0.25161290322580643,0.6899563318777293,68784471,155,39
1,64,0.3263157894736842,0.6384180790960452,80163481,95,31
2,0,1.0,1.0,70649782,2,2
1,274,0.2409972299168975,0.6857670979667283,63999565,361,87
0,159,0.11173184357541899,0.2448559670781893,80135427,179,20
1,70,0.43089430894308944,0.9372197309417041,69135073,123,53
0,111,0.059322033898305086,0.18181818181818182,78762880,118,7
0,82,0.012048192771084338,0.03208556149732621,78762922,83,1
0,97,0.039603960396039604,0.09417040358744394,78763125,101,4
1,122,0.23270440251572327,0.5393258426966292,64344966,159,37
1,127,0.23952095808383234,0.625,64344973,167,40
1,34,0.22727272727272727,0.5526315789473685,80128516,44,10
1,924,0.2235294117647059,0.6253474152306837,70121030,1190,266
0,384,0.17419354838709677,0.31492537313432833,68540675,465,81
0,378,0.17647058823529413,0.2930513595166163,70645582,459,81
0,316,0.23671497584541062,0.49818181818181817,70645946,414,98
0,1449,0.20862916439104315,0.3481089873932493,70628810,1831,382
0,86,0.18095238095238095,0.3933649289099526,74362043,105,19
0,502,0.17973856209150327,0.2233375156838143,62022415,612,110
1,213,0.34055727554179566,0.7858823529411765,65268294,323,110
1,745,0.41568627450980394,0.8870458135860979,71261792,1275,530
1,360,0.28429423459244535,0.6083032490974729,70179564,503,143
0,746,0.05089058524173028,0.021484375,70604863,786,40
0,1313,0.20182370820668694,0.3957497995188452,81979984,1645,332
0,643,0.13691275167785236,0.16510903426791276,80121137,745,102
0,122,0.10294117647058823,0.3125,18370513,136,14
0,57,0.08064516129032258,0.05521472392638037,73524696,62,5
1,403,0.25092936802973975,0.5447761194029851,80141443,538,135
0,169,0.19523809523809524,0.20717131474103587,69550236,210,41
2,12,0.7333333333333333,0.8636363636363636,66279983,45,33
2,206,0.6038461538461538,0.9614035087719298,70245210,520,314
0,301,0.050473186119873815,0.12850467289719625,80117848,317,16
0,36,0.07692307692307693,0.24324324324324326,80124189,39,3
1,362,0.2901960784313726,0.6309859154929578,80096184,510,148
0,604,0.12842712842712842,0.2944015444015444,80116750,693,89
0,224,0.17343173431734318,0.42153846153846153,70608573,271,47
1,51,0.42696629213483145,0.8924731182795699,80122707,89,38
1,242,0.2861356932153392,0.5770020533880903,70626255,339,97
1,399,0.3945371775417299,0.7039800995024875,80176790,659,260
1,1482,0.24233128834355827,0.527235354573484,70814625,1956,474
1,230,0.3255131964809384,0.760586319218241,81971160,341,111
0,489,0.07034220532319392,0.08095238095238096,68625886,526,37
1,569,0.3635346756152125,0.6592039800995025,80128013,894,325
0,230,0.15441176470588236,0.23007246376811594,69625143,272,42
0,162,0.12432432432432433,0.19460500963391136,70005082,185,23
1,379,0.37868852459016394,0.8549618320610687,69118224,610,231
0,196,0.18672199170124482,0.4180522565320665,68791121,241,45
0,96,0.22580645161290322,0.38388625592417064,70318304,124,28
1,316,0.4759535655058043,0.925,73321500,603,287
0,325,0.1751269035532995,0.2855093256814921,68537511,394,69
0,125,0.031007751937984496,0.032,69509076,129,4
2,159,0.6466666666666666,0.9781021897810219,82051891,450,291
0,1032,0.15270935960591134,0.24170353982300885,68544504,1218,186
1,908,0.26715092816787733,0.5895875591615957,67217143,1239,331
1,205,0.4225352112676056,0.8531746031746031,73524584,355,150
0,282,0.26370757180156656,0.49458483754512633,73524724,383,101
0,1197,0.14316392269148176,0.23665893271461716,70643314,1397,200
1,177,0.33955223880597013,0.6586538461538461,80168632,268,91
0,245,0.22712933753943218,0.4351851851851852,67995564,317,72
0,191,0.16228070175438597,0.19791666666666666,69498884,228,37
0,1315,0.19275629220380602,0.3738647830474268,68544553,1629,314
1,242,0.25766871165644173,0.6185567010309279,80121228,326,84
1,327,0.4191829484902309,0.9049235993208828,774333,563,236
2,107,0.5466101694915254,0.9688888888888889,65825445,236,129
0,645,0.18663303909205547,0.3400974025974026,70545832,793,148
0,71,0.16470588235294117,0.373134328358209,54204871,85,14
1,215,0.45707070707070707,0.8788598574821853,67304230,396,181
1,918,0.4319306930693069,0.9013716525146963,69900733,1616,698
0,223,0.16791044776119404,0.4355179704016913,70617372,268,45
0,439,0.12024048096192384,0.16688918558077437,67285743,499,60
0,600,0.09365558912386707,0.12750455373406194,67285764,662,62
0,115,0.16058394160583941,0.29545454545454547,67159743,137,22
0,5,0.0,0.0,64976121,5,0
0,187,0.22727272727272727,0.45176470588235296,65330426,242,55
0,206,0.2076923076923077,0.4672364672364672,68538673,260,54
0,154,0.07784431137724551,0.008771929824561403,69498541,167,13
1,453,0.29439252336448596,0.6625615763546798,68352354,642,189
0,151,0.17032967032967034,0.3041095890410959,77676305,182,31
1,798,0.29815303430079154,0.7003802281368822,69073522,1137,339
1,500,0.34554973821989526,0.8399122807017544,70632002,764,264
1,102,0.25547445255474455,0.6045627376425855,79520266,137,35
1,740,0.26147704590818366,0.5101321585903084,70641032,1002,262
0,949,0.06132542037586548,0.04357181280258203,80119368,1011,62
1,457,0.39228723404255317,0.8002894356005789,80124980,752,295
2,174,0.6,0.9460431654676259,80019513,435,261
1,37,0.3728813559322034,0.5797101449275363,80053365,59,22
0,2910,0.08201892744479496,0.06345590628050765,68534550,3170,260
0,921,0.09171597633136094,0.06500607533414338,70207060,1014,93
1,404,0.29739130434782607,0.6609485368314834,66828552,575,171
1,282,0.33175355450236965,0.8390596745027125,69421730,422,140
1,152,0.2863849765258216,0.5838509316770186,70566846,213,61
0,419,0.1360824742268041,0.17479191438763378,80119358,485,66
0,181,0.2096069868995633,0.3919308357348703,70645981,229,48
0,1101,0.11066235864297254,0.2838002436053593,69625703,1238,137
0,675,0.07280219780219781,0.11516314779270634,80124243,728,53
0,721,0.046296296296296294,0.0883054892601432,80124347,756,35
1,195,0.44126074498567336,0.7454545454545455,72425745,349,154
0,158,0.20603015075376885,0.2695035460992908,72426396,199,41
2,4,0.8947368421052632,0.9285714285714286,82038247,38,34
2,17,0.575,0.96875,69701625,40,23
2,23,0.5490196078431373,0.9484536082474226,80139935,51,28
1,426,0.37719298245614036,0.8444767441860465,69153735,684,258
0,95,0.15178571428571427,0.1890547263681592,80176737,112,17
0,92,0.22033898305084745,0.37662337662337664,80118949,118,26
1,201,0.4257142857142857,0.8687782805429864,72270905,350,149
1,153,0.48484848484848486,0.9120879120879121,67154276,297,144
0,607,0.1291248206599713,0.1404561824729892,70646170,697,90
0,565,0.11993769470404984,0.13595933926302414,70646590,642,77
1,240,0.27927927927927926,0.6707317073170732,67556601,333,93
1,369,0.2693069306930693,0.6499261447562777,70642733,505,136
0,163,0.12365591397849462,0.2465753424657534,80098564,186,23
2,153,0.5641025641025641,0.9597855227882037,75613776,351,198
0,165,0.22169811320754718,0.3933649289099526,69394171,212,47
1,189,0.26744186046511625,0.5966386554621849,70049315,258,69
1,548,0.27417218543046357,0.633816425120773,69607020,755,207
0,468,0.13970588235294118,0.16805721096543505,68543454,544,76
0,94,0.23577235772357724,0.4955357142857143,69154750,123,29
0,293,0.08150470219435736,0.2379471228615863,70908446,319,26
1,97,0.389937106918239,0.9033816425120773,64002925,159,62
1,36,0.41935483870967744,0.9550561797752809,80154141,62,26
0,914,0.1622364802933089,0.27699530516431925,63279083,1091,177
0,997,0.17330016583747926,0.31462409886714726,82000080,1206,209
0,181,0.17727272727272728,0.28517110266159695,80139711,220,39
0,922,0.06774519716885744,0.05722070844686648,82011856,989,67
0,12,0.25,0.25,69179572,16,4
1,2,0.3333333333333333,0.8333333333333334,70630021,3,1
0,238,0.1407942238267148,0.26988636363636365,62940563,277,39
0,258,0.1650485436893204,0.4563106796116505,65201724,309,51
1,60,0.3684210526315789,0.8848484848484849,68386682,95,35
0,166,0.09289617486338798,0.3276955602536998,70597975,183,17
1,341,0.2997946611909651,0.7048951048951049,81967268,487,146
0,1331,0.22751015670342425,0.4720965309200603,67159162,1723,392
1,365,0.37392795883361923,0.8240740740740741,66064635,583,218
1,247,0.28405797101449276,0.6686991869918699,68532373,345,98
0,109,0.22142857142857142,0.3790322580645161,72413922,140,31
1,220,0.3373493975903614,0.802158273381295,69177500,332,112
1,140,0.24324324324324326,0.6558891454965358,68621140,185,45
0,946,0.03861788617886179,0.05700211118930331,68242405,984,38
0,74,0.0975609756097561,0.3547008547008547,78762775,82,8
1,159,0.2535211267605634,0.6601123595505618,68542775,213,54
0,223,0.1553030303030303,0.3974630021141649,69575366,264,41
0,145,0.05228758169934641,0.14743589743589744,78762803,153,8
0,49,0.14035087719298245,0.45394736842105265,80135216,57,8
1,41,0.21153846153846154,0.5274725274725275,80135291,52,11
1,40,0.2727272727272727,0.7903225806451613,80135293,55,15
1,35,0.2391304347826087,0.5666666666666667,80135294,46,11
1,51,0.32894736842105265,0.8518518518518519,69603541,76,25
1,20,0.4117647058823529,0.9259259259259259,67759125,34,14
1,492,0.15608919382504288,0.5400192864030858,80167266,583,91
1,239,0.22402597402597402,0.5476190476190477,70618401,308,69
1,101,0.26277372262773724,0.702928870292887,70618422,137,36
1,149,0.2436548223350254,0.6311475409836066,70618436,197,48
0,739,0.054987212276214836,0.19449431478156792,62838825,782,43
0,569,0.17055393586005832,0.34405940594059403,60003174,686,117
2,195,0.5666666666666667,0.9688249400479616,80163483,450,255
1,745,0.30243445692883897,0.7567567567567568,63278551,1068,323
1,1201,0.32754759238521836,0.7749576988155669,80109246,1786,585
1,154,0.16756756756756758,0.5702917771883289,65201710,185,31
1,137,0.3686635944700461,0.8712871287128713,67118450,217,80
0,115,0.19014084507042253,0.3782894736842105,69643266,142,27
0,135,0.1509433962264151,0.22336769759450173,68534046,159,24
1,263,0.3078947368421053,0.7824675324675324,67049381,380,117
0,713,0.18045977011494252,0.44261168384879723,73194891,870,157
0,57,0.09523809523809523,0.38738738738738737,80165680,63,6
0,508,0.015503875968992248,0.01772324471710975,63182595,516,8
1,10,0.4117647058823529,0.9230769230769231,80150023,17,7
0,618,0.2236180904522613,0.49774266365688485,68540346,796,178
0,550,0.2231638418079096,0.43537964458804523,80137639,708,158
1,546,0.376,0.8384539147670962,80131484,875,329
1,175,0.38596491228070173,0.8796068796068796,69177423,285,110
1,88,0.21428571428571427,0.652,80165679,112,24
0,88,0.12,0.30991735537190085,80165682,100,12
0,422,0.06222222222222222,0.1571627260083449,70907970,450,28
0,424,0.0556792873051225,0.09416445623342175,70908691,449,25
1,65,0.32989690721649484,0.7549668874172185,69184220,97,32
1,161,0.18274111675126903,0.569620253164557,63999411,197,36
1,363,0.24688796680497926,0.6179775280898876,68535194,482,119
1,355,0.29,0.6774193548387096,69873664,500,145
1,169,0.2028301886792453,0.6401028277634961,65592632,212,43
0,929,0.20801364023870417,0.43051031487513575,72368961,1173,244
1,42,0.27586206896551724,0.7614678899082569,67049164,58,16
0,953,0.02854230377166157,0.02223816355810617,68242335,981,28
1,48,0.29411764705882354,0.7641509433962265,80154134,68,20
1,22,0.2413793103448276,0.7792207792207793,70635572,29,7
1,88,0.1619047619047619,0.5185185185185185,64451422,105,17
0,227,0.046218487394957986,0.010416666666666666,82014183,238,11
0,1591,0.1310759148006554,0.14376321353065538,69240136,1831,240
1,58,0.46788990825688076,0.9473684210526315,80072286,109,51
1,226,0.30246913580246915,0.7541254125412541,80168512,324,98
1,209,0.4366576819407008,0.924812030075188,80129945,371,162
0,59,0.20270270270270271,0.3684210526315789,67555285,74,15
0,207,0.11158798283261803,0.14807302231237324,67703510,233,26
0,62,0.10144927536231885,0.14285714285714285,82042893,69,7
0,167,0.14358974358974358,0.3610271903323263,73658144,195,28
2,223,0.5305263157894737,0.9544592030360531,82059487,475,252
2,2,0.6,0.75,69912283,5,3
1,157,0.314410480349345,0.6967213114754098,69176576,229,72
1,139,0.26063829787234044,0.5115511551155115,69176660,188,49
0,293,0.033003300330033,0.07411630558722919,68356883,303,10
0,471,0.11632270168855535,0.1082529474812433,82178174,533,62
0,926,0.07492507492507493,0.07461873638344227,73148943,1001,75
1,11,0.45,0.9411764705882353,80135265,20,9
0,685,0.209919261822376,0.44744929317762755,73255126,867,182
1,53,0.43010752688172044,0.9333333333333333,66856524,93,40
1,75,0.3119266055045872,0.7061855670103093,69177682,109,34
2,254,0.5134099616858238,0.9377880184331797,80125065,522,268
0,122,0.12857142857142856,0.4444444444444444,70467901,140,18
1,166,0.26222222222222225,0.6791277258566978,63998921,225,59
1,594,0.275609756097561,0.6502057613168725,69551720,820,226
0,2102,0.05229936880072137,0.08846880907372401,73366272,2218,116
0,95,0.15178571428571427,0.35580524344569286,69534493,112,17
1,14,0.3333333333333333,0.8676470588235294,80135214,21,7
1,20,0.2857142857142857,0.7966101694915254,80135219,28,8
0,29,0.03333333333333333,0.058333333333333334,74924255,30,1
1,105,0.35185185185185186,0.8373205741626795,68532674,162,57
0,150,0.1891891891891892,0.22077922077922077,69681073,185,35
1,31,0.46551724137931033,0.9315068493150684,82145574,58,27
1,70,0.3269230769230769,0.7849462365591398,68757115,104,34
0,1003,0.039272030651340994,0.12256728778467908,70658616,1044,41
1,129,0.3064516129032258,0.5777777777777777,62174371,186,57
1,16,0.3333333333333333,0.7391304347826086,69031095,24,8
0,164,0.15463917525773196,0.4751552795031056,70908460,194,30
1,117,0.35359116022099446,0.7966573816155988,80135247,181,64
1,58,0.17142857142857143,0.6464088397790055,80135076,70,12
1,131,0.46963562753036436,0.8986486486486487,66848726,247,116
2,19,0.7532467532467533,0.9705882352941176,67763864,77,58
2,241,0.6320610687022901,0.8658536585365854,69948760,655,414
0,567,0.15499254843517138,0.17493472584856398,70112441,671,104
2,158,0.6417233560090703,0.8908045977011494,79373315,441,283
0,874,0.05717367853290183,0.11131386861313869,80124223,927,53
1,654,0.3789173789173789,0.7868981846882399,69162555,1053,399
0,381,0.005221932114882507,0.019455252918287938,80049431,383,2
0,34,0.17073170731707318,0.359375,80049501,41,7
2,17,0.5142857142857142,0.9805825242718447,80133911,35,18
1,140,0.35185185185185186,0.7787234042553192,70046935,216,76
2,13,0.5,0.9666666666666667,70395864,26,13
2,83,0.6497890295358649,0.9900497512437811,70280084,237,154
1,860,0.2760942760942761,0.6163124641010913,65313192,1188,328
1,168,0.31983805668016196,0.7505285412262156,68763702,247,79
1,325,0.49922958397534667,0.9694915254237289,61827255,649,324
1,53,0.273972602739726,0.6198347107438017,66493280,73,20
0,93,0.15454545454545454,0.25263157894736843,698894,110,17
1,267,0.2664835164835165,0.6473429951690821,80159587,364,97
0,437,0.03956043956043956,0.09807355516637478,62838790,455,18
0,470,0.05622489959839357,0.23233908948194662,62839231,498,28
0,436,0.048034934497816595,0.16591251885369532,62840694,458,22
1,270,0.33985330073349634,0.7424892703862661,82113161,409,139
1,112,0.3212121212121212,0.7166666666666667,70234843,165,53
1,224,0.1971326164874552,0.5392156862745098,72866626,279,55
2,40,0.5,0.8823529411764706,61022010,80,40
0,1082,0.10578512396694215,0.2595685455810717,67343206,1210,128
0,781,0.10844748858447488,0.2511664074650078,67343395,876,95
1,86,0.312,0.8144329896907216,67038482,125,39
0,140,0.18604651162790697,0.24092409240924093,69389530,172,32
1,437,0.26057529610829105,0.5770491803278689,73818493,591,154
0,1027,0.08467023172905526,0.06837016574585636,66423322,1122,95
0,974,0.10477941176470588,0.0920340293890178,66423343,1088,114
0,838,0.07300884955752213,0.048589341692789965,67291322,904,66
2,302,0.5375191424196019,0.9636650868878357,68191480,653,351
1,8,0.3333333333333333,0.72,69117216,12,4
0,237,0.1625441696113074,0.4582366589327146,72907884,283,46
1,189,0.34146341463414637,0.636963696369637,80180959,287,98
1,458,0.28549141965678626,0.7282184655396619,70475083,641,183
2,61,0.5734265734265734,0.9242424242424242,68549061,143,82
1,259,0.4970873786407767,0.9539473684210527,67160373,515,256
1,358,0.48265895953757226,0.9365079365079365,72364334,692,334
2,239,0.5200803212851406,0.9564164648910412,69490736,498,259
0,437,0.11895161290322581,0.13892365456821026,70179333,496,59
1,296,0.3565217391304348,0.8304093567251462,539315,460,164
0,852,0.19165085388994307,0.32385874246339363,63681583,1054,202
0,677,0.14303797468354432,0.3772986683576411,65295524,790,113
1,246,0.25903614457831325,0.5414634146341464,80180461,332,86
1,576,0.30518697225572977,0.6908945686900958,69574624,829,253
0,1100,0.19883466860888566,0.3452446399120396,68545421,1373,273
0,314,0.24700239808153476,0.45549738219895286,69705272,417,103
1,345,0.26282051282051283,0.5977961432506887,80121222,468,123
1,369,0.25903614457831325,0.5524652338811631,70179494,498,129
0,135,0.07534246575342465,0.23703703703703705,69390972,146,11
0,88,0.16981132075471697,0.44385026737967914,69391021,106,18
1,311,0.427255985267035,0.9411764705882353,80120466,543,232
2,11,0.6071428571428571,0.8888888888888888,82037506,28,17
0,680,0.047619047619047616,0.02072538860103627,68017852,714,34
1,187,0.2889733840304182,0.6054852320675106,68211724,263,76
0,410,0.08071748878923767,0.0832313341493268,80071264,446,36
1,12,0.3684210526315789,0.8571428571428571,80180108,19,7
0,698,0.16105769230769232,0.2468354430379747,80180378,832,134
1,218,0.31230283911671924,0.6896551724137931,80109960,317,99
0,163,0.15979381443298968,0.47246376811594204,69391245,194,31
1,177,0.4971590909090909,0.9302325581395349,82110024,352,175
0,60,0.3023255813953488,0.47761194029850745,68040154,86,26
1,96,0.29927007299270075,0.6434108527131783,68040161,137,41
1,477,0.4375,0.8813793103448276,67540214,848,371
0,463,0.2058319039451115,0.42723492723492723,68542572,583,120
0,169,0.08648648648648649,0.11899313501144165,72522821,185,16
1,217,0.3384146341463415,0.8048780487804879,70234822,328,111
1,76,0.3559322033898305,0.7748344370860927,57042510,118,42
1,349,0.2804123711340206,0.5705614567526556,69458746,485,136
1,379,0.3847402597402597,0.8278335724533716,80180007,616,237
0,156,0.060240963855421686,0.04225352112676056,54204843,166,10
0,71,0.08974358974358974,0.13846153846153847,54204885,78,7
1,32,0.38461538461538464,0.8484848484848485,80125503,52,20
1,198,0.3288135593220339,0.765625,80107391,295,97
1,50,0.35064935064935066,0.8819875776397516,80109743,77,27
0,204,0.15,0.16203703703703703,70601503,240,36
0,140,0.20454545454545456,0.3594306049822064,65919021,176,36
0,591,0.2151394422310757,0.43112513144058884,66833046,753,162
1,17,0.2916666666666667,0.66,82096241,24,7
1,969,0.3996282527881041,0.9071601941747572,65268280,1614,645
0,364,0.13744075829383887,0.18732782369146006,62699616,422,58
1,31,0.46551724137931033,0.9512195121951219,80125516,58,27
0,121,0.18243243243243243,0.32996632996632996,80109834,148,27
1,461,0.26357827476038337,0.6006904487917146,80110401,626,165
1,6,0.25,0.6551724137931034,80125461,8,2
2,583,0.527169505271695,0.911070780399274,66774001,1233,650
2,30,0.8469387755102041,0.88,60916366,196,166
1,18,0.3333333333333333,0.813953488372093,70120932,27,9
0,123,0.031496062992125984,0.020618556701030927,74989600,127,4
0,203,0.08968609865470852,0.09154929577464789,74993051,223,20
1,31,0.44642857142857145,0.8076923076923077,70509264,56,25
2,6,0.7272727272727273,0.88,80127026,22,16
1,24,0.4418604651162791,0.9104477611940298,72802604,43,19
1,191,0.3202846975088968,0.5768261964735516,71478302,281,90
2,8,0.8888888888888888,0.5,80125806,72,64
1,355,0.3793706293706294,0.8110014104372355,78110816,572,217
0,68,0.2916666666666667,0.32432432432432434,80176071,96,28
1,200,0.46524064171123,0.8898876404494382,72390780,374,174
2,12,0.5862068965517241,0.8,79760030,29,17
1,99,0.4107142857142857,0.8985507246376812,82120531,168,69
1,523,0.3645200486026732,0.8053435114503816,67764445,823,300
1,596,0.3719704952581665,0.8654353562005277,69154883,949,353
1,618,0.32752992383025026,0.7539823008849558,80181646,919,301
0,1008,0.12041884816753927,0.1527403414195867,58862881,1146,138
1,501,0.3650190114068441,0.8517805582290664,80133429,789,288
2,10,0.5,0.8333333333333334,70575694,20,10
1,99,0.3028169014084507,0.6445497630331753,80136833,142,43
0,63,0.14864864864864866,0.2727272727272727,68499704,74,11
0,52,0.14754098360655737,0.3817204301075269,69415892,61,9
1,365,0.2611336032388664,0.6245847176079734,68218416,494,129
1,342,0.24503311258278146,0.5644329896907216,79520056,453,111
2,4,0.6666666666666666,0.9166666666666666,80175665,12,8
0,338,0.1571072319201995,0.26285714285714284,68543433,401,63
1,133,0.45491803278688525,0.9346938775510204,69623715,244,111
1,125,0.2647058823529412,0.7093023255813954,82006128,170,45
1,198,0.4530386740331492,0.9447731755424064,70870352,362,164
0,229,0.16727272727272727,0.31278195488721805,67554326,275,46
2,138,0.6011560693641619,0.9607142857142857,69840883,346,208
0,593,0.21143617021276595,0.37335398915569323,68236154,752,159
1,94,0.3237410071942446,0.6508620689655172,69414275,139,45
1,126,0.3114754098360656,0.7256410256410256,69180062,183,57
1,750,0.22199170124481327,0.5052337752965806,68537245,964,214
0,222,0.17164179104477612,0.32019704433497537,67159295,268,46
1,1146,0.258732212160414,0.5237797246558198,70645183,1546,400
0,855,0.1895734597156398,0.37070641607258586,66930906,1055,200
1,292,0.30641330166270786,0.6469428007889546,80108343,421,129
1,250,0.38875305623471884,0.84,67560395,409,159
0,1636,0.12560128273650453,0.22772988505747127,69638695,1871,235
1,110,0.3956043956043956,0.7992957746478874,81989144,182,72
1,154,0.33043478260869563,0.6687306501547987,80152462,230,76
0,784,0.11711711711711711,0.1560328490208465,80119404,888,104
1,360,0.37608318890814557,0.7963446475195822,74338040,577,217
1,204,0.43646408839779005,0.9107981220657277,73870706,362,158
1,22,0.40540540540540543,0.8974358974358975,66035186,37,15
1,392,0.283363802559415,0.6318807339449541,70642075,547,155
0,93,0.17699115044247787,0.2535885167464115,69184682,113,20
0,964,0.08538899430740038,0.18175438596491228,67343381,1054,90
0,409,0.08295964125560538,0.11988847583643122,80114335,446,37
1,386,0.23412698412698413,0.5466351829988194,68535075,504,118
0,337,0.08174386920980926,0.09497964721845319,80118156,367,30
0,475,0.10714285714285714,0.13424657534246576,80121876,532,57
0,447,0.2599337748344371,0.46409807355516636,71762530,604,157
0,294,0.1787709497206704,0.34839650145772594,70627403,358,64
1,151,0.36554621848739494,0.7675276752767528,82018821,238,87
0,274,0.2237960339943343,0.43275632490013316,80105732,353,79
0,37,0.0975609756097561,0.009259259259259259,69183401,41,4
2,153,0.5377643504531722,0.9690721649484536,67728626,331,178
1,81,0.2956521739130435,0.6918918918918919,65018716,115,34
1,80,0.2982456140350877,0.7401960784313726,69183590,114,34
0,406,0.10176991150442478,0.14314928425357873,72522674,452,46
0,573,0.2161422708618331,0.47011661807580174,69158012,731,158
1,247,0.35340314136125656,0.8089700996677741,68688900,382,135
0,302,0.20526315789473684,0.3578199052132701,80180231,380,78
1,579,0.26053639846743293,0.5451237263464338,65308663,783,204
0,93,0.211864406779661,0.42745098039215684,67159673,118,25
1,91,0.2661290322580645,0.5318181818181819,69602862,124,33
0,232,0.24183006535947713,0.4956063268892794,65330342,306,74
1,90,0.3918918918918919,0.7848837209302325,69531112,148,58
0,664,0.18727050183598531,0.32408660351826796,80011281,817,153
1,197,0.24521072796934865,0.5088408644400786,82120534,261,64
1,408,0.3472,0.8275862068965517,61691126,625,217
1,974,0.2637944066515495,0.6685323383084577,68543776,1323,349
0,937,0.13079777365491652,0.14642082429501085,80172870,1078,141
1,321,0.46140939597315433,0.9245742092457421,62510490,596,275
0,54,0.22857142857142856,0.35766423357664234,68763625,70,16
1,232,0.46788990825688076,0.9314079422382672,70659141,436,204
0,914,0.04592901878914405,0.13873130479628676,62835542,958,44
0,169,0.08648648648648649,0.45746388443017655,64248814,185,16
0,592,0.061806656101426306,0.2696011004126547,65401553,631,39
0,484,0.14788732394366197,0.2645739910313901,67554886,568,84
1,189,0.34146341463414637,0.7580645161290323,73650934,287,98
0,917,0.20330147697654213,0.418925831202046,70545762,1151,234
1,531,0.3730814639905549,0.8504007123775601,72966054,847,316
2,6,0.7142857142857143,0.9444444444444444,79783676,21,15
0,100,0.24242424242424243,0.449438202247191,80124964,132,32
1,1346,0.30150492994291644,0.7246525990735976,70688135,1927,581
2,10,0.7916666666666666,0.8181818181818182,67861703,48,38
0,644,0.16145833333333334,0.2969465648854962,66931165,768,124
2,130,0.6457765667574932,0.9777070063694268,67221763,367,237
2,7,0.5,0.9230769230769231,70792624,14,7
1,414,0.24863883847549909,0.6028368794326241,68541494,551,137
1,166,0.2420091324200913,0.5435897435897435,71036966,219,53
1,149,0.4966216216216216,0.9397163120567376,73588375,296,147
1,151,0.27403846153846156,0.5826086956521739,65973740,208,57
0,96,0.11926605504587157,0.07446808510638298,65973803,109,13
1,126,0.3225806451612903,0.7236024844720497,69177122,186,60
2,53,0.5267857142857143,0.9453125,80127581,112,59
1,233,0.25796178343949044,0.5728346456692913,69603002,314,81
0,449,0.11787819253438114,0.13793103448275862,69603450,509,60
1,85,0.4785276073619632,0.8380281690140845,80135037,163,78
1,8,0.3333333333333333,0.5294117647058824,67455430,12,4
1,8,0.42857142857142855,0.5454545454545454,70912821,14,6
2,117,0.5851063829787234,0.9747899159663865,82059491,282,165
1,68,0.26881720430107525,0.5921052631578947,67569166,93,25
0,175,0.10714285714285714,0.13810741687979539,73148880,196,21
1,444,0.25752508361204013,0.5466200466200466,70673575,598,154
0,316,0.13424657534246576,0.314070351758794,64929634,365,49
0,782,0.13876651982378854,0.24596464258262873,70617582,908,126
0,54,0.22857142857142856,0.3888888888888889,80136358,70,16
0,405,0.17682926829268292,0.3490011750881316,67160184,492,87
0,204,0.08108108108108109,0.09146341463414634,70615510,222,18
0,290,0.1317365269461078,0.2623239436619718,70617365,334,44
1,762,0.3947577442414615,0.8684719535783365,80127856,1259,497
0,583,0.11398176291793313,0.217753120665742,81893573,658,75
0,498,0.12784588441331,0.17229336437718276,68645010,571,73
1,819,0.3566378633150039,0.7634517766497462,66509394,1273,454
1,319,0.23317307692307693,0.5566714490674318,70527723,416,97
1,982,0.3050247699929229,0.681266846361186,80108182,1413,431
1,616,0.28703703703703703,0.6405723905723906,82008933,864,248
0,419,0.2423146473779385,0.4948453608247423,67551750,553,134
1,616,0.2752941176470588,0.6798706548100243,70627536,850,234
0,324,0.05813953488372093,0.045531197301854974,70617414,344,20
0,359,0.18961625282167044,0.3977272727272727,70040852,443,84
0,11,0.08333333333333333,0.11764705882352941,62564383,12,1
0,739,0.16591422121896163,0.21217887725975262,79817626,886,147
0,825,0.11194833153928956,0.18554551772063932,70398916,929,104
1,173,0.4956268221574344,0.95,67154430,343,170
1,880,0.36962750716332377,0.8287101248266296,70645316,1396,516
1,38,0.4153846153846154,0.8961038961038961,70658896,65,27
1,215,0.4297082228116711,0.8363171355498721,80174681,377,162
0,409,0.1010989010989011,0.20773930753564154,65921282,455,46
0,172,0.14,0.2559241706161137,65921450,200,28
0,287,0.10031347962382445,0.265625,70612472,319,32
2,15,0.6875,0.8888888888888888,66181381,48,33
1,183,0.3920265780730897,0.5872093023255814,68665751,301,118
1,185,0.4606413994169096,0.9342560553633218,80180314,343,158
1,407,0.27964601769911507,0.6596356663470757,68763716,565,158
1,194,0.3741935483870968,0.8046218487394958,69044605,310,116
0,569,0.1824712643678161,0.3562753036437247,61944953,696,127
1,281,0.34498834498834496,0.7849462365591398,67995655,429,148
2,265,0.5438898450946644,0.9648148148148148,69100640,581,316
0,372,0.14678899082568808,0.23780487804878048,70215936,436,64
0,816,0.19447186574531095,0.3405639913232104,80118967,1013,197
1,781,0.2251984126984127,0.5022421524663677,67833766,1008,227
1,177,0.23376623376623376,0.5105263157894737,69130180,231,54
0,533,0.164576802507837,0.32450896669513235,72522772,638,105
1,64,0.2967032967032967,0.6582278481012658,69184521,91,27
1,245,0.3194444444444444,0.750445632798574,82126705,360,115
1,735,0.3026565464895636,0.7221843003412969,68289053,1054,319
0,133,0.22674418604651161,0.41297935103244837,82116888,172,39
1,95,0.41358024691358025,0.95260663507109,68210611,162,67
1,378,0.29739776951672864,0.7068366164542295,70642390,538,160
0,223,0.26644736842105265,0.44819277108433736,70891933,304,81
0,640,0.1731266149870801,0.33276157804459694,68544210,774,134
1,211,0.26480836236933797,0.5754189944134078,61786074,287,76
0,383,0.20374220374220375,0.3293943870014771,67141305,481,98
0,474,0.16106194690265488,0.26524064171122996,68537546,565,91
2,200,0.6815286624203821,0.9921052631578947,65116996,628,428
0,278,0.18475073313782991,0.46742209631728043,64915270,341,63
0,26,0.13333333333333333,0.2222222222222222,64929354,30,4
0,319,0.1671018276762402,0.3969849246231156,64929445,383,64
0,407,0.16082474226804125,0.40476190476190477,67226166,485,78
0,84,0.0967741935483871,0.14218009478672985,80124525,93,9
1,274,0.31840796019900497,0.6894409937888198,80107874,402,128
0,671,0.2846481876332623,0.4230769230769231,69972371,938,267
1,477,0.3026315789473684,0.7661870503597122,80121279,684,207
1,456,0.32344213649851633,0.7447478991596639,82124938,674,218
1,8,0.3333333333333333,0.7647058823529411,65279900,12,4
2,517,0.5796747967479675,0.9720730397422127,80178210,1230,713
2,425,0.5473908413205538,0.9746606334841629,69836991,939,514
0,1058,0.1695447409733124,0.4316702819956616,300622,1274,216
0,535,0.06631762652705062,0.1347248576850095,62530482,573,38
1,75,0.2268041237113402,0.5930232558139535,68784170,97,22
1,160,0.4052044609665427,0.8571428571428571,69414282,269,109
2,39,0.6722689075630253,0.978494623655914,70713265,119,80
1,337,0.44481054365733114,0.9274292742927429,66656401,607,270
0,691,0.15318627450980393,0.40978886756238003,61717684,816,125
1,421,0.3630862329803328,0.849329205366357,69954192,661,240
1,378,0.26601941747572816,0.6214099216710183,80125371,515,137
0,473,0.09904761904761905,0.15676359039190899,60514265,525,52
1,1170,0.4519906323185012,0.9347734011012283,80125652,2135,965
0,646,0.2121951219512195,0.37447108603667134,70525294,820,174
0,258,0.10726643598615918,0.14776119402985075,68539485,289,31
1,60,0.29411764705882354,0.6746031746031746,68115390,85,25
0,315,0.136986301369863,0.24433849821215733,80098683,365,50
0,545,0.1925925925925926,0.4063373718546132,80119352,675,130
1,69,0.3669724770642202,0.8826530612244898,73398955,109,40
1,472,0.2727272727272727,0.5172910662824207,70179004,649,177
0,608,0.06317411402157165,0.25925925925925924,68356960,649,41
0,288,0.030303030303030304,0.05214368482039398,80128611,297,9
0,196,0.0297029702970297,0.0528169014084507,80128619,202,6
0,128,0.030303030303030304,0.06097560975609756,80128621,132,4
0,222,0.18681318681318682,0.4099290780141844,80119314,273,51
1,441,0.2887096774193548,0.5763473053892215,68191326,620,179
1,395,0.4544198895027624,0.9111514052583862,79807056,724,329
0,808,0.14225053078556263,0.20780399274047187,67719743,942,134
2,30,0.6703296703296703,0.9682539682539683,82106951,91,61
1,79,0.25471698113207547,0.599009900990099,70686896,106,27
1,386,0.42729970326409494,0.7747933884297521,80178983,674,288
1,1860,0.3869479235332894,0.8421750663129973,80153461,3034,1174
1,105,0.304635761589404,0.7063492063492064,80103226,151,46
0,107,0.13008130081300814,0.28013029315960913,70633472,123,16
0,64,0.1232876712328767,0.25842696629213485,70633633,73,9
1,52,0.38823529411764707,0.9305555555555556,72749145,85,33
1,154,0.4726027397260274,0.9187675070028011,67306995,292,138
1,17,0.41379310344827586,0.9411764705882353,70576170,29,12
1,101,0.4228571428571429,0.8915094339622641,67971015,175,74
1,184,0.3284671532846715,0.7841409691629956,80135817,274,90
0,632,0.2119700748129676,0.4505597014925373,68545232,802,170
0,1424,0.19910011248593926,0.36521022258862323,68535012,1778,354
0,646,0.03869047619047619,0.019588638589618023,70617400,672,26
2,21,0.5882352941176471,0.9411764705882353,70637882,51,30
1,64,0.2558139534883721,0.547945205479452,65121931,86,22
0,245,0.17785234899328858,0.30566037735849055,80027920,298,53
1,223,0.3646723646723647,0.790948275862069,80096191,351,128
1,32,0.3333333333333333,0.6716417910447762,82002279,48,16
0,392,0.1346578366445916,0.24793388429752067,66964303,453,61
1,509,0.2590975254730713,0.5716738197424893,73266403,687,178
0,88,0.011235955056179775,0.018867924528301886,80124327,89,1
0,479,0.03621730382293763,0.05028735632183908,80124351,497,18
0,246,0.05747126436781609,0.14965986394557823,80124418,261,15
0,476,0.07751937984496124,0.17899408284023668,80124437,516,40
0,177,0.19545454545454546,0.36061381074168797,80128894,220,43
0,53,0.14516129032258066,0.3469387755102041,82019427,62,9
0,74,0.06329113924050633,0.11764705882352941,82022528,79,5
0,265,0.13398692810457516,0.48601864181091875,63478954,306,41
0,1695,0.12221646815121699,0.12127236580516898,69240045,1931,236
0,1279,0.19152970922882429,0.27709279688513955,68689061,1582,303
1,409,0.2874564459930314,0.6666666666666666,69608315,574,165
1,786,0.3367088607594937,0.8233799237611181,73738966,1185,399
1,342,0.24168514412416853,0.5778045838359469,68534872,451,109
1,994,0.39684466019417475,0.8686408504176157,64193381,1648,654
1,1277,0.2723646723646724,0.6025210084033613,65312506,1755,478
1,267,0.27837837837837837,0.7144927536231884,72376304,370,103
1,123,0.3787878787878788,0.8888888888888888,68210674,198,75
1,900,0.3464052287581699,0.7931372549019607,80152811,1377,477
1,154,0.29357798165137616,0.5833333333333334,82096270,218,64
1,239,0.2507836990595611,0.5546875,71358791,319,80
0,702,0.21476510067114093,0.48828420256991684,68532884,894,192
0,1117,0.05419136325148179,0.022976501305483028,80119355,1181,64
0,912,0.09613478691774034,0.1181977764774722,80119405,1009,97
0,699,0.1608643457382953,0.39862280030604436,68155661,833,134
0,852,0.16878048780487806,0.4272675413576726,70173950,1025,173
0,437,0.17857142857142858,0.348993288590604,63279755,532,95
1,44,0.2903225806451613,0.6635514018691588,80103282,62,18
0,394,0.08372093023255814,0.06042884990253411,67666193,430,36
1,1015,0.2569546120058565,0.5978552278820375,67552996,1366,351
1,92,0.39072847682119205,0.9154929577464789,69603415,151,59
1,63,0.43243243243243246,0.9141104294478528,80127348,111,48
0,203,0.188,0.2222222222222222,81956096,250,47
0,427,0.14940239043824702,0.15130674002751032,81956098,502,75
0,517,0.178060413354531,0.4099883855981417,63092904,629,112
0,902,0.1601489757914339,0.29549902152641877,70614754,1074,172
0,509,0.13874788494077833,0.15689981096408318,67554305,591,82
1,748,0.379253112033195,0.8863328822733424,80109050,1205,457
1,374,0.2903225806451613,0.6829608938547486,69165460,527,153
1,132,0.26256983240223464,0.5370370370370371,70110292,179,47
0,1033,0.14273858921161825,0.20728291316526612,68537532,1205,172
1,426,0.2392857142857143,0.5159235668789809,80125373,560,134
1,806,0.34947538337368844,0.7517146776406035,67203752,1239,433
2,4,0.5555555555555556,0.9411764705882353,70792596,9,5
0,51,0.15,0.15463917525773196,698901,60,9
0,44,0.26666666666666666,0.4794520547945205,954002,60,16
1,153,0.3169642857142857,0.8053333333333333,69621643,224,71
1,167,0.49085365853658536,0.9274193548387096,80089835,328,161
0,49,0.02,0.047619047619047616,80124345,50,1
0,110,0.2198581560283688,0.4797047970479705,68725713,141,31
0,427,0.14770459081836326,0.16666666666666666,82036287,501,74
1,18,0.4375,0.8461538461538461,80178927,32,14
2,1,0.5,0.0,82143622,2,1
0,2,0.3333333333333333,0.3333333333333333,66815882,3,1
1,216,0.32075471698113206,0.6832740213523132,80118629,318,102
2,46,0.8826530612244898,0.9655172413793104,691733,392,346
1,60,0.4117647058823529,0.6981132075471698,80130151,102,42
0,427,0.13034623217922606,0.21019108280254778,80125016,491,64
0,429,0.05714285714285714,0.09090909090909091,80125017,455,26
0,425,0.07407407407407407,0.12034383954154727,80125022,459,34
0,677,0.2767094017094017,0.3537234042553192,69234970,936,259
2,378,0.6058394160583942,0.8424908424908425,70906493,959,581
1,180,0.3835616438356164,0.7831978319783198,79787470,292,112
1,517,0.25611510791366904,0.5516102394715111,80180124,695,178
0,379,0.15777777777777777,0.27390791027154665,63278012,450,71
1,116,0.27044025157232704,0.6747404844290658,67555152,159,43
0,84,0.2631578947368421,0.444,66896403,114,30
2,157,0.5271084337349398,0.9393939393939394,64028265,332,175
1,34,0.24444444444444444,0.5555555555555556,77676760,45,11
0,167,0.24434389140271492,0.4881516587677725,67748884,221,54
1,414,0.48825710754017304,0.9618556701030928,69573840,809,395
1,637,0.24882075471698112,0.5043478260869565,72749005,848,211
0,432,0.056768558951965066,0.21369102682701202,66876621,458,26
1,81,0.3671875,0.7960526315789473,69628993,128,47
1,597,0.27106227106227104,0.683737646001797,80112025,819,222
0,434,0.21942446043165467,0.4074074074074074,69608091,556,122
0,882,0.14285714285714285,0.2519723865877712,64217475,1029,147
1,182,0.2571428571428571,0.6277777777777778,68531295,245,63
1,91,0.35,0.8071748878923767,66931102,140,49
1,30,0.16666666666666666,0.6356589147286822,69634593,36,6
0,68,0.08108108108108109,0.23129251700680273,74511024,74,6
2,40,0.5348837209302325,0.9,70811713,86,46
1,97,0.26515151515151514,0.6604651162790698,73099005,132,35
1,121,0.37305699481865284,0.8053691275167785,64413083,193,72
0,314,0.0626865671641791,0.09308510638297872,69107073,335,21
0,264,0.03296703296703297,0.26064516129032256,70467782,273,9
1,225,0.3055555555555556,0.8685714285714285,66502646,324,99
0,88,0.06382978723404255,0.3127147766323024,67889374,94,6
1,103,0.32679738562091504,0.7470817120622568,80154104,153,50
0,50,0.038461538461538464,0.1694915254237288,63981841,52,2
0,501,0.06529850746268656,0.2446167097329888,66877216,536,35
1,261,0.32558139534883723,0.6385135135135135,80055654,387,126
1,107,0.38857142857142857,0.8045325779036827,82010234,175,68
0,818,0.14345549738219895,0.1767180925666199,70207564,955,137
1,617,0.2850521436848204,0.7058823529411765,70207886,863,246
1,13,0.4090909090909091,0.8852459016393442,70628824,22,9
0,382,0.1053864168618267,0.1532349602724177,72522611,427,45
0,454,0.1062992125984252,0.14893617021276595,80119388,508,54
0,372,0.16591928251121077,0.21105527638190955,70206934,446,74
0,896,0.25146198830409355,0.4533333333333333,66471531,1197,301
0,169,0.05056179775280899,0.23299565846599132,62836851,178,9
1,100,0.38650306748466257,0.764102564102564,80158088,163,63
1,96,0.33793103448275863,0.6451612903225806,62400254,145,49
0,359,0.16511627906976745,0.17574257425742573,69499052,430,71
0,626,0.19016817593790428,0.3964588144726713,69159055,773,147
1,241,0.3883248730964467,0.7906976744186046,70511196,394,153
1,294,0.28117359413202936,0.5737410071942446,68741596,409,115
0,142,0.1977401129943503,0.3993808049535604,68741715,177,35
0,95,0.11214953271028037,0.3212996389891697,69524511,107,12
1,585,0.3337129840546697,0.8276785714285714,80124645,878,293
0,91,0.14953271028037382,0.16293929712460065,69179796,107,16
1,13,0.35,0.5925925925925926,80176694,20,7
1,69,0.2736842105263158,0.6456310679611651,65755543,95,26
0,44,0.12,0.09574468085106383,69183632,50,6
1,103,0.33548387096774196,0.7381974248927039,80001761,155,52
1,127,0.42272727272727273,0.9146341463414634,80001782,220,93
1,116,0.42574257425742573,0.8669950738916257,82038360,202,86
0,213,0.1744186046511628,0.2655086848635236,61365640,258,45
2,447,0.5424769703172978,0.9682702149437052,79884182,977,530
1,327,0.2618510158013544,0.5136690647482014,70645855,443,116
1,97,0.46994535519125685,0.9206349206349206,64007986,183,86
1,180,0.305019305019305,0.7038043478260869,80109904,259,79
1,37,0.4126984126984127,0.7540983606557377,82034797,63,26
1,52,0.34177215189873417,0.8296296296296296,68962600,79,27
1,153,0.3076923076923077,0.6741854636591479,69177213,221,68
0,102,0.17073170731707318,0.43333333333333335,66226853,123,21
0,104,0.14754098360655737,0.25120772946859904,68526360,122,18
1,76,0.2621359223300971,0.625,71358945,103,27
0,302,0.1246376811594203,0.10931174089068826,71358994,345,43
1,328,0.2300469483568075,0.5014409221902018,70638932,426,98
0,362,0.167816091954023,0.3054726368159204,70760795,435,73
1,504,0.2840909090909091,0.6498194945848376,70179683,704,200
0,768,0.21311475409836064,0.3812375249500998,80103142,976,208
0,262,0.06761565836298933,0.07747489239598278,66087791,281,19
1,1346,0.24762437115707098,0.5709903593339176,70092925,1789,443
0,615,0.1644021739130435,0.28498168498168497,68535544,736,121
0,40,0.06976744186046512,0.048,77676683,43,3
1,30,0.4915254237288136,0.9523809523809523,65602040,59,29
1,131,0.45416666666666666,0.9074074074074074,80127697,240,109
0,640,0.09219858156028368,0.110397946084724,62940346,705,65
1,24,0.38461538461538464,0.7647058823529411,82053050,39,15
1,855,0.3283582089552239,0.7153937947494033,69925744,1273,418
0,162,0.0898876404494382,0.11470588235294117,70615314,178,16
1,748,0.2637795275590551,0.5642811906269791,68444054,1016,268
0,144,0.24210526315789474,0.47129909365558914,65973782,190,46
1,46,0.3611111111111111,0.863013698630137,68151300,72,26
0,531,0.1780185758513932,0.32765298218435324,81979694,646,115
0,202,0.2230769230769231,0.49901768172888017,68741183,260,58
2,201,0.5379310344827586,0.9818181818181818,67453036,435,234
2,75,0.5901639344262295,0.9857142857142858,68473132,183,108
1,875,0.2762613730355666,0.6032953105196451,63141414,1209,334
0,534,0.0481283422459893,0.1801994301994302,62839196,561,27
0,56,0.24324324324324326,0.3939393939393939,774354,74,18
2,84,0.5333333333333333,0.9552238805970149,63767774,180,96
1,574,0.291358024691358,0.6583333333333333,68531540,810,236
1,19,0.4411764705882353,0.9166666666666666,82041334,34,15
0,344,0.02824858757062147,0.007853403141361256,82000125,354,10
1,89,0.3945578231292517,0.7974683544303798,62173580,147,58
1,120,0.2982456140350877,0.6861313868613139,74555271,171,51
1,117,0.4890829694323144,0.9438943894389439,64333570,229,112
0,173,0.19158878504672897,0.26037735849056604,67552485,214,41
0,900,0.07975460122699386,0.10038610038610038,54609576,978,78
1,51,0.42045454545454547,0.7777777777777778,80172010,88,37
0,89,0.043010752688172046,0.1407185628742515,80128617,93,4
0,147,0.045454545454545456,0.1286031042128603,80128659,154,7
1,4,0.3333333333333333,0.5714285714285714,68400752,6,2
1,692,0.44193548387096776,0.8592508513053349,70648914,1240,548
0,66,0.21428571428571427,0.4577114427860697,69601693,84,18
0,580,0.11042944785276074,0.10425716768027801,70871241,652,72
1,41,0.2545454545454545,0.5206611570247934,71116395,55,14
0,674,0.15220125786163521,0.22198879551820727,67291616,795,121
0,337,0.16995073891625614,0.26445086705202314,68543314,406,69
0,335,0.14540816326530612,0.1989247311827957,70207375,392,57
1,1180,0.2742927429274293,0.5807909604519774,70179312,1626,446
0,294,0.026490066225165563,0.07640878701050621,62836585,302,8
1,115,0.17857142857142858,0.6434316353887399,62850424,140,25
1,92,0.12380952380952381,0.5684210526315789,64182664,105,13
0,316,0.03363914373088685,0.09132841328413284,64183140,327,11
0,404,0.04716981132075472,0.14632034632034632,65401532,424,20
0,1275,0.06524926686217009,0.2374950768018905,68798331,1364,89
0,519,0.1696,0.3623931623931624,68535565,625,106
0,115,0.09448818897637795,0.2631578947368421,72392810,127,12
0,134,0.14102564102564102,0.22,82002685,156,22
0,131,0.16560509554140126,0.2909090909090909,82002689,157,26
0,750,0.20297555791710944,0.44789356984478934,69207600,941,191
1,233,0.28307692307692306,0.7025210084033613,65005024,325,92
0,414,0.19298245614035087,0.40540540540540543,68537490,513,99
0,1039,0.16813450760608487,0.32236024844720496,68537700,1249,210
1,440,0.32515337423312884,0.7688984881209503,70760522,652,212
1,24,0.29411764705882354,0.6363636363636364,82120000,34,10
1,44,0.3333333333333333,0.6727272727272727,82125093,66,22
1,8,0.38461538461538464,0.7142857142857143,74512053,13,5
0,184,0.12796208530805686,0.39473684210526316,63771064,211,27
0,449,0.06652806652806653,0.14765906362545017,63771071,481,32
0,220,0.11290322580645161,0.2934131736526946,63771225,248,28
0,187,0.1261682242990654,0.35555555555555557,63771400,214,27
1,326,0.4007352941176471,0.8119122257053292,74675503,544,218
1,1474,0.2600401606425703,0.5498137802607076,80108406,1992,518
0,652,0.20293398533007334,0.3344316309719934,65360491,818,166
0,221,0.24315068493150685,0.43856332703213613,82023210,292,71
1,56,0.3333333333333333,0.5225225225225225,79251865,84,28
1,46,0.38666666666666666,0.7640449438202247,79251872,75,29
1,138,0.450199203187251,0.8873239436619719,73975020,251,113
1,96,0.37662337662337664,0.7876106194690266,80137410,154,58
0,221,0.1596958174904943,0.2695035460992908,70573566,263,42
1,126,0.20253164556962025,0.6843373493975904,70259196,158,32
0,159,0.2318840579710145,0.4978902953586498,70760851,207,48
1,171,0.2692307692307692,0.6078947368421053,67748891,234,63
1,203,0.365625,0.8356164383561644,69153903,320,117
0,167,0.215962441314554,0.39501779359430605,69155821,213,46
1,612,0.25728155339805825,0.5927835051546392,68289004,824,212
1,251,0.3832923832923833,0.8477064220183487,68010894,407,156
0,318,0.2638888888888889,0.4882108183079057,68785290,432,114
1,112,0.3672316384180791,0.7471264367816092,80180088,177,65
1,348,0.30952380952380953,0.5728,71752926,504,156
1,256,0.25146198830409355,0.505564387917329,82126746,342,86
1,41,0.3387096774193548,0.8080808080808081,69165236,62,21
1,95,0.4171779141104294,0.9351351351351351,69177661,163,68
0,237,0.09541984732824428,0.16552901023890784,80071012,262,25
0,71,0.1839080459770115,0.25280898876404495,69021351,87,16
1,446,0.24662162162162163,0.6297619047619047,70618331,592,146
1,146,0.3511111111111111,0.8127853881278538,80180106,225,79
1,88,0.30708661417322836,0.6721311475409836,70064106,127,39
0,130,0.281767955801105,0.43870967741935485,70879662,181,51
0,117,0.31176470588235294,0.49693251533742333,70879676,170,53
2,16,0.7241379310344828,0.8837209302325582,80178445,58,42
2,100,0.6632996632996633,0.9587155963302753,74120200,297,197
1,266,0.2631578947368421,0.642,67556923,361,95
1,580,0.2,0.5199709513435004,69578131,725,145
0,754,0.19701810436634717,0.39156626506024095,66930962,939,185
1,186,0.24390243902439024,0.6234042553191489,67160226,246,60
2,38,0.6122448979591837,0.9578947368421052,80150231,98,60
1,187,0.34843205574912894,0.6896551724137931,80051706,287,100
1,86,0.4819277108433735,0.9354838709677419,72198133,166,80
2,89,0.6454183266932271,0.9340659340659341,69401192,251,162
1,803,0.30113141862489123,0.640625,74554501,1149,346
0,120,0.0625,0.3201581027667984,64984493,128,8
0,551,0.20719424460431654,0.34798534798534797,70645323,695,144
1,41,0.4057971014492754,0.888,80128587,69,28
0,264,0.2,0.30793157076205285,80118963,330,66
0,383,0.1393258426966292,0.24034334763948498,70604646,445,62
2,70,0.6744186046511628,0.952755905511811,71665454,215,145
0,386,0.015306122448979591,0.04448398576512456,80124352,392,6
0,385,0.04228855721393035,0.09778597785977859,80124438,402,17
1,183,0.4369230769230769,0.8431372549019608,79947665,325,142
2,13,0.896,0.9545454545454546,80131446,125,112
2,726,0.6641998149861239,0.8503937007874016,65960643,2162,1436
2,36,0.5609756097560976,0.875,70867244,82,46
1,14,0.3333333333333333,0.7906976744186046,68499991,21,7
1,461,0.35252808988764045,0.782016348773842,69100136,712,251
1,13,0.35,0.7142857142857143,69464941,20,7
0,427,0.17726396917148363,0.3850129198966408,69602015,519,92
1,903,0.33505154639175255,0.8104667609618105,64002764,1358,455
1,403,0.2777777777777778,0.6371681415929203,80102974,558,155
1,511,0.40442890442890445,0.8888888888888888,80119014,858,347
0,368,0.1965065502183406,0.36254295532646047,69262354,458,90
0,87,0.05434782608695652,0.038461538461538464,79650935,92,5
0,391,0.21169354838709678,0.38605442176870747,82166802,496,105
0,313,0.20959595959595959,0.36083916083916084,71358896,396,83
0,203,0.0514018691588785,0.26019690576652604,62839133,214,11
0,673,0.20543093270365997,0.43680555555555556,81979717,847,174
1,37,0.22916666666666666,0.5932203389830508,82128670,48,11
0,728,0.20437158469945355,0.4479338842975207,68533122,915,187
0,577,0.08990536277602523,0.1130952380952381,70627606,634,57
0,316,0.08139534883720931,0.10741687979539642,70627711,344,28
2,16,0.5,0.9795918367346939,69184626,32,16
1,170,0.3656716417910448,0.7980769230769231,62024641,268,98
1,461,0.3318840579710145,0.8163900414937759,65353645,690,229
0,44,0.21428571428571427,0.330188679245283,72393321,56,12
1,30,0.3617021276595745,0.8118811881188119,82167862,47,17
0,92,0.0891089108910891,0.11363636363636363,70626675,101,9
0,169,0.25877192982456143,0.4948186528497409,79807042,228,59
0,173,0.22072072072072071,0.40941176470588236,60508875,222,49
1,545,0.2398884239888424,0.5126582278481012,67513131,717,172
0,208,0.15789473684210525,0.2692307692307692,80071033,247,39
0,192,0.1504424778761062,0.3347826086956522,73637641,226,34
0,1078,0.18947368421052632,0.4195634599838319,73700452,1330,252
1,271,0.23661971830985915,0.5122349102773246,69165621,355,84
1,414,0.4177215189873418,0.8415637860082305,80062073,711,297
2,297,0.5300632911392406,0.9742765273311897,82023519,632,335
1,539,0.3482466747279323,0.7816216216216216,80136387,827,288
2,302,0.5008264462809917,0.946058091286307,82118304,605,303
0,512,0.05009276437847866,0.1942554799697657,62834814,539,27
0,632,0.20702634880803011,0.4457252641690682,70110313,797,165
0,78,0.22772277227722773,0.4316546762589928,63051625,101,23
0,19,0.05,0.11538461538461539,66264282,20,1
1,383,0.234,0.6261829652996845,68540780,500,117
1,114,0.2348993288590604,0.5652173913043478,69388144,149,35
1,272,0.2935064935064935,0.6441102756892231,67557553,385,113
1,49,0.36363636363636365,0.8493975903614458,69895791,77,28
1,45,0.26229508196721313,0.6567164179104478,61408046,61,16
1,314,0.39615384615384613,0.8319502074688797,80180340,520,206
0,166,0.11229946524064172,0.08294930875576037,695345,187,21
0,306,0.19473684210526315,0.2891246684350133,60195142,380,74
0,497,0.10931899641577061,0.22183098591549297,54421535,558,61
1,226,0.3192771084337349,0.7391304347826086,67553444,332,106
0,71,0.22826086956521738,0.43781094527363185,82116869,92,21
1,195,0.34782608695652173,0.7901554404145078,69152272,299,104
1,299,0.3485838779956427,0.6735905044510386,76571845,459,160
1,298,0.4028056112224449,0.7623762376237624,76571852,499,201
1,43,0.45569620253164556,0.8767123287671232,82054041,79,36
1,45,0.2857142857142857,0.5185185185185185,71458702,63,18
1,436,0.2696817420435511,0.6073546856465006,69606796,597,161
2,72,0.6363636363636364,0.8584905660377359,80137973,198,126
1,282,0.248,0.5995717344753747,68533605,375,93
0,905,0.14622641509433962,0.2053412462908012,67554536,1060,155
1,110,0.2948717948717949,0.5373831775700935,73026422,156,46
0,124,0.023622047244094488,0.0732899022801303,67868731,127,3
0,1768,0.13418217433888344,0.24022531477799866,70841372,2042,274
1,363,0.29651162790697677,0.7852760736196319,68542243,516,153
1,55,0.2948717948717949,0.6186440677966102,82041252,78,23
0,101,0.2109375,0.3770491803278688,82126657,128,27
1,348,0.4209650582362729,0.8068350668647846,70202251,601,253
0,695,0.17751479289940827,0.34642233856893545,68534193,845,150
2,53,0.5267857142857143,0.9836065573770492,82095537,112,59
0,25,0.13793103448275862,0.08064516129032258,70771113,29,4
0,326,0.10684931506849316,0.1111111111111111,82178176,365,39
1,709,0.30078895463510846,0.7866449511400652,65511061,1014,305
0,42,0.16,0.24509803921568626,80053855,50,8
0,600,0.16666666666666666,0.3023952095808383,72785776,720,120
1,81,0.25,0.6787330316742082,80121245,108,27
0,592,0.19346049046321526,0.39985642498205315,81979693,734,142
1,21,0.4,0.9302325581395349,70253820,35,14
1,77,0.25961538461538464,0.7255813953488373,68639641,104,27
0,275,0.1691842900302115,0.26681614349775784,70719964,331,56
1,305,0.23558897243107768,0.5050391937290034,70638596,399,94
2,9,0.6086956521739131,0.9655172413793104,74539290,23,14
1,318,0.32051282051282054,0.5734265734265734,80128011,468,150
0,236,0.07086614173228346,0.32558139534883723,76805673,254,18
0,608,0.1783783783783784,0.42415316642120765,73194912,740,132
0,133,0.15822784810126583,0.40481927710843374,65714040,158,25
0,384,0.16339869281045752,0.3257328990228013,80121099,459,75
0,107,0.01834862385321101,0.17672413793103448,67004343,109,2
1,143,0.1875,0.5304568527918782,69395396,176,33
0,382,0.030456852791878174,0.00949367088607595,62940290,394,12
1,229,0.3081570996978852,0.7300884955752213,67884194,331,102
1,592,0.20855614973262032,0.5311653116531165,69926311,748,156
1,157,0.24519230769230768,0.640661938534279,73148901,208,51
0,930,0.1388888888888889,0.1382857142857143,72749026,1080,150
0,114,0.13636363636363635,0.4903047091412742,70908061,132,18
0,276,0.1038961038961039,0.24580152671755726,70909342,308,32
0,412,0.11206896551724138,0.13710879284649777,68018006,464,52
1,271,0.44123711340206184,0.9243697478991597,70072611,485,214
0,1662,0.13166144200626959,0.15683760683760684,67555334,1914,252
0,73,0.1411764705882353,0.45933014354066987,80128708,85,12
0,213,0.07792207792207792,0.34620174346201743,69204926,231,18
0,287,0.13813813813813813,0.4345679012345679,66035823,333,46
1,412,0.31900826446280994,0.7341317365269461,62015835,605,193
0,245,0.12811387900355872,0.1926163723916533,80176488,281,36
0,81,0.15625,0.4765625,82103832,96,15
0,588,0.21390374331550802,0.33513027852650495,69183296,748,160
1,1070,0.38006952491309387,0.8426303854875283,65775801,1726,656
0,226,0.1171875,0.17938144329896907,82011775,256,30
0,251,0.09386281588447654,0.09487666034155598,82011777,277,26
0,696,0.24511930585683298,0.4829787234042553,19821060,922,226
1,472,0.32763532763532766,0.8292682926829268,80121193,702,230
0,579,0.1293233082706767,0.09343434343434344,68040266,665,86
1,97,0.1415929203539823,0.5475,70467831,113,16
1,20,0.2,0.5735294117647058,70661416,25,5
1,147,0.45353159851301117,0.8926380368098159,65787400,269,122
0,220,0.055793991416309016,0.19836065573770492,80128610,233,13
0,112,0.058823529411764705,0.24444444444444444,80128616,119,7
0,259,0.04428044280442804,0.10673443456162643,80128618,271,12
1,96,0.21311475409836064,0.6779661016949152,70908530,122,26
1,81,0.2358490566037736,0.7088122605363985,70324625,106,25
1,131,0.43043478260869567,0.8543046357615894,72270996,230,99
0,421,0.18568665377176016,0.3368920521945433,63277942,517,96
2,25,0.5833333333333334,0.9019607843137255,69654522,60,35
0,45,0.21052631578947367,0.20192307692307693,61365402,57,12
0,194,0.25384615384615383,0.49417249417249415,67551680,260,66
0,739,0.05979643765903308,0.230028328611898,62835332,786,47
2,169,0.5014749262536873,0.9482758620689655,64975624,339,170
1,274,0.2237960339943343,0.6171875,67656232,353,79
1,178,0.26141078838174275,0.5056818181818182,66210053,241,63
0,235,0.22442244224422442,0.3905882352941176,66210081,303,68
1,133,0.31794871794871793,0.6371951219512195,80056396,195,62
1,331,0.3132780082987552,0.6015625,65562490,482,151
0,382,0.1278538812785388,0.3835294117647059,65590105,438,56
0,410,0.1440501043841336,0.3715909090909091,67049535,479,69
1,150,0.4296577946768061,0.8881987577639752,70505911,263,113
0,133,0.09523809523809523,0.1614457831325301,82012539,147,14
0,123,0.21656050955414013,0.3659574468085106,964481,157,34
1,31,0.2619047619047619,0.8785046728971962,69638583,42,11
0,196,0.04854368932038835,0.237017310252996,62839161,206,10
0,85,0.09574468085106383,0.12037037037037036,60032525,94,9
0,134,0.10666666666666667,0.07936507936507936,60032546,150,16
0,84,0.24324324324324326,0.40298507462686567,65930823,111,27
1,377,0.3758278145695364,0.8454661558109834,67994850,604,227
1,92,0.3741496598639456,0.8207547169811321,68763996,147,55
1,224,0.35816618911174786,0.720226843100189,70563500,349,125
1,47,0.3380281690140845,0.8536585365853658,79816982,71,24
1,427,0.2953795379537954,0.6807511737089202,81967269,606,179
0,27,0.15625,0.4528301886792453,70474761,32,5
0,53,0.05357142857142857,0.18947368421052632,82150119,56,3
1,550,0.23291492329149233,0.5392670157068062,72760373,717,167
1,209,0.3569230769230769,0.6136363636363636,69055644,325,116
1,194,0.27340823970037453,0.5604651162790698,80107601,267,73
0,153,0.06134969325153374,0.1736842105263158,62743800,163,10
1,244,0.3087818696883853,0.6978297161936561,80109113,353,109
0,145,0.16184971098265896,0.4940898345153664,78763342,173,28
1,178,0.285140562248996,0.7910447761194029,64001196,249,71
1,601,0.43033175355450237,0.9297800338409475,66926251,1055,454
0,800,0.10414333706606943,0.09559434746467166,68539604,893,93
0,274,0.1620795107033639,0.462992125984252,64001945,327,53
0,261,0.19444444444444445,0.48714285714285716,70642845,324,63
0,39,0.04878048780487805,0.03508771929824561,64099973,41,2
0,210,0.1566265060240964,0.4139344262295082,67049276,249,39
0,290,0.17613636363636365,0.4612676056338028,68036073,352,62
0,174,0.13432835820895522,0.3333333333333333,80155839,201,27
1,226,0.16911764705882354,0.5166666666666667,81973013,272,46
0,129,0.0851063829787234,0.17543859649122806,82103874,141,12
1,43,0.31746031746031744,0.8553459119496856,64002183,63,20
1,74,0.3392857142857143,0.8820754716981132,80154140,112,38
0,1313,0.12757475083056477,0.22660753880266074,69159895,1505,192
1,1102,0.262876254180602,0.5865139949109415,62140561,1495,393
1,121,0.26666666666666666,0.6630434782608695,65004555,165,44
1,390,0.4491525423728814,0.9189842805320435,69574715,708,318
1,314,0.26291079812206575,0.5705614567526556,68741694,426,112
0,1279,0.07318840579710145,0.27817343946376205,82134957,1380,101
1,349,0.2157303370786517,0.5217864923747276,72760401,445,96
1,24,0.25,0.647887323943662,66305134,32,8
0,85,0.19047619047619047,0.33,80121226,105,20
0,157,0.14207650273224043,0.44536082474226807,78763251,183,26
0,231,0.11494252873563218,0.3167202572347267,78763454,261,30
1,236,0.2955223880597015,0.5631868131868132,80180251,335,99
0,2101,0.02956120092378753,0.05821917808219178,68130685,2165,64
0,1272,0.20698254364089774,0.47886710239651414,73194940,1604,332
0,176,0.12871287128712872,0.3442265795206972,72866710,202,26
2,8,0.5294117647058824,0.9583333333333334,68545750,17,9
1,280,0.2875318066157761,0.7636054421768708,67558064,393,113
2,52,0.5357142857142857,0.96,72932440,112,60
2,1,0.9166666666666666,0.5,82037226,12,11
1,32,0.4074074074074074,0.851063829787234,68995472,54,22
2,36,0.8767123287671232,0.9833333333333333,70076370,292,256
1,53,0.3375,0.5131578947368421,68117091,80,27
0,292,0.2192513368983957,0.38190954773869346,80141503,374,82
1,600,0.38080495356037153,0.8335208098987626,63967953,969,369
0,460,0.12045889101338432,0.1550925925925926,80119332,523,63
1,632,0.34643226473629785,0.830204081632653,67305714,967,335
0,198,0.038834951456310676,0.13490725126475547,70314615,206,8
0,244,0.03937007874015748,0.036328871892925434,80119094,254,10
2,199,0.6259398496240601,0.9827586206896551,74236484,532,333
1,220,0.34328358208955223,0.8084577114427861,67276321,335,115
1,590,0.3218390804597701,0.7583011583011583,63463540,870,280
0,485,0.1565217391304348,0.32265112891478515,80135349,575,90
2,43,0.6293103448275862,0.8837209302325582,66612854,116,73
0,1123,0.131477184841454,0.1599229287090559,68539366,1293,170
1,555,0.26973684210526316,0.6671850699844479,63283346,760,205
1,194,0.2971014492753623,0.6645021645021645,61216946,276,82
1,449,0.25662251655629137,0.5691428571428572,80121234,604,155
1,81,0.425531914893617,0.8771929824561403,72919420,141,60
1,724,0.26720647773279355,0.5381882770870338,80114510,988,264
0,200,0.14163090128755365,0.20642201834862386,73524801,233,33
1,681,0.2716577540106952,0.6518563603164942,68235881,935,254
0,384,0.04239401496259352,0.16857899382171226,62835213,401,17
0,783,0.24127906976744187,0.48279158699808794,72561174,1032,249
1,267,0.3972911963882618,0.8284993694829761,80030552,443,176
1,222,0.4095744680851064,0.8935574229691877,67551764,376,154
1,348,0.23348017621145375,0.5561797752808989,72382296,454,106
1,574,0.3900106269925611,0.9062200956937799,68200391,941,367
1,413,0.3606811145510836,0.8200514138817481,70760704,646,233
1,575,0.28035043804755944,0.6616199848599545,68212186,799,224
2,0,1.0,1.0,69538301,1,1
1,545,0.22804532577903683,0.5206136145733461,70643426,706,161
1,232,0.42997542997543,0.9416342412451362,69165390,407,175
1,81,0.39097744360902253,0.7421875,65281272,133,52
0,571,0.09794628751974724,0.13738317757009347,80124515,633,62
0,288,0.04,0.12849162011173185,62839105,300,12
0,210,0.03669724770642202,0.124,62839476,218,8
0,405,0.060324825986078884,0.23787878787878788,62841331,431,26
0,656,0.06818181818181818,0.05782575173477255,82011780,704,48
0,513,0.07733812949640288,0.0959409594095941,82011783,556,43
1,23,0.3611111111111111,0.8333333333333334,65289630,36,13
1,21,0.3,0.6851851851851852,65289742,30,9
0,536,0.21407624633431085,0.4012409513960703,69165775,682,146
1,24,0.45454545454545453,0.82,67118373,44,20
0,659,0.16370558375634517,0.2833078101071976,62687254,788,129
0,1014,0.0671573137074517,0.03952011291460833,66423301,1087,73
1,362,0.21475054229934923,0.5242195909580194,80098900,461,99
2,259,0.512241054613936,0.9276139410187667,82018805,531,272
0,516,0.09947643979057591,0.0944527736131934,67653873,573,57
2,44,0.5319148936170213,0.9538461538461539,80062542,94,50
0,330,0.2009685230024213,0.3955094991364421,82115973,413,83
2,73,0.54375,0.8928571428571429,80174923,160,87
0,286,0.13595166163141995,0.3319672131147541,74446162,331,45
0,497,0.074487895716946,0.11375661375661375,80124257,537,40
1,76,0.2621359223300971,0.5049019607843137,82062468,103,27
1,34,0.47692307692307695,0.9482758620689655,69133036,65,31
1,133,0.27717391304347827,0.5614973262032086,70209391,184,51
1,222,0.3657142857142857,0.8383658969804618,67657492,350,128
1,414,0.29949238578680204,0.6144393241167435,70078134,591,177
0,12,0.2,0.3541666666666667,70224343,15,3
1,84,0.3333333333333333,0.6892655367231638,72802366,126,42
0,4,0.0,0.0,72809142,4,0
0,510,0.1853035143769968,0.3935599284436494,68535460,626,116
1,667,0.33233233233233234,0.7098525989138867,80127423,999,332
0,6,0.25,0.0,73653636,8,2
1,10,0.4444444444444444,0.5,73653643,18,8
1,294,0.32413793103448274,0.7790697674418605,70252623,435,141
1,226,0.15355805243445692,0.5482315112540193,60087454,267,41
0,602,0.07951070336391437,0.22773279352226722,63780815,654,52
1,741,0.3567708333333333,0.8047016274864376,81965832,1152,411
1,442,0.25838926174496646,0.5410526315789473,69184745,596,154
0,517,0.11472602739726027,0.3554285714285714,63775565,584,67
0,299,0.1021021021021021,0.3622377622377622,63780353,333,34
0,309,0.12215909090909091,0.38740157480314963,67836923,352,43
0,462,0.09411764705882353,0.11290322580645161,73399536,510,48
0,267,0.19090909090909092,0.45,77677110,330,63
0,53,0.208955223880597,0.42592592592592593,80150379,67,14
1,120,0.4174757281553398,0.7822878228782287,80180246,206,86
0,1027,0.14202172096908938,0.19247378161628625,67554676,1197,170
1,1425,0.2892768079800499,0.6878612716763006,80109064,2005,580
1,363,0.36649214659685864,0.8506944444444444,69153714,573,210
0,309,0.10951008645533142,0.21407624633431085,74026211,347,38
0,229,0.16117216117216118,0.2545731707317073,251650,273,44
1,54,0.4065934065934066,0.875,69582702,91,37
0,506,0.099644128113879,0.20859671302149177,63771316,562,56
1,52,0.3157894736842105,0.6984126984126984,67253291,76,24
1,1013,0.4594450373532551,0.9460410557184751,70642894,1874,861
1,443,0.24013722126929674,0.5653753026634383,68461582,583,140
0,322,0.09550561797752809,0.116751269035533,68539443,356,34
1,266,0.2222222222222222,0.5010893246187363,68541515,342,76
0,452,0.15514018691588785,0.2777777777777778,67554872,535,83
1,548,0.30982367758186397,0.7077865266841645,61848136,794,246
1,246,0.29914529914529914,0.6459143968871596,65330293,351,105
1,118,0.39487179487179486,0.8960573476702509,68884361,195,77
0,924,0.1029126213592233,0.08294930875576037,67555054,1030,106
0,947,0.16046099290780141,0.26940298507462684,67865602,1128,181
1,126,0.44,0.889344262295082,82007138,225,99
0,359,0.16898148148148148,0.42413162705667273,69383622,432,73
1,180,0.305019305019305,0.7293233082706767,70642285,259,79
2,117,0.6740947075208914,0.9315068493150684,72425535,359,242
0,682,0.2069767441860465,0.4208955223880597,54436116,860,178
0,522,0.116751269035533,0.21367521367521367,70643076,591,69
1,250,0.2647058823529412,0.5896700143472023,80152459,340,90
1,285,0.25392670157068065,0.5906040268456376,73514035,382,97
1,81,0.2894736842105263,0.7829457364341085,80135085,114,33
1,574,0.3254994124559342,0.7874743326488707,65355710,851,277
2,88,0.5728155339805825,0.9348837209302325,82022870,206,118
1,163,0.43205574912891986,0.9419953596287703,67556475,287,124
1,774,0.23668639053254437,0.536096256684492,80121139,1014,240
0,1,0.0,0.0,70237930,1,0
0,29,0.03333333333333333,0.183206106870229,70746291,30,1
0,28,0.0,0.0,70746515,28,0
2,2,0.9130434782608695,0.75,82007812,23,21
2,98,0.6216216216216216,0.8369565217391305,70906521,259,161
0,242,0.12,0.13882863340563992,70322980,275,33
0,559,0.1238244514106583,0.12335958005249344,80178946,638,79
2,48,0.625,0.9710144927536232,80018561,128,80
1,22,0.4634146341463415,0.6666666666666666,74123763,41,19
0,256,0.055350553505535055,0.22104018912529552,62837866,271,15
0,259,0.075,0.36912065439672803,68798086,280,21
0,134,0.18787878787878787,0.4393939393939394,68625732,165,31
0,453,0.15955473098330242,0.2861111111111111,68942272,539,86
1,252,0.24776119402985075,0.5291479820627802,70185311,335,83
0,142,0.21978021978021978,0.43911439114391143,68533703,182,40
0,32,0.1794871794871795,0.41,76717522,39,7
0,323,0.23820754716981132,0.49794238683127573,68542551,424,101
1,294,0.25380710659898476,0.5083487940630798,69868743,394,100
0,60,0.0625,0.13138686131386862,67620476,64,4
1,487,0.3575197889182058,0.8328205128205128,68534795,758,271
1,413,0.28422876949740034,0.6536458333333334,69606775,577,164
1,99,0.34868421052631576,0.8244274809160306,65971640,152,53
2,6,0.5,0.9166666666666666,68240396,12,6
0,843,0.0935483870967742,0.10829103214890017,67792851,930,87
1,5,0.375,0.8,68625795,8,3
1,74,0.32727272727272727,0.7397260273972602,74045335,110,36
0,721,0.10323383084577115,0.09117647058823529,72899323,804,83
1,825,0.2838541666666667,0.6804123711340206,80109736,1152,327
0,566,0.15522388059701492,0.1881720430107527,80118622,670,104
1,328,0.31092436974789917,0.6954887218045113,80125381,476,148
0,354,0.17096018735362997,0.34277620396600567,80125018,427,73
1,354,0.4906474820143885,0.9307116104868914,62512296,695,341
2,95,0.6360153256704981,0.9717514124293786,80128681,261,166
1,137,0.33170731707317075,0.7574626865671642,65854992,205,68
1,219,0.3047619047619048,0.7485493230174082,67557441,315,96
2,0,1.0,1.0,68289193,1,1
0,200,0.06103286384976526,0.03197674418604651,82095520,213,13
1,870,0.4188376753507014,0.8935663224781573,63487473,1497,627
1,154,0.27358490566037735,0.6696696696696697,67940621,212,58
0,43,0.2037037037037037,0.2972972972972973,65005976,54,11
1,139,0.305,0.538860103626943,65005983,200,61
1,371,0.3826955074875208,0.85667215815486,65768451,601,230
1,345,0.37613019891500904,0.8824362606232294,64905722,553,208
0,723,0.1812004530011325,0.3516014234875445,63278964,883,160
1,496,0.28735632183908044,0.6285714285714286,67766391,696,200
0,146,0.11515151515151516,0.2440087145969499,69416550,165,19
1,298,0.42135922330097086,0.8967136150234741,69467412,515,217
0,337,0.20892018779342722,0.3911392405063291,66087315,426,89
0,772,0.18220338983050846,0.3160690571049137,80119330,944,172
1,170,0.34108527131782945,0.7938144329896907,81971159,258,88
0,163,0.2347417840375587,0.4523809523809524,72706095,213,50
1,210,0.2605633802816901,0.6766467065868264,68642343,284,74
1,466,0.374496644295302,0.8401826484018264,65218391,745,279
0,587,0.18245125348189414,0.3163265306122449,80121012,718,131
1,173,0.2967479674796748,0.7117794486215538,81980706,246,73
1,63,0.35051546391752575,0.6979166666666666,70179711,97,34
0,107,0.38857142857142857,0.4344262295081967,66281166,175,68
1,601,0.253416149068323,0.5131707317073171,80107300,805,204
1,291,0.33256880733944955,0.8053221288515406,69180293,436,145
1,180,0.4098360655737705,0.929384965831435,80127343,305,125
1,129,0.31016042780748665,0.5858585858585859,70348033,187,58
1,294,0.40365111561866124,0.897133220910624,80110135,493,199
1,132,0.36538461538461536,0.8874172185430463,70013020,208,76
2,2,0.6666666666666666,0.9285714285714286,67694732,6,4
0,76,0.10588235294117647,0.11836734693877551,69640284,85,9
0,102,0.19047619047619047,0.3474320241691843,70045185,126,24
1,601,0.464349376114082,0.7408759124087592,70121933,1122,521
0,407,0.2035225048923679,0.3904191616766467,67833801,511,104
2,82,0.6510638297872341,0.9746835443037974,80118346,235,153
1,726,0.4851063829787234,0.9237536656891495,80136477,1410,684
1,35,0.3269230769230769,0.6727272727272727,69506871,52,17
1,264,0.3874709976798144,0.8045977011494253,78110823,431,167
1,295,0.25316455696202533,0.5899182561307902,80180491,395,100
0,171,0.06043956043956044,0.06140350877192982,69416746,182,11
0,510,0.2543859649122807,0.3995433789954338,80167986,684,174
0,117,0.11363636363636363,0.15454545454545454,70934234,132,15
1,20,0.3103448275862069,0.7222222222222222,80127355,29,9
1,413,0.31960461285008235,0.7745504840940526,69073473,607,194
2,2,0.6,0.875,73643934,5,3
1,52,0.47474747474747475,0.979381443298969,67173393,99,47
1,346,0.3982608695652174,0.8563656147986942,81971155,575,229
0,198,0.2556390977443609,0.45989304812834225,80027983,266,68
2,0,1.0,1.0,82022957,1,1
0,130,0.09722222222222222,0.17682926829268292,72545844,144,14
1,3,0.25,0.6666666666666666,70702744,4,1
1,180,0.40789473684210525,0.8885245901639345,68782476,304,124
1,228,0.3254437869822485,0.5757575757575758,70866495,338,110
2,1,0.8,0.5,68163004,5,4
0,383,0.0880952380952381,0.21507760532150777,72275196,420,37
2,8,0.8048780487804879,0.8571428571428571,62237105,41,33
1,319,0.30501089324618735,0.7335164835164835,80140055,459,140
0,27,0.03571428571428571,0.0,80141489,28,1
1,608,0.38832997987927564,0.6985645933014354,70717241,994,386
0,460,0.13857677902621723,0.25,73700606,534,74
1,538,0.24649859943977592,0.5545224006762468,70479906,714,176
2,45,0.6564885496183206,0.9609375,72417975,131,86
0,116,0.04918032786885246,0.04395604395604396,71762586,122,6
1,222,0.3638968481375358,0.7830342577487766,69521074,349,127
1,316,0.271889400921659,0.609167671893848,82124919,434,118
1,547,0.30407124681933845,0.6984,68600791,786,239
0,1119,0.21693491952414276,0.398598516075845,65308656,1429,310
1,272,0.28608923884514437,0.6388101983002833,68763933,381,109
0,369,0.04896907216494845,0.20559210526315788,68356904,388,19
1,420,0.32367149758454106,0.7672955974842768,69089650,621,201
1,269,0.36705882352941177,0.8810344827586207,65355836,425,156
0,1433,0.10269254852849093,0.2014806980433633,299964,1597,164
0,292,0.039473684210526314,0.12917115177610333,62839931,304,12
0,42,0.045454545454545456,0.16939890710382513,62841303,44,2
0,63,0.24096385542168675,0.49282296650717705,82126689,83,20
0,648,0.06493506493506493,0.0628698224852071,80070914,693,45
1,194,0.2679245283018868,0.5743243243243243,70741636,265,71
1,220,0.2948717948717949,0.6818181818181818,69621895,312,92
1,73,0.45925925925925926,0.87248322147651,73321045,135,62
1,98,0.3194444444444444,0.6982758620689655,73650941,144,46
1,372,0.40669856459330145,0.9124365482233503,82038331,627,255
1,881,0.41344873501997337,0.8970283344851416,69967275,1502,621
1,747,0.22910216718266255,0.5451327433628319,68541480,969,222
1,630,0.3623481781376518,0.8195718654434251,63445725,988,358
0,698,0.21484814398200225,0.4428463285389856,70207172,889,191
0,1137,0.2495049504950495,0.4713271436373566,70870870,1515,378
0,229,0.05761316872427984,0.049738219895287955,67706443,243,14
1,242,0.44110854503464203,0.8969258589511754,80096100,433,191
1,90,0.3181818181818182,0.7703349282296651,69056694,132,42
1,493,0.40097205346294046,0.880927291886196,67993534,823,330
1,523,0.2766251728907331,0.6475495307612096,68531876,723,200
1,265,0.3977272727272727,0.9382940108892922,80121190,440,175
0,381,0.2318548387096774,0.37209302325581395,57042370,496,115
1,196,0.4948453608247423,0.9068627450980392,82007491,388,192
0,196,0.1694915254237288,0.4220430107526882,69965140,236,40
0,224,0.12840466926070038,0.37073170731707317,70746095,257,33
1,320,0.2967032967032967,0.5835010060362174,70720426,455,135
1,783,0.3191304347826087,0.6974085365853658,69692931,1150,367
1,196,0.38170347003154576,0.8819095477386935,82126700,317,121
1,93,0.256,0.5863874345549738,80130629,125,32
2,66,0.56,0.9837837837837838,61698574,150,84
0,1087,0.23071479122434538,0.43105022831050227,69045760,1413,326
1,29,0.30952380952380953,0.6888888888888889,61167841,42,13
0,622,0.14206896551724138,0.22542735042735043,67928693,725,103
1,139,0.47547169811320755,0.8388059701492537,80135031,265,126
1,56,0.38461538461538464,0.7218934911242604,80178920,91,35
1,522,0.2647887323943662,0.6833176248821866,68391883,710,188
0,850,0.09381663113006397,0.12052877138413685,70641886,938,88
1,256,0.25146198830409355,0.5770392749244713,70670530,342,86
2,4,0.5555555555555556,0.9090909090909091,82144697,9,5
1,114,0.37362637362637363,0.868421052631579,82126732,182,68
1,166,0.28448275862068967,0.7163865546218487,70242662,232,66
2,203,0.5300925925925926,0.9635036496350365,80181011,432,229
1,139,0.3738738738738739,0.8377483443708609,67995172,222,83
1,48,0.42168674698795183,0.8807339449541285,63612304,83,35
1,378,0.2840909090909091,0.6175395858708892,82008934,528,150
0,336,0.14285714285714285,0.3069948186528497,70617253,392,56
0,76,0.07317073170731707,0.46875,74607022,82,6
1,194,0.25384615384615383,0.6419753086419753,73346840,260,66
0,185,0.17040358744394618,0.41472868217054265,63321916,223,38
0,311,0.1837270341207349,0.45365853658536587,65198735,381,70
1,126,0.31891891891891894,0.7735191637630662,70672875,185,59
0,730,0.048239895697522815,0.02316076294277929,70072051,767,37
0,91,0.1651376146788991,0.4345991561181435,60812150,109,18
0,45,0.1509433962264151,0.33076923076923076,78763195,53,8
1,18,0.3076923076923077,0.8421052631578947,67464033,26,8
1,102,0.296551724137931,0.68,70742511,145,43
1,52,0.4639175257731959,0.896551724137931,68750010,97,45
1,150,0.1935483870967742,0.5363984674329502,67222582,186,36
1,118,0.3621621621621622,0.7415730337078652,70585865,185,67
1,72,0.4098360655737705,0.6716417910447762,70583436,122,50
0,92,0.2,0.2712765957446808,74921784,115,23
1,226,0.2893081761006289,0.7027863777089783,82128667,318,92
0,209,0.08733624454148471,0.2894736842105263,67463935,229,20
2,2,0.5,0.8,67464061,4,2
0,148,0.075,0.21728971962616822,68279344,160,12
1,13,0.1875,0.675,69895546,16,3
0,33,0.08333333333333333,0.21875,82150077,36,3
1,31,0.3111111111111111,0.8192771084337349,82150079,45,14
0,974,0.21955128205128205,0.37220259128386335,67027226,1248,274
1,25,0.24242424242424243,0.6296296296296297,60249455,33,8
1,31,0.20512820512820512,0.7640449438202247,65667931,39,8
0,58,0.01694915254237288,0.030405405405405407,70251034,59,1
0,63,0.03076923076923077,0.09821428571428571,63993335,65,2
0,170,0.07608695652173914,0.32954545454545453,63780920,184,14
0,199,0.06572769953051644,0.03272727272727273,68600770,213,14
1,233,0.2360655737704918,0.5342465753424658,68533682,305,72
0,315,0.06528189910979229,0.2074074074074074,69965042,337,22
0,212,0.2,0.490521327014218,69965063,265,53
1,19,0.17391304347826086,0.5211267605633803,70746445,23,4
0,310,0.06626506024096386,0.052571428571428575,69551811,332,22
1,48,0.21311475409836064,0.5,75523000,61,13
1,23,0.17857142857142858,0.7383177570093458,63781921,28,5
1,23,0.25806451612903225,0.726027397260274,64352701,31,8
1,120,0.3617021276595745,0.8483754512635379,69180153,188,68
0,122,0.14084507042253522,0.4274611398963731,69133533,142,20
0,204,0.13924050632911392,0.21428571428571427,68299721,237,33
0,411,0.20809248554913296,0.38179347826086957,68299770,519,108
0,77,0.26666666666666666,0.4444444444444444,66263540,105,28
1,81,0.3816793893129771,0.8809523809523809,67464166,131,50
1,97,0.2814814814814815,0.6612903225806451,69587903,135,38
1,1012,0.41637831603229525,0.860655737704918,70850423,1734,722
0,66,0.14285714285714285,0.375,70908943,77,11
0,107,0.17692307692307693,0.31223628691983124,82150084,130,23
0,39,0.07142857142857142,0.21311475409836064,63993244,42,3
1,15,0.21052631578947367,0.5555555555555556,64041670,19,4
0,18,0.1,0.2903225806451613,66806831,20,2
0,6,0.14285714285714285,0.3,67754386,7,1
1,169,0.41522491349480967,0.9,64039864,289,120
1,178,0.17592592592592593,0.5427350427350427,61386122,216,38
0,30,0.0625,0.18604651162790697,63993006,32,2
1,14,0.2222222222222222,0.8235294117647058,65668323,18,4
0,11,0.08333333333333333,0.38461538461538464,67475310,12,1
1,436,0.21014492753623187,0.5066124109867752,68536790,552,116
0,487,0.21578099838969403,0.3866552609067579,67737152,621,134
1,288,0.36283185840707965,0.8718929254302104,70207235,452,164
1,92,0.3611111111111111,0.8587786259541985,67557791,144,52
0,411,0.11422413793103449,0.12125534950071326,73347043,464,53
1,59,0.21333333333333335,0.6554054054054054,80028795,75,16
0,25,0.0,0.0,69638086,25,0
1,23,0.34285714285714286,0.7450980392156863,80135058,35,12
0,288,0.023728813559322035,0.00819672131147541,70606886,295,7
0,417,0.13305613305613306,0.4092465753424658,68318341,481,64
0,584,0.0875,0.061878453038674036,80112802,640,56
0,337,0.05865921787709497,0.023255813953488372,80112823,358,21
0,51,0.08928571428571429,0.09195402298850575,70587034,56,5
1,382,0.29908256880733947,0.6844207723035952,81967304,545,163
2,86,0.7556818181818182,0.9139784946236559,67430426,352,266
0,434,0.12323232323232323,0.26120556414219476,63769804,495,61
0,78,0.1875,0.20618556701030927,82009527,96,18
0,93,0.19130434782608696,0.16363636363636364,82009543,115,22
0,27,0.03571428571428571,0.030303030303030304,70686980,28,1
1,223,0.21201413427561838,0.5474006116207951,73637571,283,60
1,86,0.13131313131313133,0.5726495726495726,61945863,99,13
0,25,0.13793103448275862,0.16483516483516483,68391190,29,4
1,321,0.44559585492227977,0.8671023965141612,80124819,579,258
2,58,0.8092105263157895,0.922077922077922,73410862,304,246
1,6,0.25,0.6190476190476191,62087683,8,2
0,351,0.11809045226130653,0.15077319587628865,65034634,398,47
0,91,0.07142857142857142,0.16727272727272727,63993321,98,7
0,16,0.058823529411764705,0.125,67475723,17,1
1,143,0.20994475138121546,0.6265356265356266,69887104,181,38
0,2,0.0,0.0,70487340,2,0
2,36,0.6635514018691588,0.7659574468085106,64316294,107,71
1,18,0.4,0.9753086419753086,80137534,30,12
1,15,0.4444444444444444,0.9038461538461539,19454792,27,12
1,196,0.42857142857142855,0.8387096774193549,70576653,343,147
1,43,0.4027777777777778,0.8203125,80162174,72,29
2,94,0.5765765765765766,0.9832214765100671,81971169,222,128
1,35,0.4852941176470588,0.81,80158289,68,33
1,422,0.3596358118361153,0.8627700127064803,69607643,659,237
0,41,0.2545454545454545,0.4854368932038835,70568260,55,14
0,103,0.14166666666666666,0.3548387096774194,70568736,120,17
1,438,0.3452914798206278,0.75,80096233,669,231
1,52,0.42857142857142855,0.94,81971175,91,39
0,5,0.16666666666666666,0.08333333333333333,70843423,6,1
1,47,0.44047619047619047,0.8373493975903614,82013625,84,37
0,126,0.03076923076923077,0.0136986301369863,80135332,130,4
0,326,0.06051873198847262,0.08463949843260188,80135342,347,21
0,83,0.22429906542056074,0.412,70121562,107,24
1,19,0.20833333333333334,0.5806451612903226,72801883,24,5
0,24,0.04,0.02857142857142857,72808862,25,1
2,8,0.5789473684210527,0.8333333333333334,67844483,19,11
1,260,0.21686746987951808,0.6351039260969977,66348065,332,72
1,11,0.45,0.8181818181818182,75265113,20,9
1,262,0.2577903682719547,0.5032397408207343,80176788,353,91
2,8,0.7777777777777778,0.8571428571428571,80178960,36,28
0,591,0.16407355021216408,0.20783847980997625,69550215,707,116
1,335,0.4112478031634446,0.7392638036809815,80172978,569,234
0,47,0.06,0.10059171597633136,63993363,50,3
1,23,0.34285714285714286,0.9027777777777778,69621391,35,12
1,106,0.32051282051282054,0.7655677655677655,69607055,156,50
1,28,0.24324324324324326,0.5679012345679012,80162162,37,9
0,67,0.0945945945945946,0.3005181347150259,80029285,74,7
1,51,0.3625,0.7266187050359713,69334636,80,29
1,230,0.3009118541033435,0.6555183946488294,74554494,329,99
1,696,0.27800829875518673,0.6590421729807004,82008907,964,268
0,399,0.18237704918032788,0.4949381327334083,62050506,488,89
1,13,0.4090909090909091,0.7241379310344828,80176611,22,9
2,16,0.5897435897435898,0.9444444444444444,82145529,39,23
0,144,0.12195121951219512,0.4477211796246649,62529712,164,20
2,16,0.5428571428571428,0.9722222222222222,69221425,35,19
0,595,0.0943683409436834,0.07754442649434572,67964155,657,62
2,68,0.615819209039548,0.9775280898876404,80178209,177,109
0,257,0.15181518151815182,0.37920489296636084,67463991,303,46
0,240,0.09433962264150944,0.23500810372771475,69869121,265,25
2,285,0.6164199192462988,0.9660377358490566,80137986,743,458
0,18,0.18181818181818182,0.4576271186440678,64352673,22,4
1,46,0.22033898305084745,0.5486111111111112,67463914,59,13
0,610,0.06584992343032159,0.034255599472990776,66508561,653,43
0,69,0.15853658536585366,0.3655913978494624,68279393,82,13
0,348,0.03333333333333333,0.04516129032258064,65914863,360,12
0,1070,0.15681639085894405,0.2396039603960396,68539373,1269,199
1,69,0.26595744680851063,0.5574712643678161,68628994,94,25
0,2512,0.04377617053673392,0.022802653399668325,67706541,2627,115
1,279,0.3881578947368421,0.8959349593495934,65268133,456,177
1,134,0.32323232323232326,0.7905604719764012,69421541,198,64
1,47,0.43373493975903615,0.9528301886792453,69421842,83,36
0,133,0.17901234567901234,0.2704225352112676,77676655,162,29
1,329,0.4786053882725832,0.9283536585365854,61022213,631,302
1,100,0.3288590604026846,0.6319444444444444,65931131,149,49
0,47,0.11320754716981132,0.3430232558139535,70069951,53,6
1,247,0.37468354430379747,0.85,69421422,395,148
0,142,0.11801242236024845,0.10687022900763359,73347022,161,19
1,51,0.34615384615384615,0.8235294117647058,69180622,78,27
1,19,0.20833333333333334,0.5,71081395,24,5
1,34,0.37037037037037035,0.6197183098591549,80178915,54,20
0,285,0.09235668789808917,0.10434782608695652,72135413,314,29
1,138,0.2849740932642487,0.6976047904191617,80118964,193,55
0,12,0.14285714285714285,0.4915254237288136,67475555,14,2
0,86,0.022727272727272728,0.10810810810810811,66876873,88,2
0,642,0.08936170212765958,0.10239651416122005,82036710,705,63
0,51,0.13559322033898305,0.232,60463396,59,8
0,112,0.104,0.2542955326460481,65467290,125,13
1,52,0.3157894736842105,0.7333333333333333,69955571,76,24
1,14,0.36363636363636365,0.8723404255319149,80133808,22,8
1,90,0.20353982300884957,0.5566037735849056,60812171,113,23
0,35,0.16666666666666666,0.4144144144144144,64261820,42,7
0,4,0.0,0.0,66782905,4,0
1,257,0.3493670886075949,0.8595600676818951,70072233,395,138
1,360,0.32710280373831774,0.7363515312916112,70748293,535,175
2,9,0.5714285714285714,0.9629629629629629,76176926,21,12
1,23,0.34285714285714286,0.9142857142857143,73650633,35,12
0,1243,0.044581091468101464,0.1216772744290528,68130902,1301,58
1,20,0.3333333333333333,0.7368421052631579,69499472,30,10
1,35,0.18604651162790697,0.5905511811023622,80153534,43,8
1,199,0.26838235294117646,0.7057356608478803,68541774,272,73
1,512,0.3469387755102041,0.8105590062111802,70670663,784,272
1,146,0.4016393442622951,0.9075342465753424,69421443,244,98
2,128,0.5241635687732342,0.9226190476190477,67823084,269,141
1,1601,0.29346866725507503,0.6086662153012864,63115976,2266,665
1,785,0.26704014939309056,0.6146153846153846,67942651,1071,286
1,477,0.4421052631578947,0.9460431654676259,70870345,855,378
1,216,0.3333333333333333,0.727069351230425,69130033,324,108
1,910,0.30321592649310875,0.7256740914419695,67668062,1306,396
0,845,0.07244785949506037,0.07583417593528817,70609350,911,66
0,514,0.1183533447684391,0.12081218274111676,69621251,583,69
0,5,0.16666666666666666,0.3076923076923077,80130735,6,1
1,123,0.32786885245901637,0.7392996108949417,72270751,183,60
2,558,0.6206662134602311,0.9876760563380281,70073822,1471,913
0,339,0.14393939393939395,0.2552742616033755,80116596,396,57
0,207,0.11914893617021277,0.4692982456140351,65509794,235,28
0,92,0.02127659574468085,0.018796992481203006,67846394,94,2
1,171,0.41638225255972694,0.884318766066838,80125422,293,122
0,280,0.06354515050167224,0.2117039586919105,60541740,299,19
1,313,0.31057268722466963,0.746,63113505,454,141
0,70,0.1566265060240964,0.18518518518518517,73650906,83,13
0,43,0.14,0.294478527607362,70760291,50,7
1,480,0.40074906367041196,0.8847980997624703,74091444,801,321
0,182,0.20869565217391303,0.38596491228070173,80168513,230,48
1,333,0.3521400778210117,0.8252279635258358,68200363,514,181
0,394,0.0413625304136253,0.06482593037214886,63780752,411,17
2,423,0.5149082568807339,0.9727488151658767,73016342,872,449
0,34,0.2916666666666667,0.4520547945205479,68401095,48,14
1,25,0.4791666666666667,0.9183673469387755,69165292,48,23
0,15,0.0625,0.359375,66783234,16,1
0,4,0.0,0.0,66786461,4,0
1,271,0.4601593625498008,0.8940520446096655,67070605,502,231
2,183,0.5246753246753246,0.9683257918552036,69838552,385,202
0,596,0.05396825396825397,0.12835820895522387,70001631,630,34
1,332,0.2703296703296703,0.6327985739750446,73524836,455,123
0,1642,0.17362858580775037,0.2920962199312715,73245606,1987,345
0,99,0.175,0.27472527472527475,67771732,120,21
0,1156,0.22778891115564462,0.476,72293851,1497,341
1,281,0.24664879356568364,0.5032362459546925,80103135,373,92
0,142,0.1497005988023952,0.17321016166281755,80118976,167,25
1,106,0.14516129032258066,0.5228426395939086,61976432,124,18
1,646,0.2806236080178174,0.604135893648449,81967264,898,252
0,31,0.11428571428571428,0.23684210526315788,66221890,35,4
0,87,0.2018348623853211,0.48854961832061067,69416634,109,22
0,190,0.05472636815920398,0.03225806451612903,69416942,201,11
1,561,0.25596816976127323,0.5977410947002606,68532912,754,193
0,272,0.18562874251497005,0.33541341653666146,68533283,334,62
0,247,0.03137254901960784,0.03231017770597738,60028675,255,8
2,73,0.7326007326007326,0.9864864864864865,69069364,273,200
0,327,0.06303724928366762,0.32653061224489793,69383433,349,22
0,212,0.16535433070866143,0.25889328063241107,67554312,254,42
0,72,0.1111111111111111,0.05472636815920398,67556230,81,9
1,224,0.33134328358208953,0.7827004219409283,80107832,335,111
1,160,0.29515418502202645,0.6452442159383034,82124933,227,67
1,304,0.38461538461538464,0.8144192256341789,69164746,494,190
0,286,0.1513353115727003,0.29084380610412924,68542754,337,51
1,405,0.2636363636363636,0.7692307692307693,67364234,550,145
1,100,0.2907801418439716,0.7177033492822966,80145461,141,41
1,128,0.33678756476683935,0.7417582417582418,63898814,193,65
2,67,0.6898148148148148,0.9538461538461539,80150978,216,149
0,193,0.12272727272727273,0.11466666666666667,68512031,220,27
0,281,0.03767123287671233,0.012658227848101266,68512073,292,11
0,46,0.08,0.1870967741935484,67475786,50,4
1,42,0.19230769230769232,0.552,67475835,52,10
0,304,0.0529595015576324,0.025714285714285714,70643391,321,17
1,90,0.26229508196721313,0.5259259259259259,65316643,122,32
1,91,0.2601626016260163,0.7714285714285715,66534853,123,32
0,775,0.1993801652892562,0.4349388928828181,68544140,968,193
1,446,0.2270363951473137,0.5430932703659976,69587574,577,131
0,310,0.0855457227138643,0.31993006993006995,61946143,339,29
0,198,0.07042253521126761,0.2818371607515658,61946150,213,15
1,70,0.21348314606741572,0.7078651685393258,80135172,89,19
2,24,0.7241379310344828,0.9423076923076923,80137979,87,63
1,433,0.30048465266558966,0.6980874316939891,70642684,619,186
1,285,0.38177874186550975,0.8405797101449275,70350021,461,176
0,536,0.0868824531516184,0.07891637220259129,69873755,587,51
1,107,0.2517482517482518,0.6625514403292181,70058681,143,36
1,74,0.1956521739130435,0.644,69084512,92,18
0,357,0.16783216783216784,0.48664343786295006,70121086,429,72
1,417,0.35046728971962615,0.7913043478260869,70673834,642,225
1,197,0.3253424657534247,0.7603773584905661,69176940,292,95
1,76,0.2621359223300971,0.5463917525773195,69179621,103,27
0,16,0.0,0.0,70629622,16,0
0,45,0.1346153846153846,0.4260869565217391,70629804,52,7
0,758,0.05721393034825871,0.05092592592592592,73245641,804,46
1,121,0.25308641975308643,0.5311572700296736,81967359,162,41
1,355,0.32509505703422054,0.8097686375321337,71389150,526,171
1,91,0.2540983606557377,0.8348623853211009,80118427,122,31
1,618,0.2695035460992908,0.6107431935246505,68763842,846,228
2,4,0.6666666666666666,0.8333333333333334,69899963,12,8
1,96,0.2066115702479339,0.5906976744186047,70908950,121,25
0,53,0.1016949152542373,0.3701657458563536,82103880,59,6
1,664,0.31048805815160957,0.7374149659863946,68212151,963,299
0,317,0.15240641711229946,0.29447236180904524,80070732,374,57
0,216,0.0847457627118644,0.06060606060606061,80079930,236,20
1,360,0.2885375494071146,0.7382465057179162,68536391,506,146
1,279,0.46449136276391556,0.8993839835728953,66037965,521,242
0,11,0.15384615384615385,0.40476190476190477,80128551,13,2
2,7,0.5,0.9032258064516129,70121261,14,7
1,682,0.27523910733262485,0.6935933147632312,70515424,941,259
1,817,0.25114573785517874,0.5846883468834688,80098403,1091,274
0,207,0.18503937007874016,0.21739130434782608,82128658,254,47
1,134,0.29473684210526313,0.8027522935779816,66035970,190,56
1,137,0.315,0.7735294117647059,80103240,200,63
1,47,0.45348837209302323,0.9230769230769231,77881034,86,39
0,124,0.1388888888888889,0.29945054945054944,68604011,144,20
0,163,0.24537037037037038,0.4936440677966102,69723864,216,53
1,161,0.31196581196581197,0.8393665158371041,67835152,234,73
1,92,0.25806451612903225,0.7509025270758123,67835166,124,32
0,174,0.17535545023696683,0.30213903743315507,70047824,211,37
0,233,0.14022140221402213,0.18674698795180722,70093072,271,38
0,204,0.1774193548387097,0.33589251439539347,70573825,248,44
1,205,0.2857142857142857,0.5994694960212201,81967260,287,82
1,88,0.4430379746835443,0.9082125603864735,67638711,158,70
0,123,0.09558823529411764,0.15384615384615385,70566804,136,13
1,21,0.475,0.9024390243902439,72803122,40,19
2,0,1.0,1.0,69206830,4,4
1,182,0.3546099290780142,0.8148854961832062,81971144,282,100
0,23,0.041666666666666664,0.14285714285714285,70568141,24,1
0,19,0.13636363636363635,0.37254901960784315,80122877,22,3
0,169,0.11979166666666667,0.12130177514792899,74549174,192,23
0,719,0.22688172043010751,0.45249169435215947,80105746,930,211
0,647,0.20807833537331702,0.3576072821846554,72899253,817,170
0,113,0.23648648648648649,0.3677685950413223,80102946,148,35
1,60,0.25,0.7175925925925926,71359491,80,20
2,18,0.7631578947368421,0.9827586206896551,68656280,76,58
2,17,0.8671875,0.9696969696969697,80175636,128,111
1,65,0.2857142857142857,0.6417910447761194,80027990,91,26
2,120,0.5219123505976095,0.9248554913294798,70183015,251,131
0,490,0.10583941605839416,0.09761388286334056,68192460,548,58
1,16,0.3333333333333333,0.8285714285714286,73623410,24,8
2,54,0.5045871559633027,0.925,70117166,109,55
1,222,0.48130841121495327,0.8898071625344353,66452925,428,206
0,666,0.18181818181818182,0.35481023830538394,69621272,814,148
0,61,0.2077922077922078,0.4672897196261682,60900854,77,16
0,78,0.15217391304347827,0.2967741935483871,80125972,92,14
1,38,0.45714285714285713,0.9081632653061225,77686336,70,32
0,198,0.208,0.26506024096385544,69548843,250,52
0,1039,0.1707901037509976,0.2623089983022071,69155800,1253,214
1,201,0.3871951219512195,0.8217821782178217,74029403,328,127
1,89,0.4506172839506173,0.9416342412451362,70035581,162,73
1,37,0.4307692307692308,0.8852459016393442,80074351,65,28
0,601,0.062402496099843996,0.03954305799648506,70643090,641,40
0,194,0.12612612612612611,0.29130434782608694,60536973,222,28
1,1291,0.24810716365754223,0.6039418113561709,68158265,1717,426
0,764,0.1539313399778516,0.231433506044905,66931893,903,139
1,170,0.3656716417910448,0.808,79800105,268,98
0,429,0.19360902255639098,0.38382899628252787,80130759,532,103
1,129,0.287292817679558,0.6301775147928994,67653145,181,52
1,428,0.27580372250423013,0.6473282442748092,68191683,591,163
0,232,0.1773049645390071,0.2247191011235955,67552254,282,50
1,180,0.2682926829268293,0.5274725274725275,67555432,246,66
1,34,0.38181818181818183,0.8,69955431,55,21
2,11,0.7380952380952381,0.9583333333333334,79816443,42,31
0,280,0.1836734693877551,0.26865671641791045,65941764,343,63
1,103,0.38323353293413176,0.8725490196078431,68393962,167,64
1,479,0.2538940809968847,0.5480072463768116,73298904,642,163
1,586,0.3539140022050717,0.8245778611632271,81967316,907,321
1,69,0.28865979381443296,0.71900826446281,69621881,97,28
0,168,0.1724137931034483,0.30933333333333335,67159701,203,35
1,332,0.3590733590733591,0.765017667844523,80180004,518,186
0,649,0.21807228915662652,0.4875900720576461,68543412,830,181
1,239,0.3379501385041551,0.7845849802371542,63099071,361,122
1,354,0.30859375,0.7965909090909091,68158370,512,158
0,229,0.18214285714285713,0.3724137931034483,70627326,280,51
1,56,0.4166666666666667,0.917910447761194,69177521,96,40
1,163,0.28820960698689957,0.7312925170068028,73399004,229,66
1,187,0.43843843843843844,0.8496732026143791,80174901,333,146
1,15,0.375,0.8518518518518519,67513915,24,9
2,6,0.5384615384615384,0.9411764705882353,64195985,13,7
1,92,0.4491017964071856,0.9159663865546218,682031,167,75
0,203,0.1814516129032258,0.48502994011976047,68257042,248,45
0,273,0.052083333333333336,0.10714285714285714,80124387,288,15
2,193,0.5682326621923938,0.9548387096774194,74361784,447,254
0,1,0.0,0.0,82019911,1,0
1,33,0.45901639344262296,0.64,80172963,61,28
1,352,0.2605042016806723,0.5242494226327945,82047582,476,124
1,176,0.2,0.5512295081967213,70649201,220,44
0,27,0.03571428571428571,0.10476190476190476,70679630,28,1
0,27,0.1,0.2553191489361702,70693280,30,3
1,360,0.25925925925925924,0.725094577553594,70190414,486,126
1,46,0.4772727272727273,0.9375,69209224,88,42
0,113,0.15671641791044777,0.2636363636363636,67159771,134,21
0,485,0.15357766143106458,0.27764976958525345,68538582,573,88
1,84,0.25663716814159293,0.517948717948718,81956345,113,29
1,391,0.2877959927140255,0.676510067114094,66206511,549,158
0,256,0.18210862619808307,0.3413793103448276,67159302,313,57
1,101,0.43575418994413406,0.8326530612244898,69157683,179,78
1,429,0.30357142857142855,0.7159420289855073,65290435,616,187
1,421,0.3401253918495298,0.7693726937269373,62413421,638,217
1,356,0.2457627118644068,0.5909661229611042,80134714,472,116
1,526,0.3151041666666667,0.7111770524233432,75326972,768,242
1,143,0.33796296296296297,0.7533875338753387,63602651,216,73
0,245,0.050387596899224806,0.15049751243781095,80124777,258,13
0,207,0.03271028037383177,0.06580829756795423,80124778,214,7
0,206,0.037383177570093455,0.0684931506849315,80124779,214,8
0,182,0.031914893617021274,0.05365853658536585,80124780,188,6
0,90,0.1891891891891892,0.325,69949082,111,21
1,72,0.36283185840707965,0.7878787878787878,74738335,113,41
0,396,0.20958083832335328,0.4507042253521127,68155871,501,105
0,89,0.1981981981981982,0.4225352112676056,69978335,111,22
1,212,0.4479166666666667,0.9233644859813084,70909993,384,172
1,376,0.3188405797101449,0.6336805555555556,72170035,552,176
2,106,0.5673469387755102,0.9238095238095239,80174924,245,139
2,359,0.5786384976525821,0.9755700325732899,64028272,852,493
1,122,0.25153374233128833,0.597864768683274,69110881,163,41
1,695,0.3159448818897638,0.7954545454545454,80121045,1016,321
1,670,0.3245967741935484,0.7755725190839695,70597730,992,322
1,387,0.28990825688073396,0.67497034400949,68236133,545,158
0,294,0.06369426751592357,0.08067542213883677,300545,314,20
1,658,0.3051742344244984,0.7263643351268255,69607986,947,289
0,131,0.13815789473684212,0.2827868852459016,64147706,152,21
2,22,0.7317073170731707,0.9310344827586207,68666465,82,60
2,59,0.5163934426229508,0.9644970414201184,80053344,122,63
1,181,0.3885135135135135,0.8144796380090498,80137729,296,115
0,969,0.11989100817438691,0.3068340306834031,63771085,1101,132
0,150,0.025974025974025976,0.017094017094017096,70606872,154,4
1,267,0.3153846153846154,0.7346534653465346,69073606,390,123
0,208,0.2,0.29978586723768735,82124905,260,52
1,22,0.18518518518518517,0.5333333333333333,72918685,27,5
1,31,0.20512820512820512,0.5909090909090909,72918713,39,8
0,306,0.10263929618768329,0.1593172119487909,72900541,341,35
0,266,0.17391304347826086,0.22082585278276481,67552240,322,56
1,499,0.3173734610123119,0.6771397616468039,67995032,731,232
0,174,0.14705882352941177,0.493368700265252,68350772,204,30
0,384,0.20987654320987653,0.39254658385093166,66887303,486,102
1,88,0.37142857142857144,0.7892857142857143,66358264,140,52
1,541,0.39553072625698327,0.8175559380378657,80123759,895,354
1,13,0.3157894736842105,0.6545454545454545,82137928,19,6
2,9,0.9470588235294117,0.9523809523809523,70933786,170,161
2,31,0.6352941176470588,0.9847328244274809,69475476,85,54
0,152,0.24752475247524752,0.4007352941176471,82060564,202,50
2,29,0.75,0.9591836734693877,80118605,116,87
0,288,0.07692307692307693,0.2695035460992908,80116862,312,24
0,170,0.1282051282051282,0.30434782608695654,80124270,195,25
0,28,0.125,0.25,70184401,32,4
1,62,0.1506849315068493,0.638095238095238,69033405,73,11
0,13,0.07142857142857142,0.2631578947368421,74460526,14,1
0,28,0.0967741935483871,0.3225806451612903,74460561,31,3
2,47,0.7513227513227513,0.9868421052631579,80122545,189,142
0,56,0.034482758620689655,0.08771929824561403,80124293,58,2
0,30,0.09090909090909091,0.37777777777777777,80124364,33,3
2,205,0.5424107142857143,0.9656946826758147,80161885,448,243
2,96,0.5576036866359447,0.9736070381231672,80125417,217,121
0,239,0.14028776978417265,0.10886075949367088,67630612,278,39
0,156,0.10344827586206896,0.061068702290076333,67630696,174,18
1,37,0.4931506849315068,0.8767123287671232,82095522,73,36
1,226,0.31722054380664655,0.74609375,81967279,331,105
1,346,0.26382978723404255,0.6541353383458647,82014181,470,124
0,289,0.17897727272727273,0.3501628664495114,68545225,352,63
2,11,0.6764705882352942,0.7647058823529411,67246760,34,23
2,207,0.5071428571428571,0.9659685863874345,67428690,420,213
1,353,0.4405705229793978,0.8883435582822086,69588981,631,278
1,91,0.3,0.6567796610169492,70256942,130,39
1,156,0.383399209486166,0.8958333333333334,80124705,253,97
0,748,0.19135135135135134,0.41220238095238093,73637620,925,177
0,473,0.09213051823416507,0.0935483870967742,82095668,521,48
1,307,0.35095137420718814,0.7934472934472935,65919000,473,166
2,40,0.5061728395061729,0.9454545454545454,68756891,81,41
0,171,0.16176470588235295,0.24864864864864866,68741141,204,33
1,531,0.28243243243243243,0.6302681992337165,68211955,740,209
1,163,0.27876106194690264,0.6754966887417219,74848242,226,63
0,341,0.09066666666666667,0.17320261437908496,66110982,375,34
1,398,0.3254237288135593,0.738003838771593,68212025,590,192
0,363,0.19690265486725664,0.3568,80130748,452,89
1,608,0.3968253968253968,0.8548812664907651,73581165,1008,400
0,662,0.017804154302670624,8.305647840531562E-4,80114286,674,12
0,6,0.14285714285714285,0.08333333333333333,72493785,7,1
1,668,0.2683461117196057,0.57006603081438,81967272,913,245
1,324,0.3135593220338983,0.71334431630972,70643055,472,148
1,177,0.26859504132231404,0.7441860465116279,80128838,242,65
0,1793,0.10394802598700649,0.09767641996557659,67291301,2001,208
0,575,0.025423728813559324,0.013414634146341463,82022546,590,15
1,973,0.23626373626373626,0.5291359678499665,67336682,1274,301
1,211,0.27986348122866894,0.6535087719298246,80140054,293,82
0,121,0.12318840579710146,0.19895287958115182,80141498,138,17
2,131,0.5236363636363637,0.8351648351648352,70179844,275,144
0,387,0.2020618556701031,0.4161915621436716,67160044,485,98
2,182,0.5309278350515464,0.968421052631579,67485852,388,206
0,388,0.039603960396039604,0.12701421800947868,62839371,404,16
1,302,0.20316622691292877,0.5374149659863946,64912841,379,77
1,142,0.3983050847457627,0.868421052631579,67558085,236,94
1,58,0.2839506172839506,0.5952380952380952,70741503,81,23
0,176,0.06382978723404255,0.08139534883720931,67438175,188,12
1,103,0.32679738562091504,0.7887788778877888,80103513,153,50
1,11,0.3125,0.8076923076923077,65279564,16,5
1,96,0.2066115702479339,0.6375,64259251,121,25
1,315,0.23357664233576642,0.6738738738738739,64001140,411,96
0,78,0.22,0.486013986013986,70045283,100,22
1,42,0.2222222222222222,0.5357142857142857,63685741,54,12
1,236,0.2,0.5062388591800356,70909202,295,59
1,288,0.19101123595505617,0.5035971223021583,77969913,356,68
1,128,0.2727272727272727,0.5859154929577465,70660163,176,48
0,313,0.1329639889196676,0.30103359173126615,70660415,361,48
0,56,0.16417910447761194,0.27976190476190477,70683221,67,11
0,43,0.06521739130434782,0.0945945945945946,70684866,46,3
1,861,0.2740303541315346,0.6878980891719745,80121027,1186,325
1,129,0.4342105263157895,0.5878378378378378,72846025,228,99
1,319,0.3125,0.7679324894514767,67160436,464,145
1,416,0.23948811700182815,0.5561797752808989,67160485,547,131
2,4,0.9090909090909091,0.8571428571428571,80118905,44,40
1,60,0.42857142857142855,0.73,72433494,105,45
2,224,0.6914600550964187,0.9704641350210971,72472890,726,502
0,60,0.16666666666666666,0.30434782608695654,70045171,72,12
0,745,0.13472706155632985,0.31954887218045114,80096310,861,116
0,139,0.0915032679738562,0.31645569620253167,69701856,153,14
2,44,0.5555555555555556,0.9651162790697675,80081043,99,55
2,24,0.6923076923076923,0.9878048780487805,72417793,78,54
0,171,0.2119815668202765,0.43548387096774194,68535376,217,46
1,327,0.32298136645962733,0.8014285714285714,67261992,483,156
0,314,0.1444141689373297,0.16279069767441862,69606901,367,53
1,1040,0.29682217714672077,0.7388739946380697,80121272,1479,439
1,206,0.2426470588235294,0.610204081632653,72199463,272,66
2,19,0.822429906542056,0.9736842105263158,70334173,107,88
1,416,0.21212121212121213,0.6043360433604336,67761001,528,112
1,58,0.30952380952380953,0.6451612903225806,67456494,84,26
1,509,0.2536656891495601,0.5325,71340213,682,173
1,91,0.4484848484848485,0.927038626609442,67922596,165,74
0,385,0.21106557377049182,0.42201834862385323,68533430,488,103
0,404,0.15833333333333333,0.3147268408551069,69558440,480,76
1,574,0.4242728184553661,0.8894523326572008,65924110,997,423
1,11,0.3125,0.75,78825271,16,5
1,55,0.26666666666666666,0.7018633540372671,69408374,75,20
0,495,0.11131059245960502,0.15078534031413612,54609681,557,62
0,271,0.16615384615384615,0.25457875457875456,67159113,325,54
0,311,0.12640449438202248,0.1357142857142857,67766874,356,45
1,342,0.4992679355783309,0.9706336939721792,67982012,683,341
0,61,0.24691358024691357,0.4697986577181208,60763283,81,20
0,263,0.1174496644295302,0.20833333333333334,67597992,298,35
0,171,0.10471204188481675,0.268018018018018,72866843,191,20
0,523,0.20030581039755352,0.40330920372285417,68540535,654,131
0,433,0.05043859649122807,0.03994673768308921,72899813,456,23
0,826,0.13958333333333334,0.15807860262008733,69621573,960,134
0,870,0.1282565130260521,0.12687813021702837,69621790,998,128
1,193,0.228,0.5146103896103896,70760760,250,57
0,463,0.14732965009208104,0.2116591928251121,66931914,543,80
0,108,0.14285714285714285,0.19672131147540983,67554781,126,18
1,664,0.3996383363471971,0.8306737588652482,79838731,1106,442
0,506,0.19936708860759494,0.41693121693121693,63277725,632,126
1,88,0.2605042016806723,0.690677966101695,69559182,119,31
1,190,0.31899641577060933,0.7103274559193955,69606831,279,89
0,836,0.08030803080308031,0.0544,68171341,909,73
1,27,0.4807692307692308,0.86,72700215,52,25
0,289,0.16714697406340057,0.3510054844606947,68537035,347,58
1,214,0.33746130030959753,0.7485822306238186,80128503,323,109
1,30,0.4,0.8275862068965517,80119287,50,20
1,143,0.4302788844621514,0.9102564102564102,80129999,251,108
0,543,0.14890282131661442,0.24015748031496062,68290894,638,95
2,70,0.5512820512820513,0.9090909090909091,80045616,156,86
1,88,0.375886524822695,0.7767441860465116,67627665,141,53
1,303,0.41505791505791506,0.9045454545454545,64191925,518,215
1,146,0.2946859903381642,0.5956112852664577,54551833,207,61
1,318,0.4218181818181818,0.9473684210526315,65289154,550,232
2,62,0.6395348837209303,0.937007874015748,69129564,172,110
1,327,0.32854209445585214,0.8509316770186336,80137143,487,160
0,116,0.1076923076923077,0.1906779661016949,54204850,130,14
1,163,0.27876106194690264,0.5861244019138756,69177101,226,63
1,72,0.2727272727272727,0.5612244897959183,69183352,99,27
0,236,0.036734693877551024,0.02493765586034913,73905986,245,9
0,1346,0.12880258899676375,0.15780296425457715,70202650,1545,199
1,302,0.42803030303030304,0.8571428571428571,74393921,528,226
2,507,0.5087209302325582,0.948093220338983,80124693,1032,525
1,236,0.3569482288828338,0.7671957671957672,73026415,367,131
1,96,0.4576271186440678,0.7534883720930232,61022003,177,81
2,161,0.5871794871794872,0.9762611275964391,80160400,390,229
0,86,0.054945054945054944,0.23696682464454977,68668404,91,5
1,130,0.4063926940639269,0.8603603603603603,66470971,219,89
1,194,0.24806201550387597,0.5869565217391305,66423154,258,64
1,78,0.2641509433962264,0.5771812080536913,69621846,106,28
0,190,0.020618556701030927,0.04792746113989637,62839294,194,4
1,217,0.3,0.7924944812362031,80121122,310,93
0,663,0.1423027166882277,0.24324324324324326,66203354,773,110
1,14,0.48148148148148145,0.9538461538461539,71489845,27,13
2,141,0.745945945945946,0.99609375,80126528,555,414
0,179,0.09595959595959595,0.20970873786407768,70660261,198,19
1,587,0.3229527104959631,0.6959165942658557,74326644,867,280
0,190,0.06403940886699508,0.1313364055299539,80124263,203,13
0,173,0.11734693877551021,0.4009111617312073,80124445,196,23
1,20,0.23076923076923078,0.8045977011494253,68384561,26,6
0,377,0.11502347417840375,0.21937842778793418,70615293,426,49
1,217,0.16216216216216217,0.5444646098003629,80124712,259,42
0,710,0.06455862977602109,0.04156479217603912,67557903,759,49
1,344,0.26180257510729615,0.603085553997195,67942553,466,122
2,71,0.5359477124183006,0.950354609929078,69994855,153,82
0,714,0.21796276013143484,0.4389168765743073,81988938,913,199
1,77,0.45390070921985815,0.815068493150685,62375754,141,64
2,3,0.7272727272727273,0.8333333333333334,80172941,11,8
0,337,0.1976190476190476,0.45219638242894056,70686875,420,83
1,910,0.3347953216374269,0.6820428336079077,68395684,1368,458
1,308,0.4166666666666667,0.879382889200561,65787582,528,220
0,21,0.19230769230769232,0.35,67591643,26,5
0,77,0.24509803921568626,0.49029126213592233,67553794,102,25
1,245,0.40097799511002447,0.9037433155080213,70582526,409,164
1,565,0.2857142857142857,0.6278118609406953,80107482,791,226
0,44,0.15384615384615385,0.20353982300884957,67555614,52,8
1,89,0.20535714285714285,0.5206611570247934,80098886,112,23
0,459,0.1339622641509434,0.26327193932827736,80117998,530,71
1,208,0.3180327868852459,0.682092555331992,69208230,305,97
1,72,0.42857142857142855,0.8181818181818182,63385126,126,54
0,705,0.09266409266409266,0.11282051282051282,61583851,777,72
0,1174,0.1656005685856432,0.300520381613183,82011771,1407,233
1,675,0.2902208201892745,0.7014042867701404,70179501,951,276
0,330,0.08839779005524862,0.2566995768688293,63771155,362,32
1,184,0.3588850174216028,0.8348909657320872,73398990,287,103
0,668,0.08743169398907104,0.102322206095791,82011796,732,64
1,389,0.2660377358490566,0.6524547803617571,80111871,530,141
1,203,0.275,0.6048034934497817,69607524,280,77
1,120,0.38461538461538464,0.855036855036855,82021917,195,75
1,175,0.45652173913043476,0.8759894459102903,82059498,322,147
1,105,0.2222222222222222,0.6302521008403361,64399594,135,30
0,231,0.17204301075268819,0.33056478405315615,82011829,279,48
2,55,0.6726190476190477,0.976,80130694,168,113
0,293,0.1994535519125683,0.4435483870967742,68541571,366,73
0,261,0.12416107382550336,0.15416098226466576,66887261,298,37
1,128,0.2967032967032967,0.7407407407407407,68763632,182,54
1,518,0.3148148148148148,0.7211413748378729,69176730,756,238
1,482,0.47608695652173916,0.9073170731707317,68214440,920,438
0,234,0.13333333333333333,0.36619718309859156,70908271,270,36
0,155,0.025157232704402517,0.06831395348837209,74607344,159,4
0,117,0.025,0.10410958904109589,68811631,120,3
1,97,0.26515151515151514,0.694560669456067,67922484,132,35
1,226,0.4792626728110599,0.9455337690631809,65787372,434,208
1,136,0.40611353711790393,0.8825396825396825,67346923,229,93
0,186,0.015873015873015872,0.017673048600883652,62838223,189,3
0,440,0.15221579961464354,0.42929936305732486,64225196,519,79
1,336,0.42168674698795183,0.9233278955954323,63445711,581,245
0,92,0.0707070707070707,0.24232081911262798,80149852,99,7
0,143,0.08333333333333333,0.26779026217228463,80149854,156,13
0,31,0.0,0.0,80149882,31,0
2,111,0.5194805194805194,0.961352657004831,69657413,231,120
1,11,0.47619047619047616,0.8928571428571429,70413021,21,10
0,902,0.19103139013452916,0.36974219810040704,68541123,1115,213
1,101,0.44808743169398907,0.8616352201257862,68040336,183,82
1,133,0.3072916666666667,0.5590062111801242,68040385,192,59
0,140,0.1907514450867052,0.3631713554987212,69724046,173,33
2,13,0.7045454545454546,0.9074074074074074,70120022,44,31
0,327,0.023880597014925373,0.04849660523763336,62839686,335,8
2,6,0.5,0.9375,72802100,12,6
1,571,0.3414071510957324,0.7339667458432304,70201810,867,296
0,626,0.044274809160305344,0.01478953356086462,79788163,655,29
0,453,0.2038664323374341,0.40955631399317405,67554620,569,116
0,443,0.18265682656826568,0.43717277486910994,65467304,542,99
1,187,0.3074074074074074,0.7278617710583153,69177535,270,83
1,184,0.38666666666666666,0.8946015424164524,70760732,300,116
1,24,0.3684210526315789,0.8412698412698413,68393444,38,14
1,200,0.38461538461538464,0.7117794486215538,80180194,325,125
1,104,0.2827586206896552,0.6009615384615384,69153896,145,41
0,325,0.15584415584415584,0.23741007194244604,70871220,385,60
1,255,0.32180851063829785,0.6614906832298136,70327306,376,121
1,1223,0.2767593140153755,0.6470920383963862,80110443,1691,468
1,445,0.2914012738853503,0.6116959064327485,80107286,628,183
1,110,0.4527363184079602,0.8687943262411347,82059496,201,91
0,215,0.1856060606060606,0.3313343328335832,70073171,264,49
1,16,0.36,0.7333333333333333,74709061,25,9
1,96,0.49206349206349204,0.9432835820895522,73131205,189,93
1,193,0.42729970326409494,0.8856015779092702,70197442,337,144
0,246,0.042801556420233464,0.18671679197994986,62838783,257,11
0,450,0.046610169491525424,0.15384615384615385,65910866,472,22
2,27,0.5263157894736842,0.9636363636363636,80053351,57,30
2,22,0.5111111111111111,0.9534883720930233,69621916,45,23
0,285,0.22764227642276422,0.4838709677419355,80121159,369,84
0,648,0.1828499369482976,0.24611398963730569,69184353,793,145
1,14,0.46153846153846156,0.76,73590181,26,12
2,30,0.5161290322580645,0.945054945054945,63129164,62,32
0,202,0.26545454545454544,0.4198473282442748,68401501,275,73
1,266,0.24645892351274787,0.5622119815668203,69160462,353,87
0,338,0.06887052341597796,0.26435536294691225,67341981,363,25
0,110,0.05172413793103448,0.28378378378378377,68811624,116,6
1,129,0.2543352601156069,0.615819209039548,80128513,173,44
1,476,0.2574102964118565,0.5678336980306345,66930710,641,165
1,60,0.3684210526315789,0.8757062146892656,67159505,95,35
1,428,0.47868453105968334,0.9027624309392265,73321493,821,393
1,517,0.28983516483516486,0.6029609690444145,70469896,728,211
0,860,0.20517560073937152,0.3245136186770428,68192033,1082,222
2,195,0.6428571428571429,0.9460916442048517,72561741,546,351
1,173,0.3024193548387097,0.7201492537313433,68531365,248,75
0,352,0.21252796420581654,0.35413153456998314,70653793,447,95
1,75,0.375,0.8215962441314554,69134996,120,45
0,22,0.08333333333333333,0.06944444444444445,71081493,24,2
1,16,0.2727272727272727,0.5616438356164384,80128507,22,6
1,60,0.25925925925925924,0.6343283582089553,69603030,81,21
1,323,0.4392361111111111,0.9123867069486404,67149082,576,253
1,281,0.2813299232736573,0.7196819085487077,75697601,391,110
1,313,0.3702213279678068,0.5654450261780105,70544201,497,184
0,230,0.1986062717770035,0.308411214953271,72899246,287,57
1,85,0.30327868852459017,0.7557251908396947,73672886,122,37
1,101,0.2518518518518518,0.5186721991701245,80118403,135,34
1,406,0.24535315985130113,0.6246786632390745,63279013,538,132
0,86,0.18867924528301888,0.3278008298755187,63283325,106,20
1,86,0.4228187919463087,0.9408866995073891,67305651,149,63
1,45,0.48863636363636365,0.9568965517241379,82002262,88,43
1,156,0.363265306122449,0.7573221757322176,67122594,245,89
0,686,0.0458970792767733,0.06802721088435375,67747190,719,33
0,253,0.14527027027027026,0.2594458438287154,69204562,296,43
0,130,0.051094890510948905,0.05653710247349823,70081333,137,7
2,16,0.6363636363636364,0.9710144927536232,80158263,44,28
2,313,0.7539308176100629,0.9874326750448833,70005964,1272,959
0,384,0.1829787234042553,0.2781065088757396,69666695,470,86
0,328,0.18407960199004975,0.4303448275862069,69239961,402,74
0,397,0.2200392927308448,0.46494464944649444,70627620,509,112
0,87,0.2018348623853211,0.34701492537313433,82116838,109,22
1,151,0.34347826086956523,0.8267898383371824,82126760,230,79
1,565,0.24059139784946237,0.5261075949367089,73266410,744,179
1,524,0.3105263157894737,0.7412371134020619,68531932,760,236
0,220,0.09090909090909091,0.3240556660039761,788172,242,22
0,148,0.14942528735632185,0.20146520146520147,82021921,174,26
1,693,0.3559479553903346,0.8115015974440895,69572951,1076,383
1,285,0.4367588932806324,0.8754098360655738,67744271,506,221
1,56,0.30864197530864196,0.7380952380952381,66264254,81,25
0,153,0.211340206185567,0.319672131147541,68112632,194,41
1,61,0.4351851851851852,0.9615384615384616,68112660,108,47
0,599,0.2340153452685422,0.408930669800235,67203983,782,183
0,94,0.020833333333333332,0.030864197530864196,521745,96,2
0,49,0.0392156862745098,0.08163265306122448,521801,51,2
1,804,0.3008695652173913,0.7198162729658792,80120461,1150,346
1,390,0.3181818181818182,0.758273381294964,67556573,572,182
0,134,0.24719101123595505,0.40384615384615385,68668523,178,44
0,430,0.1115702479338843,0.21744627054361568,75283453,484,54
1,46,0.4523809523809524,0.912621359223301,70913101,84,38
1,88,0.4601226993865031,0.9478260869565217,66379593,163,75
1,569,0.2806573957016435,0.7184241019698725,68540325,791,222
1,102,0.4486486486486487,0.915,69622021,185,83
1,533,0.31841432225063937,0.7331223628691983,68532800,782,249
1,84,0.3114754098360656,0.7422680412371134,81965826,122,38
0,177,0.06349206349206349,0.283609576427256,66877020,189,12
0,207,0.21292775665399238,0.45546558704453444,80128677,263,56
1,308,0.3852295409181637,0.8866666666666667,69177696,501,193
0,229,0.029661016949152543,0.04727272727272727,64240750,236,7
0,743,0.01978891820580475,0.01509433962264151,67299645,758,15
0,140,0.21787709497206703,0.26609442060085836,69489371,179,39
2,33,0.5074626865671642,0.9054054054054054,80180173,67,34
1,372,0.29545454545454547,0.5950617283950618,73049795,528,156
1,109,0.41397849462365593,0.8798586572438163,72270961,186,77
1,83,0.44666666666666666,0.9119170984455959,67841851,150,67
1,158,0.41044776119402987,0.9163987138263665,69582863,268,110
2,153,0.6076923076923076,0.9855491329479769,69622735,390,237
0,263,0.2287390029325513,0.4931129476584022,70601580,341,78
1,442,0.3373313343328336,0.8237250554323725,70659890,667,225
1,135,0.2894736842105263,0.6692708333333334,68763954,190,55
1,874,0.2452504317789292,0.5315763301839881,80011274,1158,284
0,1258,0.20530638029058748,0.3999106344950849,81999950,1583,325
0,346,0.07733333333333334,0.087248322147651,82012516,375,29
0,103,0.02830188679245283,0.06157112526539278,82049092,106,3
0,103,0.176,0.35874439461883406,67597936,125,22
1,336,0.3225806451612903,0.7773049645390071,80111850,496,160
0,608,0.1239193083573487,0.4175334323922734,80128671,694,86
0,238,0.09505703422053231,0.38778220451527223,76805624,263,25
0,42,0.125,0.2682926829268293,81965615,48,6
1,249,0.2824207492795389,0.5564784053156147,73820173,347,98
1,333,0.3508771929824561,0.6887417218543046,68628903,513,180
0,702,0.16527942925089179,0.2586367880485528,79520091,841,139
0,70,0.36936936936936937,0.4074074074074074,70655116,111,41
2,120,0.7183098591549296,0.958974358974359,70617204,426,306
1,34,0.41379310344827586,0.75,72834020,58,24
0,265,0.14516129032258066,0.2215568862275449,69094543,310,45
1,153,0.3318777292576419,0.7785388127853882,68218654,229,76
0,648,0.10743801652892562,0.12385321100917432,68536972,726,78
1,347,0.44657097288676234,0.8741418764302059,62512142,627,280
1,76,0.2549019607843137,0.6298342541436464,80121196,102,26
1,622,0.39611650485436894,0.9043552519214346,67558050,1030,408
1,109,0.1865671641791045,0.5598290598290598,70629342,134,25
0,288,0.04318936877076412,0.18469656992084432,82103942,301,13
1,880,0.2697095435684647,0.6307583274273565,67940565,1205,325
0,323,0.05278592375366569,0.039927404718693285,80114174,341,18
1,55,0.4270833333333333,0.8841463414634146,82037503,96,41
0,96,0.04950495049504951,0.2809917355371901,62835983,101,5
0,403,0.05841121495327103,0.04024767801857585,72522702,428,25
0,323,0.07977207977207977,0.09125964010282776,72522716,351,28
1,54,0.25,0.5642857142857143,80108532,72,18
0,262,0.20364741641337386,0.47651006711409394,70331583,329,67
1,390,0.2571428571428571,0.573049645390071,69165250,525,135
0,462,0.22483221476510068,0.3801526717557252,79817612,596,134
1,61,0.24691358024691357,0.5167785234899329,63282905,81,20
1,263,0.3078947368421053,0.7745664739884393,80121191,380,117
0,297,0.1972972972972973,0.34349030470914127,67555215,370,73
1,594,0.32036613272311215,0.6768916155419223,67994430,874,280
2,23,0.5576923076923077,0.7916666666666666,80083591,52,29
1,439,0.2596964586846543,0.5714285714285714,449015,593,154
1,106,0.28859060402684567,0.6037037037037037,987623,149,43
0,79,0.20202020202020202,0.329004329004329,70654696,99,20
1,107,0.41530054644808745,0.8736263736263736,80126959,183,76
1,134,0.37383177570093457,0.85,80145295,214,80
0,24,0.14285714285714285,0.09302325581395349,70748895,28,4
1,332,0.22065727699530516,0.6102003642987249,65392796,426,94
2,3,0.9545454545454546,0.75,80126546,66,63
0,330,0.15167095115681234,0.3131720430107527,69416851,389,59
1,1017,0.46247357293868924,0.9022369511184756,771060,1892,875
1,220,0.2971246006389776,0.6304347826086957,69490764,313,93
1,445,0.28685897435897434,0.5339805825242718,65000614,624,179
0,537,0.11822660098522167,0.14245014245014245,68534431,609,72
0,705,0.18778801843317972,0.3381245722108145,70909811,868,163
0,419,0.13786008230452676,0.2296157450796626,80098305,486,67
0,801,0.21083743842364533,0.46253521126760566,80098333,1015,214
1,63,0.3368421052631579,0.8333333333333334,82126751,95,32
0,494,0.15555555555555556,0.3038990825688073,70617610,585,91
1,97,0.49214659685863876,0.9134328358208955,69162513,191,94
2,206,0.7040229885057471,0.9514563106796117,68744564,696,490
1,249,0.4288990825688073,0.8721804511278195,70586012,436,187
1,258,0.37073170731707317,0.7619047619047619,73331034,410,152
2,28,0.5942028985507246,0.9811320754716981,67984896,69,41
1,15,0.4230769230769231,0.9402985074626866,69168022,26,11
2,251,0.5264150943396226,0.9474747474747475,66641582,530,279
1,336,0.3411764705882353,0.6086956521739131,70575092,510,174
2,1,0.875,0.75,82023684,8,7
1,11,0.42105263157894735,0.8888888888888888,71458744,19,8
1,374,0.24899598393574296,0.6027227722772277,63283374,498,124
2,301,0.5910326086956522,0.7309941520467836,68342526,736,435
2,394,0.5253012048192771,0.948051948051948,70057225,830,436
1,431,0.3997214484679666,0.8963855421686747,80121238,718,287
0,288,0.14029850746268657,0.24242424242424243,68538526,335,47
1,130,0.26136363636363635,0.5576923076923077,68191375,176,46
1,238,0.36363636363636365,0.8739837398373984,80107615,374,136
2,119,0.8456549935149157,0.9847715736040609,72410674,771,652
0,483,0.06936416184971098,0.05258215962441314,82011804,519,36
0,314,0.057057057057057055,0.03586206896551724,72900583,333,19
1,390,0.3321917808219178,0.7001763668430335,67043886,584,194
1,237,0.30701754385964913,0.6927592954990215,70070840,342,105
1,226,0.24916943521594684,0.512,70070875,301,75
1,418,0.2830188679245283,0.6743002544529262,67555894,583,165
1,177,0.41776315789473684,0.9490445859872612,68210842,304,127
0,44,0.21428571428571427,0.4298245614035088,78863701,56,12
0,41,0.14583333333333334,0.25316455696202533,69478255,48,7
1,176,0.2845528455284553,0.7582417582417582,68533773,246,70
1,238,0.34972677595628415,0.8550420168067226,70617813,366,128
1,343,0.33527131782945735,0.8171806167400881,81980451,516,173
0,831,0.14506172839506173,0.23157894736842105,68542803,972,141
1,28,0.45098039215686275,0.9333333333333333,64918280,51,23
0,214,0.1640625,0.3246492985971944,68391953,256,42
0,141,0.0784313725490196,0.0972644376899696,81965616,153,12
0,250,0.1830065359477124,0.352112676056338,67760812,306,56
0,665,0.14852752880921896,0.1918032786885246,68544182,781,116
1,377,0.47711511789181693,0.9365351629502573,68257882,721,344
0,138,0.1320754716981132,0.18118466898954705,72863371,159,21
0,177,0.12376237623762376,0.20417633410672853,72863385,202,25
1,152,0.2549019607843137,0.6016483516483516,68531281,204,52
2,112,0.672514619883041,0.9707317073170731,67719113,342,230
0,127,0.17532467532467533,0.4090909090909091,68542831,154,27
0,37,0.17777777777777778,0.38144329896907214,77676816,45,8
0,651,0.14002642007926025,0.281214848143982,70643475,757,106
0,58,0.12121212121212122,0.10106382978723404,66575964,66,8
1,158,0.4952076677316294,0.9476309226932669,80127706,313,155
0,253,0.18122977346278318,0.28628230616302186,70863506,309,56
0,871,0.13160518444666003,0.1755577109602328,62940542,1003,132
1,690,0.46386946386946387,0.9114785992217899,69666856,1287,597
0,120,0.24528301886792453,0.4155251141552511,73590076,159,39
0,203,0.2339622641509434,0.4854111405835544,63051030,265,62
1,47,0.25396825396825395,0.6684782608695652,66931585,63,16
0,376,0.09397590361445783,0.14175257731958762,68312111,415,39
0,44,0.2903225806451613,0.27848101265822783,80037412,62,18
1,281,0.21508379888268156,0.5029585798816568,67291294,358,77
0,555,0.10048622366288493,0.11597729115977291,82011811,617,62
0,680,0.0449438202247191,0.15067650676506766,62839392,712,32
0,147,0.06962025316455696,0.3252747252747253,66877153,158,11
0,380,0.1592920353982301,0.48546824542518835,69638786,452,72
0,19,0.05,0.10144927536231885,70210371,20,1
0,12,0.0,0.0,70210392,12,0
0,161,0.09550561797752809,0.36279926335174956,70314671,178,17
0,168,0.061452513966480445,0.3805970149253731,74607043,179,11
0,187,0.041025641025641026,0.14214046822742474,82095491,195,8
1,388,0.245136186770428,0.5082956259426847,80152855,514,126
0,209,0.14344262295081966,0.17365269461077845,80152856,244,35
1,316,0.3497942386831276,0.7462462462462462,67411876,486,170
1,315,0.45689655172413796,0.9235772357723577,65006032,580,265
0,40,0.1111111111111111,0.21551724137931033,67730096,45,5
1,461,0.2670906200317965,0.6563737133808393,80139712,629,168
0,422,0.05803571428571429,0.24656488549618322,62836893,448,26
1,196,0.3422818791946309,0.7180156657963447,72077740,298,102
1,238,0.4005037783375315,0.8440111420612814,80150985,397,159
1,170,0.27350427350427353,0.6521739130434783,80121107,234,64
1,299,0.3295964125560538,0.8008849557522124,69176786,446,147
1,338,0.2854122621564482,0.5432900432900433,62510343,473,135
1,54,0.25,0.5324675324675324,67148900,72,18
1,69,0.3235294117647059,0.7089552238805971,80180328,102,33
0,164,0.04093567251461988,0.09006928406466513,63527303,171,7
0,170,0.03954802259887006,0.0830860534124629,65839585,177,7
1,89,0.19090909090909092,0.69140625,66738161,110,21
0,137,0.13836477987421383,0.4984520123839009,68350751,159,22
0,432,0.05470459518599562,0.2003454231433506,62835451,457,25
0,211,0.1134453781512605,0.4745762711864407,82049131,238,27
1,282,0.3705357142857143,0.8031634446397188,74332545,448,166
1,812,0.3355155482815057,0.7693726937269373,67215505,1222,410
0,289,0.19722222222222222,0.3945086705202312,63277641,360,71
1,342,0.2645161290322581,0.5551684088269454,68763800,465,123
0,336,0.05352112676056338,0.20021074815595363,66876334,355,19
0,401,0.036057692307692304,0.08940397350993377,68254613,416,15
1,16,0.1111111111111111,0.6699029126213593,74607015,18,2
0,119,0.22727272727272727,0.4625322997416021,82116859,154,35
1,212,0.335423197492163,0.738430583501006,80109806,319,107
1,153,0.4226415094339623,0.9121212121212121,67556181,265,112
1,36,0.28,0.6808510638297872,73245753,50,14
2,14,0.7586206896551724,0.9333333333333333,82018806,58,44
2,47,0.5982905982905983,0.975609756097561,69622014,117,70
1,313,0.26697892271662765,0.6018867924528302,67940495,427,114
0,88,0.1926605504587156,0.35789473684210527,80108574,109,21
1,132,0.26256983240223464,0.6011730205278593,67551792,179,47
0,802,0.15132275132275133,0.2866004962779156,80098802,945,143
0,12,0.25,0.4897959183673469,76606285,16,4
0,412,0.17764471057884232,0.3795454545454545,69240192,501,89
1,1112,0.283043197936815,0.5831381733021077,81956100,1551,439
0,455,0.196113074204947,0.36492890995260663,63264390,566,111
1,219,0.37606837606837606,0.859538784067086,69836060,351,132
1,165,0.4811320754716981,0.9432485322896281,70925792,318,153
1,166,0.33064516129032256,0.7492447129909365,69177192,248,82
0,879,0.14327485380116958,0.2123456790123457,69240122,1026,147
2,759,0.5850191361399671,0.9736842105263158,80126530,1829,1070
1,230,0.2857142857142857,0.5866983372921615,81967318,322,92
1,126,0.3114754098360656,0.7553516819571865,81967338,183,57
1,62,0.3673469387755102,0.8455882352941176,67993821,98,36
2,7,0.5,0.8888888888888888,73582495,14,7
1,164,0.3925925925925926,0.771689497716895,68383686,270,106
1,295,0.38923395445134573,0.8167539267015707,72077810,483,188
1,199,0.33666666666666667,0.8180039138943248,67942336,300,101
0,41,0.2545454545454545,0.37662337662337664,62510315,55,14
1,815,0.4124008651766402,0.848,66994235,1387,572
0,420,0.21787709497206703,0.4273972602739726,80112242,537,117
0,473,0.20903010033444816,0.4328205128205128,72387420,598,125
0,287,0.15088757396449703,0.30364963503649633,72900653,338,51
0,193,0.14977973568281938,0.40498442367601245,67809973,227,34
1,85,0.2916666666666667,0.7423312883435583,69603191,120,35
1,43,0.23214285714285715,0.6727272727272727,68642231,56,13
0,357,0.05053191489361702,0.10419681620839363,80124213,376,19
2,25,0.6794871794871795,0.9696969696969697,80181786,78,53
2,2,0.8461538461538461,0.6666666666666666,80161911,13,11
2,173,0.6295503211991434,0.9908675799086758,80096065,467,294
1,295,0.375,0.7570532915360502,69108683,472,177
2,24,0.6883116883116883,0.9864864864864865,72417821,77,53
0,4,0.2,0.3684210526315789,70703871,5,1
1,10,0.23076923076923078,0.62,70706125,13,3
1,5,0.2857142857142857,0.7142857142857143,73295460,7,2
0,12,0.07692307692307693,0.21311475409836064,73295544,13,1
1,22,0.35294117647058826,0.7154471544715447,70063630,34,12
1,99,0.25,0.5359477124183006,70219023,132,33
0,181,0.12560386473429952,0.31072210065645517,70219072,207,26
2,46,0.5053763440860215,0.9538461538461539,72803164,93,47
1,32,0.4576271186440678,0.8869565217391304,72803374,59,27
0,44,0.12,0.3162393162393162,72808771,50,6
1,5,0.375,0.5,80113446,8,3
0,82,0.07865168539325842,0.07692307692307693,80135329,89,7
0,505,0.08014571948998178,0.11452991452991453,80135341,549,44
1,33,0.45,0.8333333333333334,80145773,60,27
1,271,0.33415233415233414,0.7643312101910829,66355240,407,136
0,84,0.11578947368421053,0.09259259259259259,68784842,95,11
1,50,0.32432432432432434,0.6521739130434783,66815630,74,24
2,181,0.539440203562341,0.4084507042253521,57193752,393,212
2,36,0.5813953488372093,0.8888888888888888,68321904,86,50
2,10,0.8958333333333334,0.875,60101384,96,86
1,856,0.2782462057335582,0.53125,80124982,1186,330
1,139,0.25668449197860965,0.5375494071146245,72426333,187,48
1,110,0.32098765432098764,0.5666666666666667,80061093,162,52
0,26,0.36585365853658536,0.1935483870967742,67800411,41,15
0,162,0.13829787234042554,0.18857142857142858,80176726,188,26
2,259,0.5158878504672897,0.8790849673202614,80019450,535,276
2,94,0.5502392344497608,0.8365384615384616,69973260,209,115
1,84,0.373134328358209,0.7207207207207207,82248125,134,50
1,27,0.34146341463414637,0.8245614035087719,80180330,41,14
0,55,0.19117647058823528,0.24358974358974358,73412192,68,13
2,32,0.5555555555555556,0.90625,80019856,72,40
0,40,0.047619047619047616,0.0125,73129651,42,2
0,16,0.2727272727272727,0.4375,80176713,22,6
0,13,0.13333333333333333,0.1951219512195122,80176717,15,2
1,24,0.45454545454545453,0.851063829787234,80176685,44,20
0,209,0.12184873949579832,0.17685589519650655,80181300,238,29
1,40,0.3103448275862069,0.5982142857142857,82096281,58,18
2,19,0.5777777777777777,0.9354838709677419,70610505,45,26
0,555,0.18502202643171806,0.32814526588845655,69480803,681,126
1,794,0.29233511586452765,0.5428840716305372,80127289,1122,328
0,307,0.12285714285714286,0.2087378640776699,82009581,350,43
0,158,0.1366120218579235,0.24686192468619247,82009582,183,25
0,74,0.18681318681318682,0.46551724137931033,64971760,91,17
1,242,0.2861356932153392,0.5407098121085595,80180244,339,97
2,16,0.75,0.9090909090909091,68631514,64,48
1,1175,0.3515452538631347,0.8295520651541594,80109890,1812,637
1,86,0.29508196721311475,0.6234309623430963,82126646,122,36
0,213,0.18076923076923077,0.2777777777777778,62511652,260,47
0,160,0.17525773195876287,0.2077922077922078,69578516,194,34
1,289,0.3966597077244259,0.8467289719626169,62791981,479,190
0,449,0.18065693430656934,0.445095168374817,70398804,548,99
0,353,0.08311688311688312,0.08583690987124463,82011827,385,32
0,106,0.14516129032258066,0.3080357142857143,70489293,124,18
2,10,0.5652173913043478,0.9444444444444444,65066386,23,13
1,21,0.38235294117647056,0.6944444444444444,67862802,34,13
1,100,0.3103448275862069,0.6983050847457627,72135280,145,45
0,5,0.16666666666666666,0.0,73171812,6,1
0,998,0.15208156329651656,0.2028985507246377,68534494,1177,179
1,26,0.2777777777777778,0.6379310344827587,63283444,36,10
0,153,0.16393442622950818,0.3781094527363184,70642040,183,30
1,282,0.3395784543325527,0.8141592920353983,67556636,427,145
0,233,0.06048387096774194,0.03298611111111111,68539660,248,15
1,181,0.3271375464684015,0.7074235807860262,69739362,269,88
0,240,0.2356687898089172,0.3903002309468822,80109204,314,74
0,74,0.14942528735632185,0.23204419889502761,80108630,87,13
1,859,0.3993006993006993,0.8257059396299903,69458564,1430,571
2,241,0.5949579831932773,0.9896694214876033,80119016,595,354
1,329,0.28322440087145967,0.6843702579666161,69724361,459,130
1,95,0.36666666666666664,0.7133105802047781,80037965,150,55
1,384,0.3018181818181818,0.653997378768021,69183646,550,166
0,240,0.1891891891891892,0.25220458553791886,71458870,296,56
0,479,0.0735009671179884,0.08783783783783784,70617351,517,38
1,49,0.19672131147540983,0.5163934426229508,68530693,61,12
0,23,0.14814814814814814,0.2903225806451613,77676956,27,4
1,738,0.31092436974789917,0.6886645962732919,69184241,1071,333
1,326,0.23294117647058823,0.56,82016315,425,99
0,230,0.20689655172413793,0.3481675392670157,69165936,290,60
0,297,0.2575,0.49502982107355864,69165964,400,103
1,128,0.4576271186440678,0.8313253012048193,67037096,236,108
1,392,0.4218289085545723,0.914616497829233,67560003,678,286
1,121,0.41545893719806765,0.9026548672566371,80108714,207,86
0,123,0.13380281690140844,0.3016393442622951,70221116,142,19
0,118,0.2080536912751678,0.39552238805970147,63051611,149,31
1,57,0.2962962962962963,0.6039603960396039,66423224,81,24
0,122,0.22784810126582278,0.4476987447698745,68511982,158,36
0,609,0.14225352112676057,0.21706263498920086,68539534,710,101
1,189,0.23170731707317074,0.5498721227621484,68539555,246,57
0,351,0.1,0.13404825737265416,68539590,390,39
0,957,0.1848381601362862,0.41688654353562005,63837410,1174,217
1,151,0.29767441860465116,0.6629711751662971,69056253,215,64
1,434,0.2568493150684932,0.5525494276795005,68218381,584,150
0,227,0.013043478260869565,0.012106537530266344,68743346,230,3
0,250,0.2088607594936709,0.46254681647940077,68289270,316,66
1,147,0.4024390243902439,0.8778135048231511,69058444,246,99
0,180,0.09547738693467336,0.10774410774410774,80121718,199,19
2,60,0.6938775510204082,0.9886363636363636,67979562,196,136
1,19,0.32142857142857145,0.5769230769230769,82129392,28,9
0,20,0.2,0.44285714285714284,69737052,25,5
1,1365,0.39198218262806234,0.8652450090744102,70252350,2245,880
1,470,0.2724458204334365,0.6231306081754736,80124529,646,176
1,538,0.25277777777777777,0.6188760806916427,68648566,720,182
1,920,0.2532467532467532,0.5990566037735849,70532903,1232,312
0,114,0.2597402597402597,0.4954128440366973,69108746,154,40
0,198,0.08333333333333333,0.3469387755102041,80128654,216,18
0,398,0.05463182897862233,0.1323851203501094,788123,421,23
0,588,0.0392156862745098,0.06150978564771668,64240274,612,24
0,159,0.15873015873015872,0.23160762942779292,68497100,189,30
1,438,0.28664495114006516,0.6951102588686481,80097605,614,176
1,48,0.36,0.8037383177570093,62508061,75,27
0,1024,0.12851063829787235,0.18698630136986302,68561675,1175,151
1,152,0.24378109452736318,0.5067385444743935,68542523,201,49
1,15,0.34782608695652173,0.9347826086956522,69718530,23,8
2,121,0.5485074626865671,0.9418604651162791,73330992,268,147
1,437,0.2692307692307692,0.6098159509202454,70800366,598,161
1,531,0.3723404255319149,0.8535414165666266,67667985,846,315
1,19,0.4864864864864865,0.9574468085106383,61582885,37,18
0,628,0.057057057057057055,0.1347708894878706,70001134,666,38
1,66,0.47619047619047616,0.9022222222222223,67532941,126,60
2,57,0.8131147540983606,0.9655172413793104,72640050,305,248
0,25,0.2857142857142857,0.44594594594594594,70357140,35,10
0,195,0.22310756972111553,0.4009433962264151,69101655,251,56
1,421,0.2936241610738255,0.6387195121951219,67748912,596,175
0,471,0.2464,0.43841642228739003,70641025,625,154
0,24,0.2,0.2153846153846154,72362213,30,6
0,287,0.22010869565217392,0.41064638783269963,81956093,368,81
0,201,0.20866141732283464,0.3415977961432507,81956140,254,53
1,102,0.32,0.7687687687687688,70753886,150,48
2,76,0.5032679738562091,0.8780487804878049,82059489,153,77
1,419,0.2725694444444444,0.6592317224287485,68545624,576,157
0,29,0.03333333333333333,0.0,80119305,30,1
0,322,0.09803921568627451,0.1889055472263868,299915,357,35
1,133,0.44583333333333336,0.9415807560137457,70215656,240,107
1,122,0.3146067415730337,0.634020618556701,63729050,178,56
1,201,0.37770897832817335,0.7829787234042553,65825263,323,122
0,697,0.154126213592233,0.24593301435406698,68171362,824,127
1,258,0.26495726495726496,0.6047120418848168,70642082,351,93
1,312,0.24271844660194175,0.6202247191011236,70642222,412,100
1,163,0.2383177570093458,0.5381679389312977,69550264,214,51
0,107,0.24113475177304963,0.488,69550292,141,34
2,25,0.7448979591836735,0.9574468085106383,67064865,98,73
2,14,0.5882352941176471,0.9841269841269841,72417863,34,20
0,253,0.01937984496124031,0.02288329519450801,80124381,258,5
1,92,0.46511627906976744,0.8364779874213837,72471175,172,80
1,81,0.39552238805970147,0.8893805309734514,70219121,134,53
0,98,0.20967741935483872,0.4626865671641791,70219156,124,26
0,125,0.1935483870967742,0.4018264840182648,70219163,155,30
0,36,0.07692307692307693,0.19375,70675073,39,3
0,3,0.0,0.0,70706461,3,0
0,5,0.16666666666666666,0.2916666666666667,72910033,6,1
0,4,0.0,0.0,72910082,4,0
2,10,0.8,0.9565217391304348,668731,50,40
2,12,0.7,0.65,80118337,40,28
1,619,0.33938100320170755,0.8244485294117647,63774466,937,318
0,33,0.1951219512195122,0.15,68275081,41,8
1,47,0.3561643835616438,0.7627118644067796,80027934,73,26
2,92,0.5106382978723404,0.8111888111888111,63029344,188,96
2,28,0.7829457364341085,0.8787878787878788,68413506,129,101
2,4,0.8461538461538461,0.875,68413394,26,22
2,139,0.5487012987012987,0.9114583333333334,75026091,308,169
2,489,0.5233918128654971,0.9071925754060325,80155220,1026,537
1,213,0.2392857142857143,0.5131375579598145,69724004,280,67
1,341,0.3504761904761905,0.8210526315789474,68257980,525,184
1,302,0.40784313725490196,0.9176646706586826,65267160,510,208
0,688,0.21100917431192662,0.38461538461538464,67705981,872,184
1,291,0.3340961098398169,0.6911447084233261,60195135,437,146
1,251,0.25958702064896755,0.587360594795539,70573482,339,88
2,231,0.6298076923076923,0.978494623655914,65581033,624,393
1,102,0.423728813559322,0.868421052631579,70486584,177,75
2,111,0.6063829787234043,0.9457364341085271,80137990,282,171
1,54,0.2702702702702703,0.631578947368421,64868335,74,20
1,160,0.49206349206349204,0.9543147208121827,68290733,315,155
0,379,0.05721393034825871,0.06497175141242938,66087413,402,23
0,206,0.09251101321585903,0.16809116809116809,66087483,227,21
1,140,0.25133689839572193,0.5501519756838906,67556384,187,47
1,34,0.32,0.5789473684210527,80119184,50,16
1,113,0.49099099099099097,0.938375350140056,67914532,222,109
1,360,0.24369747899159663,0.62,70618303,476,116
0,349,0.21218961625282168,0.4898989898989899,68541564,443,94
0,472,0.19039451114922812,0.2503364737550471,81956116,583,111
1,278,0.27034120734908135,0.6180451127819548,66087840,381,103
1,131,0.25142857142857145,0.6061776061776062,66892392,175,44
1,224,0.41968911917098445,0.8765690376569037,70562373,386,162
0,360,0.13875598086124402,0.20036429872495445,80180236,418,58
1,120,0.4782608695652174,0.8320610687022901,68961984,230,110
1,1074,0.23395149786019973,0.5167342799188641,80121153,1402,328
2,85,0.5971563981042654,0.9898477157360406,68191844,211,126
2,232,0.5647279549718575,0.961864406779661,80126951,533,301
0,490,0.02584493041749503,0.03795966785290629,63336896,503,13
0,235,0.008438818565400843,0.008676789587852495,63336994,237,2
0,310,0.003215434083601286,0.003418803418803419,63337036,311,1
1,71,0.4409448818897638,0.9333333333333333,73842762,127,56
1,565,0.37082405345211583,0.8533801580333626,82062459,898,333
0,225,0.21602787456445993,0.4588910133843212,66087133,287,62
1,157,0.2863636363636364,0.6367713004484304,70812742,220,63
0,87,0.13861386138613863,0.15555555555555556,70179221,101,14
0,80,0.13978494623655913,0.22868217054263565,70870674,93,13
1,26,0.21212121212121213,0.6483516483516484,79788373,33,7
0,156,0.0658682634730539,0.036827195467422094,80071061,167,11
1,178,0.3153846153846154,0.7237163814180929,68039944,260,82
1,291,0.27970297029702973,0.6587982832618026,69152440,404,113
1,500,0.2668621700879765,0.5757575757575758,69165971,682,182
1,184,0.3698630136986301,0.7433628318584071,69490722,292,108
0,52,0.1746031746031746,0.398989898989899,81980457,63,11
0,65,0.04411764705882353,0.056338028169014086,67810134,68,3
0,100,0.17355371900826447,0.3568281938325991,63397754,121,21
1,195,0.417910447761194,0.9221411192214112,67558302,335,140
1,58,0.49122807017543857,0.8934426229508197,82062225,114,56
1,277,0.33890214797136037,0.7521367521367521,72658551,419,142
1,1137,0.2583170254403131,0.6152398871119473,81999994,1533,396
0,91,0.21551724137931033,0.4318181818181818,70527436,116,25
0,374,0.2059447983014862,0.3285968028419183,62022324,471,97
0,177,0.2062780269058296,0.4384858044164038,70638890,223,46
0,210,0.22794117647058823,0.47804878048780486,68533731,272,62
1,172,0.36764705882352944,0.821522309711286,71019921,272,100
1,153,0.4612676056338028,0.9326241134751773,80111031,284,131
1,990,0.2978723404255319,0.6194915254237288,69267814,1410,420
0,843,0.13891726251276812,0.26872586872586873,70617715,979,136
1,648,0.40875912408759124,0.8884615384615384,68046006,1096,448
0,98,0.2032520325203252,0.4956521739130435,61439665,123,25
0,522,0.05776173285198556,0.03524229074889868,82011832,554,32
0,248,0.06415094339622641,0.05245901639344262,82011833,265,17
0,227,0.18050541516245489,0.3920704845814978,75522986,277,50
1,179,0.27235772357723576,0.6193548387096774,65308600,246,67
0,780,0.037037037037037035,0.010273972602739725,63757435,810,30
0,273,0.04878048780487805,0.043243243243243246,63757463,287,14
0,430,0.06318082788671024,0.06741573033707865,63757470,459,29
0,543,0.03208556149732621,0.007067137809187279,65140383,561,18
1,161,0.24766355140186916,0.5195729537366548,66892651,214,53
0,526,0.1794071762870515,0.27132579650565264,69637092,641,115
0,166,0.15736040609137056,0.4734042553191489,69383475,197,31
0,190,0.0995260663507109,0.40653357531760437,66877181,211,21
2,265,0.5276292335115864,0.9424920127795527,80028466,561,296
1,25,0.40476190476190477,0.5405405405405406,80135039,42,17
2,2,0.6666666666666666,0.75,82143782,6,4
0,184,0.2301255230125523,0.34365325077399383,80111080,239,55
2,1,0.6666666666666666,0.5,63380373,3,2
1,306,0.4354243542435424,0.896774193548387,80159835,542,236
0,2,0.0,0.0,73296034,2,0
0,6,0.0,0.0,73296055,6,0
0,373,0.0857843137254902,0.19254658385093168,73331335,408,35
2,35,0.7058823529411765,0.9907407407407407,72270954,119,84
2,217,0.5068181818181818,0.9646569646569647,80122709,440,223
1,64,0.41284403669724773,0.9146341463414634,80168516,109,45
0,100,0.24812030075187969,0.49264705882352944,70486696,133,33
1,13,0.4090909090909091,0.8260869565217391,67513005,22,9
0,325,0.19154228855721392,0.3663003663003663,70040915,402,77
0,614,0.1802403204272363,0.34548467274233635,68536552,749,135
1,336,0.30864197530864196,0.7296137339055794,70760571,486,150
1,1033,0.2600286532951289,0.5617977528089888,69608140,1396,363
1,432,0.46,0.9529298751200769,70768152,800,368
1,121,0.3423913043478261,0.8648648648648649,70525301,184,63
1,111,0.37988826815642457,0.9017341040462428,67551876,179,68
0,177,0.20982142857142858,0.45964912280701753,68538722,224,47
0,135,0.24157303370786518,0.45454545454545453,69177080,178,43
1,514,0.3054054054054054,0.7038581856100105,67557980,740,226
1,172,0.328125,0.6463768115942029,67995186,256,84
1,370,0.29791271347248577,0.6859154929577465,67552345,527,157
1,183,0.3920265780730897,0.8608923884514436,80135526,301,118
0,450,0.19499105545617174,0.38065661047027505,82000066,559,109
1,216,0.2847682119205298,0.5714285714285714,80136843,302,86
0,251,0.06691449814126393,0.32112970711297073,63477995,269,18
0,456,0.08064516129032258,0.32797140303842715,66877195,496,40
0,304,0.1239193083573487,0.4332210998877666,68811575,347,43
0,155,0.22885572139303484,0.44988344988344986,69607713,201,46
1,114,0.3595505617977528,0.8470588235294118,65353946,178,64
1,174,0.43137254901960786,0.9112050739957717,69208265,306,132
0,151,0.10650887573964497,0.10801393728222997,69621930,169,18
0,308,0.23192019950124687,0.424,69943426,401,93
1,859,0.32785602503912364,0.7741132545115121,81976651,1278,419
1,246,0.49382716049382713,0.904,63580965,486,240
1,183,0.47413793103448276,0.9422110552763819,78734404,348,165
0,503,0.08043875685557587,0.2638105975197294,61704104,547,44
0,578,0.09546165884194054,0.26570915619389585,62530412,639,61
0,411,0.21264367816091953,0.4856770833333333,68642056,522,111
0,225,0.11067193675889328,0.12334801762114538,66422965,253,28
0,113,0.16911764705882354,0.326271186440678,69621223,136,23
1,371,0.3701188455008489,0.8846625766871166,80135837,589,218
1,62,0.42592592592592593,0.8835616438356164,72271045,108,46
0,380,0.19148936170212766,0.42913776015857286,82038984,470,90
1,24,0.4782608695652174,0.9444444444444444,80122935,46,22
1,14,0.36363636363636365,0.5384615384615384,69483841,22,8
1,54,0.46534653465346537,0.8938547486033519,80141320,101,47
1,83,0.484472049689441,0.9398496240601504,68283082,161,78
1,295,0.3107476635514019,0.6363636363636364,69630134,428,133
0,1325,0.16561712846347607,0.2691542288557214,80109694,1588,263
1,178,0.2908366533864542,0.6779661016949152,70070861,251,73
1,311,0.31194690265486724,0.7240356083086054,81967356,452,141
1,458,0.3475783475783476,0.748558246828143,67995242,702,244
1,342,0.31736526946107785,0.7477678571428571,80136985,501,159
0,556,0.10897435897435898,0.12065637065637065,68534480,624,68
0,411,0.12179487179487179,0.2319309600862999,69416214,468,57
0,662,0.1916971916971917,0.3719611021069692,68536832,819,157
0,334,0.21040189125295508,0.4426807760141093,69621202,423,89
0,256,0.13804713804713806,0.25076923076923074,70627284,297,41
0,15,0.21052631578947367,0.43478260869565216,80175650,19,4
0,414,0.22180451127819548,0.34911242603550297,69177416,532,118
0,44,0.16981132075471697,0.07017543859649122,82008922,53,9
0,258,0.06521739130434782,0.023809523809523808,82095684,276,18
0,516,0.13856427378964942,0.25913338997451146,81893570,599,83
0,203,0.12121212121212122,0.23076923076923078,69415836,231,28
1,240,0.2546583850931677,0.5050675675675675,69628160,322,82
2,52,0.6462585034013606,0.9805825242718447,82009641,147,95
1,374,0.3048327137546468,0.6655773420479303,68212256,538,164
1,11,0.35294117647058826,0.5185185185185185,80176700,17,6
0,95,0.10377358490566038,0.14840989399293286,72523332,106,11
0,132,0.014925373134328358,0.0,63757456,134,2
0,319,0.058997050147492625,0.06297709923664122,63757512,339,20
0,151,0.09580838323353294,0.07692307692307693,68533255,167,16
0,336,0.15789473684210525,0.20260492040520983,68533311,399,63
0,473,0.1125703564727955,0.13748657357679914,70642012,533,60
0,877,0.10873983739837398,0.12850467289719625,68534634,984,107
1,315,0.46519524617996605,0.8775055679287305,70646821,589,274
0,788,0.2151394422310757,0.4080914687774846,68010873,1004,216
1,400,0.3162393162393162,0.709375,81967280,585,185
0,93,0.041237113402061855,0.032520325203252036,69416466,97,4
0,186,0.06060606060606061,0.06212424849699399,69416984,198,12
0,248,0.07462686567164178,0.10380622837370242,70617722,268,20
0,90,0.16666666666666666,0.24745762711864408,70047761,108,18
1,240,0.2878338278931751,0.612565445026178,70573573,337,97
1,686,0.37236962488563585,0.8025114155251142,68384113,1093,407
1,478,0.36939313984168864,0.784037558685446,68384386,758,280
1,26,0.38095238095238093,0.7,80172022,42,16
1,131,0.2722222222222222,0.5794871794871795,67553325,180,49
2,5,0.8275862068965517,0.9230769230769231,70076251,29,24
1,131,0.345,0.7846153846153846,62508040,200,69
0,414,0.17693836978131214,0.24635332252836303,63681562,503,89
0,442,0.19343065693430658,0.23219814241486067,80178944,548,106
1,138,0.4,0.9020979020979021,74863313,230,92
0,112,0.17647058823529413,0.49333333333333335,75283250,136,24
0,101,0.24060150375939848,0.462406015037594,67617480,133,32
1,407,0.2958477508650519,0.6504672897196262,67038454,578,171
0,158,0.22926829268292684,0.40202702702702703,80176704,205,47
1,677,0.4008849557522124,0.8669354838709677,65000103,1130,453
1,303,0.4,0.8167053364269141,73599624,505,202
1,618,0.40861244019138754,0.8904403866809882,80136476,1045,427
1,93,0.2734375,0.6588235294117647,80121117,128,35
0,287,0.15339233038348082,0.3290653008962868,80135425,339,52
0,763,0.15316315205327413,0.26887417218543047,69417530,901,138
1,688,0.2633832976445396,0.6582995951417004,80121174,934,246
1,32,0.15789473684210525,0.6444444444444445,70818412,38,6
1,374,0.36394557823129253,0.6511226252158895,68529741,588,214
1,248,0.31301939058171746,0.6991304347826087,69534185,361,113
0,277,0.07973421926910298,0.2229299363057325,69158201,301,24
2,100,0.5412844036697247,0.9624413145539906,72198315,218,118
1,114,0.31736526946107785,0.6047904191616766,80136908,167,53
0,267,0.036101083032490974,0.11605206073752712,62836382,277,10
1,271,0.12861736334405144,0.5215869311551925,82049136,311,40
0,310,0.1906005221932115,0.426917510853835,68542740,383,73
1,187,0.25793650793650796,0.5382513661202186,60455080,252,65
1,275,0.2231638418079096,0.6477987421383647,69157242,354,79
0,129,0.17834394904458598,0.41411764705882353,82011801,157,28
1,266,0.3248730964467005,0.7274305555555556,81967278,394,128
0,163,0.07909604519774012,0.13544668587896252,63141876,177,14
0,170,0.21296296296296297,0.46004319654427644,67160520,216,46
1,340,0.28421052631578947,0.6852409638554217,82095529,475,135
0,16,0.1111111111111111,0.09615384615384616,69417180,18,2
0,28,0.17647058823529413,0.3220338983050847,79785601,34,6
0,116,0.1888111888111888,0.4188034188034188,82053039,143,27
0,54,0.16923076923076924,0.2714285714285714,82053040,65,11
1,170,0.37037037037037035,0.7529411764705882,79790151,270,100
1,38,0.17391304347826086,0.5585585585585585,69417551,46,8
0,170,0.06593406593406594,0.052307692307692305,70617435,182,12
2,230,0.5463510848126233,0.9565217391304348,70957194,507,277
0,792,0.12195121951219512,0.15144596651445966,68542866,902,110
0,463,0.1746880570409982,0.3292517006802721,73346805,561,98
1,291,0.26329113924050634,0.5121359223300971,62510000,395,104
1,113,0.3615819209039548,0.8581081081081081,67557770,177,64
1,434,0.3111111111111111,0.7174119885823026,80133409,630,196
0,425,0.22586520947176686,0.4420849420849421,70525322,549,124
0,58,0.15942028985507245,0.40606060606060607,60512501,69,11
1,138,0.24175824175824176,0.5052631578947369,67666270,182,44
2,136,0.6046511627906976,0.9811320754716981,82009747,344,208
1,123,0.25,0.5179282868525896,65897580,164,41
1,456,0.3595505617977528,0.8746928746928747,70659904,712,256
1,105,0.3137254901960784,0.6995515695067265,66470775,153,48
1,485,0.3693107932379714,0.8532663316582915,68210772,769,284
1,127,0.47520661157024796,0.8935185185185185,63639814,242,115
1,252,0.27793696275071633,0.647495361781076,80118958,349,97
0,481,0.20888157894736842,0.4067796610169492,65355381,608,127
0,170,0.22018348623853212,0.4027777777777778,70769776,218,48
0,159,0.16753926701570682,0.31070496083550914,68740735,191,32
1,664,0.2890792291220557,0.6838235294117647,82011762,934,270
1,293,0.32798165137614677,0.7923186344238976,69184633,436,143
1,415,0.23853211009174313,0.5843520782396088,67299722,545,130
1,154,0.4726027397260274,0.9220489977728286,80161887,292,138
0,315,0.08959537572254335,0.24052718286655683,63772016,346,31
2,328,0.5294117647058824,0.9676898222940227,70659960,697,369
1,398,0.22417153996101363,0.5957446808510638,79087890,513,115
1,236,0.2484076433121019,0.6371490280777538,62234053,314,78
0,97,0.3310344827586207,0.43902439024390244,72445632,145,48
1,814,0.2538955087076077,0.567398119122257,80141445,1091,277
2,82,0.52046783625731,0.907608695652174,80172012,171,89
2,35,0.527027027027027,0.8412698412698413,80172013,74,39
2,0,1.0,1.0,70678972,2,2
0,14,0.2222222222222222,0.4583333333333333,70843143,18,4
0,233,0.06048387096774194,0.1559633027522936,80124238,248,15
0,69,0.041666666666666664,0.0,80135331,72,3
0,80,0.2079207920792079,0.39669421487603307,80135340,101,21
2,98,0.5050505050505051,0.9603960396039604,70760235,198,100
0,570,0.0981012658227848,0.08229426433915212,80140080,632,62
2,16,0.7288135593220338,0.967741935483871,80150977,59,43
2,17,0.7926829268292683,0.6666666666666666,69216434,82,65
0,91,0.11650485436893204,0.345,72773204,103,12
0,238,0.032520325203252036,0.047058823529411764,80124214,246,8
2,48,0.5596330275229358,0.9594594594594594,69700302,109,61
2,481,0.5106815869786369,0.9580838323353293,73131254,983,502
2,2,0.6,0.9230769230769231,75149704,5,3
1,193,0.2825278810408922,0.7299771167048055,72760422,269,76
0,408,0.19367588932806323,0.3463414634146341,64158682,506,98
1,298,0.3479212253829322,0.7289586305278174,73435516,457,159
0,511,0.17580645161290323,0.37973568281938325,69239800,620,109
0,512,0.152317880794702,0.3110367892976589,70618205,604,92
0,24,0.1724137931034483,0.2835820895522388,61748722,29,5
1,124,0.24390243902439024,0.5635838150289018,70207711,164,40
1,50,0.4117647058823529,0.8851351351351351,69630260,85,35
0,887,0.1337890625,0.2526395173453997,70643321,1024,137
1,745,0.3555363321799308,0.8174550299800133,69636903,1156,411
1,159,0.3146551724137931,0.7058823529411765,80162108,232,73
0,124,0.06060606060606061,0.28709055876685935,62841583,132,8
1,131,0.25142857142857145,0.6702508960573477,73398976,175,44
0,129,0.12837837837837837,0.14429530201342283,68530784,148,19
2,130,0.5131086142322098,0.9659090909090909,82151297,267,137
1,124,0.24390243902439024,0.5089820359281437,73399634,164,40
2,4,0.8181818181818182,0.8333333333333334,67118142,22,18
2,37,0.5697674418604651,0.9576271186440678,80141352,86,49
1,81,0.40875912408759124,0.8761904761904762,67901414,137,56
1,402,0.196,0.5595116988809766,82056899,500,98
1,441,0.2722772277227723,0.677449168207024,70573146,606,165
0,508,0.05223880597014925,0.20291693088142043,62837145,536,28
1,142,0.25263157894736843,0.549618320610687,69039306,190,48
0,290,0.1807909604519774,0.2573099415204678,70644931,354,64
0,415,0.13541666666666666,0.1395007342143906,70645225,480,65
2,69,0.5460526315789473,0.9627329192546584,68285945,152,83
1,46,0.17857142857142858,0.5078125,68639375,56,10
1,17,0.19047619047619047,0.5795454545454546,67862872,21,4
0,558,0.09120521172638436,0.26396495071193865,63237111,614,56
0,178,0.1188118811881188,0.2012987012987013,80071173,202,24
1,357,0.3886986301369863,0.8489304812834224,73026401,584,227
0,8,0.0,0.0,80124398,8,0
0,85,0.07608695652173914,0.35842293906810035,80126904,92,7
0,330,0.07563025210084033,0.2318840579710145,80126905,357,27
2,2,0.6,0.6666666666666666,65899694,5,3
2,8,0.68,0.9722222222222222,72803150,25,17
1,250,0.3489583333333333,0.7993079584775087,69636910,384,134
1,252,0.4857142857142857,0.9391480730223124,68028310,490,238
0,44,0.21428571428571427,0.3076923076923077,80134796,56,12
1,22,0.21428571428571427,0.7216494845360825,65850771,28,6
1,482,0.3074712643678161,0.6834381551362684,82126817,696,214
0,195,0.23828125,0.46435845213849286,62793255,256,61
1,117,0.44019138755980863,0.8813559322033898,67154290,209,92
0,18,0.35714285714285715,0.4594594594594595,273924,28,10
2,102,0.5984251968503937,0.9508196721311475,65008244,254,152
0,512,0.11876075731497418,0.2556894243641232,70642054,581,69
0,389,0.2297029702970297,0.4578441835645678,66931956,505,116
1,486,0.24884080370942813,0.5874886672710788,63283360,647,161
1,406,0.33003300330033003,0.7928483353884094,69155002,606,200
0,87,0.2018348623853211,0.37037037037037035,69616953,109,22
1,93,0.40764331210191085,0.8828828828828829,80136474,157,64
1,169,0.4477124183006536,0.9182156133828996,67017321,306,137
2,179,0.7513888888888889,0.9629629629629629,62819974,720,541
2,120,0.5180722891566265,0.9527896995708155,69157970,249,129
0,300,0.21465968586387435,0.42,65921051,382,82
0,379,0.07560975609756097,0.0859375,69621671,410,31
0,358,0.032432432432432434,0.07537688442211055,80124408,370,12
1,45,0.22413793103448276,0.5064102564102564,70593362,58,13
1,156,0.27102803738317754,0.5971014492753624,69153973,214,58
1,659,0.22743259085580306,0.5406015037593985,80118434,853,194
0,143,0.19662921348314608,0.3132183908045977,67551974,178,35
1,86,0.37681159420289856,0.8287292817679558,65008545,138,52
1,904,0.2981366459627329,0.6897931954636425,71388100,1288,384
1,27,0.4,0.8837209302325582,68400710,45,18
1,172,0.381294964028777,0.9072681704260651,70070882,278,106
1,125,0.2937853107344633,0.6440677966101694,70070896,177,52
1,120,0.2857142857142857,0.5855263157894737,80124767,168,48
1,29,0.4423076923076923,0.8787878787878788,54291034,52,23
1,130,0.30851063829787234,0.7651933701657458,67506131,188,58
0,344,0.20554272517321015,0.4579710144927536,70642565,433,89
0,176,0.10204081632653061,0.13031161473087818,70642873,196,20
1,473,0.2562893081761006,0.5947302383939774,66423441,636,163
1,105,0.44148936170212766,0.8913857677902621,80070214,188,83
1,98,0.43023255813953487,0.8809523809523809,70211904,172,74
0,312,0.20408163265306123,0.4579646017699115,73255112,392,80
1,1061,0.22441520467836257,0.5195121951219512,68541130,1368,307
0,171,0.06557377049180328,0.378419452887538,62839056,183,12
2,55,0.5338983050847458,0.9418604651162791,80137568,118,63
0,19,0.17391304347826086,0.36764705882352944,70908376,23,4
1,35,0.375,0.8899082568807339,70854266,56,21
1,133,0.31088082901554404,0.6915254237288135,69607545,193,60
0,285,0.18803418803418803,0.3466666666666667,68530756,351,66
1,12,0.42857142857142855,0.8,69152580,21,9
1,180,0.23728813559322035,0.5419501133786848,70669305,236,56
0,493,0.13051146384479717,0.18063583815028902,68539800,567,74
2,161,0.5306122448979592,0.971875,70716933,343,182
0,136,0.12258064516129032,0.15034965034965034,69165285,155,19
1,413,0.25985663082437277,0.5932584269662922,69869450,558,145
1,80,0.47368421052631576,0.90625,69317605,152,72
1,808,0.25939505041246563,0.5859714463066419,66930780,1091,283
1,151,0.4323308270676692,0.8626373626373627,66170251,266,115
2,40,0.5121951219512195,0.963855421686747,70854161,82,42
1,345,0.3235294117647059,0.7168758716875872,67994871,510,165
2,14,0.6410256410256411,0.9696969696969697,69666716,39,25
0,101,0.2047244094488189,0.20673076923076922,70814401,127,26
2,49,0.7151162790697675,0.9868421052631579,80137992,172,123
0,378,0.17105263157894737,0.34561626429479037,63812070,456,78
1,5,0.4444444444444444,0.9285714285714286,70968912,9,4
1,26,0.3333333333333333,0.8620689655172413,70347466,39,13
0,761,0.15066964285714285,0.19168356997971603,70646625,896,135
1,319,0.35685483870967744,0.7599009900990099,69800465,496,177
1,132,0.37735849056603776,0.8694362017804155,80120458,212,80
0,9,0.1,0.2413793103448276,75148045,10,1
0,108,0.09243697478991597,0.03187250996015936,68885425,119,11
0,286,0.14626865671641792,0.2033898305084746,69536362,335,49
0,127,0.22085889570552147,0.35944700460829493,695534,163,36
2,263,0.548885077186964,0.9761499148211243,62381340,583,320
0,326,0.16195372750642673,0.30551181102362207,66423616,389,63
1,237,0.3506849315068493,0.6340694006309149,72433501,365,128
1,133,0.4088888888888889,0.8378378378378378,61561374,225,92
1,3,0.4,0.75,71618925,5,2
0,5,0.0,0.0,71618932,5,0
1,217,0.2931596091205212,0.5658536585365853,74347546,307,90
1,259,0.44776119402985076,0.8731942215088283,68189730,469,210
1,81,0.3769230769230769,0.7131782945736435,67411302,130,49
2,28,0.582089552238806,0.875,72845402,67,39
0,197,0.04830917874396135,0.017921146953405017,80119385,207,10
0,132,0.23255813953488372,0.4807692307692308,72208612,172,40
0,87,0.10309278350515463,0.11386138613861387,80124743,97,10
1,98,0.449438202247191,0.9234234234234234,68039965,178,80
1,108,0.36470588235294116,0.8576923076923076,82126650,170,62
1,105,0.2605633802816901,0.5902777777777778,67202240,142,37
0,409,0.19488188976377951,0.38016528925619836,63277760,508,99
2,63,0.5367647058823529,0.95,79816450,136,73
0,452,0.20141342756183744,0.3887468030690537,68540654,566,114
0,325,0.20147420147420148,0.3837837837837838,70850773,407,82
1,746,0.263573543928924,0.6397003745318353,68530973,1013,267
0,75,0.24242424242424243,0.48205128205128206,74709012,99,24
0,229,0.1455223880597015,0.28544061302681994,69416291,268,39
1,177,0.15714285714285714,0.5051334702258727,81965793,210,33
1,29,0.4727272727272727,0.8805970149253731,80180118,55,26
1,197,0.4573002754820937,0.8867521367521367,67306960,363,166
1,140,0.46153846153846156,0.9017341040462428,73599463,260,120
1,22,0.3125,0.6666666666666666,70669585,32,10
0,149,0.14857142857142858,0.23270440251572327,70645295,175,26
1,68,0.29896907216494845,0.6625766871165644,72917376,97,29
2,11,0.6666666666666666,0.8518518518518519,79816541,33,22
0,840,0.1907514450867052,0.35978004713275724,80097640,1038,198
1,275,0.3735763097949886,0.8691099476439791,65353596,439,164
0,143,0.1875,0.3463855421686747,66423931,176,33
0,312,0.09037900874635568,0.09255079006772009,80112816,343,31
0,422,0.16435643564356436,0.3211920529801324,79651040,505,83
1,408,0.4069767441860465,0.9137168141592921,66379635,688,280
2,85,0.5502645502645502,0.967741935483871,69208160,189,104
0,133,0.05673758865248227,0.15223880597014924,80124378,141,8
2,2,0.6666666666666666,0.8,75347454,6,4
0,71,0.04054054054054054,0.06486486486486487,70181230,74,3
0,16,0.0,0.0,70257950,16,0
1,133,0.3415841584158416,0.7111650485436893,70867874,202,69
2,2,0.5,0.8235294117647058,72804676,4,2
1,83,0.26548672566371684,0.5376344086021505,74267683,113,30
1,51,0.25,0.5212765957446809,75048750,68,17
2,24,0.5555555555555556,0.975,75115334,54,30
1,52,0.30666666666666664,0.5371900826446281,79796850,75,23
2,0,1.0,1.0,82090150,9,9
0,261,0.018796992481203006,0.0378619153674833,70109774,266,5
1,1341,0.24620573355817876,0.556176919166243,68545603,1779,438
2,9,0.6785714285714286,0.75,82049159,28,19
1,21,0.4,0.7777777777777778,60135250,35,14
0,9,0.3076923076923077,0.0,68155773,13,4
1,597,0.36421725239616615,0.7758620689655172,79787036,939,342
1,235,0.25396825396825395,0.6009174311926605,80121259,315,80
1,10,0.23076923076923078,0.5128205128205128,80118160,13,3
1,249,0.28653295128939826,0.7302752293577982,66930605,349,100
1,72,0.24210526315789474,0.55,65249226,95,23
2,40,0.6428571428571429,0.978494623655914,58871113,112,72
0,270,0.12337662337662338,0.2727272727272727,64931006,308,38
2,84,0.5029585798816568,0.9223300970873787,63766185,169,85
2,77,0.6030927835051546,0.92,77319536,194,117
1,337,0.3122448979591837,0.7754442649434572,70642474,490,153
0,326,0.03550295857988166,0.023722627737226276,63757540,338,12
1,1218,0.29350348027842227,0.6925490196078431,69878564,1724,506
1,203,0.36163522012578614,0.8227848101265823,74372893,318,115
1,10,0.4117647058823529,0.9032258064516129,67430783,17,7
0,9,0.18181818181818182,0.4444444444444444,65279466,11,2
1,295,0.2416452442159383,0.565028901734104,80125375,389,94
1,41,0.4875,0.9396551724137931,67281515,80,39
1,141,0.30198019801980197,0.676595744680851,73650822,202,61
1,115,0.4072164948453608,0.8712871287128713,62142766,194,79
1,43,0.36764705882352944,0.8064516129032258,65278591,68,25
1,254,0.19873817034700317,0.588339222614841,65099951,317,63
1,258,0.3435114503816794,0.7083333333333334,65018961,393,135
2,26,0.5357142857142857,0.9090909090909091,69979861,56,30
1,342,0.41337907375643224,0.8961038961038961,67993863,583,241
0,318,0.22627737226277372,0.4567901234567901,68192026,411,93
1,62,0.42592592592592593,0.8425925925925926,67043032,108,46
2,22,0.828125,0.9767441860465116,70514136,128,106
2,157,0.5015873015873016,0.967391304347826,80119106,315,158
1,641,0.3129689174705252,0.7238734419942474,80109400,933,292
1,190,0.3770491803278688,0.752851711026616,70639485,305,115
0,20,0.2,0.32653061224489793,68021023,25,5
1,78,0.3333333333333333,0.7611940298507462,66856293,117,39
0,60,0.01639344262295082,0.01875,521752,61,1
0,25,0.038461538461538464,0.13580246913580246,60899832,26,1
0,146,0.05194805194805195,0.03048780487804878,67553913,154,8
0,93,0.211864406779661,0.36428571428571427,68763940,118,25
1,78,0.47651006711409394,0.7796610169491526,80174902,149,71
0,34,0.19047619047619047,0.1375,81978954,42,8
0,539,0.19791666666666666,0.33429394812680113,69056596,672,133
1,207,0.3122923588039867,0.7986111111111112,67942560,301,94
2,1,0.5,0.6666666666666666,67654790,2,1
1,117,0.2909090909090909,0.6223776223776224,69183345,165,48
2,151,0.5325077399380805,0.9178082191780822,80124975,323,172
2,97,0.6040816326530613,0.96875,80062164,245,148
1,181,0.41423948220064727,0.8947368421052632,80096282,309,128
1,53,0.36904761904761907,0.8080808080808081,66742585,84,31
2,287,0.594059405940594,0.9919354838709677,70206185,707,420
1,23,0.28125,0.55,73871350,32,9
0,649,0.1241565452091768,0.125,67555061,741,92
2,15,0.5,0.9,70854091,30,15
1,452,0.30030959752321984,0.7002012072434608,69177052,646,194
1,172,0.3333333333333333,0.7488038277511961,66619161,258,86
2,289,0.5277777777777778,0.9627906976744186,69622742,612,323
0,268,0.09764309764309764,0.04497354497354497,67553332,297,29
0,347,0.062162162162162166,0.05919661733615222,67747183,370,23
1,379,0.48644986449864497,0.955108359133127,70670334,738,359
0,987,0.0878003696857671,0.08656145384983262,69416774,1082,95
0,516,0.135678391959799,0.235595390524968,63609532,597,81
1,8,0.2727272727272727,0.6,61102594,11,3
2,381,0.5574912891986062,0.9730250481695568,66345146,861,480
0,82,0.21153846153846154,0.47560975609756095,70812931,104,22
1,73,0.4065040650406504,0.8545454545454545,67017342,123,50
1,135,0.22413793103448276,0.5765027322404371,68517134,174,39
1,367,0.3387387387387387,0.6815068493150684,70673421,555,188
1,553,0.24453551912568305,0.5364025695931478,62140652,732,179
1,687,0.23751387347391786,0.5563636363636364,80121028,901,214
2,73,0.6137566137566137,0.9761904761904762,82102326,189,116
1,276,0.22033898305084745,0.5,77563934,354,78
1,482,0.3975,0.8495092693565977,70258762,800,318
2,3,0.5714285714285714,0.875,66969644,7,4
1,182,0.3284132841328413,0.6642066420664207,68401375,271,89
1,311,0.2899543378995434,0.6762075134168157,70643041,438,127
1,454,0.27009646302250806,0.6305220883534136,69608224,622,168
0,637,0.16732026143790849,0.29264214046822745,68538092,765,128
0,226,0.08870967741935484,0.1097770154373928,69625241,248,22
0,722,0.13636363636363635,0.18488023952095808,80114111,836,114
1,715,0.2799597180261833,0.660594439117929,69216952,993,278
0,307,0.15426997245179064,0.44031311154598823,60249280,363,56
0,659,0.09849521203830369,0.17829457364341086,60351235,731,72
1,597,0.3082271147161066,0.7089305402425579,67652214,863,266
1,53,0.2318840579710145,0.5136612021857924,67676973,69,16
0,202,0.10619469026548672,0.11599297012302284,67703440,226,24
0,79,0.1595744680851064,0.3244444444444444,70061824,94,15
2,50,0.5238095238095238,0.9689922480620154,70854455,105,55
1,30,0.2857142857142857,0.625,70854392,42,12
2,0,1.0,1.0,66237584,3,3
0,17,0.0,0.0,70239092,17,0
1,48,0.4666666666666667,0.930379746835443,72802492,90,42
2,6,0.9032258064516129,0.9545454545454546,70253526,62,56
2,64,0.7408906882591093,0.9878048780487805,73029110,247,183
1,462,0.38317757009345793,0.8462455303933254,67994325,749,287
0,656,0.199023199023199,0.432793136320305,80125481,819,163
0,615,0.22641509433962265,0.2809364548494983,70112434,795,180
0,403,0.12581344902386118,0.25510204081632654,80118313,461,58
0,745,0.16945373467112598,0.33129770992366414,73637550,897,152
1,863,0.33615384615384614,0.6152482269503546,67162242,1300,437
0,159,0.15873015873015872,0.3640661938534279,60800565,189,30
2,15,0.6341463414634146,0.8421052631578947,80002916,41,26
0,17,0.19047619047619047,0.36363636363636365,65708391,21,4
0,425,0.05133928571428571,0.11691259931895573,70001421,448,23
1,261,0.423841059602649,0.8709055876685935,72322040,453,192
1,283,0.4259634888438134,0.908029197080292,68741414,493,210
1,269,0.4164859002169197,0.8738938053097345,73850805,461,192
1,612,0.38738738738738737,0.8532818532818532,70240674,999,387
0,330,0.15384615384615385,0.2534992223950233,948822,390,60
1,50,0.29577464788732394,0.76,70206913,71,21
0,5,0.2857142857142857,0.25,65280082,7,2
2,20,0.5454545454545454,0.9803921568627451,65288944,44,24
1,7,0.46153846153846156,0.9473684210526315,66378984,13,6
2,49,0.5916666666666667,0.9861111111111112,80053442,120,71
1,4,0.42857142857142855,0.6666666666666666,65290225,7,3
0,921,0.20534943917169973,0.4358974358974359,68544532,1159,238
1,125,0.3279569892473118,0.8171641791044776,80139727,186,61
0,16,0.2,0.40816326530612246,65286452,20,4
1,71,0.297029702970297,0.6115107913669064,72426445,101,30
2,25,0.5098039215686274,0.8235294117647058,72426431,51,26
1,239,0.3575268817204301,0.7231833910034602,80127529,372,133
1,212,0.3496932515337423,0.835214446952596,68112534,326,114
0,150,0.18032786885245902,0.24347826086956523,69394164,183,33
1,158,0.3705179282868526,0.8286516853932584,76983200,251,93
2,131,0.5130111524163569,0.9444444444444444,62512303,269,138
1,60,0.3258426966292135,0.8300653594771242,70420476,89,29
1,87,0.31496062992125984,0.812807881773399,69386555,127,40
1,62,0.37373737373737376,0.8041958041958042,71388002,99,37
1,16,0.4666666666666667,0.9142857142857143,71388016,30,14
1,41,0.22641509433962265,0.5230769230769231,70057582,53,12
0,117,0.19863013698630136,0.38671875,62767740,146,29
1,956,0.3379501385041551,0.8391739674593242,80112403,1444,488
1,16,0.23809523809523808,0.5625,70802984,21,5
1,28,0.2631578947368421,0.5,71387981,38,10
1,101,0.34415584415584416,0.73,75550923,154,53
1,757,0.2693050193050193,0.6009139375476009,68531995,1036,279
1,181,0.30916030534351147,0.6542669584245077,70476700,262,81
1,44,0.3230769230769231,0.7520661157024794,70005936,65,21
0,1059,0.17715617715617715,0.3235908141962422,68535453,1287,228
1,188,0.3815789473684211,0.8446389496717724,67994906,304,116
0,63,0.20253164556962025,0.3247422680412371,73709216,79,16
2,13,0.5185185185185185,0.9259259259259259,71458863,27,14
1,123,0.3422459893048128,0.8047493403693932,62687464,187,64
2,109,0.5691699604743083,0.9738805970149254,73599442,253,144
1,113,0.2981366459627329,0.7071651090342679,80180123,161,48
0,128,0.1292517006802721,0.17346938775510204,54298412,147,19
0,14,0.2222222222222222,0.34375,62375733,18,4
0,3,0.0,0.0,67784906,3,0
1,88,0.3178294573643411,0.6397849462365591,69204541,129,41
1,218,0.2990353697749196,0.6385767790262172,69177150,311,93
1,280,0.25133689839572193,0.5626780626780626,73226461,374,94
0,500,0.18699186991869918,0.3975373790677221,82008914,615,115
1,97,0.389937106918239,0.751269035532995,79792041,159,62
2,96,0.5949367088607594,0.991869918699187,82041279,237,141
1,333,0.26490066225165565,0.5809716599190283,82047581,453,120
1,85,0.4720496894409938,0.9337016574585635,67556020,161,76
2,88,0.5621890547263682,0.9806763285024155,67556055,201,113
0,62,0.0,0.0,80124307,62,0
2,7,0.5882352941176471,0.9090909090909091,69063680,17,10
1,509,0.3491048593350384,0.7523105360443623,62510322,782,273
2,121,0.6253869969040248,0.9103448275862069,80155215,323,202
0,3,0.0,0.0,69463471,3,0
1,234,0.29518072289156627,0.7345276872964169,80119406,332,98
0,695,0.13341645885286782,0.22826086956521738,80098536,802,107
1,16,0.15789473684210525,0.5081967213114754,69886705,19,3
0,1055,0.10212765957446808,0.12960526315789472,70617694,1175,120
0,349,0.19770114942528735,0.38175675675675674,81979802,435,86
1,406,0.3441033925686591,0.7789904502046384,80180003,619,213
0,130,0.1095890410958904,0.2204968944099379,64147720,146,16
1,423,0.3054187192118227,0.7379162191192267,68666976,609,186
1,519,0.2606837606837607,0.5774134790528234,71358952,702,183
0,1075,0.19835943325876212,0.4018817204301075,80056872,1341,266
2,20,0.7727272727272727,0.9565217391304348,69168225,88,68
1,217,0.31545741324921134,0.6853932584269663,72390913,317,100
2,3,0.625,0.8333333333333334,75588744,8,5
1,136,0.42616033755274263,0.9395604395604396,67982306,237,101
1,116,0.23684210526315788,0.5589622641509434,70564452,152,36
0,63,0.125,0.4216417910447761,80165683,72,9
0,46,0.061224489795918366,0.291866028708134,74607036,49,3
1,471,0.30837004405286345,0.6953125,66965941,681,210
1,117,0.4,0.8659003831417624,78734446,195,78
0,285,0.06862745098039216,0.20045558086560364,72275203,306,21
1,452,0.1766848816029144,0.5307621671258035,69712426,549,97
1,96,0.3142857142857143,0.7432432432432432,64002841,140,44
0,123,0.14583333333333334,0.21993127147766323,72208591,144,21
1,69,0.3611111111111111,0.7942857142857143,69309331,108,39
0,114,0.10236220472440945,0.2913165266106443,78763496,127,13
1,629,0.18523316062176165,0.5534188034188035,67814285,772,143
0,312,0.04,0.13557594291539246,62838776,325,13
2,38,0.7564102564102564,0.9642857142857143,69401185,156,118
2,29,0.5,0.8421052631578947,69401206,58,29
2,87,0.8031674208144797,0.9731543624161074,80118204,442,355
1,40,0.4594594594594595,0.8103448275862069,80019765,74,34
2,72,0.8059299191374663,0.9846153846153847,80118208,371,299
0,263,0.24641833810888253,0.4042904290429043,65553922,349,86
1,20,0.48717948717948717,0.967741935483871,70857591,39,19
0,1,0.0,0.0,80145890,1,0
1,127,0.4525862068965517,0.8818181818181818,75278896,232,105
1,423,0.43221476510067114,0.937046004842615,68531043,745,322
1,114,0.4794520547945205,0.9358974358974359,72622515,219,105
1,329,0.19951338199513383,0.50625,64915256,411,82
0,235,0.1840277777777778,0.48261758691206547,80135155,288,53
2,24,0.5471698113207547,0.9418604651162791,80178137,53,29
0,157,0.012578616352201259,0.019867549668874173,63336910,159,2
0,325,0.015151515151515152,0.028892455858747994,63337001,330,5
0,111,0.034782608695652174,0.09349593495934959,63337015,115,4
0,149,0.006666666666666667,0.00946372239747634,63337064,150,1
0,389,0.10161662817551963,0.1976911976911977,70641865,433,44
1,97,0.25384615384615383,0.6622807017543859,69704460,130,33
0,170,0.10526315789473684,0.3107344632768362,78763265,190,20
2,214,0.5201793721973094,0.9282700421940928,67823091,446,232
0,307,0.08902077151335312,0.14736842105263157,70283710,337,30
0,230,0.17266187050359713,0.2687385740402194,70207032,278,48
1,181,0.24583333333333332,0.5704989154013015,68745586,240,59
0,533,0.19242424242424241,0.3859964093357271,70047810,660,127
1,912,0.37103448275862067,0.8178082191780822,67994192,1450,538
1,253,0.37530864197530867,0.8611111111111112,66931151,405,152
0,483,0.1038961038961039,0.22766217870257038,73366153,539,56
0,186,0.1267605633802817,0.4519650655021834,63775453,213,27
0,403,0.13333333333333333,0.21451787648970747,82011843,465,62
0,799,0.12004405286343613,0.1962121212121212,74026190,908,109
1,308,0.23192019950124687,0.6125827814569537,68534340,401,93
0,51,0.22727272727272727,0.4306569343065693,66554593,66,15
1,93,0.3673469387755102,0.9230769230769231,70710143,147,54
1,774,0.24708171206225682,0.543365881677197,68236175,1028,254
0,121,0.14788732394366197,0.41914191419141916,69143410,142,21
0,16,0.1111111111111111,0.2857142857142857,69478332,18,2
0,6,0.0,0.0,69479354,6,0
0,102,0.1968503937007874,0.38620689655172413,54464942,127,25
1,125,0.35233160621761656,0.8135048231511254,72522212,193,68
1,23,0.28125,0.6029411764705882,69143340,32,9
1,19,0.36666666666666664,0.7735849056603774,69158096,30,11
0,14,0.17647058823529413,0.43902439024390244,69158194,17,3
0,22,0.08333333333333333,0.3333333333333333,69158334,24,2
0,50,0.15254237288135594,0.3925925925925926,69158432,59,9
0,338,0.19331742243436753,0.34901960784313724,67703496,419,81
2,1,0.5,0.9,65634961,2,1
1,206,0.37003058103975534,0.8236994219653179,69691370,327,121
0,233,0.18815331010452963,0.3755656108597285,70185346,287,54
0,7,0.125,0.38095238095238093,73102281,8,1
1,31,0.2619047619047619,0.7857142857142857,73400600,42,11
0,3,0.0,0.0,70705334,3,0
2,21,0.7469879518072289,0.9464285714285714,66763564,83,62
0,38,0.20833333333333334,0.3333333333333333,66614163,48,10
0,387,0.22444889779559118,0.47909604519774013,70841582,499,112
1,215,0.3384615384615385,0.7959927140255009,80119024,325,110
1,240,0.35135135135135137,0.7293064876957495,69489406,370,130
0,270,0.14826498422712933,0.18503937007874016,66931984,317,47
0,522,0.20426829268292682,0.4554865424430642,68541592,656,134
2,159,0.5015673981191222,0.9408602150537635,80128548,319,160
1,22,0.3333333333333333,0.6615384615384615,69055455,33,11
1,311,0.47018739352640543,0.9463276836158192,69621825,587,276
0,63,0.20253164556962025,0.45789473684210524,69159041,79,16
1,62,0.38613861386138615,0.8277777777777777,67211172,101,39
1,564,0.34265734265734266,0.7097222222222223,70687764,858,294
2,60,0.6428571428571429,0.9669421487603306,74574514,168,108
1,463,0.281055900621118,0.5792592592592593,74955454,644,181
2,26,0.5,0.9367088607594937,74646572,52,26
1,527,0.2566995768688293,0.6733615221987315,68541634,709,182
0,78,0.12359550561797752,0.25,61234852,89,11
1,450,0.2730210016155089,0.6500508646998983,80121218,619,169
0,176,0.06382978723404255,0.09454545454545454,63757526,188,12
0,31,0.225,0.4491525423728814,67995515,40,9
0,37,0.0975609756097561,0.18032786885245902,66224536,41,4
1,182,0.38926174496644295,0.81875,70657685,298,116
1,192,0.30685920577617326,0.6926713947990544,80161483,277,85
2,489,0.5637823371989296,0.9673024523160763,54884550,1121,632
2,349,0.5049645390070922,0.9334637964774951,82056730,705,356
2,204,0.5944333996023857,0.9740566037735849,80181568,503,299
0,637,0.13568521031207598,0.16868512110726644,68544021,737,100
0,247,0.05725190839694656,0.052521008403361345,70617421,262,15
0,283,0.059800664451827246,0.22485207100591717,80124776,301,18
2,1,0.6666666666666666,0.6,67799291,3,2
1,87,0.4662576687116564,0.8655913978494624,80125421,163,76
0,33,0.25,0.2727272727272727,68383665,44,11
0,1070,0.1640625,0.3294172932330827,80140154,1280,210
2,16,0.5,0.8461538461538461,80137885,32,16
0,92,0.17117117117117117,0.4276315789473684,67903360,111,19
1,278,0.2853470437017995,0.7397260273972602,64000706,389,111
1,119,0.41379310344827586,0.8814814814814815,82116609,203,84
1,64,0.3402061855670103,0.7741935483870968,62497050,97,33
1,52,0.3333333333333333,0.6666666666666666,62497631,78,26
1,254,0.3385416666666667,0.7534883720930232,62497820,384,130
0,1,0.0,0.0,69973386,1,0
1,97,0.3576158940397351,0.8862876254180602,65675484,151,54
0,18,0.21739130434782608,0.29411764705882354,73783206,23,5
0,1263,0.1396457765667575,0.1757469244288225,68885236,1468,205
1,238,0.28955223880597014,0.6997971602434077,70642516,335,97
1,282,0.22099447513812154,0.6423017107309487,69084463,362,80
0,24,0.2727272727272727,0.3333333333333333,80135006,33,9
1,362,0.3442028985507246,0.6826625386996904,69150865,552,190
1,188,0.38961038961038963,0.891156462585034,81971146,308,120
1,14,0.36363636363636365,0.5476190476190477,80176832,22,8
0,18,0.25,0.47619047619047616,70078365,24,6
0,111,0.09016393442622951,0.09473684210526316,73376170,122,11
2,241,0.6119162640901772,0.632,57193745,621,380
0,192,0.1615720524017467,0.31088082901554404,80141504,229,37
1,181,0.29296875,0.6428571428571429,80118632,256,75
2,31,0.7280701754385965,0.9387755102040817,80137030,114,83
2,196,0.5991820040899796,0.6642335766423357,82049152,489,293
2,1,0.75,0.6666666666666666,80130724,4,3
1,1101,0.2650200267022697,0.5338181818181819,67552646,1498,397
1,443,0.26533996683250416,0.6389728096676737,68680640,603,160
1,428,0.2633390705679862,0.6115606936416185,80125377,581,153
0,320,0.2540792540792541,0.42749244712990936,74477802,429,109
2,235,0.5515267175572519,0.9805352798053528,65820706,524,289
0,308,0.11239193083573487,0.17857142857142858,68526381,347,39
1,110,0.3413173652694611,0.7157894736842105,70646933,167,57
1,236,0.2625,0.5454545454545454,80121102,320,84
2,10,0.5652173913043478,0.875,12911073,23,13
1,50,0.24242424242424243,0.5246913580246914,63282926,66,16
0,65,0.2441860465116279,0.4166666666666667,76116320,86,21
0,576,0.23809523809523808,0.4198019801980198,63767536,756,180
1,157,0.39846743295019155,0.5879120879120879,80089926,261,104
0,70,0.06666666666666667,0.2,68357093,75,5
1,44,0.12,0.5035460992907801,68357163,50,6
2,3,0.5714285714285714,0.9,82145102,7,4
2,19,0.6779661016949152,0.9836065573770492,82059898,59,40
1,951,0.4041353383458647,0.8978963571062083,70350840,1596,645
1,85,0.3560606060606061,0.7458563535911602,69739201,132,47
1,135,0.3632075471698113,0.8190184049079755,69183765,212,77
0,665,0.19685990338164253,0.3629103815439219,68540430,828,163
0,52,0.21212121212121213,0.2807017543859649,69607741,66,14
0,499,0.18993506493506493,0.31805929919137466,67246501,616,117
1,13,0.35,0.7692307692307693,65913624,20,7
1,582,0.2832512315270936,0.6616702355460385,67555705,812,230
0,78,0.22,0.3248407643312102,82126761,100,22
1,95,0.17391304347826086,0.5,80124523,115,20
0,399,0.24858757062146894,0.4256505576208178,66993535,531,132
1,133,0.4743083003952569,0.941025641025641,70925631,253,120
2,15,0.6938775510204082,0.96,80137974,49,34
0,740,0.16004540295119182,0.22110162916989914,69073501,881,141
1,408,0.3177257525083612,0.7315270935960592,80121217,598,190
2,32,0.7557251908396947,0.9333333333333333,65888753,131,99
0,201,0.20553359683794467,0.3625,74445623,253,52
1,24,0.3333333333333333,0.6027397260273972,82002273,36,12
1,449,0.2861685214626391,0.7515527950310559,80128837,629,180
2,20,0.8765432098765432,0.9743589743589743,82062035,162,142
0,49,0.07547169811320754,0.23684210526315788,80124176,53,4
1,249,0.30833333333333335,0.6324324324324324,82021925,360,111
2,125,0.503968253968254,0.9331395348837209,69162632,252,127
1,41,0.2807017543859649,0.5251798561151079,82010239,57,16
1,253,0.44880174291938996,0.8157894736842105,68666381,459,206
2,4,0.8260869565217391,0.8571428571428571,70631932,23,19
2,24,0.7108433734939759,0.8378378378378378,65960622,83,59
2,164,0.7266666666666667,0.9058823529411765,69948774,600,436
1,331,0.2156398104265403,0.5045317220543807,69601966,422,91
1,476,0.2608695652173913,0.6760374832663989,68540073,644,168
0,450,0.23339011925042588,0.467843631778058,66471342,587,137
1,94,0.2932330827067669,0.5742574257425742,82126790,133,39
1,479,0.3137535816618911,0.7459770114942529,66765265,698,219
1,8,0.1111111111111111,0.5370370370370371,67868794,9,1
0,319,0.042042042042042045,0.14723320158102768,67872826,333,14
0,767,0.0691747572815534,0.2922297297297297,68130552,824,57
2,32,0.6049382716049383,0.9508196721311475,66860031,81,49
0,133,0.13636363636363635,0.2507462686567164,72863406,154,21
2,14,0.5882352941176471,0.9615384615384616,63159390,34,20
2,74,0.5956284153005464,0.9625,80126927,183,109
0,488,0.07400379506641366,0.08163265306122448,82011823,527,39
1,21,0.46153846153846156,0.782608695652174,73503332,39,18
0,760,0.09415971394517282,0.10072689511941849,79788156,839,79
0,59,0.16901408450704225,0.45454545454545453,68150992,71,12
0,408,0.14644351464435146,0.2788339670468948,70615412,478,70
0,329,0.1273209549071618,0.19812583668005354,70615433,377,48
0,199,0.2196078431372549,0.4972677595628415,80091165,255,56
1,384,0.38461538461538464,0.8484848484848485,54564104,624,240
1,96,0.49206349206349204,0.9813432835820896,70514262,189,93
0,324,0.14058355437665782,0.2190332326283988,67285715,377,53
0,620,0.16778523489932887,0.3100828729281768,74792361,745,125
1,350,0.3805309734513274,0.8224,67911410,565,215
1,982,0.26825633383010433,0.6772952171522815,68155584,1342,360
0,51,0.16393442622950818,0.410958904109589,54417496,61,10
1,519,0.2510822510822511,0.5826702033598585,80124522,693,174
1,124,0.3541666666666667,0.7931034482758621,80136827,192,68
1,230,0.36639118457300274,0.8859315589353612,69177591,363,133
1,220,0.4513715710723192,0.9034749034749034,67306953,401,181
0,573,0.11024844720496894,0.10652920962199312,54609611,644,71
0,18,0.14285714285714285,0.0,82163479,21,3
2,440,0.5353748680042238,0.9715157680569685,69055112,947,507
1,82,0.26126126126126126,0.5825688073394495,72135364,111,29
0,163,0.22380952380952382,0.45112781954887216,67942791,210,47
1,95,0.3581081081081081,0.8270676691729323,68241481,148,53
0,126,0.1310344827586207,0.23397435897435898,70566790,145,19
0,131,0.14935064935064934,0.38095238095238093,80116792,154,23
1,243,0.2873900293255132,0.5772495755517827,69150872,341,98
2,26,0.5737704918032787,0.9540229885057471,72393174,61,35
0,531,0.25630252100840334,0.42948717948717946,80125002,714,183
1,174,0.29838709677419356,0.6224066390041494,69548283,248,74
1,119,0.2958579881656805,0.6653543307086615,68644996,169,50
0,724,0.16009280742459397,0.2696871628910464,68657771,862,138
0,995,0.19237012987012986,0.3425832492431887,70042385,1232,237
1,636,0.2672811059907834,0.6558441558441559,73735445,868,232
1,355,0.25263157894736843,0.5148986889153755,69179614,475,120
1,74,0.3508771929824561,0.7318435754189944,70599025,114,40
0,718,0.2345415778251599,0.49411764705882355,70686560,938,220
1,96,0.36423841059602646,0.88671875,68587421,151,55
2,74,0.5771428571428572,0.9626865671641791,82039828,175,101
0,485,0.14762741652021089,0.2204515272244356,80083346,569,84
2,98,0.6537102473498233,0.890625,66762290,283,185
1,248,0.27058823529411763,0.6126126126126126,68239682,340,92
1,207,0.2837370242214533,0.6942003514938488,68763835,289,82
1,11,0.42105263157894735,0.9565217391304348,65279291,19,8
1,204,0.37423312883435583,0.8720682302771855,82126704,326,122
2,365,0.5454545454545454,0.9848254931714719,69056645,803,438
2,6,0.75,0.9285714285714286,70343532,24,18
1,63,0.496,0.9375,70768362,125,62
1,199,0.27898550724637683,0.5652173913043478,63681576,276,77
1,923,0.2598235765838011,0.5594405594405595,67706044,1247,324
1,247,0.29829545454545453,0.7264957264957265,69165404,352,105
1,89,0.32575757575757575,0.7488372093023256,69177381,132,43
1,199,0.40773809523809523,0.9003436426116839,69152510,336,137
1,137,0.30808080808080807,0.7017045454545454,69176870,198,61
1,52,0.37349397590361444,0.875,73111703,83,31
1,375,0.27184466019417475,0.55765595463138,81967320,515,140
1,222,0.4126984126984127,0.8466819221967964,72999465,378,156
1,83,0.336,0.7176470588235294,74850062,125,42
2,43,0.5473684210526316,0.9885057471264368,80028501,95,52
0,659,0.07573632538569425,0.07772020725388601,70072023,713,54
1,665,0.3581081081081081,0.7825086306098964,72655632,1036,371
1,77,0.35833333333333334,0.8434343434343434,68512752,120,43
2,1,0.75,0.5,67181751,4,3
1,486,0.23943661971830985,0.5272547076313181,69540086,639,153
0,160,0.047619047619047616,0.12030075187969924,73331363,168,8
0,440,0.14563106796116504,0.461,65592772,515,75
0,298,0.17679558011049723,0.2236842105263158,80103163,362,64
2,416,0.5196304849884527,0.9560315670800451,68285553,866,450
0,829,0.188050930460333,0.35572616762635956,68537315,1021,192
1,559,0.261558784676354,0.6311926605504588,68537336,757,198
0,174,0.1076923076923077,0.15313653136531366,82000026,195,21
1,234,0.23529411764705882,0.6159638554216867,82006127,306,72
0,410,0.1750503018108652,0.3134160090191657,82036902,497,87
1,43,0.44871794871794873,0.8955223880597015,72417233,78,35
1,236,0.2625,0.6007984031936128,68531302,320,84
1,30,0.45454545454545453,0.8867924528301887,68521194,55,25
2,163,0.5582655826558266,0.9733333333333334,70074165,369,206
0,320,0.21951219512195122,0.3793103448275862,70644966,410,90
2,209,0.6475548060708263,0.9403409090909091,80137969,593,384
1,162,0.2534562211981567,0.5525606469002695,67154465,217,55
0,79,0.23300970873786409,0.3875598086124402,82126783,103,24
1,121,0.4829059829059829,0.9501557632398754,67519382,234,113
0,224,0.19133574007220217,0.4406779661016949,80098893,277,53
1,841,0.304383788254756,0.7289650037230082,69482021,1209,368
1,156,0.28440366972477066,0.6755852842809364,70643293,218,62
1,177,0.43086816720257237,0.9416342412451362,67060630,311,134
1,58,0.3829787234042553,0.7142857142857143,63773080,94,36
0,129,0.10416666666666667,0.14864864864864866,80119316,144,15
0,147,0.16477272727272727,0.29581151832460734,82036698,176,29
0,683,0.08933333333333333,0.09431245500359971,82011812,750,67
1,180,0.256198347107438,0.5873015873015873,66264940,242,62
0,359,0.17848970251716248,0.3337423312883436,70207921,437,78
1,100,0.3006993006993007,0.6167400881057269,69636966,143,43
1,206,0.23703703703703705,0.5667189952904239,70920773,270,64
1,114,0.4031413612565445,0.8411214953271028,70673505,191,77
1,68,0.3333333333333333,0.7432432432432432,68532793,102,34
1,51,0.39285714285714285,0.8857142857142857,69621685,84,33
1,187,0.28076923076923077,0.6657824933687002,66422972,260,73
1,159,0.37401574803149606,0.8443877551020408,63492961,254,95
0,199,0.11555555555555555,0.25217391304347825,70500122,225,26
0,167,0.07734806629834254,0.049586776859504134,80180234,181,14
0,112,0.13846153846153847,0.250936329588015,82116607,130,18
0,68,0.15,0.34558823529411764,80156738,80,12
2,94,0.5154639175257731,0.9178743961352657,82041902,194,100
0,332,0.11936339522546419,0.3654891304347826,67836986,377,45
0,392,0.14782608695652175,0.26735751295336785,80098823,460,68
0,675,0.21144859813084113,0.31534569983136596,69184304,856,181
0,268,0.04964539007092199,0.19402985074626866,80128641,282,14
0,34,0.22727272727272727,0.417910447761194,74362092,44,10
0,292,0.10153846153846154,0.16300940438871472,66849286,325,33
0,322,0.13440860215053763,0.2379421221864952,66849531,372,50
2,327,0.5807692307692308,0.9852700490998363,70818951,780,453
2,187,0.5065963060686016,0.9447731755424064,80137406,379,192
0,80,0.12087912087912088,0.2810810810810811,70568162,91,11
0,14,0.06666666666666667,0.15625,70701162,15,1
0,17,0.05555555555555555,0.10666666666666667,72910061,18,1
0,64,0.08571428571428572,0.21678321678321677,70568036,70,6
1,142,0.2828282828282828,0.5736842105263158,69489336,198,56
0,352,0.11335012594458438,0.1513353115727003,67285722,397,45
1,251,0.2949438202247191,0.6347305389221557,70256935,356,105
0,685,0.05124653739612189,0.09775784753363229,70001316,722,37
1,87,0.12121212121212122,0.5090252707581228,70001764,99,12
1,178,0.23605150214592274,0.5071574642126789,81967358,233,55
0,162,0.21359223300970873,0.28903654485049834,80177556,206,44
0,37,0.075,0.11510791366906475,69415983,40,3
0,453,0.08299595141700405,0.08445532435740515,70615531,494,41
0,335,0.2748917748917749,0.43680709534368073,69285902,462,127
0,241,0.12681159420289856,0.21142857142857144,80071131,276,35
0,113,0.2565789473684211,0.4913294797687861,70812770,152,39
1,107,0.4022346368715084,0.70995670995671,80180200,179,72
1,107,0.39204545454545453,0.7876106194690266,80180210,176,69
0,360,0.1044776119402985,0.09261939218523878,80181303,402,42
1,96,0.32867132867132864,0.7443609022556391,70324891,143,47
1,147,0.4431818181818182,0.8745519713261649,80062255,264,117
1,190,0.34256055363321797,0.8244274809160306,68645052,289,99
2,254,0.5364963503649635,0.9789303079416531,82052731,548,294
1,159,0.3861003861003861,0.8338762214983714,80110086,259,100
0,199,0.2196078431372549,0.3253731343283582,80114622,255,56
1,94,0.3188405797101449,0.72,69388564,138,44
2,132,0.5352112676056338,0.9781659388646288,80126321,284,152
0,81,0.12903225806451613,0.32386363636363635,70527555,93,12
0,75,0.0963855421686747,0.12807881773399016,70527562,83,8
0,172,0.22869955156950672,0.39255014326647564,70891884,223,51
1,280,0.3154034229828851,0.7166666666666667,69154050,409,129
1,251,0.4135514018691589,0.7981651376146789,82147546,428,177
1,77,0.3984375,0.8450704225352113,70919296,128,51
2,197,0.5679824561403509,0.7461538461538462,68187742,456,259
2,154,0.5510204081632653,0.9560439560439561,80124816,343,189
0,217,0.225,0.4036697247706422,67136713,280,63
1,261,0.2585227272727273,0.5210674157303371,73709174,352,91
0,352,0.1065989847715736,0.11390728476821192,68791296,394,42
1,116,0.30952380952380953,0.7452054794520548,80136831,168,52
1,193,0.31802120141342755,0.6750700280112045,68532730,283,90
1,93,0.363013698630137,0.7654867256637168,69932380,146,53
0,351,0.2076749435665914,0.4451145958986731,81979711,443,92
1,73,0.47101449275362317,0.934640522875817,71036945,138,65
0,493,0.2086677367576244,0.3006451612903226,81956094,623,130
1,514,0.2900552486187845,0.6235521235521235,74341162,724,210
2,30,0.6938775510204082,0.9487179487179487,73848733,98,68
0,832,0.20686367969494757,0.40649867374005305,74990216,1049,217
1,28,0.37777777777777777,0.7804878048780488,72426410,45,17
2,10,0.9557522123893806,0.9166666666666666,72510900,226,216
1,117,0.4583333333333333,0.8878504672897196,72790095,216,99
2,245,0.5617173524150268,0.8592592592592593,80178919,559,314
1,28,0.3170731707317073,0.5510204081632653,73551751,41,13
2,162,0.5397727272727273,0.782258064516129,70660674,352,190
0,142,0.1977401129943503,0.45112781954887216,80118192,177,35
1,557,0.358294930875576,0.8523654159869495,69607335,868,311
0,140,0.1907514450867052,0.3018181818181818,68642385,173,33
0,212,0.21189591078066913,0.3697478991596639,68283166,269,57
0,19,0.13636363636363635,0.075,82096261,22,3
2,3,0.7,0.6666666666666666,82096287,10,7
1,142,0.3879310344827586,0.8342245989304813,80134785,232,90
2,2,0.8888888888888888,0.6666666666666666,75636120,18,16
2,97,0.6135458167330677,0.9166666666666666,80019443,251,154
0,21,0.045454545454545456,0.0625,80072223,22,1
2,34,0.7322834645669292,0.9770114942528736,72472575,127,93
2,71,0.5988700564971752,0.9425837320574163,75048113,177,106
1,225,0.38858695652173914,0.8719512195121951,72749271,368,143
0,56,0.16417910447761194,0.41148325358851673,70649705,67,11
2,101,0.6039215686274509,0.91005291005291,80178978,255,154
1,215,0.3217665615141956,0.7243150684931506,80145294,317,102
2,0,1.0,1.0,81903748,4,4
2,11,0.6764705882352942,0.7777777777777778,69973253,34,23
1,73,0.3706896551724138,0.7352941176470589,69055735,116,43
2,16,0.5,0.9411764705882353,70072800,32,16
2,0,1.0,1.0,80126587,8,8
2,42,0.72,0.9156626506024096,72426025,150,108
1,8,0.3333333333333333,0.6756756756756757,80158312,12,4
0,322,0.14133333333333334,0.21664275466284075,82011805,375,53
2,0,1.0,1.0,70344743,11,11
2,2,0.8666666666666667,0.0,74484095,15,13
0,62,0.2619047619047619,0.46551724137931033,72425696,84,22
0,202,0.1952191235059761,0.3183673469387755,72425703,251,49
1,52,0.37349397590361444,0.9019607843137255,70593250,83,31
2,29,0.6282051282051282,0.9259259259259259,70566440,78,49
2,0,1.0,1.0,80162138,13,13
2,36,0.847457627118644,0.9571428571428572,72456783,236,200
0,8,0.1111111111111111,0.09090909090909091,80158314,9,1
1,22,0.40540540540540543,0.7962962962962963,80158333,37,15
2,3,0.9423076923076923,0.9166666666666666,70594104,52,49
1,4,0.42857142857142855,0.6666666666666666,82096291,7,3
2,27,0.55,0.8648648648648649,73549833,60,33
1,371,0.49523809523809526,0.9381188118811881,67042822,735,364
2,0,1.0,1.0,19488014,2,2
0,30,0.21052631578947367,0.3114754098360656,65813174,38,8
0,1,0.0,0.0,82042140,1,0
0,1,0.0,0.0,82042141,1,0
1,239,0.27794561933534745,0.6482939632545932,66384640,331,92
2,7,0.7083333333333334,0.875,67347315,24,17
0,5,0.16666666666666666,0.25,74539311,6,1
2,0,1.0,1.0,69159363,11,11
0,158,0.18134715025906736,0.2236842105263158,68943084,193,35
2,0,1.0,1.0,82175558,4,4
2,28,0.5087719298245614,0.9051724137931034,80158252,57,29
2,46,0.6,0.9767441860465116,69057975,115,69
2,0,1.0,1.0,69158740,4,4
0,50,0.0,0.0,73113586,50,0
0,75,0.08536585365853659,0.11267605633802817,73113600,82,7
0,215,0.14342629482071714,0.19594594594594594,80127558,251,36
2,37,0.7016129032258065,0.9285714285714286,69533282,124,87
1,20,0.2,0.5483870967741935,80141472,25,5
2,0,1.0,1.0,80159227,16,16
1,487,0.3858764186633039,0.814,80096212,793,306
2,17,0.5,0.7586206896551724,80172007,34,17
2,0,1.0,1.0,80134717,2,2
0,17,0.32,0.46153846153846156,72801582,25,8
1,221,0.39285714285714285,0.8318385650224215,72322145,364,143
1,60,0.3617021276595745,0.8201438848920863,78714433,94,34
2,7,0.6111111111111112,0.8888888888888888,80055045,18,11
1,66,0.31958762886597936,0.7226890756302521,65958893,97,31
0,11,0.3888888888888889,0.47619047619047616,66257625,18,7
2,46,0.6592592592592592,0.989010989010989,80152711,135,89
1,336,0.47003154574132494,0.9325842696629213,68370722,634,298
1,29,0.3695652173913043,0.6326530612244898,75121102,46,17
2,1,0.75,0.8333333333333334,80158253,4,3
2,186,0.5218508997429306,0.868995633187773,63727454,389,203
0,412,0.1271186440677966,0.10365853658536585,80178945,472,60
1,11,0.45,0.90625,80174687,20,9
0,206,0.13445378151260504,0.09558823529411764,80174691,238,32
2,48,0.6129032258064516,0.9382716049382716,69733202,124,76
0,1,0.0,0.0,70314335,1,0
2,2,0.8181818181818182,0.25,70314342,11,9
1,61,0.3838383838383838,0.8764044943820225,80172867,99,38
2,0,1.0,1.0,80159292,15,15
2,0,1.0,1.0,80136587,1,1
1,191,0.3818770226537217,0.844311377245509,64191946,309,118
2,189,0.6802030456852792,0.9666666666666667,72471826,591,402
2,66,0.8290155440414507,0.9541284403669725,80118209,386,320
2,8,0.8961038961038961,0.9090909090909091,68556740,77,69
1,222,0.36023054755043227,0.8183118741058655,81971153,347,125
0,433,0.0525164113785558,0.1344632768361582,70862435,457,24
0,425,0.0449438202247191,0.10011376564277588,80081064,445,20
2,0,1.0,1.0,82037203,7,7
2,16,0.7241379310344828,0.8571428571428571,80178922,58,42
0,5,0.2857142857142857,0.0,80178935,7,2
2,1,0.5,0.0,82018686,2,1
2,2,0.6,0.8,82022877,5,3
2,10,0.8214285714285714,0.9714285714285714,69512282,56,46
2,1,0.6666666666666666,0.5,82041294,3,2
0,12,0.14285714285714285,0.2962962962962963,82009590,14,2
2,6,0.8421052631578947,0.8888888888888888,82041304,38,32
0,613,0.04961240310077519,0.04284412032816773,68017775,645,32
1,122,0.3333333333333333,0.6457142857142857,70219114,183,61
0,188,0.08292682926829269,0.1519434628975265,71762292,205,17
0,85,0.0,0.0,71762670,85,0
2,12,0.5,0.5555555555555556,73108455,24,12
1,89,0.2764227642276423,0.5617283950617284,70202566,123,34
2,36,0.6756756756756757,0.8852459016393442,82096258,111,75
2,3,0.7272727272727273,0.8,80018925,11,8
1,48,0.3142857142857143,0.6792452830188679,80135820,70,22
2,0,1.0,1.0,80079685,4,4
2,6,0.8888888888888888,0.25,80126598,54,48
1,94,0.4891304347826087,0.9353448275862069,69157690,184,90
2,2,0.5,0.3333333333333333,82023072,4,2
2,74,0.7867435158501441,0.921875,70718011,347,273
2,7,0.5625,0.7368421052631579,73551765,16,9
1,137,0.33816425120772947,0.7019230769230769,80055346,207,70
1,2,0.3333333333333333,0.5,80162547,3,1
0,11,0.26666666666666666,0.3333333333333333,80162588,15,4
2,0,1.0,1.0,70080185,3,3
2,36,0.6288659793814433,0.9508196721311475,69058696,97,61
1,78,0.4,0.7581699346405228,69047286,130,52
2,77,0.6225490196078431,0.911504424778761,69401150,204,127
1,82,0.4533333333333333,0.8023255813953488,69401171,150,68
0,6,0.14285714285714285,0.25,69946912,7,1
1,77,0.40310077519379844,0.9210526315789473,70649586,129,52
2,0,1.0,1.0,69172572,4,4
1,112,0.32934131736526945,0.7288135593220338,70605381,167,55
2,97,0.6420664206642066,0.8795180722891566,80135748,271,174
2,2,0.8571428571428571,0.8333333333333334,74047085,14,12
2,20,0.8701298701298701,0.9411764705882353,80055402,154,134
2,39,0.5185185185185185,0.6842105263157895,77885654,81,42
2,0,1.0,1.0,80178175,8,8
2,38,0.5308641975308642,0.9852941176470589,72051651,81,43
0,148,0.2780487804878049,0.3956043956043956,80176766,205,57
0,89,0.2644628099173554,0.3983739837398374,80176767,121,32
0,90,0.16666666666666666,0.15555555555555556,80176769,108,18
1,175,0.32432432432432434,0.7311827956989247,69216105,259,84
0,11,0.26666666666666666,0.2222222222222222,70637980,15,4
2,0,1.0,1.0,75636183,3,3
0,39,0.11363636363636363,0.3548387096774194,80072125,44,5
0,141,0.0784313725490196,0.10236220472440945,80072160,153,12
0,42,0.10638297872340426,0.1875,80072202,47,5
0,24,0.0,0.0,80072244,24,0
2,105,0.5833333333333334,0.9741379310344828,80117935,252,147
2,19,0.8020833333333334,0.9830508474576272,69733426,96,77
2,36,0.8333333333333334,0.9508196721311475,80056382,216,180
1,408,0.289198606271777,0.5121495327102804,80176772,574,166
1,89,0.27049180327868855,0.6256410256410256,69986182,122,33
0,430,0.12244897959183673,0.11654135338345864,80172872,490,60
0,46,0.22033898305084745,0.34074074074074073,80176724,59,13
2,27,0.5970149253731343,0.9855072463768116,69622280,67,40
2,7,0.6818181818181818,0.9285714285714286,79792286,22,15
0,82,0.28695652173913044,0.4519774011299435,80180189,115,33
1,142,0.2154696132596685,0.5048543689320388,68283236,181,39
2,0,1.0,1.0,82039350,5,5
2,5,0.7222222222222222,0.9473684210526315,82145108,18,13
2,3,0.9210526315789473,0.25,70314475,38,35
1,90,0.23728813559322035,0.5427350427350427,80125655,118,28
1,261,0.44349680170575695,0.856020942408377,68884774,469,208
2,3,0.8125,0.8,70222481,16,13
2,35,0.8717948717948718,0.9868421052631579,68301156,273,238
2,2,0.8888888888888888,0.75,79073813,18,16
0,175,0.2324561403508772,0.4776536312849162,82096292,228,53
1,11,0.45,0.8888888888888888,82037505,20,9
0,167,0.09239130434782608,0.11475409836065574,69112344,184,17
1,106,0.30718954248366015,0.6785714285714286,69112386,153,47
2,6,0.6842105263157895,0.9615384615384616,70632695,19,13
2,7,0.5,0.625,80018456,14,7
1,40,0.2982456140350877,0.9105691056910569,80137588,57,17
0,249,0.2905982905982906,0.4723404255319149,60405310,351,102
2,35,0.6276595744680851,0.9444444444444444,82008300,94,59
2,0,1.0,1.0,80162575,26,26
1,26,0.4090909090909091,0.8311688311688312,82038361,44,18
0,45,0.0425531914893617,0.015384615384615385,80141485,47,2
0,13,0.35,0.2,82018979,20,7
0,51,0.1206896551724138,0.03571428571428571,72425710,58,7
1,160,0.4557823129251701,0.9086651053864169,82095524,294,134
2,88,0.6857142857142857,0.9203539823008849,66848712,280,192
2,31,0.5921052631578947,0.8620689655172413,80145464,76,45
2,17,0.8068181818181818,0.9833333333333333,65619330,88,71
1,9,0.35714285714285715,0.7647058823529411,80056333,14,5
1,88,0.2605042016806723,0.6105263157894737,80114671,119,31
2,0,1.0,1.0,82143786,5,5
2,16,0.6,0.875,80028396,40,24
2,95,0.7049689440993789,0.9440559440559441,72471476,322,227
1,196,0.24904214559386972,0.5806451612903226,80128629,261,65
1,293,0.47584973166368516,0.786833855799373,75060503,559,266
2,71,0.6055555555555555,0.940677966101695,69733524,180,109
1,413,0.31735537190082647,0.6112956810631229,79787442,605,192
0,427,0.16764132553606237,0.46220095693779906,80124653,513,86
0,3,0.0,0.0,82051772,3,0
2,11,0.8472222222222222,0.9655172413793104,70073794,72,61
2,20,0.7530864197530864,0.9859154929577465,80126939,81,61
2,15,0.6511627906976745,0.9696969696969697,80158309,43,28
2,72,0.558282208588957,0.9490445859872612,66468192,163,91
2,5,0.7368421052631579,0.8333333333333334,68620923,19,14
2,0,1.0,1.0,80159170,9,9
1,9,0.47058823529411764,0.9473684210526315,79989574,17,8
2,1,0.8,0.0,69958630,5,4
2,2,0.8666666666666667,0.75,69958644,15,13
2,8,0.9279279279279279,0.75,80126594,111,103
1,29,0.42,0.7090909090909091,80145771,50,21
2,3,0.5,0.75,80137367,6,3
2,11,0.8804347826086957,0.9090909090909091,69547674,92,81
2,0,1.0,1.0,69546344,2,2
2,20,0.7916666666666666,0.9433962264150944,76545441,96,76
0,70,0.2391304347826087,0.49696969696969695,74676294,92,22
2,13,0.8433734939759037,0.9615384615384616,68620930,83,70
2,0,1.0,1.0,82145146,3,3
1,107,0.3227848101265823,0.7300613496932515,73151330,158,51
2,7,0.75,0.9333333333333333,82040660,28,21
0,20,0.16666666666666666,0.4067796610169492,80053505,24,4
0,4,0.0,0.0,80053526,4,0
2,5,0.5833333333333334,0.8666666666666667,80053533,12,7
2,189,0.5227272727272727,0.9049079754601227,82009743,396,207
1,24,0.22580645161290322,0.6666666666666666,80141474,31,7
1,173,0.352059925093633,0.6975717439293598,68189604,267,94
0,29,0.23684210526315788,0.3,69314042,38,9
1,9,0.18181818181818182,0.5641025641025641,70701883,11,2
0,5,0.0,0.0,70703493,5,0
2,176,0.5281501340482574,0.9653916211293261,68028870,373,197
1,7,0.2222222222222222,0.6923076923076923,70692972,9,2
0,8,0.0,0.0,70694225,8,0
0,1,0.0,0.0,70699146,1,0
0,3,0.0,0.0,70699762,3,0
0,88,0.043478260869565216,0.11068702290076336,80124314,92,4
1,401,0.3714733542319749,0.7584541062801933,69162646,638,237
0,309,0.006430868167202572,0.001949317738791423,73906000,311,2
1,31,0.39215686274509803,0.9210526315789473,82095535,51,20
0,221,0.12301587301587301,0.1189873417721519,66015572,252,31
1,56,0.36363636363636365,0.7985074626865671,80136847,88,32
1,77,0.45774647887323944,0.8344827586206897,72323804,142,65
2,196,0.5344418052256532,0.8952095808383234,80180299,421,225
0,195,0.13716814159292035,0.37538461538461537,60833521,226,31
0,268,0.13548387096774195,0.3270440251572327,66348730,310,42
1,88,0.42483660130718953,0.8343558282208589,69285734,153,65
2,288,0.5450236966824644,0.9803921568627451,80111906,633,345
1,73,0.33636363636363636,0.7988165680473372,69165222,110,37
0,133,0.04316546762589928,0.18618042226487524,62838965,139,6
1,256,0.38461538461538464,0.8117088607594937,67304300,416,160
0,144,0.2,0.43169398907103823,80097423,180,36
0,571,0.14006024096385541,0.19615384615384615,69228201,664,93
1,115,0.2857142857142857,0.5735294117647058,69176982,161,46
1,178,0.4163934426229508,0.8914027149321267,74576810,305,127
0,286,0.20555555555555555,0.39617486338797814,80180379,360,74
0,223,0.21201413427561838,0.33557046979865773,82126794,283,60
0,146,0.16091954022988506,0.31950207468879666,70850766,174,28
1,173,0.27310924369747897,0.5634920634920635,70891891,238,65
0,661,0.16329113924050634,0.2982601491300746,68542705,790,129
1,22,0.4358974358974359,0.8297872340425532,68401872,39,17
1,66,0.45454545454545453,0.7291666666666666,80003735,121,55
1,320,0.3205944798301486,0.7745241581259151,80120445,471,151
2,35,0.6236559139784946,0.8666666666666667,73443006,93,58
2,4,0.5,0.7333333333333333,66352643,8,4
2,25,0.7641509433962265,0.9920634920634921,80122544,106,81
0,29,0.23684210526315788,0.38333333333333336,68905690,38,9
1,104,0.3988439306358382,0.7872340425531915,70474824,173,69
0,30,0.11764705882352941,0.06521739130434782,67555313,34,4
0,24,0.14285714285714285,0.14754098360655737,67555383,28,4
0,515,0.12414965986394558,0.2861356932153392,66348051,588,73
2,21,0.6037735849056604,0.8918918918918919,69731564,53,32
0,60,0.24050632911392406,0.4125,82126644,79,19
2,47,0.5765765765765766,0.9065420560747663,69512534,111,64
0,88,0.14563106796116504,0.3438914027149321,80128228,103,15
2,107,0.5023255813953489,0.9307958477508651,16866395,215,108
1,16,0.30434782608695654,0.75,68229070,23,7
0,93,0.225,0.392,69737192,120,27
0,2,0.0,0.0,69640466,2,0
1,152,0.32142857142857145,0.7419354838709677,82126695,224,72
1,363,0.3375912408759124,0.8309859154929577,67552002,548,185
1,183,0.3464285714285714,0.8169398907103825,67553654,280,97
1,29,0.43137254901960786,0.9626168224299065,70210406,51,22
2,52,0.6,0.9813084112149533,69198570,130,78
1,332,0.319672131147541,0.6272965879265092,62510301,488,156
0,61,0.07575757575757576,0.036585365853658534,80070991,66,5
0,413,0.16733870967741934,0.37624750499001997,80098781,496,83
0,420,0.20903954802259886,0.4884979702300406,68536930,531,111
1,332,0.2261072261072261,0.53437876960193,80097612,429,97
1,28,0.4166666666666667,0.9310344827586207,67993576,48,20
0,435,0.1194331983805668,0.2304093567251462,68312090,494,59
1,321,0.21323529411764705,0.5515267175572519,64222165,408,87
1,96,0.29411764705882354,0.6732673267326733,69176632,136,40
1,103,0.24817518248175183,0.5844155844155844,69177325,137,34
1,86,0.3228346456692913,0.7738693467336684,66415195,127,41
1,230,0.32748538011695905,0.7298387096774194,63732676,342,112
1,461,0.32305433186490456,0.6237113402061856,80172014,681,220
1,3,0.25,0.6666666666666666,70202664,4,1
1,77,0.3063063063063063,0.704225352112676,80135440,111,34
0,253,0.10915492957746478,0.11337868480725624,70649551,284,31
0,315,0.136986301369863,0.15485996705107083,70649593,365,50
2,82,0.503030303030303,0.8633540372670807,72838164,165,83
1,61,0.3146067415730337,0.7763157894736842,80130628,89,28
1,59,0.2716049382716049,0.5966850828729282,82036401,81,22
1,496,0.28735632183908044,0.6785714285714286,63278495,696,200
0,76,0.09523809523809523,0.2097902097902098,69158033,84,8
0,206,0.08849557522123894,0.23229461756373937,69158390,226,20
0,483,0.16291161178509533,0.2922134733158355,68535523,577,94
1,575,0.43792766373411535,0.9238351254480287,65008426,1023,448
2,140,0.6354166666666666,0.9714285714285714,903525,384,244
0,70,0.05405405405405406,0.05084745762711865,80178128,74,4
0,758,0.07334963325183375,0.1636828644501279,67343290,818,60
2,11,0.56,0.92,69039313,25,14
1,258,0.4,0.8532423208191127,72999276,430,172
0,136,0.2,0.35526315789473684,68533710,170,34
1,12,0.25,0.8235294117647058,66653482,16,4
1,243,0.2334384858044164,0.5249500998003992,67159330,317,74
1,421,0.282793867120954,0.7324766355140186,67159344,587,166
1,41,0.29310344827586204,0.6902654867256637,705614,58,17
1,89,0.3904109589041096,0.8493975903614458,80117925,146,57
1,23,0.25806451612903225,0.5981308411214953,70829094,31,8
0,637,0.10533707865168539,0.13752122241086587,68791240,712,75
1,33,0.49230769230769234,0.967391304347826,82151299,65,32
1,144,0.2835820895522388,0.6424581005586593,67435781,201,57
0,299,0.11538461538461539,0.12585034013605442,70614831,338,39
2,15,0.8543689320388349,0.975,73362233,103,88
0,112,0.16417910447761194,0.1693548387096774,54046510,134,22
0,31,0.1388888888888889,0.1326530612244898,73783255,36,5
0,565,0.06301824212271974,0.1349056603773585,67814271,603,38
0,15,0.16666666666666666,0.17391304347826086,70059731,18,3
1,101,0.22900763358778625,0.6505681818181818,80118423,131,30
1,175,0.25213675213675213,0.6457925636007827,80156772,234,59
0,739,0.12544378698224853,0.15146831530139104,67291973,845,106
1,190,0.4117647058823529,0.8448275862068966,73321262,323,133
2,184,0.6043010752688172,0.994269340974212,70673463,465,281
2,40,0.6153846153846154,0.9863013698630136,68040000,104,64
2,0,1.0,1.0,80159230,24,24
2,5,0.7222222222222222,0.9285714285714286,74965625,18,13
0,2,0.0,0.0,77283703,2,0
1,102,0.3503184713375796,0.7682539682539683,70078330,157,55
0,151,0.03205128205128205,0.07716049382716049,70109585,156,5
0,71,0.013888888888888888,0.014705882352941176,70080871,72,1
0,92,0.061224489795918366,0.10067114093959731,70081144,98,6
0,136,0.05555555555555555,0.058823529411764705,70081193,144,8
1,7,0.36363636363636365,0.5,68904892,11,4
2,1,0.9166666666666666,0.5,80126549,12,11
1,57,0.4,0.8469387755102041,70063336,95,38
1,5,0.4444444444444444,0.9090909090909091,80067323,9,4
2,12,0.8441558441558441,0.8666666666666667,69520472,77,65
0,555,0.20028818443804033,0.4064039408866995,66180135,694,139
2,8,0.8,0.9090909090909091,68173756,40,32
2,110,0.5089285714285714,0.8928571428571429,80124810,224,114
0,910,0.1574074074074074,0.21804511278195488,80140092,1080,170
1,302,0.4568345323741007,0.9062119366626066,70925491,556,254
0,659,0.17314930991217065,0.36224028906955735,68538134,797,138
0,82,0.21153846153846154,0.4827586206896552,69621965,104,22
1,118,0.424390243902439,0.8904109589041096,64242941,205,87
1,121,0.25766871165644173,0.5118483412322274,73590034,163,42
1,173,0.2821576763485477,0.7453416149068323,68553604,241,68
1,182,0.36585365853658536,0.8607843137254902,80119027,287,105
1,793,0.21485148514851485,0.5,68541046,1010,217
1,380,0.24603174603174602,0.5912938331318017,70059843,504,124
1,121,0.45495495495495497,0.9055793991416309,63728014,222,101
1,90,0.4375,0.828125,66462074,160,70
0,29,0.09375,0.09803921568627451,70206990,32,3
1,327,0.310126582278481,0.751207729468599,69586342,474,147
0,68,0.22727272727272727,0.49029126213592233,69603373,88,20
0,293,0.13823529411764707,0.22474747474747475,72785916,340,47
1,345,0.31,0.786472148541114,63278621,500,155
0,318,0.2109181141439206,0.47058823529411764,80056942,403,85
1,217,0.3541666666666667,0.8129139072847682,65155461,336,119
1,471,0.35567715458276333,0.7894221351616063,57181026,731,260
1,249,0.26331360946745563,0.6551059730250481,67428424,338,89
1,156,0.3953488372093023,0.9014492753623189,70910994,258,102
1,48,0.29411764705882354,0.8352941176470589,68791044,68,20
1,177,0.2625,0.5973154362416108,80130001,240,63
0,16,0.15789473684210525,0.1875,80067141,19,3
1,97,0.41916167664670656,0.8758620689655172,82009286,167,70
1,147,0.41434262948207173,0.94375,69165096,251,104
0,65,0.04411764705882353,0.0,70646030,68,3
1,185,0.30970149253731344,0.7060301507537688,72413936,268,83
1,192,0.3469387755102041,0.8442822384428224,69183282,294,102
1,202,0.28368794326241137,0.7024070021881839,72522856,282,80
1,228,0.2692307692307692,0.623400365630713,72493764,312,84
1,102,0.23880597014925373,0.5227272727272727,67557231,134,32
0,989,0.07397003745318352,0.05763517528223411,80118153,1068,79
2,166,0.5426997245179064,0.924,67244632,363,197
1,74,0.2815533980582524,0.7009803921568627,69073592,103,29
0,268,0.10666666666666667,0.12874251497005987,72900576,300,32
0,256,0.1232876712328767,0.17294520547945205,72900590,292,36
0,139,0.13664596273291926,0.2236842105263158,80097374,161,22
1,584,0.34966592427616927,0.8391752577319588,80125383,898,314
1,368,0.2654690618762475,0.541782729805014,67995326,501,133
0,833,0.14388489208633093,0.1941448382126348,68541942,973,140
1,309,0.32532751091703055,0.7662178702570379,70758450,458,149
0,73,0.039473684210526314,0.07650273224043716,73245452,76,3
1,146,0.3047619047619048,0.8007662835249042,67291651,210,64
1,209,0.4722222222222222,0.8934782608695652,70562380,396,187
1,93,0.27906976744186046,0.5,80180277,129,36
2,85,0.5058139534883721,0.8792270531400966,80180181,172,87
2,46,0.6068376068376068,0.91,70284515,117,71
2,22,0.5686274509803921,0.7872340425531915,70718921,51,29
2,18,0.5135135135135135,0.9230769230769231,80180254,37,19
1,41,0.4533333333333333,0.8309859154929577,80180257,75,34
2,8,0.8461538461538461,0.9523809523809523,70593474,52,44
1,122,0.39303482587064675,0.8192771084337349,80067225,201,79
0,72,0.2,0.4063926940639269,82002229,90,18
1,6,0.4,0.9130434782608695,82182792,10,4
1,53,0.2638888888888889,0.5316455696202531,80141501,72,19
1,43,0.3582089552238806,0.559322033898305,70115171,67,24
0,1173,0.14442013129102846,0.1806282722513089,68283306,1371,198
0,43,0.06521739130434782,0.15555555555555556,82003744,46,3
1,144,0.2727272727272727,0.5495750708215298,80145840,198,54
1,8,0.38461538461538464,0.9154929577464789,70606221,13,5
1,189,0.3482758620689655,0.7535211267605634,80130184,290,101
0,119,0.032520325203252036,0.052884615384615384,80114580,123,4
2,60,0.7665369649805448,0.9899497487437185,80127881,257,197
2,100,0.5024875621890548,0.948,60199384,201,101
1,20,0.42857142857142855,0.7777777777777778,75102874,35,15
0,161,0.16145833333333334,0.2422360248447205,65289371,192,31
0,109,0.18045112781954886,0.36212624584717606,65289882,133,24
1,604,0.2570725707257073,0.5023696682464455,70957145,813,209
1,71,0.22826086956521738,0.5637254901960784,72758742,92,21
0,366,0.04935064935064935,0.16213683223992503,62836921,385,19
1,19,0.3870967741935484,0.6875,80125559,31,12
1,58,0.34831460674157305,0.7476635514018691,70673743,89,31
1,75,0.4897959183673469,0.953757225433526,79815960,147,72
0,6,0.0,0.0,68600854,6,0
1,97,0.302158273381295,0.6855895196506551,69183835,139,42
1,499,0.36835443037974686,0.7083333333333334,71752933,790,291
0,96,0.22580645161290322,0.35564853556485354,72560215,124,28
1,91,0.3767123287671233,0.7783505154639175,67154311,146,55
1,268,0.2342857142857143,0.5446685878962536,82036704,350,82
1,416,0.23669724770642203,0.5563298490127758,79520175,545,129
1,427,0.42219215155615697,0.8818897637795275,68028142,739,312
0,128,0.18471337579617833,0.2902208201892745,82126662,157,29
0,173,0.15609756097560976,0.29128440366972475,82116606,205,32
1,281,0.28498727735368956,0.5592885375494071,66614023,393,112
0,202,0.18875502008032127,0.3811252268602541,82009377,249,47
0,232,0.06072874493927125,0.24411764705882352,76805603,247,15
1,442,0.26578073089701,0.7058261700095511,82143791,602,160
1,202,0.40762463343108507,0.8833333333333333,70183064,341,139
0,132,0.2,0.3112391930835735,82126652,165,33
1,491,0.3530961791831357,0.8102564102564103,70627452,759,268
2,97,0.529126213592233,0.9766081871345029,69165201,206,109
0,132,0.14285714285714285,0.32195121951219513,69417096,154,22
0,102,0.23880597014925373,0.4482758620689655,62024571,134,32
0,100,0.16666666666666666,0.3969849246231156,82095671,120,20
1,102,0.423728813559322,0.8483412322274881,66326400,177,75
0,187,0.17982456140350878,0.3805309734513274,67963161,228,41
1,8,0.3333333333333333,0.5294117647058824,69660752,12,4
1,305,0.25790754257907544,0.6140350877192983,72760394,411,106
0,81,0.11956521739130435,0.05714285714285714,70645596,92,11
1,73,0.39669421487603307,0.8320610687022901,73650836,121,48
1,64,0.26436781609195403,0.5752212389380531,80119008,87,23
0,137,0.17964071856287425,0.454,80124658,167,30
1,44,0.26666666666666666,0.6634615384615384,69464171,60,16
0,42,0.19230769230769232,0.375,63286811,52,10
0,15,0.25,0.4473684210526316,80125048,20,5
1,105,0.27586206896551724,0.7161716171617162,66931991,145,40
1,102,0.3013698630136986,0.7378048780487805,66932005,146,44
0,378,0.23636363636363636,0.4474431818181818,69993462,495,117
1,43,0.44871794871794873,0.8791208791208791,69205283,78,35
1,214,0.21033210332103322,0.5088028169014085,80168275,271,57
1,152,0.42641509433962266,0.8975,54013862,265,113
1,167,0.3552123552123552,0.7597911227154047,63156443,259,92
1,260,0.2696629213483146,0.5874730021598272,66459106,356,96
1,33,0.4,0.868421052631579,65278136,55,22
2,6,0.76,0.9333333333333333,69205255,25,19
0,21,0.08695652173913043,0.10714285714285714,80133625,23,2
0,34,0.10526315789473684,0.10256410256410256,80133626,38,4
2,54,0.5384615384615384,0.9731543624161074,77479262,117,63
2,42,0.5,0.9682539682539683,80166904,84,42
0,136,0.18072289156626506,0.3229665071770335,68563194,166,30
1,153,0.34051724137931033,0.778125,70176281,232,79
0,189,0.05025125628140704,0.04721030042918455,69107003,199,10
0,189,0.26171875,0.4255952380952381,80107930,256,67
1,213,0.30618892508143325,0.6108786610878661,65903544,307,94
0,166,0.2350230414746544,0.28695652173913044,82060565,217,51
2,33,0.6944444444444444,0.8958333333333334,70634452,108,75
1,613,0.23375,0.5152643335815339,82002087,800,187
1,150,0.40476190476190477,0.8193979933110368,69108662,252,102
0,165,0.15816326530612246,0.16470588235294117,80152857,196,31
0,158,0.08139534883720931,0.030303030303030304,80152861,172,14
0,644,0.19298245614035087,0.32872200263504614,82000447,798,154
2,21,0.8571428571428571,0.8636363636363636,1040291,147,126
0,160,0.030303030303030304,0.09121621621621621,62835241,165,5
0,13,0.07142857142857142,0.45454545454545453,80150795,14,1
1,180,0.22413793103448276,0.5408388520971302,69549165,232,52
0,161,0.06395348837209303,0.01652892561983471,73650913,172,11
0,68,0.24444444444444444,0.375,73652131,90,22
1,102,0.43333333333333335,0.8515625,67307023,180,78
1,181,0.24896265560165975,0.5135135135135135,69608203,241,60
1,287,0.23872679045092837,0.5426470588235294,66422916,377,90
1,127,0.2824858757062147,0.7212643678160919,80180991,177,50
0,4,0.2,0.16666666666666666,70253764,5,1
1,38,0.32142857142857145,0.8018018018018018,804825,56,18
0,127,0.2616279069767442,0.48698884758364314,80108301,172,45
1,22,0.4358974358974359,0.9482758620689655,80117695,39,17
0,181,0.2551440329218107,0.47093023255813954,80107503,243,62
0,271,0.25753424657534246,0.480225988700565,80108266,365,94
0,225,0.046610169491525424,0.19203413940256045,62835010,236,11
0,201,0.028985507246376812,0.07133757961783439,64984885,207,6
0,585,0.06698564593301436,0.05012531328320802,70627746,627,42
0,561,0.12206572769953052,0.1092436974789916,70644952,639,78
1,102,0.31543624161073824,0.7391304347826086,73111710,149,47
1,197,0.27037037037037037,0.5514563106796116,67215344,270,73
0,87,0.13861386138613863,0.1509433962264151,77677131,101,14
0,324,0.15625,0.3268529769137303,80098375,384,60
0,6,0.25,0.36,69149290,8,2
1,231,0.3547486033519553,0.8489795918367347,68434506,358,127
2,330,0.541029207232267,0.9576719576719577,70202475,719,389
1,558,0.2017167381974249,0.5163447251114414,67812843,699,141
1,59,0.3516483516483517,0.8943089430894309,65018772,91,32
0,104,0.06306306306306306,0.23725055432372505,69463576,111,7
0,64,0.2,0.4,63282191,80,16
0,113,0.06611570247933884,0.25825825825825827,60286611,121,8
0,481,0.12704174228675136,0.40711462450592883,907011,551,70
0,9,0.18181818181818182,0.32142857142857145,71619380,11,2
1,104,0.2925170068027211,0.596958174904943,82007150,147,43
0,671,0.1654228855721393,0.42495479204339964,60463410,804,133
1,11,0.45,0.7419354838709677,69521221,20,9
0,310,0.143646408839779,0.424860853432282,80149888,362,52
1,131,0.2556818181818182,0.7181008902077152,70919541,176,45
2,104,0.5071090047393365,0.966824644549763,70077903,211,107
2,9,0.55,0.8666666666666667,71689604,20,11
1,572,0.21536351165980797,0.5996533795493935,63975555,729,157
1,362,0.3758620689655172,0.8657616892911011,68783624,580,218
0,154,0.031446540880503145,0.3032258064516129,80149928,159,5
2,115,0.603448275862069,0.9765886287625418,72198126,290,175
1,22,0.35294117647058826,0.8356164383561644,63991816,34,12
1,67,0.3557692307692308,0.7055214723926381,72534315,104,37
0,5,0.0,0.0,67468023,5,0
0,96,0.2440944881889764,0.4652173913043478,73734584,127,31
0,71,0.06578947368421052,0.46458923512747874,62834884,76,5
1,591,0.2423076923076923,0.5399449035812672,77688002,780,189
0,24,0.07692307692307693,0.24719101123595505,80149844,26,2
0,523,0.05765765765765766,0.15467980295566502,788130,555,32
0,50,0.18032786885245902,0.3076923076923077,82150085,61,11
1,44,0.2,0.7151898734177216,67900826,55,11
1,10,0.09090909090909091,0.6056338028169014,70918050,11,1
0,147,0.09815950920245399,0.33047210300429186,64944621,163,16
0,116,0.056910569105691054,0.18717948717948718,69463870,123,7
0,414,0.037209302325581395,0.11348684210526316,62837915,430,16
1,27,0.34146341463414637,0.7323943661971831,63781746,41,14
0,23,0.041666666666666664,0.11578947368421053,67782092,24,1
0,8,0.2,0.12903225806451613,68760496,10,2
0,33,0.10810810810810811,0.2328767123287671,80128823,37,4
1,44,0.2,0.6712328767123288,66512691,55,11
0,192,0.14285714285714285,0.48717948717948717,67455010,224,32
1,18,0.4,0.7368421052631579,80176715,30,12
0,245,0.06130268199233716,0.27419354838709675,62839091,261,16
0,174,0.04918032786885246,0.19561551433389546,62839721,183,9
1,517,0.22372372372372373,0.525399129172714,70642355,666,149
0,21,0.045454545454545456,0.05194805194805195,80149824,22,1
0,240,0.18088737201365188,0.2816,70921130,293,53
0,202,0.14042553191489363,0.16120218579234974,68740784,235,33
2,44,0.6535433070866141,0.975,80130695,127,83
0,76,0.19148936170212766,0.42124542124542125,80118449,94,18
2,0,1.0,1.0,67142194,21,21
1,152,0.4882154882154882,0.9007633587786259,80137884,297,145
1,10,0.4444444444444444,0.5,69129886,18,8
0,4,0.0,0.0,70680106,4,0
2,2,0.8181818181818182,0.8888888888888888,65942695,11,9
1,46,0.2923076923076923,0.806930693069307,71359505,65,19
2,6,0.6842105263157895,0.9090909090909091,72417842,19,13
0,239,0.0842911877394636,0.22115384615384615,69701044,261,22
0,144,0.09433962264150944,0.15714285714285714,70678482,159,15
2,5,0.5833333333333334,0.75,80094112,12,7
0,27,0.3076923076923077,0.36,80118324,39,12
0,11,0.08333333333333333,0.2894736842105263,70691740,12,1
0,12,0.07692307692307693,0.34782608695652173,70693791,13,1
1,63,0.411214953271028,0.8541666666666666,80070193,107,44
0,90,0.01098901098901099,0.01092896174863388,80124289,91,1
0,27,0.06896551724137931,0.4044943820224719,80124360,29,2
1,19,0.4411764705882353,0.9215686274509803,82017785,34,15
2,38,0.5913978494623656,0.9765625,82013632,93,55
0,228,0.17391304347826086,0.31129032258064515,68497002,276,48
0,110,0.20863309352517986,0.3770491803278688,69863423,139,29
1,258,0.33505154639175255,0.7661927330173776,80120427,388,130
0,167,0.13020833333333334,0.3311546840958606,69887034,192,25
1,48,0.45454545454545453,0.9775280898876404,69613712,88,40
1,53,0.3977272727272727,0.924812030075188,69184381,88,35
0,208,0.1440329218106996,0.18872017353579176,68716375,243,35
0,58,0.01694915254237288,0.11627906976744186,67467512,59,1
0,156,0.14285714285714285,0.49444444444444446,67889332,182,26
1,28,0.125,0.5054945054945055,80150786,32,4
1,223,0.3421828908554572,0.7860696517412935,81966306,339,116
1,188,0.34494773519163763,0.7050938337801609,70891975,287,99
1,79,0.2616822429906542,0.5621890547263682,70463925,107,28
0,189,0.05970149253731343,0.019390581717451522,63141022,201,12
0,1359,0.22696245733788395,0.43087414755114695,67552156,1758,399
1,64,0.13513513513513514,0.5685279187817259,67887596,74,10
0,138,0.11538461538461539,0.15942028985507245,82009584,156,18
1,270,0.33985330073349634,0.8338368580060423,64860901,409,139
0,348,0.22666666666666666,0.4652605459057072,77065086,450,102
0,62,0.18421052631578946,0.273972602739726,74361812,76,14
0,390,0.11764705882352941,0.14798850574712644,68536951,442,52
1,401,0.45143638850889195,0.8414322250639387,80180301,731,330
0,155,0.2548076923076923,0.4296028880866426,80111563,208,53
0,149,0.20320855614973263,0.35973597359735976,68740756,187,38
1,376,0.34608695652173915,0.8232161874334398,81967289,575,199
0,45,0.19642857142857142,0.48226950354609927,67551253,56,11
1,35,0.18604651162790697,0.5423728813559322,69562514,43,8
1,321,0.3199152542372881,0.7432950191570882,69617534,472,151
1,206,0.29931972789115646,0.6696428571428571,67159540,294,88
1,386,0.2504854368932039,0.5774240231548481,68533171,515,129
1,124,0.32972972972972975,0.7925170068027211,80124664,185,61
0,117,0.09302325581395349,0.18374558303886926,69509153,129,12
0,280,0.1111111111111111,0.17383512544802868,69509181,315,35
1,108,0.2653061224489796,0.5857142857142857,82124907,147,39
0,100,0.2248062015503876,0.49554896142433236,82124908,129,29
0,361,0.11735941320293398,0.21448999046711154,61698931,409,48
1,104,0.24087591240875914,0.5472636815920398,60763514,137,33
1,86,0.24561403508771928,0.6555023923444976,68533535,114,28
1,78,0.3709677419354839,0.66875,79765546,124,46
1,95,0.42771084337349397,0.8722627737226277,70219100,166,71
1,162,0.4,0.9050847457627119,69177745,270,108
1,28,0.17647058823529413,0.5128205128205128,63992502,34,6
0,88,0.22807017543859648,0.43103448275862066,63283451,114,26
0,62,0.06060606060606061,0.21904761904761905,64399202,66,4
1,205,0.3344155844155844,0.7536534446764092,65232195,308,103
0,90,0.0625,0.11960132890365449,67889381,96,6
0,65,0.09722222222222222,0.3522012578616352,80149816,72,7
2,101,0.545045045045045,0.963302752293578,69056652,222,121
2,95,0.6401515151515151,0.9848484848484849,70521073,264,169
1,64,0.26436781609195403,0.6080402010050251,63282891,87,23
0,33,0.08333333333333333,0.2971014492753623,70917700,36,3
1,130,0.38095238095238093,0.8381742738589212,80111675,210,80
0,426,0.15308151093439365,0.26660600545950863,60617361,503,77
1,313,0.2035623409669211,0.5663716814159292,73783584,393,80
0,385,0.15570175438596492,0.21119592875318066,68192453,456,71
0,106,0.17829457364341086,0.4182825484764543,82042892,129,23
2,110,0.502262443438914,0.922509225092251,67154283,221,111
1,38,0.3968253968253968,0.84,66566976,63,25
1,376,0.3176043557168784,0.6724409448818898,69177465,551,175
1,28,0.2631578947368421,0.6785714285714286,80136355,38,10
1,20,0.2,0.6727272727272727,67454730,25,5
0,14,0.06666666666666667,0.1506849315068493,67888303,15,1
0,24,0.07692307692307693,0.2689075630252101,69464332,26,2
1,46,0.1320754716981132,0.5364806866952789,69890401,53,7
1,321,0.3448979591836735,0.7640449438202247,81967259,490,169
1,661,0.2313953488372093,0.5299352750809061,77676480,860,199
1,189,0.3176895306859206,0.8033240997229917,66930500,277,88
2,4,0.6923076923076923,0.9523809523809523,82018715,13,9
0,233,0.12406015037593984,0.2635135135135135,69417376,266,33
0,14,0.17647058823529413,0.13333333333333333,66892525,17,3
1,22,0.35294117647058826,0.782608695652174,66892546,34,12
0,32,0.13513513513513514,0.42391304347826086,80124184,37,5
2,27,0.5423728813559322,0.9,80175943,59,32
1,547,0.2677376171352075,0.6229985443959243,68236574,747,200
0,314,0.09770114942528736,0.06300813008130081,70207431,348,34
1,436,0.4797136038186158,0.9134734239802225,63461510,838,402
0,35,0.20454545454545456,0.48717948717948717,80149955,44,9
0,490,0.04669260700389105,0.19477434679334918,82134985,514,24
1,92,0.31851851851851853,0.7534246575342466,80164933,135,43
1,36,0.25,0.580952380952381,80128515,48,12
1,310,0.2565947242206235,0.6748971193415638,80135346,417,107
0,160,0.13978494623655913,0.20557491289198607,80180228,186,26
0,243,0.24299065420560748,0.4009433962264151,80180229,321,78
0,349,0.1807511737089202,0.46557377049180326,69191626,426,77
1,329,0.2737306843267108,0.6744444444444444,82050491,453,124
0,251,0.09386281588447654,0.47565118912797283,82049130,277,26
0,971,0.19217970049916805,0.4385593220338983,70690711,1202,231
1,5,0.2857142857142857,0.75,70597884,7,2
1,6,0.3333333333333333,0.7,73485923,9,3
0,5,0.16666666666666666,0.375,78763692,6,1
1,161,0.3374485596707819,0.7027777777777777,70713083,243,82
0,64,0.2,0.40625,80132465,80,16
1,539,0.4044198895027624,0.8856015779092702,66838695,905,366
1,20,0.25925925925925924,0.6162790697674418,68948894,27,7
2,50,0.6575342465753424,0.9047619047619048,67727401,146,96
1,92,0.4888888888888889,0.837696335078534,82102379,180,88
1,130,0.48616600790513836,0.8855421686746988,69588085,253,123
1,72,0.3793103448275862,0.5084745762711864,68171705,116,44
1,84,0.3170731707317073,0.8651685393258427,80128498,123,39
1,56,0.422680412371134,0.7142857142857143,72186646,97,41
0,209,0.13278008298755187,0.21306818181818182,80172874,241,32
0,564,0.2056338028169014,0.42344244984160506,70690774,710,146
2,1,0.5,0.6666666666666666,66782163,2,1
1,10,0.375,0.8214285714285714,71619142,16,6
2,49,0.6201550387596899,0.9779411764705882,80178117,129,80
0,99,0.038834951456310676,0.3073286052009456,67434556,103,4
0,54,0.1,0.4039408866995074,67434570,60,6
0,155,0.08284023668639054,0.45951417004048584,67434591,169,14
1,2,0.3333333333333333,0.8,70343644,3,1
1,808,0.24060150375939848,0.5710306406685237,70690816,1064,256
1,39,0.13333333333333333,0.6691729323308271,80138872,45,6
1,4,0.42857142857142855,0.8181818181818182,66783122,7,3
1,104,0.18110236220472442,0.7160194174757282,67004651,127,23
0,275,0.14860681114551083,0.4177215189873418,68904381,323,48
1,96,0.43529411764705883,0.9098039215686274,70341635,170,74
0,3,0.25,0.2,63375690,4,1
0,125,0.11971830985915492,0.375366568914956,69886950,142,17
0,121,0.032,0.28403361344537814,64501500,125,4
1,230,0.3072289156626506,0.7041095890410959,82008921,332,102
0,69,0.06756756756756757,0.43513513513513513,62834380,74,5
1,99,0.18181818181818182,0.7048054919908466,62836886,121,22
1,225,0.1245136186770428,0.5332252836304701,66389253,257,32
0,813,0.0568445475638051,0.21473029045643152,68255166,862,49
0,300,0.05660377358490566,0.2948846539618857,82049096,318,18
2,205,0.6003898635477583,0.9728260869565217,69499416,513,308
0,267,0.06968641114982578,0.2837209302325581,66877104,287,20
1,9,0.35714285714285715,0.5833333333333334,69903400,14,5
0,8,0.1111111111111111,0.25,82163428,9,1
1,191,0.4723756906077348,0.9222222222222223,69285741,362,171
1,33,0.2826086956521739,0.5625,74058831,46,13
0,318,0.0782608695652174,0.42645607107601186,67004686,345,27
0,81,0.05813953488372093,0.3288135593220339,67434521,86,5
1,190,0.3687707641196013,0.6227272727272727,70798560,301,111
2,42,0.7529411764705882,0.9444444444444444,72410681,170,128
1,25,0.24242424242424243,0.75,65293711,33,8
2,41,0.5591397849462365,0.9523809523809523,70251601,93,52
2,11,0.5416666666666666,0.7407407407407407,73588893,24,13
2,115,0.5247933884297521,0.9227642276422764,80018533,242,127
1,39,0.36065573770491804,0.6590909090909091,80159640,61,22
1,173,0.4175084175084175,0.8494623655913979,67426912,297,124
0,28,0.2,0.46511627906976744,80135092,35,7
2,113,0.6904109589041096,0.9647577092511013,80125416,365,252
1,258,0.32987012987012987,0.7252396166134185,80140056,385,127
2,11,0.56,0.9411764705882353,80135699,25,14
1,86,0.4068965517241379,0.8864628820960698,77224616,145,59
1,39,0.22,0.6228070175438597,63596911,50,11
0,314,0.1969309462915601,0.398046398046398,69073340,391,77
1,275,0.3956043956043956,0.6595744680851063,80174472,455,180
1,3,0.4,0.7272727272727273,80163412,5,2
1,24,0.4418604651162791,0.963855421686747,66595375,43,19
0,224,0.06666666666666667,0.011764705882352941,80140072,240,16
0,23,0.17857142857142858,0.2413793103448276,80118169,28,5
1,175,0.32950191570881227,0.6507936507936508,68408326,261,86
0,15,0.11764705882352941,0.08108108108108109,75338326,17,2
0,788,0.06302021403091558,0.2774566473988439,82134984,841,53
1,80,0.2982456140350877,0.8145161290322581,69895021,114,34
0,17,0.10526315789473684,0.3,82150082,19,2
1,133,0.2849462365591398,0.7392197125256673,67721164,186,53
2,65,0.5911949685534591,0.7681159420289855,65534644,159,94
2,240,0.50920245398773,0.9378427787934186,70245623,489,249
1,10,0.3333333333333333,0.8936170212765957,69698083,15,5
0,323,0.07449856733524356,0.03206997084548105,82001895,349,26
1,91,0.3546099290780142,0.7581395348837209,77224602,141,50
0,53,0.018518518518518517,0.030120481927710843,63803502,54,1
1,77,0.1348314606741573,0.6558441558441559,65912252,89,12
0,141,0.10191082802547771,0.45075757575757575,80128665,157,16
1,95,0.4808743169398907,0.910377358490566,66476613,183,88
1,141,0.3532110091743119,0.8646788990825688,67160051,218,77
1,136,0.38181818181818183,0.8825396825396825,67766454,220,84
1,239,0.3379501385041551,0.7923664122137405,65330601,361,122
0,314,0.14905149051490515,0.2664835164835165,69633116,369,55
0,619,0.19714656290531776,0.33601841196777904,70653821,771,152
0,166,0.08287292817679558,0.15158924205378974,69416620,181,15
1,82,0.31666666666666665,0.7746478873239436,69421940,120,38
1,157,0.41198501872659177,0.8677494199535963,71020201,267,110
0,221,0.21908127208480566,0.3935599284436494,66191895,283,62
0,425,0.17315175097276264,0.2335928809788654,67556503,514,89
1,543,0.4198717948717949,0.889344262295082,80163509,936,393
1,346,0.24945770065075923,0.5835411471321695,71036973,461,115
0,40,0.047619047619047616,0.0,81956346,42,2
0,543,0.24792243767313019,0.4530791788856305,65005822,722,179
1,306,0.40117416829745595,0.910355486862442,67942455,511,205
2,36,0.6814159292035398,0.7659574468085106,67623486,113,77
2,93,0.5528846153846154,0.6896551724137931,68187735,208,115
2,3,0.7,0.8333333333333334,70745101,10,7
2,56,0.7395348837209302,0.851063829787234,70174006,215,159
2,8,0.7419354838709677,0.9285714285714286,69876436,31,23
1,41,0.39705882352941174,0.85,74811464,68,27
1,113,0.3651685393258427,0.9015873015873016,82126716,178,65
1,315,0.42727272727272725,0.9450072358900145,80120468,550,235
0,140,0.17159763313609466,0.3475177304964539,67568676,169,29
0,218,0.16793893129770993,0.251088534107402,80118972,262,44
0,546,0.18991097922848665,0.31966053748231965,80118974,674,128
0,182,0.2222222222222222,0.4821852731591449,67160310,234,52
1,334,0.47151898734177217,0.9090909090909091,70202174,632,298
0,560,0.0743801652892562,0.08839779005524862,68017530,605,45
0,174,0.10309278350515463,0.15963855421686746,68018223,194,20
0,186,0.1267605633802817,0.2452316076294278,70200424,213,27
2,0,1.0,1.0,67182430,1,1
1,37,0.44776119402985076,0.9370629370629371,69627950,67,30
1,88,0.2542372881355932,0.5076923076923077,61748743,118,30
1,156,0.4090909090909091,0.91701244813278,69153770,264,108
1,271,0.2430167597765363,0.5434462444771723,70207193,358,87
1,76,0.3870967741935484,0.8622754491017964,67751264,124,48
0,505,0.12173913043478261,0.1259029927760578,68545372,575,70
0,280,0.06976744186046512,0.08586762075134168,70615286,301,21
0,228,0.12307692307692308,0.21722846441947566,70642635,260,32
1,823,0.2799650043744532,0.6337157987643425,70207046,1143,320
0,27,0.12903225806451613,0.3333333333333333,68497646,31,4
0,577,0.21174863387978143,0.4614820249449743,16662331,732,155
0,412,0.13263157894736843,0.255278310940499,82011848,475,63
0,738,0.15560640732265446,0.20741862225586677,68545036,874,136
0,357,0.22391304347826088,0.49038461538461536,70632205,460,103
0,176,0.16981132075471697,0.2815533980582524,68641944,212,36
1,97,0.26515151515151514,0.6666666666666666,70800310,132,35
0,282,0.08441558441558442,0.16137566137566137,63322021,308,26
0,99,0.20161290322580644,0.49321266968325794,68318285,124,25
0,73,0.09876543209876543,0.24166666666666667,69021911,81,8
2,54,0.6223776223776224,0.9428571428571428,80155274,143,89
2,90,0.6069868995633187,0.8742138364779874,80134708,229,139
1,152,0.2549019607843137,0.5107913669064749,82143569,204,52
2,155,0.630071599045346,0.7532467532467533,70855603,419,264
1,540,0.3446601941747573,0.7606516290726817,80180331,824,284
0,339,0.10789473684210527,0.37058823529411766,63775516,380,41
1,137,0.4963235294117647,0.8152173913043478,80180297,272,135
1,153,0.49,0.8042328042328042,80180298,300,147
0,121,0.12949640287769784,0.46107784431137727,62529516,139,18
1,11,0.42105263157894735,0.8571428571428571,80180480,19,8
1,83,0.2905982905982906,0.6698564593301436,82126586,117,34
1,12,0.4,0.64,69666681,20,8
1,238,0.2145214521452145,0.692167577413479,63517783,303,65
1,164,0.1921182266009852,0.6155378486055777,68649140,203,39
1,114,0.34104046242774566,0.5724907063197026,80180188,173,59
1,160,0.4463667820069204,0.8519736842105263,82062421,289,129
0,812,0.07936507936507936,0.23958333333333334,60509512,882,70
0,24,0.0,0.0,63527422,24,0
0,88,0.06382978723404255,0.26755852842809363,67846380,94,6
1,199,0.32996632996632996,0.6622516556291391,70058394,297,98
1,40,0.2727272727272727,0.8229166666666666,62529145,55,15
1,60,0.14285714285714285,0.589041095890411,62529215,70,10
0,26,0.07142857142857142,0.32456140350877194,62529523,28,2
0,182,0.10344827586206896,0.3446601941747573,62529551,203,21
0,30,0.09090909090909091,0.3684210526315789,62529754,33,3
2,39,0.5185185185185185,0.8390804597701149,72322054,81,42
2,12,0.7692307692307693,0.96,80178980,52,40
0,105,0.18604651162790697,0.46464646464646464,67620455,129,24
0,28,0.24324324324324326,0.4805194805194805,80134774,37,9
0,217,0.026905829596412557,0.07988980716253444,62839616,223,6
2,28,0.6705882352941176,0.8615384615384616,72169475,85,57
2,0,1.0,1.0,19645122,4,4
0,9,0.0,0.0,80135284,9,0
1,122,0.4077669902912621,0.8381742738589212,80176780,206,84
1,101,0.4898989898989899,0.9296482412060302,82007139,198,97
1,97,0.30714285714285716,0.8082595870206489,69949271,140,43
0,36,0.02702702702702703,0.044585987261146494,60542741,37,1
0,257,0.15737704918032788,0.4786150712830957,61594393,305,48
1,572,0.33872832369942196,0.6072507552870091,72433515,865,293
0,172,0.054945054945054944,0.22103004291845493,61947914,182,10
0,310,0.07738095238095238,0.23909531502423265,64240715,336,26
1,248,0.3673469387755102,0.8197879858657244,682010,392,144
1,84,0.43243243243243246,0.8848167539267016,65715244,148,64
0,110,0.043478260869565216,0.11815561959654179,70001281,115,5
0,19,0.05,0.23478260869565218,70174216,20,1
1,266,0.4411764705882353,0.764505119453925,70179830,476,210
1,29,0.17142857142857143,0.7127659574468085,60313113,35,6
0,33,0.08333333333333333,0.24242424242424243,64220506,36,3
0,448,0.1401151631477927,0.3344370860927152,66348681,521,73
0,457,0.12619502868068833,0.2732142857142857,67225893,523,66
0,82,0.11827956989247312,0.2158273381294964,72907863,93,11
1,272,0.3887640449438202,0.8394495412844036,80180312,445,173
1,135,0.27419354838709675,0.6542553191489362,65316601,186,51
2,1,0.6666666666666666,0.6666666666666666,285075,3,2
1,381,0.22718052738336714,0.6635761589403973,63821030,493,112
2,270,0.516994633273703,0.9558823529411765,82091015,559,289
0,408,0.162217659137577,0.26860254083484575,70612822,487,79
0,11,0.0,0.0,65769802,11,0
0,447,0.1813186813186813,0.42374854481955765,81965686,546,99
1,74,0.25252525252525254,0.6927083333333334,62233941,99,25
0,114,0.12307692307692308,0.4307228915662651,62507613,130,16
0,237,0.11895910780669144,0.42320261437908496,69530433,269,32
1,220,0.33933933933933935,0.8020304568527918,69606915,333,113
1,174,0.48214285714285715,0.907185628742515,73330964,336,162
2,74,0.6979591836734694,0.9951456310679612,73348835,245,171
2,5,0.5454545454545454,0.95,80150339,11,6
1,208,0.23529411764705882,0.5895691609977324,69207565,272,64
0,48,0.09433962264150944,0.125,70680554,53,5
0,70,0.09090909090909091,0.4,73064453,77,7
0,175,0.11616161616161616,0.32926829268292684,80124413,198,23
0,6,0.25,0.38235294117647056,13776385,8,2
1,470,0.35704514363885087,0.8799171842650103,68200216,731,261
2,167,0.5936739659367397,0.9705882352941176,70770413,411,244
1,285,0.28211586901763225,0.6609442060085837,80108791,397,112
1,86,0.26495726495726496,0.6611570247933884,68530826,117,31
2,133,0.5413793103448276,0.9622641509433962,67307240,290,157
1,162,0.2767857142857143,0.6446280991735537,80109575,224,62
0,711,0.11235955056179775,0.1601104209799862,80119400,801,90
0,756,0.12398609501738123,0.14128440366972478,73642912,863,107
0,256,0.18210862619808307,0.3403068340306834,68535383,313,57
1,169,0.22119815668202766,0.5426621160409556,19915175,217,48
1,300,0.336283185840708,0.7983050847457627,69154190,452,152
1,497,0.2582089552238806,0.5845213849287169,69607496,670,173
1,97,0.3356164383561644,0.6808510638297872,70892045,146,49
2,107,0.5407725321888412,0.9583333333333334,80150943,233,126
1,377,0.21621621621621623,0.5304212168486739,68543265,481,104
0,1068,0.06233538191395961,0.045755568934376885,70642033,1139,71
0,237,0.22549019607843138,0.41092636579572445,72706081,306,69
0,109,0.22142857142857142,0.42560553633217996,81956134,140,31
0,333,0.19951923076923078,0.44552058111380144,70040901,416,83
1,17,0.45161290322580644,0.9473684210526315,69179726,31,14
2,111,0.5173913043478261,0.9489795918367347,57176826,230,119
1,157,0.38910505836575876,0.8905325443786982,77563871,257,100
1,132,0.37142857142857144,0.8685015290519877,82126736,210,78
0,440,0.21847246891651864,0.48677248677248675,82000081,563,123
2,64,0.5259259259259259,0.9560439560439561,75550300,135,71
0,77,0.19791666666666666,0.47560975609756095,82143793,96,19
2,10,0.5652173913043478,0.975,67650205,23,13
1,23,0.43902439024390244,0.8363636363636363,67303775,41,18
0,122,0.18120805369127516,0.21893491124260356,74362050,149,27
0,21,0.19230769230769232,0.25925925925925924,80124944,26,5
2,32,0.6235294117647059,0.9636363636363636,82045532,85,53
1,501,0.32205683355886333,0.7711442786069652,80125379,739,238
1,231,0.2643312101910828,0.6534653465346535,67225984,314,83
0,108,0.18796992481203006,0.25,61706176,133,25
1,30,0.16666666666666666,0.5142857142857142,69479151,36,6
2,1,0.5,0.5,73536505,2,1
1,21,0.3225806451612903,0.5476190476190477,69469645,31,10
1,181,0.2901960784313726,0.5578034682080925,70485765,255,74
0,130,0.2857142857142857,0.49572649572649574,70524132,182,52
1,219,0.27,0.5714285714285714,62722492,300,81
1,557,0.2877237851662404,0.6592292089249493,80107685,782,225
0,100,0.06542056074766354,0.02857142857142857,64934912,107,7
0,296,0.06624605678233439,0.06159420289855073,68018202,317,21
0,394,0.2537878787878788,0.4647058823529412,80120434,528,134
1,14,0.4166666666666667,0.8837209302325582,69997536,24,10
1,56,0.4716981132075472,0.9390243902439024,68509581,106,50
1,127,0.28651685393258425,0.7129337539432177,65005955,178,51
1,840,0.22865013774104684,0.5146757679180888,73195822,1089,249
1,337,0.2860169491525424,0.6854304635761589,68645080,472,135
1,96,0.36,0.6923076923076923,68400521,150,54
0,116,0.2108843537414966,0.4227129337539432,67553073,147,31
0,59,0.1323529411764706,0.1348314606741573,67554375,68,9
0,109,0.20437956204379562,0.4263322884012539,67557343,137,28
1,51,0.32,0.7829457364341085,68171425,75,24
0,334,0.04297994269340974,0.032,68017733,349,15
0,376,0.15124153498871332,0.2446236559139785,69668921,443,67
1,153,0.32894736842105265,0.7645161290322581,82126738,228,75
1,76,0.2,0.5675675675675675,66226776,95,19
0,301,0.11988304093567251,0.3306613226452906,69965133,342,41
0,17,0.10526315789473684,0.29310344827586204,70238875,19,2
1,77,0.16304347826086957,0.525,70417011,92,15
0,54,0.01818181818181818,0.1322314049586777,70417074,55,1
0,48,0.1111111111111111,0.4397163120567376,70417102,54,6
0,96,0.07692307692307693,0.228310502283105,70417186,104,8
0,50,0.0196078431372549,0.10869565217391304,70417221,51,1
0,60,0.09090909090909091,0.23529411764705882,70746032,66,6
1,5,0.16666666666666666,0.7894736842105263,70746214,6,1
0,138,0.08,0.27472527472527475,70746263,150,12
0,72,0.06493506493506493,0.23444976076555024,73490060,77,5
1,11,0.26666666666666666,0.8767123287671232,79990064,15,4
0,547,0.05363321799307959,0.24835164835164836,69383503,578,31
0,448,0.03862660944206009,0.20863309352517986,69383510,466,18
0,77,0.0,0.0,82158891,77,0
0,76,0.0,0.0,82158892,76,0
2,88,0.5343915343915344,0.9795918367346939,64544361,189,101
0,140,0.10828025477707007,0.21011673151750973,70081123,157,17
1,142,0.36036036036036034,0.7530364372469636,73331055,222,80
0,98,0.057692307692307696,0.15384615384615385,73331370,104,6
0,412,0.28347826086956524,0.49836601307189543,66272136,575,163
1,347,0.23903508771929824,0.5927342256214149,63306404,456,109
0,389,0.08037825059101655,0.16252821670428894,63322014,423,34
2,6,0.7272727272727273,0.9333333333333333,75793704,22,16
1,197,0.4084084084084084,0.8776223776223776,73323166,333,136
1,274,0.261455525606469,0.5380875202593193,80135348,371,97
0,44,0.10204081632653061,0.11920529801324503,66887485,49,5
0,101,0.04716981132075472,0.08881578947368421,66892931,106,5
2,24,0.6307692307692307,0.72,70855253,65,41
2,10,0.5833333333333334,0.6666666666666666,70413532,24,14
1,187,0.2549800796812749,0.5865209471766849,70234794,251,64
1,52,0.35802469135802467,0.8365384615384616,66412024,81,29
2,66,0.6872037914691943,0.8983050847457628,70906423,211,145
0,10,0.16666666666666666,0.32608695652173914,69597164,12,2
1,243,0.41445783132530123,0.8405253283302064,65825242,415,172
0,456,0.20833333333333334,0.4692502106149958,80056935,576,120
1,62,0.27058823529411763,0.5277777777777778,70741510,85,23
1,306,0.20930232558139536,0.6003344481605352,61339593,387,81
1,368,0.36660929432013767,0.8354114713216958,67652823,581,213
0,447,0.14038461538461539,0.19765739385065886,66055094,520,73
1,285,0.2729591836734694,0.6191117092866757,80118666,392,107
1,758,0.366750208855472,0.7959022852639874,70713930,1197,439
0,408,0.07692307692307693,0.11134020618556702,70606935,442,34
0,102,0.08928571428571429,0.2608695652173913,70608006,112,10
1,285,0.2729591836734694,0.5872781065088757,73200022,392,107
0,1228,0.05683563748079877,0.10947930574098798,60027884,1302,74
1,423,0.19734345351043645,0.6237864077669902,61946206,527,104
0,164,0.08888888888888889,0.08366533864541832,64158920,180,16
1,105,0.4587628865979381,0.902127659574468,70831971,194,89
1,151,0.22564102564102564,0.5504322766570605,77676711,195,44
0,256,0.16065573770491803,0.21906354515050167,67159281,305,49
1,396,0.1732776617954071,0.5199138858988159,75283173,479,83
1,306,0.41935483870967744,0.8853118712273642,73524486,527,221
1,614,0.38783649052841473,0.8224899598393575,68211871,1003,389
0,42,0.10638297872340426,0.09090909090909091,58864995,47,5
0,107,0.10833333333333334,0.1213235294117647,58865030,120,13
1,82,0.26785714285714285,0.75,80133441,112,30
0,99,0.21428571428571427,0.4696485623003195,67160065,126,27
1,162,0.352,0.8389610389610389,68762561,250,88
2,73,0.5730994152046783,0.9731543624161074,69056785,171,98
0,153,0.19473684210526315,0.3716216216216216,68642476,190,37
1,434,0.2838283828382838,0.6409666283084005,67282061,606,172
1,107,0.28187919463087246,0.737037037037037,69421170,149,42
0,447,0.04893617021276596,0.02837573385518591,80070921,470,23
1,168,0.45980707395498394,0.953405017921147,72904160,311,143
1,355,0.38687392055267705,0.6994219653179191,72320934,579,224
1,56,0.3,0.6666666666666666,80176607,80,24
0,134,0.22988505747126436,0.397887323943662,80176615,174,40
1,27,0.4807692307692308,0.96875,66842321,52,25
1,112,0.3,0.7401315789473685,68536013,160,48
1,94,0.23577235772357724,0.6535433070866141,69416410,123,29
0,346,0.1761904761904762,0.37213740458015265,69551706,420,74
1,103,0.2589928057553957,0.6184738955823293,69421800,139,36
0,241,0.11070110701107011,0.14065510597302505,66412605,271,30
1,719,0.305984555984556,0.639135959339263,70851326,1036,317
1,333,0.4821150855365474,0.9553903345724907,63100541,643,310
1,153,0.47959183673469385,0.9490022172949002,68030522,294,141
1,81,0.4452054794520548,0.9282051282051282,82126715,146,65
1,673,0.23696145124716553,0.5794785534062237,68534186,882,209
1,330,0.396709323583181,0.884272997032641,67159393,547,217
0,140,0.16167664670658682,0.3771712158808933,69416256,167,27
0,60,0.24050632911392406,0.4549763033175355,70207823,79,19
0,749,0.21240799158780233,0.4677754677754678,65004534,951,202
0,851,0.17378640776699028,0.2956645344705046,68536664,1030,179
1,549,0.32967032967032966,0.7408793264733395,67148984,819,270
1,221,0.4075067024128686,0.8519924098671727,69637015,373,152
0,339,0.2662337662337662,0.4900523560209424,70631211,462,123
0,337,0.23234624145785876,0.453646477132262,66991946,439,102
0,419,0.2340036563071298,0.49547511312217196,80121233,547,128
0,160,0.06432748538011696,0.2511737089201878,788186,171,11
0,321,0.18527918781725888,0.3298097251585624,67140185,394,73
0,268,0.053003533568904596,0.19642857142857142,68798114,283,15
0,564,0.16071428571428573,0.25082236842105265,67555551,672,108
0,101,0.17886178861788618,0.28703703703703703,70871115,123,22
0,313,0.18701298701298702,0.3673708920187793,62687226,385,72
1,74,0.28846153846153844,0.5642458100558659,68210744,104,30
1,406,0.367601246105919,0.845100105374078,68210751,642,236
1,464,0.43757575757575756,0.9438339438339438,80125365,825,361
0,79,0.19387755102040816,0.47058823529411764,69416284,98,19
1,109,0.23776223776223776,0.546583850931677,69417383,143,34
0,287,0.07717041800643087,0.06718346253229975,77182196,311,24
0,408,0.04895104895104895,0.0728862973760933,80124248,429,21
0,72,0.24210526315789474,0.46153846153846156,68283145,95,23
1,23,0.34285714285714286,0.75,70603575,35,12
1,19,0.2692307692307692,0.7,70674044,26,7
1,850,0.26534140017286084,0.5083682008368201,80153470,1157,307
2,7,0.5,0.8235294117647058,80165176,14,7
0,53,0.08620689655172414,0.10638297872340426,70686581,58,5
1,43,0.47560975609756095,0.8118811881188119,68475575,82,39
1,363,0.22929936305732485,0.5527704485488126,66931522,471,108
2,300,0.5827538247566064,0.9272727272727272,273952,719,419
2,288,0.625,0.9696132596685083,889973,768,480
1,75,0.3181818181818182,0.5063291139240507,62624142,110,35
0,4,0.0,0.0,69170906,4,0
1,883,0.32285276073619634,0.7249657064471879,80128631,1304,421
2,53,0.6074074074074074,0.896551724137931,68154856,135,82
1,344,0.27578947368421053,0.6019047619047619,69731396,475,131
0,576,0.1783166904422254,0.37254901960784315,70615496,701,125
0,524,0.10884353741496598,0.19788359788359788,70617316,588,64
0,781,0.1574973031283711,0.2766476810414972,80125291,927,146
2,359,0.5200534759358288,0.968671679197995,80127705,748,389
0,37,0.17777777777777778,0.28,67742500,45,8
1,147,0.3975409836065574,0.8327137546468402,80120423,244,97
0,100,0.09090909090909091,0.2590909090909091,70746123,110,10
1,311,0.41320754716981134,0.858195211786372,72077845,530,219
0,266,0.2222222222222222,0.4782608695652174,80079902,342,76
1,166,0.37358490566037733,0.782991202346041,69636952,265,99
1,109,0.31446540880503143,0.677115987460815,69386933,159,50
1,147,0.3,0.5932203389830508,80066336,210,63
1,113,0.37222222222222223,0.8787878787878788,82126645,180,67
1,286,0.29207920792079206,0.5952380952380952,74361175,404,118
1,476,0.21839080459770116,0.5061867266591676,68530882,609,133
0,415,0.22429906542056074,0.44779582366589327,80159583,535,120
0,108,0.22302158273381295,0.44280442804428044,81966305,139,31
1,43,0.39436619718309857,0.9375,69183310,71,28
0,224,0.18840579710144928,0.375,69723920,276,52
0,185,0.11904761904761904,0.19801980198019803,80141497,210,25
2,22,0.7684210526315789,0.9393939393939394,70506114,95,73
0,375,0.23155737704918034,0.49698795180722893,69242614,488,113
0,187,0.19742489270386265,0.3860045146726862,70628502,233,46
0,12,0.14285714285714285,0.46153846153846156,69198682,14,2
2,114,0.5148936170212766,0.9234449760765551,70860993,235,121
0,299,0.03858520900321544,0.12138084632516703,62834933,311,12
0,183,0.13679245283018868,0.2688888888888889,70633654,212,29
0,802,0.21449559255631734,0.4152352501867065,72293886,1021,219
2,5,0.5,0.9333333333333333,80117891,10,5
1,142,0.4008438818565401,0.8163265306122449,66389610,237,95
1,193,0.46089385474860334,0.9149377593360996,63992866,358,165
1,23,0.28125,0.7011494252873564,70638575,32,9
2,102,0.5426008968609866,0.9577464788732394,68040063,223,121
1,97,0.302158273381295,0.5,66272073,139,42
0,79,0.29464285714285715,0.4906832298136646,66272115,112,33
0,356,0.22608695652173913,0.4806201550387597,80121229,460,104
1,231,0.28703703703703703,0.6865942028985508,80121230,324,93
0,112,0.23809523809523808,0.39634146341463417,68040175,147,35
0,4,0.0,0.0,62158810,4,0
2,93,0.6463878326996197,0.9694323144104804,63386323,263,170
1,50,0.39759036144578314,0.7786885245901639,65596902,83,33
1,449,0.3416422287390029,0.7210796915167095,68345193,682,233
0,289,0.08832807570977919,0.18055555555555555,67226082,317,28
1,153,0.4778156996587031,0.9238754325259516,69388410,293,140
1,117,0.3352272727272727,0.6408839779005525,67552373,176,59
1,27,0.2702702702702703,0.5616438356164384,70632331,37,10
1,453,0.47325581395348837,0.958139534883721,69072885,860,407
1,114,0.3090909090909091,0.6,65007355,165,51
1,99,0.49230769230769234,0.933649289099526,72077712,195,96
2,87,0.5606060606060606,0.9625,70686826,198,111
0,146,0.1751412429378531,0.38953488372093026,69800101,177,31
0,324,0.22673031026252982,0.4409171075837742,70800394,419,95
1,71,0.3238095238095238,0.7518248175182481,68779410,105,34
1,190,0.2962962962962963,0.6984615384615385,67173302,270,80
1,55,0.19117647058823528,0.7107843137254902,69007001,68,13
0,50,0.16666666666666666,0.3709677419354839,61439672,60,10
1,8,0.2727272727272727,0.7692307692307693,68642140,11,3
1,4,0.3333333333333333,0.6666666666666666,70801682,6,2
1,33,0.25,0.6779661016949152,69478801,44,11
1,4,0.3333333333333333,0.5714285714285714,80150982,6,2
2,146,0.5521472392638037,0.9537815126050421,80062262,326,180
2,0,1.0,1.0,70591444,89,89
1,22,0.3333333333333333,0.7872340425531915,81971185,33,11
1,24,0.4,0.8413793103448276,70063175,40,16
0,549,0.1271860095389507,0.13839285714285715,66471454,629,80
0,215,0.14342629482071714,0.42203742203742206,70641732,251,36
1,92,0.25806451612903225,0.6213991769547325,80132301,124,32
2,3,0.7,0.75,65565731,10,7
0,12,0.0,0.0,69958994,12,0
1,104,0.22388059701492538,0.5315315315315315,80141450,134,30
2,16,0.5151515151515151,0.8888888888888888,72425605,33,17
0,155,0.2131979695431472,0.3034825870646766,72426375,197,42
2,146,0.5,0.952191235059761,72271024,292,146
1,80,0.24528301886792453,0.6162790697674418,80141454,106,26
1,15,0.34782608695652173,0.5,8011871,23,8
1,26,0.21212121212121213,0.5512820512820513,70046606,33,7
1,360,0.26078028747433263,0.6495278069254984,80056956,487,127
0,459,0.1,0.12763819095477386,54609884,510,51
1,401,0.46816976127320953,0.9178433889602053,82021096,754,353
0,245,0.20967741935483872,0.47438330170777987,67833773,310,65
1,449,0.41460234680573665,0.8848920863309353,80159817,767,318
1,90,0.3793103448275862,0.7388535031847133,76294911,145,55
1,196,0.4024390243902439,0.8063241106719368,70202503,328,132
1,51,0.46875,0.9647058823529412,66493231,96,45
1,142,0.2755102040816326,0.5547169811320755,67627385,196,54
1,314,0.3630831643002028,0.8580060422960725,68532562,493,179
1,90,0.29133858267716534,0.65625,69183681,127,37
1,128,0.292817679558011,0.794425087108014,67226054,181,53
0,264,0.07042253521126761,0.0828125,82044808,284,20
1,309,0.4191729323308271,0.9179190751445087,72658544,532,223
1,423,0.24866785079928952,0.6092619392185239,62657931,563,140
1,37,0.3148148148148148,0.611764705882353,68394116,54,17
1,109,0.37714285714285717,0.8085106382978723,70626234,175,66
1,173,0.2880658436213992,0.5691823899371069,82023770,243,70
0,405,0.13646055437100213,0.15995762711864406,82128634,469,64
0,351,0.07631578947368421,0.0668693009118541,82128637,380,29
0,319,0.1284153005464481,0.16578947368421051,82128642,366,47
0,212,0.12033195020746888,0.2130637636080871,72522723,241,29
1,159,0.3375,0.8095238095238095,78921423,240,81
0,206,0.04186046511627907,0.04177545691906005,73905965,215,9
1,160,0.24528301886792453,0.5517241379310345,72706144,212,52
0,340,0.2237442922374429,0.4574468085106383,80103170,438,98
1,95,0.3402777777777778,0.8535031847133758,82011765,144,49
0,3,0.0,0.0,69596786,3,0
1,254,0.48582995951417,0.939443535188216,80127462,494,240
1,639,0.36227544910179643,0.8279678068410463,69586251,1002,363
1,82,0.3543307086614173,0.8780487804878049,68408333,127,45
2,30,0.7580645161290323,0.9761904761904762,80126928,124,94
1,113,0.43781094527363185,0.9292035398230089,66257436,201,88
0,651,0.17490494296577946,0.3333333333333333,68625746,789,138
1,15,0.2857142857142857,0.72,73400572,21,6
0,76,0.06172839506172839,0.225130890052356,80124246,81,5
0,321,0.012307692307692308,0.02729044834307992,80124349,325,4
0,320,0.047619047619047616,0.09845559845559845,80124435,336,16
0,34,0.17073170731707318,0.3541666666666667,70063091,41,7
0,109,0.128,0.20085470085470086,70814380,125,16
1,234,0.4164588528678304,0.9260628465804066,80119029,401,167
0,674,0.07671232876712329,0.08228730822873083,82000019,730,56
1,173,0.3346153846153846,0.6588628762541806,62400282,260,87
1,281,0.2546419098143236,0.5012406947890818,82013000,377,96
0,138,0.1038961038961039,0.15457413249211358,63141890,154,16
1,373,0.2895238095238095,0.6245733788395904,66028872,525,152
1,107,0.3096774193548387,0.7100371747211895,64166613,155,48
1,63,0.4375,0.7857142857142857,80125419,112,49
0,4,0.0,0.0,69622511,4,0
0,735,0.18694690265486727,0.34837688044338877,68543461,904,169
1,120,0.4174757281553398,0.9424460431654677,70641816,206,86
1,528,0.26359832635983266,0.6049723756906077,80139718,717,189
0,61,0.22784810126582278,0.31851851851851853,70711270,79,18
1,325,0.27455357142857145,0.6286644951140065,80125372,448,123
1,192,0.37254901960784315,0.7619047619047619,69463282,306,114
1,467,0.2455573505654281,0.5578947368421052,66931942,619,152
0,317,0.20151133501259447,0.40514469453376206,70073234,397,80
0,285,0.1903409090909091,0.37425742574257426,66930542,352,67
2,9,0.7352941176470589,0.9444444444444444,67993751,34,25
1,437,0.4165554072096128,0.7537154989384289,72433452,749,312
2,20,0.5,0.9069767441860465,64697514,40,20
1,100,0.2805755395683453,0.7103174603174603,70073262,139,39
0,723,0.11397058823529412,0.10718954248366012,67964183,816,93
2,55,0.5416666666666666,0.9117647058823529,77770182,120,65
1,518,0.24599708879184862,0.5176470588235295,80180148,687,169
0,482,0.2188006482982172,0.3605313092979127,70631246,617,135
2,3,0.6666666666666666,0.9166666666666666,80145811,9,6
1,53,0.3764705882352941,0.856,70654451,85,32
0,281,0.11912225705329153,0.3374233128834356,72773211,319,38
1,145,0.46886446886446886,0.9456521739130435,66381980,273,128
1,163,0.4340277777777778,0.9335260115606936,66382001,288,125
0,117,0.22,0.45357142857142857,70209783,150,33
1,379,0.37458745874587457,0.8369987063389392,62769644,606,227
1,250,0.2236024844720497,0.5280728376327769,80109512,322,72
0,133,0.09523809523809523,0.1794871794871795,67285610,147,14
0,239,0.06274509803921569,0.3403205918618989,62837355,255,16
0,1090,0.06598114824335904,0.04354032833690221,70645043,1167,77
1,126,0.3076923076923077,0.6455696202531646,66384654,182,56
1,207,0.4068767908309456,0.861198738170347,68036360,349,142
0,90,0.14285714285714285,0.2441860465116279,70121695,105,15
1,341,0.33268101761252444,0.8302139037433155,80121088,511,170
1,41,0.2807017543859649,0.625,80118616,57,16
1,97,0.3618421052631579,0.7560975609756098,80027955,152,55
2,3,0.7,0.5714285714285714,67427304,10,7
1,34,0.423728813559322,0.7752808988764045,73975006,59,25
1,138,0.26595744680851063,0.6222222222222222,67017475,188,50
0,87,0.13,0.14689265536723164,68283222,100,13
0,63,0.23170731707317074,0.4883720930232558,80125053,82,19
0,25,0.0,0.0,80125054,25,0
0,40,0.024390243902439025,0.05405405405405406,82001876,41,1
0,217,0.24125874125874125,0.48130841121495327,80125039,286,69
2,3,0.5,0.75,73443895,6,3
0,252,0.03076923076923077,0.08837209302325581,80049361,260,8
0,246,0.008064516129032258,0.02843601895734597,80049403,248,2
0,59,0.09230769230769231,0.34328358208955223,80049522,65,6
0,339,0.08130081300813008,0.20551724137931035,70660394,369,30
0,89,0.16822429906542055,0.42424242424242425,72773260,107,18
0,72,0.05263157894736842,0.22598870056497175,80126900,76,4
0,64,0.07246376811594203,0.33766233766233766,80176555,69,5
1,102,0.42045454545454547,0.8047808764940239,82010240,176,74
1,30,0.4827586206896552,0.9464285714285714,72803185,58,28
0,297,0.04501607717041801,0.07453416149068323,80124269,311,14
1,302,0.3333333333333333,0.6953125,70658315,453,151
0,274,0.14375,0.2345505617977528,70870611,320,46
0,587,0.10107197549770292,0.2634297520661157,66344292,653,66
0,664,0.12401055408970976,0.3557504873294347,68318215,758,94
0,155,0.0718562874251497,0.03151862464183381,66412563,167,12
1,596,0.28365384615384615,0.6921754084264833,80125359,832,236
1,149,0.32272727272727275,0.8293515358361775,68541536,220,71
1,60,0.27710843373493976,0.624113475177305,69184290,83,23
1,133,0.31088082901554404,0.6584507042253521,80136834,193,60
1,34,0.2608695652173913,0.5287356321839081,65931033,46,12
0,562,0.2395128552097429,0.45004344048653344,70628915,739,177
0,1130,0.1654357459379616,0.27230046948356806,69240066,1354,224
1,104,0.2925170068027211,0.6101083032490975,82128651,147,43
0,329,0.2091346153846154,0.4468371467025572,67246312,416,87
0,49,0.2222222222222222,0.3559322033898305,65930963,63,14
1,480,0.29411764705882354,0.7217194570135747,68542600,680,200
0,99,0.13157894736842105,0.2206896551724138,80133443,114,15
0,65,0.09722222222222222,0.28368794326241137,69106912,72,7
1,320,0.375,0.9123434704830053,70643125,512,192
0,110,0.08333333333333333,0.10344827586206896,73113621,120,10
0,279,0.07,0.050955414012738856,73113635,300,21
1,35,0.375,0.8095238095238095,80181341,56,21
2,354,0.5170532060027285,0.9554234769687965,69169961,733,379
0,25,0.038461538461538464,0.023255813953488372,82143809,26,1
0,17,0.22727272727272727,0.38095238095238093,69611304,22,5
1,257,0.4314159292035398,0.9074074074074074,65840026,452,195
2,20,0.6296296296296297,0.9583333333333334,74363310,54,34
2,44,0.5887850467289719,0.9264705882352942,82045531,107,63
0,204,0.1774193548387097,0.2857142857142857,80174686,248,44
0,290,0.12121212121212122,0.21462264150943397,80176756,330,40
1,697,0.4337936636880585,0.8609756097560975,80019681,1231,534
2,106,0.7323232323232324,0.9818181818181818,80019961,396,290
0,199,0.17083333333333334,0.2430939226519337,80178941,240,41
1,67,0.3020833333333333,0.5637583892617449,67994206,96,29
1,347,0.2710084033613445,0.6115906288532675,76043436,476,129
1,101,0.4388888888888889,0.9402173913043478,80110233,180,79
0,747,0.12937062937062938,0.13105229180116204,67963504,858,111
1,51,0.32,0.7687074829931972,82126809,75,24
1,75,0.4140625,0.7924528301886793,69985972,128,53
1,425,0.3441358024691358,0.8267716535433071,70643356,648,223
1,461,0.29402756508422667,0.6796714579055442,69180594,653,192
1,243,0.4268867924528302,0.8698517298187809,80132807,424,181
0,97,0.13392857142857142,0.24152542372881355,72900485,112,15
0,645,0.16774193548387098,0.30632411067193677,74792375,775,130
0,561,0.19164265129682997,0.4268867924528302,80097206,694,133
1,259,0.4406047516198704,0.9092382495948136,65825074,463,204
1,21,0.4,0.8115942028985508,80141353,35,14
0,47,0.11320754716981132,0.225,80135334,53,6
0,155,0.16666666666666666,0.305019305019305,80135338,186,31
1,194,0.3618421052631579,0.8485714285714285,62795201,304,110
0,1067,0.115990057995029,0.12875867386276021,70645134,1207,140
0,156,0.13812154696132597,0.27605633802816903,69417362,181,25
1,165,0.4230769230769231,0.8266129032258065,80136904,286,121
1,145,0.46691176470588236,0.9381443298969072,69621811,272,127
1,245,0.37017994858611825,0.8396039603960396,70874160,389,144
1,373,0.33273703041144903,0.6895522388059702,72270926,559,186
0,136,0.16049382716049382,0.23275862068965517,67553080,162,26
0,198,0.13537117903930132,0.15878378378378377,68600756,229,31
0,260,0.20489296636085627,0.3469055374592834,71444576,327,67
1,108,0.3032258064516129,0.532051282051282,80126985,155,47
2,37,0.6967213114754098,0.9885057471264368,68628770,122,85
0,352,0.1963470319634703,0.44015444015444016,70642691,438,86
1,238,0.31805157593123207,0.7544426494345718,74555495,349,111
0,177,0.1407766990291262,0.2711267605633803,62940465,206,29
2,6,0.5714285714285714,0.8125,74362085,14,8
1,33,0.43103448275862066,0.875,69021344,58,25
0,182,0.1651376146788991,0.3900862068965517,70209741,218,36
1,18,0.3793103448275862,0.7906976744186046,70768103,29,11
2,2,0.7777777777777778,0.8,79792755,9,7
1,44,0.30158730158730157,0.6075949367088608,68532611,63,19
1,173,0.33969465648854963,0.7262357414448669,73390443,262,89
1,36,0.47058823529411764,0.9523809523809523,68532625,68,32
1,473,0.34214186369958277,0.8111888111888111,69607013,719,246
1,215,0.3909348441926346,0.7573696145124716,69531161,353,138
1,18,0.4857142857142857,0.9464285714285714,82010273,35,17
0,282,0.06312292358803986,0.07925407925407925,80123615,301,19
1,36,0.3076923076923077,0.7254901960784313,68475540,52,16
0,483,0.13129496402877697,0.4368932038834951,68241376,556,73
0,1,0.0,0.0,68519794,1,0
0,7,0.125,0.29411764705882354,72808624,8,1
1,148,0.3018867924528302,0.7342465753424657,70048083,212,64
2,52,0.5,0.9533678756476683,79792202,104,52
1,36,0.4375,0.8070175438596491,80176678,64,28
0,336,0.25333333333333335,0.4812680115273775,67749003,450,114
0,197,0.15086206896551724,0.15384615384615385,70645785,232,35
0,238,0.2347266881028939,0.48739495798319327,70646002,311,73
1,34,0.30612244897959184,0.6909090909090909,72549253,49,15
1,96,0.2558139534883721,0.6049382716049383,80154006,129,33
1,39,0.22,0.6230769230769231,73650451,50,11
1,212,0.24555160142348753,0.6028708133971292,68533836,281,69
0,61,0.11594202898550725,0.15625,69621832,69,8
0,2,0.0,0.0,69640235,2,0
0,3,0.0,0.0,69640291,3,0
0,2,0.0,0.0,69640375,2,0
0,2,0.0,0.0,69640452,2,0
0,4,0.0,0.0,69640522,4,0
1,38,0.42424242424242425,0.8,69666884,66,28
1,62,0.37373737373737376,0.5394736842105263,80178938,99,37
0,548,0.028368794326241134,0.017838405036726127,70001722,564,16
1,112,0.2727272727272727,0.6704980842911877,70207662,154,42
1,74,0.4263565891472868,0.8771929824561403,79960055,129,55
0,256,0.1873015873015873,0.4288,80071005,315,59
1,149,0.39919354838709675,0.7833827893175074,72321970,248,99
0,626,0.17195767195767195,0.24746621621621623,67555866,756,130
0,533,0.15262321144674085,0.2249718785151856,80125484,629,96
0,301,0.19733333333333333,0.3857566765578635,68535880,375,74
0,248,0.18421052631578946,0.32684824902723736,80118415,304,56
1,79,0.2818181818181818,0.6785714285714286,66931095,110,31
0,43,0.044444444444444446,0.006756756756756757,67226145,45,2
1,105,0.33121019108280253,0.7738693467336684,69388165,157,52
1,30,0.45454545454545453,0.9855072463768116,69055742,55,25
0,164,0.08379888268156424,0.421792618629174,62834716,179,15
0,217,0.19029850746268656,0.30238726790450926,69873853,268,51
0,135,0.23728813559322035,0.42735042735042733,69873965,177,42
0,288,0.04318936877076412,0.09202453987730061,70001302,301,13
2,58,0.6158940397350994,0.9795918367346939,70245434,151,93
1,732,0.25534079348931843,0.5406471981057617,80125351,983,251
1,349,0.3314176245210728,0.8143939393939394,80135439,522,173
1,20,0.3103448275862069,0.6875,65236535,29,9
0,38,0.13636363636363635,0.203125,69464990,44,6
1,24,0.29411764705882354,0.8588235294117647,73650360,34,10
0,90,0.1,0.1111111111111111,68399870,100,10
2,65,0.6130952380952381,0.981651376146789,67402482,168,103
1,123,0.3910891089108911,0.8567639257294429,82119994,202,79
1,310,0.27906976744186046,0.75,70626976,430,120
0,131,0.09027777777777778,0.18456375838926176,70633451,144,13
0,62,0.08823529411764706,0.20967741935483872,80135088,68,6
1,236,0.30177514792899407,0.615625,73588823,338,102
1,544,0.29987129987129985,0.6890756302521008,80110303,777,233
0,172,0.1568627450980392,0.24324324324324326,80114692,204,32
0,960,0.08571428571428572,0.13868986693961105,80140158,1050,90
1,164,0.2511415525114155,0.5849889624724062,70545916,219,55
1,81,0.38636363636363635,0.885,66856510,132,51
0,70,0.18604651162790697,0.4694835680751174,69417110,86,16
1,314,0.4290909090909091,0.8769898697539797,73974985,550,236
1,62,0.28735632183908044,0.6823529411764706,82126749,87,25
1,78,0.46938775510204084,0.9291338582677166,70919282,147,69
0,215,0.17307692307692307,0.3869047619047619,73700543,260,45
0,270,0.19881305637982197,0.33488372093023255,68283152,337,67
2,91,0.5991189427312775,0.7627118644067796,65931796,227,136
2,78,0.5491329479768786,0.9621621621621622,73501400,173,95
0,368,0.1598173515981735,0.296,80125019,438,70
0,373,0.05569620253164557,0.06569343065693431,80125020,395,22
0,379,0.03316326530612245,0.018315018315018316,80125021,392,13
1,406,0.188,0.5012345679012346,80125023,500,94
0,93,0.06060606060606061,0.08487084870848709,80119310,99,6
0,60,0.047619047619047616,0.025,80119337,63,3
1,52,0.46938775510204084,0.9111111111111111,69285776,98,46
0,317,0.21144278606965175,0.4677871148459384,64929494,402,85
1,37,0.3392857142857143,0.7558139534883721,60020366,56,19
1,214,0.2983606557377049,0.721868365180467,68775315,305,91
1,79,0.2882882882882883,0.5966850828729282,80176675,111,32
1,381,0.2673076923076923,0.6722454672245467,67833815,520,139
1,482,0.33055555555555555,0.8171557562076749,80125376,720,238
1,184,0.167420814479638,0.5474613686534217,80135077,221,37
1,404,0.18548387096774194,0.5254054054054054,72866682,496,92
1,459,0.45808736717827625,0.887012987012987,70202181,847,388
0,40,0.14893617021276595,0.25806451612903225,69642965,47,7
1,98,0.17647058823529413,0.5708154506437768,69084456,119,21
0,161,0.030120481927710843,0.2707993474714519,64501990,166,5
1,59,0.42718446601941745,0.9642857142857143,66493315,103,44
0,586,0.16879432624113475,0.3003003003003003,81979732,705,119
1,201,0.22988505747126436,0.7642276422764228,68036290,261,60
2,195,0.582441113490364,0.9065155807365439,80137987,467,272
0,861,0.016,0.018280632411067192,68254641,875,14
1,107,0.43386243386243384,0.9146341463414634,80166905,189,82
0,203,0.14345991561181434,0.4911504424778761,70907984,237,34
1,179,0.19730941704035873,0.5688775510204082,64001182,223,44
2,48,0.6821192052980133,0.9844961240310077,80130692,151,103
0,52,0.2,0.2740740740740741,70910980,65,13
1,130,0.43722943722943725,0.9492753623188406,65268273,231,101
0,41,0.06818181818181818,0.37,82116587,44,3
1,286,0.2011173184357542,0.5442073170731707,68036325,358,72
0,578,0.08253968253968254,0.07298657718120806,80118143,630,52
2,43,0.6293103448275862,0.9506172839506173,77319256,116,73
0,78,0.12359550561797752,0.22897196261682243,70527450,89,11
0,76,0.15555555555555556,0.49583333333333335,82150129,90,14
1,423,0.37518463810930575,0.9277266754270697,67049290,677,254
0,84,0.22935779816513763,0.45108695652173914,80046141,109,25
1,107,0.3227848101265823,0.7449664429530202,65388414,158,51
0,19,0.09523809523809523,0.2736842105263158,70675654,21,2
0,15,0.0,0.0,70683284,15,0
0,23,0.08,0.29411764705882354,80126821,25,2
0,383,0.05665024630541872,0.11691884456671252,67792522,406,23
1,207,0.23616236162361623,0.6824324324324325,68413212,271,64
0,65,0.04411764705882353,0.26006191950464397,62840806,68,3
0,266,0.16352201257861634,0.3251088534107402,68621693,318,52
1,531,0.3337515683814304,0.7631336405529954,69195406,797,266
0,189,0.18181818181818182,0.29398148148148145,70645631,231,42
1,116,0.27044025157232704,0.5114503816793893,72749222,159,43
0,128,0.16883116883116883,0.2591240875912409,68299784,154,26
0,35,0.10256410256410256,0.1651376146788991,69100843,39,4
1,398,0.3692551505546751,0.8517940717628705,61400920,631,233
0,136,0.087248322147651,0.08059701492537313,80098592,149,13
2,12,0.7272727272727273,0.9545454545454546,956145,44,32
1,166,0.3224489795918367,0.7347328244274809,81971147,245,79
2,17,0.5277777777777778,0.9636363636363636,66354085,36,19
0,201,0.1483050847457627,0.1889400921658986,70645694,236,35
0,182,0.10344827586206896,0.286697247706422,80155848,203,21
0,44,0.043478260869565216,0.19791666666666666,82134954,46,2
1,197,0.18930041152263374,0.5752032520325203,67049486,243,46
0,734,0.06496815286624204,0.23809523809523808,62839070,785,51
0,126,0.10638297872340426,0.38513513513513514,64359995,141,15
0,300,0.21052631578947367,0.3645224171539961,67141270,380,80
1,85,0.4097222222222222,0.7682119205298014,69458445,144,59
1,31,0.20512820512820512,0.5544554455445545,65714026,39,8
1,116,0.14074074074074075,0.5038759689922481,70467341,135,19
0,26,0.10344827586206896,0.4713375796178344,70467523,29,3
0,94,0.06930693069306931,0.29141104294478526,70467866,101,7
0,110,0.17293233082706766,0.46502057613168724,80150026,133,23
1,113,0.4433497536945813,0.9214876033057852,66493210,203,90
1,125,0.4212962962962963,0.8152610441767069,73871000,216,91
0,125,0.07407407407407407,0.05309734513274336,70179242,135,10
1,528,0.30066225165562915,0.741337630942788,66387671,755,227
0,143,0.1437125748502994,0.45481049562682213,70468440,167,24
2,10,0.5238095238095238,0.8260869565217391,68113213,21,11
0,144,0.1,0.209366391184573,80155840,160,16
0,213,0.018433179723502304,0.04,82049089,217,4
0,475,0.036511156186612576,0.21555915721231766,80149993,493,18
0,65,0.0,0.0,62840225,65,0
0,122,0.10294117647058823,0.2163265306122449,69704614,136,14
0,21,0.125,0.4268292682926829,82134966,24,3
1,78,0.28440366972477066,0.6935483870967742,82128648,109,31
0,122,0.14685314685314685,0.26685393258426965,68621700,143,21
1,597,0.2490566037735849,0.5861297539149888,68535096,795,198
0,451,0.1601489757914339,0.2682926829268293,80137327,537,86
0,96,0.08571428571428572,0.05555555555555555,73650871,105,9
0,399,0.177319587628866,0.21189591078066913,67552471,485,86
0,230,0.24092409240924093,0.4656160458452722,70631365,303,73
0,131,0.12666666666666668,0.16203703703703703,80118978,150,19
1,103,0.32679738562091504,0.6111111111111112,80127345,153,50
1,199,0.4094955489614243,0.9258589511754068,70687981,337,138
1,54,0.3333333333333333,0.7409638554216867,65675463,81,27
1,123,0.2634730538922156,0.6058394160583942,80158198,167,44
0,114,0.17985611510791366,0.16049382716049382,69606866,139,25
0,246,0.08208955223880597,0.3316892725030826,69204702,268,22
0,85,0.06593406593406594,0.44072164948453607,74606994,91,6
1,174,0.18309859154929578,0.5048309178743962,67924661,213,39
0,277,0.2175141242937853,0.3589001447178003,71358966,354,77
1,428,0.3074433656957929,0.7277486910994765,69155023,618,190
0,166,0.14871794871794872,0.3613595706618962,80122456,195,29
1,141,0.265625,0.6438356164383562,70045325,192,51
0,169,0.23873873873873874,0.4370179948586118,82126679,222,53
1,136,0.28421052631578947,0.5576923076923077,80136837,190,54
2,3,0.5,0.85,69388613,6,3
0,59,0.09230769230769231,0.2185430463576159,82103873,65,6
0,128,0.16883116883116883,0.46384039900249374,67118534,154,26
0,45,0.1346153846153846,0.45408163265306123,70468405,52,7
1,77,0.20618556701030927,0.7019607843137254,72868166,97,20
1,141,0.2033898305084746,0.5978835978835979,69704593,177,36
2,2,0.6666666666666666,0.8,80145882,6,4
1,33,0.49230769230769234,0.9605263157894737,70612633,65,32
1,68,0.48872180451127817,0.8888888888888888,70842303,133,65
1,15,0.2857142857142857,0.7586206896551724,82055994,21,6
2,127,0.5152671755725191,0.95,72390794,262,135
2,4,0.75,0.875,82039112,16,12
1,100,0.17355371900826447,0.5948717948717949,80155857,121,21
0,25,0.07407407407407407,0.36470588235294116,82206069,27,2
1,46,0.20689655172413793,0.7033898305084746,70121121,58,12
0,453,0.19107142857142856,0.3422680412371134,63967974,560,107
0,269,0.15141955835962145,0.2460431654676259,63967981,317,48
1,37,0.26,0.6666666666666666,77676473,50,13
2,7,0.5333333333333333,0.9642857142857143,67551323,15,8
0,118,0.06349206349206349,0.3,80149954,126,8
1,83,0.13541666666666666,0.5495867768595041,80149975,96,13
1,266,0.39819004524886875,0.9051321928460342,70613536,442,176
0,29,0.2564102564102564,0.4461538461538462,80163516,39,10
1,7,0.36363636363636365,0.5714285714285714,80163517,11,4
1,42,0.2222222222222222,0.6201550387596899,69510406,54,12
0,149,0.1534090909090909,0.4697802197802198,82103875,176,27
1,265,0.37203791469194314,0.8670411985018727,68467854,422,157
1,137,0.33170731707317075,0.7993630573248408,69056421,205,68
0,609,0.19444444444444445,0.383248730964467,63277704,756,147
1,537,0.22622478386167147,0.5155412647374062,63264551,694,157
0,191,0.1906779661016949,0.37402597402597404,63264572,236,45
0,112,0.042735042735042736,0.12014134275618374,78762873,117,5
0,93,0.010638297872340425,0.018957345971563982,78762915,94,1
0,242,0.14788732394366197,0.35234215885947046,70908971,284,42
0,513,0.23432835820895523,0.4718826405867971,80158197,670,157
0,80,0.13043478260869565,0.43157894736842106,65713172,92,12
0,712,0.13487241798298907,0.18189509306260576,68542796,823,111
1,7,0.36363636363636365,0.8636363636363636,68635525,11,4
1,58,0.3176470588235294,0.7540983606557377,72749236,85,27
1,234,0.23778501628664495,0.734375,80118430,307,73
1,94,0.24193548387096775,0.5294117647058824,82126626,124,30
1,5,0.2857142857142857,0.9310344827586207,68942041,7,2
0,82,0.0,0.0,69857774,82,0
2,3,0.5,0.8888888888888888,70908593,6,3
0,396,0.09382151029748284,0.11675675675675676,80114370,437,41
0,495,0.08839779005524862,0.12242798353909465,80118148,543,48
0,160,0.1919191919191919,0.3770491803278688,64173774,198,38
1,199,0.19433198380566802,0.6264236902050114,66925425,247,48
2,26,0.6231884057971014,0.96,68250196,69,43
0,360,0.14893617021276595,0.1791530944625407,68613965,423,63
2,156,0.5642458100558659,0.6341463414634146,68618354,358,202
0,355,0.10579345088161209,0.4415841584158416,70250880,397,42
1,35,0.2857142857142857,0.6774193548387096,70421995,49,14
0,480,0.15641476274165203,0.2614807872539831,70642201,569,89
0,123,0.0390625,0.12350597609561753,62834324,128,5
0,1007,0.04368471035137702,0.12539349422875132,62835563,1053,46
1,102,0.25547445255474455,0.5656565656565656,65018254,137,35
1,130,0.2655367231638418,0.569620253164557,66384633,177,47
0,679,0.15965346534653466,0.2853185595567867,68537091,808,129
0,186,0.24390243902439024,0.4412470023980815,80107314,246,60
1,265,0.35049019607843135,0.7513812154696132,67203773,408,143
1,315,0.36363636363636365,0.709480122324159,70209440,495,180
0,103,0.06363636363636363,0.1,80119334,110,7
2,66,0.5510204081632653,0.967741935483871,70925764,147,81
0,302,0.0473186119873817,0.20489977728285078,62834793,317,15
1,127,0.43555555555555553,0.9515151515151515,69176954,225,98
0,201,0.03827751196172249,0.14368650217706821,62838832,209,8
0,365,0.08521303258145363,0.3658051689860835,62835626,399,34
0,160,0.06432748538011696,0.35547576301615796,62834513,171,11
1,503,0.24474474474474475,0.6258596973865199,70240744,666,163
1,39,0.44285714285714284,0.9313725490196079,67513040,70,31
1,154,0.27014218009478674,0.6086956521739131,66892560,211,57
2,107,0.5753968253968254,0.9573170731707317,68040483,252,145
1,24,0.3684210526315789,0.7792207792207793,72512685,38,14
1,12,0.4,0.68,82119995,20,8
0,346,0.18779342723004694,0.4304291287386216,69239982,426,80
1,59,0.42718446601941745,0.9023255813953488,80067470,103,44
1,48,0.3424657534246575,0.7477064220183486,70197806,73,25
0,17,0.15,0.24561403508771928,70685251,20,3
1,279,0.32116788321167883,0.7451235370611183,81971152,411,132
1,216,0.2987012987012987,0.6313993174061433,82013628,308,92
1,66,0.44537815126050423,0.9558011049723757,64225861,119,53
0,151,0.050314465408805034,0.10443864229765012,70681331,159,8
1,7,0.2222222222222222,0.6764705882352942,70700252,9,2
0,17,0.15,0.22916666666666666,70222341,20,3
0,342,0.08064516129032258,0.1227154046997389,71762271,372,30
0,55,0.08333333333333333,0.0851063829787234,71762593,60,5
2,24,0.6307692307692307,0.9841269841269841,69045676,65,41
1,271,0.3139240506329114,0.757527733755943,80108742,395,124
1,51,0.49,0.832,80018526,100,49
2,6,0.5,0.8181818181818182,70343525,12,6
2,10,0.6,0.7931034482758621,77329511,25,15
1,124,0.27058823529411763,0.7060518731988472,80103471,170,46
0,281,0.19714285714285715,0.45670391061452514,82011802,350,69
1,195,0.29347826086956524,0.6588785046728972,62376125,276,81
0,117,0.1,0.2840466926070039,300440,130,13
1,125,0.48132780082987553,0.8895348837209303,80155273,241,116
1,58,0.35555555555555557,0.8120805369127517,81980705,90,32
0,183,0.14883720930232558,0.15030674846625766,66471300,215,32
1,72,0.32710280373831774,0.702247191011236,68668530,107,35
2,86,0.5141242937853108,0.8682926829268293,80042991,177,91
0,48,0.1111111111111111,0.05517241379310345,82116847,54,6
2,41,0.5543478260869565,0.9732142857142857,69698230,92,51
1,44,0.26666666666666666,0.6328125,69608070,60,16
1,84,0.3,0.700374531835206,65930844,120,36
1,494,0.36989795918367346,0.8586609989373007,69184010,784,290
0,312,0.1702127659574468,0.3352380952380952,69622490,376,64
0,421,0.01405152224824356,0.016042780748663103,63337043,427,6
2,63,0.5298507462686567,0.9304347826086956,62512191,134,71
0,505,0.1984126984126984,0.43902439024390244,81999335,630,125
0,90,0.1743119266055046,0.3263157894736842,67868864,109,19
0,45,0.22413793103448276,0.4329896907216495,74386606,58,13
0,113,0.2565789473684211,0.4824120603015075,74389336,152,39
0,16,0.15789473684210525,0.3026315789473684,82001457,19,3
1,483,0.29694323144104806,0.6537698412698413,74478320,687,204
0,55,0.15384615384615385,0.10948905109489052,82126680,65,10
1,78,0.3157894736842105,0.7594339622641509,80113943,114,36
1,231,0.27586206896551724,0.6198019801980198,69101760,319,88
1,69,0.37272727272727274,0.8104265402843602,70219135,110,41
0,130,0.1095890410958904,0.27941176470588236,70219142,146,16
0,7,0.2222222222222222,0.4090909090909091,73295943,9,2
0,64,0.1232876712328767,0.425531914893617,80116925,73,9
2,104,0.6809815950920245,0.9964028776978417,80122542,326,222
0,81,0.352,0.46788990825688076,82009347,125,44
1,158,0.38996138996138996,0.8076923076923077,80135007,259,101
1,272,0.30256410256410254,0.5706806282722513,80135008,390,118
0,938,0.20642978003384094,0.39155920281359907,63278593,1182,244
0,118,0.08527131782945736,0.07692307692307693,68621721,129,11
2,64,0.5586206896551724,0.9106145251396648,70512820,145,81
1,45,0.3283582089552239,0.5666666666666667,80180906,67,22
2,0,1.0,1.0,74088483,4,4
1,31,0.44642857142857145,0.9047619047619048,70925715,56,25
1,76,0.36666666666666664,0.9114583333333334,67428291,120,44
0,15,0.16666666666666666,0.38461538461538464,65282364,18,3
0,72,0.02702702702702703,0.004651162790697674,69416564,74,2
1,9,0.4,0.85,65289672,15,6
1,280,0.30864197530864196,0.717546362339515,73148383,405,125
1,80,0.33884297520661155,0.8488372093023255,69024613,121,41
1,35,0.43548387096774194,0.8928571428571429,66028921,62,27
0,197,0.2480916030534351,0.4772234273318872,80120453,262,65
0,117,0.040983606557377046,0.12652068126520682,80128614,122,5
1,332,0.26548672566371684,0.6292286874154263,70398923,452,120
0,525,0.15048543689320387,0.261558784676354,68537112,618,93
0,3,0.25,0.25,70005852,4,1
1,9,0.4,0.9444444444444444,65708384,15,6
0,673,0.22196531791907514,0.4342688330871492,69165782,865,192
0,354,0.18433179723502305,0.35929203539823007,67705974,434,80
1,76,0.24752475247524752,0.553072625698324,82129385,101,25
0,119,0.16783216783216784,0.3883720930232558,80097444,143,24
0,478,0.22276422764227644,0.4803001876172608,81979702,615,137
0,216,0.16923076923076924,0.3515981735159817,69229524,260,44
0,479,0.18537414965986396,0.41725888324873095,68419652,588,109
2,147,0.6334164588528678,0.9826302729528535,72271066,401,254
1,279,0.18421052631578946,0.5617469879518072,70113512,342,63
1,160,0.30434782608695654,0.7486910994764397,71358665,230,70
1,152,0.3153153153153153,0.7401129943502824,82126766,222,70
0,157,0.16042780748663102,0.28205128205128205,68299763,187,30
0,842,0.2181987000928505,0.3945945945945946,79520084,1077,235
1,48,0.35135135135135137,0.6818181818181818,71288644,74,26
1,104,0.391812865497076,0.8953488372093024,67601044,171,67
1,118,0.37894736842105264,0.8181818181818182,66919160,190,72
1,78,0.35,0.8258426966292135,69607251,120,42
0,435,0.07838983050847458,0.07799442896935933,70642621,472,37
0,508,0.17932148626817448,0.3512658227848101,68542880,619,111
0,155,0.27230046948356806,0.4858757062146893,80126986,213,58
1,140,0.3548387096774194,0.7920792079207921,67600610,217,77
2,17,0.5,0.6875,80160405,34,17
0,58,0.18309859154929578,0.4146341463414634,80135089,71,13
0,174,0.14705882352941177,0.19310344827586207,82128791,204,30
1,266,0.32142857142857145,0.6635802469135802,68421850,392,126
1,23,0.39473684210526316,0.9342105263157895,79520273,38,15
1,157,0.2559241706161137,0.5158150851581509,80121162,211,54
1,134,0.32323232323232326,0.7043701799485861,70633983,198,64
2,231,0.5425742574257426,0.9546485260770975,70720986,505,274
1,235,0.38961038961038963,0.8084507042253521,973133,385,150
1,133,0.23563218390804597,0.53125,80097416,174,41
0,55,0.1791044776119403,0.30337078651685395,70760830,67,12
0,83,0.23148148148148148,0.4027777777777778,82126614,108,25
1,92,0.42138364779874216,0.8661971830985915,68449892,159,67
1,124,0.4789915966386555,0.883495145631068,80118588,238,114
0,800,0.052132701421800945,0.02616279069767442,80118155,844,44
1,99,0.38509316770186336,0.8508771929824561,70958272,161,62
0,655,0.17297979797979798,0.34522560335781743,68537742,792,137
1,72,0.1111111111111111,0.6328828828828829,65498503,81,9
0,137,0.15432098765432098,0.2801724137931034,70004956,162,25
0,120,0.21052631578947367,0.49193548387096775,70004991,152,32
2,310,0.5609065155807366,0.979757085020243,82023514,706,396
2,38,0.6161616161616161,0.9753086419753086,70926394,99,61
0,292,0.2335958005249344,0.49032258064516127,68533486,381,89
2,191,0.5213032581453634,0.9742268041237113,72560985,399,208
2,74,0.6185567010309279,0.9813664596273292,74444804,194,120
2,133,0.5817610062893082,0.9716981132075472,80086293,318,185
1,215,0.31746031746031744,0.7671517671517671,82128662,315,100
1,286,0.2814070351758794,0.6923076923076923,70514843,398,112
2,337,0.5565789473684211,0.9333333333333333,70625940,760,423
0,272,0.24653739612188366,0.49271844660194175,67747204,361,89
1,58,0.32558139534883723,0.6953125,60232634,86,28
0,400,0.21104536489151873,0.444743935309973,67627266,507,107
0,448,0.18248175182481752,0.3063343717549325,70545755,548,100
1,349,0.25902335456475584,0.6180371352785146,72376283,471,122
0,226,0.18411552346570398,0.3821376281112738,82011850,277,51
0,325,0.19554455445544555,0.41163055872291904,82011851,404,79
1,316,0.271889400921659,0.5873850197109067,69180342,434,118
1,62,0.3673469387755102,0.8076923076923077,80107384,98,36
0,90,0.19642857142857142,0.4950980392156863,72773274,112,22
1,117,0.4558139534883721,0.8565217391304348,69388403,215,98
1,56,0.3488372093023256,0.8484848484848485,54608351,86,30
1,347,0.3690909090909091,0.7946428571428571,82018790,550,203
1,112,0.3563218390804598,0.8456140350877193,69154680,174,62
0,247,0.24,0.4584269662921348,66459470,325,78
0,74,0.0975609756097561,0.3614457831325301,70746431,82,8
0,149,0.2074468085106383,0.3625,69166363,188,39
0,67,0.028985507246376812,0.04794520547945205,72545942,69,2
0,33,0.10810810810810811,0.2553191489361702,72546621,37,4
1,7,0.36363636363636365,0.8275862068965517,80150337,11,4
1,89,0.41830065359477125,0.90625,62815305,153,64
1,124,0.45614035087719296,0.8456375838926175,71665216,228,104
1,8,0.42857142857142855,0.9558823529411765,69470793,14,6
0,260,0.09722222222222222,0.10089686098654709,69100941,288,28
2,13,0.717391304347826,0.6666666666666666,68474462,46,33
0,18,0.25,0.3333333333333333,80145768,24,6
0,38,0.09523809523809523,0.20833333333333334,80145888,42,4
1,44,0.45,0.5636363636363636,70631470,80,36
1,731,0.3938640132669983,0.5539112050739958,70179816,1206,475
2,21,0.7558139534883721,0.95,80118336,86,65
2,45,0.801762114537445,0.9333333333333333,73441396,227,182
2,47,0.5,0.9701492537313433,72512643,94,47
0,127,0.2111801242236025,0.46685082872928174,70761173,161,34
0,117,0.11363636363636363,0.47706422018348627,80128663,132,15
1,409,0.4106628242074928,0.9151061173533084,81980704,694,285
2,84,0.6146788990825688,0.9863013698630136,67402496,218,134
1,142,0.36607142857142855,0.833922261484099,67160394,224,82
0,258,0.2037037037037037,0.3108108108108108,67307030,324,66
1,96,0.2835820895522388,0.6536796536796536,72549246,134,38
0,7,0.125,0.17391304347826086,68766656,8,1
1,450,0.34876989869753977,0.7445175438596491,79790886,691,241
1,46,0.2698412698412698,0.7,69621286,63,17
1,342,0.3713235294117647,0.8758389261744967,68531610,544,202
1,24,0.38461538461538464,0.7761194029850746,70844956,39,15
0,284,0.1419939577039275,0.1856925418569254,69622273,331,47
1,70,0.3069306930693069,0.7872340425531915,80109582,101,31
2,11,0.5416666666666666,0.6666666666666666,80019695,24,13
0,102,0.04672897196261682,0.07623318385650224,63141925,107,5
1,161,0.3263598326359833,0.706081081081081,68401312,239,78
1,103,0.36419753086419754,0.7868852459016393,68401466,162,59
0,115,0.22297297297297297,0.42474916387959866,70912702,148,33
1,127,0.2784090909090909,0.6206896551724138,82126807,176,49
0,6,0.25,0.38461538461538464,80145419,8,2
0,28,0.2,0.37894736842105264,80145906,35,7
0,11,0.15384615384615385,0.2553191489361702,80145908,13,2
1,51,0.32,0.5060240963855421,80180905,75,24
0,27,0.12903225806451613,0.23684210526315788,70678111,31,4
2,25,0.5689655172413793,0.9882352941176471,82052049,58,33
0,156,0.012658227848101266,0.020527859237536656,80126894,158,2
0,404,0.22456813819577734,0.4753787878787879,82055997,521,117
1,115,0.3390804597701149,0.7255520504731862,69162590,174,59
0,186,0.1267605633802817,0.304635761589404,70209664,213,27
2,47,0.6802721088435374,0.9333333333333333,69597675,147,100
0,7,0.125,0.4144144144144144,82137457,8,1
1,483,0.25116279069767444,0.5595903165735568,71444534,645,162
0,287,0.05901639344262295,0.0425531914893617,66087434,305,18
0,177,0.07329842931937172,0.11466666666666667,66087490,191,14
0,44,0.06382978723404255,0.0,61989536,47,3
2,28,0.6164383561643836,0.9861111111111112,72315460,73,45
2,6,0.5,0.9333333333333333,76941725,12,6
1,390,0.2641509433962264,0.5084033613445378,69489343,530,140
1,271,0.4197002141327623,0.8096676737160121,82047562,467,196
2,1,0.8888888888888888,0.6666666666666666,80152719,9,8
2,9,0.8714285714285714,0.967741935483871,70076363,70,61
1,185,0.4032258064516129,0.7857142857142857,69531021,310,125
0,22,0.2413793103448276,0.48,65752463,29,7
0,49,0.19672131147540983,0.24285714285714285,68434254,61,12
1,140,0.2893401015228426,0.6339869281045751,68434485,197,57
0,51,0.23880597014925373,0.4785714285714286,69184073,67,16
0,95,0.12844036697247707,0.07368421052631578,69184192,109,14
1,279,0.2638522427440633,0.5396551724137931,69184752,379,100
1,149,0.25870646766169153,0.5833333333333334,80133426,201,52
0,86,0.2037037037037037,0.3547008547008547,63050771,108,22
0,46,0.08,0.09195402298850575,66264912,50,4
0,55,0.21428571428571427,0.45614035087719296,69180202,70,15
2,164,0.6411378555798687,0.9883720930232558,69627824,457,293
1,220,0.34911242603550297,0.8034825870646766,68241502,338,118
1,209,0.2939189189189189,0.6796338672768879,68241565,296,87
1,323,0.2179176755447942,0.5283018867924528,68537560,413,90
1,74,0.45185185185185184,0.9366197183098591,67555915,135,61
1,72,0.3142857142857143,0.676923076923077,70110362,105,33
1,316,0.3008849557522124,0.6491994177583698,67995305,452,136
1,146,0.3393665158371041,0.8194444444444444,68766845,221,75
0,298,0.06875,0.08056872037914692,70604653,320,22
1,48,0.30434782608695654,0.6363636363636364,66857343,69,21
1,30,0.4642857142857143,0.9315068493150684,73226524,56,26
1,273,0.3175,0.7116104868913857,67154472,400,127
1,32,0.1794871794871795,0.7391304347826086,62841793,39,7
0,85,0.09574468085106383,0.28735632183908044,62841905,94,9
2,100,0.5145631067961165,0.9442231075697212,70815661,206,106
0,370,0.058524173027989825,0.04794520547945205,68047686,393,23
1,238,0.3670212765957447,0.709480122324159,69285846,376,138
0,363,0.08793969849246232,0.10445682451253482,80071250,398,35
1,145,0.48398576512455516,0.9433962264150944,80021942,281,136
0,384,0.2033195020746888,0.23865300146412885,69180146,482,98
0,125,0.10714285714285714,0.4608501118568233,80128658,140,15
1,79,0.3008849557522124,0.7232142857142857,67626986,113,34
1,118,0.2625,0.5398773006134969,67995200,160,42
0,256,0.10801393728222997,0.33223684210526316,62532323,287,31
0,126,0.08695652173913043,0.24031007751937986,80029243,138,12
0,134,0.11842105263157894,0.2708333333333333,69416473,152,18
1,170,0.3117408906882591,0.6802325581395349,68191361,247,77
0,467,0.04693877551020408,0.09548793284365163,63775691,490,23
0,452,0.07942973523421588,0.13316582914572864,66653244,491,39
0,412,0.08035714285714286,0.16241610738255033,68017684,448,36
1,91,0.3,0.7740384615384616,65108071,130,39
0,141,0.0784313725490196,0.15406976744186046,65683723,153,12
0,396,0.04578313253012048,0.09735576923076923,63780416,415,19
0,593,0.04508856682769726,0.07958115183246073,63780934,621,28
0,369,0.1707865168539326,0.3567110036275695,80121020,445,76
1,448,0.3065015479876161,0.7164303586321935,81989529,646,198
1,22,0.4883720930232558,0.95,65289441,43,21
1,420,0.27586206896551724,0.615595075239398,69607811,580,160
1,333,0.3431952662721893,0.7740029542097489,68741603,507,174
1,154,0.3094170403587444,0.7265415549597856,68553611,223,69
0,141,0.053691275167785234,0.12745098039215685,64240743,149,8
1,267,0.4378947368421053,0.9015384615384615,67662504,475,208
0,590,0.15472779369627507,0.43364197530864196,68036332,698,108
0,152,0.06172839506172839,0.36054421768707484,62835052,162,10
0,38,0.0,0.0,80138870,38,0
1,68,0.2,0.5662650602409639,67877054,85,17
1,286,0.23324396782841822,0.5035460992907801,67160030,373,87
1,351,0.4020442930153322,0.7938931297709924,82009520,587,236
1,101,0.28368794326241137,0.7172995780590717,82054691,141,40
0,79,0.05952380952380952,0.1013215859030837,63702163,84,5
0,180,0.09090909090909091,0.49,67887106,198,18
0,66,0.05714285714285714,0.3550488599348534,82049109,70,4
1,76,0.3770491803278688,0.8295964125560538,67202233,122,46
1,17,0.41379310344827586,0.8163265306122449,77065142,29,12
1,194,0.34459459459459457,0.7925407925407926,80108056,296,102
0,4,0.0,0.0,67434626,4,0
1,14,0.2222222222222222,0.717948717948718,67434640,18,4
0,19,0.05,0.21428571428571427,67435081,20,1
1,41,0.1276595744680851,0.5460122699386503,67435095,47,6
0,52,0.018867924528301886,0.04035874439461883,67454744,53,1
0,26,0.0,0.0,67887561,26,0
0,49,0.10909090909090909,0.453781512605042,80149806,55,6
0,339,0.16911764705882354,0.2145922746781116,70645890,408,69
1,22,0.35294117647058826,0.76,80152635,34,12
0,150,0.23076923076923078,0.4673202614379085,82046832,195,45
0,159,0.09659090909090909,0.3242506811989101,67888331,176,17
0,168,0.07692307692307693,0.3120728929384966,67888772,182,14
0,85,0.022988505747126436,0.058333333333333334,69024354,87,2
1,80,0.2982456140350877,0.6284403669724771,77563892,114,34
1,21,0.25,0.6219512195121951,70475055,28,7
1,202,0.15481171548117154,0.5548902195608783,63981813,239,37
0,312,0.10601719197707736,0.34026465028355385,67888310,349,37
0,264,0.10508474576271186,0.3891992551210428,67889276,295,31
1,113,0.3192771084337349,0.8311345646437994,68941992,166,53
0,226,0.08502024291497975,0.3644067796610169,69639150,247,21
0,269,0.04946996466431095,0.18170103092783504,70917483,283,14
0,84,0.08695652173913043,0.3217993079584775,80149807,92,8
1,58,0.2054794520547945,0.7333333333333333,67455255,73,15
0,79,0.05952380952380952,0.2158273381294964,80149838,84,5
1,106,0.3161290322580645,0.8125,68761882,155,49
1,119,0.327683615819209,0.7806451612903226,73200085,177,58
0,199,0.0787037037037037,0.4906832298136646,67887085,216,17
0,11,0.08333333333333333,0.36538461538461536,68757122,12,1
0,19,0.0,0.0,80128107,19,0
0,4,0.0,0.0,63984172,4,0
0,11,0.08333333333333333,0.375,68384540,12,1
0,292,0.033112582781456956,0.12366230677764566,66876943,302,10
0,36,0.0,0.0,82103949,36,0
0,129,0.16233766233766234,0.4365256124721604,80154083,154,25
0,35,0.125,0.28888888888888886,82103842,40,5
0,275,0.12698412698412698,0.1617161716171617,66849461,315,40
1,198,0.2235294117647059,0.5054744525547445,70347543,255,57
1,236,0.11940298507462686,0.5325936199722607,69639220,268,32
1,61,0.22784810126582278,0.6292134831460674,80128125,79,18
0,84,0.10638297872340426,0.23076923076923078,80135156,94,10
1,50,0.35064935064935066,0.8671328671328671,80124703,77,27
0,131,0.022388059701492536,0.07878787878787878,82103943,134,3
2,30,0.696969696969697,0.8679245283018868,80155255,99,69
1,69,0.41025641025641024,0.9058823529411765,70690536,117,48
1,603,0.2939110070257611,0.7373447946513849,70207802,854,251
0,371,0.0725,0.25452609158679446,80149819,400,29
1,130,0.30851063829787234,0.7699115044247787,70753305,188,58
0,86,0.13131313131313133,0.340625,80128110,99,13
1,224,0.2911392405063291,0.5811088295687885,67282635,316,92
0,347,0.14320987654320988,0.3193504736129905,80116743,405,58
0,115,0.11538461538461539,0.2852233676975945,80124258,130,15
0,88,0.07368421052631578,0.2542372881355932,80124277,95,7
2,2,0.8333333333333334,0.75,80176845,12,10
2,2,0.8333333333333334,0.9090909090909091,69735792,12,10
1,13,0.2777777777777778,0.5652173913043478,70063910,18,5
1,151,0.3682008368200837,0.7859154929577464,72417121,239,88
0,512,0.1715210355987055,0.3116474291710388,66931424,618,106
0,90,0.0625,0.22285714285714286,68798296,96,6
1,546,0.31493099121706397,0.7133689839572193,68531050,797,251
0,472,0.04838709677419355,0.04067796610169491,68017705,496,24
1,46,0.22033898305084745,0.7315789473684211,73650430,59,13
1,165,0.4,0.8959537572254336,80107440,275,110
1,45,0.3283582089552239,0.6648936170212766,60033974,67,22
1,56,0.391304347826087,0.7666666666666667,82023693,92,36
0,240,0.07335907335907337,0.2533783783783784,68198963,259,19
2,153,0.5203761755485894,0.9573863636363636,69157844,319,166
1,81,0.2831858407079646,0.7385892116182573,68533472,113,32
1,65,0.2777777777777778,0.690677966101695,82116857,90,25
1,284,0.2935323383084577,0.5469387755102041,80167987,402,118
1,362,0.36155202821869487,0.8716049382716049,69180503,567,205
2,88,0.6190476190476191,0.9531914893617022,79816030,231,143
1,157,0.33191489361702126,0.6217105263157895,69399351,235,78
0,593,0.10692771084337349,0.3800186741363212,67889255,664,71
2,33,0.6024096385542169,0.9775280898876404,82011708,83,50
0,162,0.10497237569060773,0.3719512195121951,65212364,181,19
0,336,0.0967741935483871,0.3739612188365651,69024361,372,36
1,407,0.23925233644859814,0.6019151846785226,60514286,535,128
0,4,0.0,0.0,80128218,4,0
0,169,0.12886597938144329,0.19902912621359223,69582954,194,25
1,290,0.3842887473460722,0.8518518518518519,70686784,471,181
1,36,0.3076923076923077,0.57,66613722,52,16
0,19,0.24,0.4888888888888889,73650640,25,6
2,51,0.5048543689320388,0.925531914893617,74045293,103,52
1,59,0.45871559633027525,0.90625,70617505,109,50
2,35,0.7407407407407407,0.989247311827957,72315425,135,100
1,23,0.17857142857142858,0.5662650602409639,67454723,28,5
1,36,0.29411764705882354,0.859375,80128098,51,15
0,202,0.0380952380952381,0.1320754716981132,62839280,210,8
0,16,0.1111111111111111,0.36,67435263,18,2
1,97,0.25384615384615383,0.5985915492957746,80121100,130,33
0,218,0.08403361344537816,0.45021037868162694,67886945,238,20
1,198,0.07476635514018691,0.5014749262536873,67888842,214,16
1,138,0.3669724770642202,0.7885196374622356,67199391,218,80
1,33,0.46774193548387094,0.9468085106382979,69031102,62,29
0,60,0.0625,0.15639810426540285,67455045,64,4
0,218,0.043859649122807015,0.011725293132328308,80097122,228,10
0,298,0.10510510510510511,0.4993006993006993,67889304,333,35
0,44,0.06382978723404255,0.38666666666666666,67682412,47,3
0,137,0.12738853503184713,0.23076923076923078,69204450,157,20
1,51,0.2714285714285714,0.5511363636363636,82019414,70,19
1,181,0.3649122807017544,0.7729166666666667,67307002,285,104
1,542,0.27540106951871657,0.7079395085066162,66931326,748,206
1,311,0.33547008547008544,0.8037578288100209,70642915,468,157
1,98,0.4024390243902439,0.7628865979381443,81989150,164,66
1,244,0.39753086419753086,0.8364963503649635,80123782,405,161
2,74,0.5163398692810458,0.9527027027027027,62402123,153,79
0,51,0.2714285714285714,0.38095238095238093,80180199,70,19
0,56,0.18840579710144928,0.21138211382113822,80180209,69,13
2,1,0.5,0.5,70110103,2,1
1,94,0.437125748502994,0.8650306748466258,68943581,167,73
0,34,0.05555555555555555,0.22302158273381295,70676214,36,2
0,19,0.05,0.08571428571428572,70685783,20,1
2,49,0.6620689655172414,0.9923076923076923,70612661,145,96
1,4,0.3333333333333333,0.7105263157894737,70692153,6,2
1,42,0.3,0.5686274509803921,73482472,60,18
2,15,0.7540983606557377,0.9459459459459459,66848460,61,46
0,59,0.45871559633027525,0.2777777777777778,62634215,109,50
1,291,0.389937106918239,0.850974930362117,65825186,477,186
0,222,0.11904761904761904,0.2801724137931034,70617736,252,30
2,67,0.5562913907284768,0.9344262295081968,80118360,151,84
1,405,0.2931937172774869,0.7024647887323944,63099232,573,168
1,23,0.30303030303030304,0.6707317073170732,61566386,33,10
2,37,0.6574074074074074,0.9722222222222222,69943216,108,71
1,24,0.1724137931034483,0.6111111111111112,80125963,29,5
0,15,0.11764705882352941,0.1388888888888889,80125962,17,2
0,295,0.1643059490084986,0.32409972299168976,80172875,353,58
2,0,1.0,1.0,80128782,2,2
2,16,0.5789473684210527,0.9680851063829787,67588255,38,22
1,23,0.23333333333333334,0.5535714285714286,68497870,30,7
2,70,0.7046413502109705,0.9274193548387096,70277326,237,167
0,201,0.1589958158995816,0.29573170731707316,68538694,239,38
0,129,0.07194244604316546,0.06865671641791045,82011830,139,10
0,142,0.24867724867724866,0.49829351535836175,69165320,189,47
0,1426,0.19298245614035087,0.3750496622963846,81979710,1767,341
0,46,0.08,0.019801980198019802,82063321,50,4
0,619,0.2233375156838143,0.43986543313709,80180149,797,178
1,68,0.43333333333333335,0.9260700389105059,82142694,120,52
2,19,0.7076923076923077,0.9333333333333333,75793711,65,46
1,81,0.25688073394495414,0.5167464114832536,70048006,109,28
0,126,0.1870967741935484,0.47474747474747475,67760805,155,29
0,4,0.0,0.0,70780150,4,0
1,147,0.37446808510638296,0.7484076433121019,80180250,235,88
1,93,0.23770491803278687,0.5,80119189,122,29
0,157,0.18229166666666666,0.3063583815028902,80119190,192,35
1,237,0.2988165680473373,0.6876310272536688,67558281,338,101
1,183,0.2620967741935484,0.5782122905027933,70646450,248,65
0,137,0.22598870056497175,0.434375,70646464,177,40
1,40,0.4666666666666667,0.9142857142857143,63434651,75,35
1,483,0.26595744680851063,0.566147859922179,80124678,658,175
1,16,0.4074074074074074,0.8461538461538461,67287934,27,11
1,122,0.3107344632768362,0.6563706563706564,81967261,177,55
0,101,0.056074766355140186,0.03571428571428571,80119286,107,6
2,154,0.5319148936170213,0.9722814498933902,80126448,329,175
0,44,0.21428571428571427,0.49122807017543857,70633262,56,12
1,273,0.30886075949367087,0.5417721518987342,80180247,395,122
2,210,0.5150115473441108,0.9692307692307692,73181374,433,223
1,484,0.2329635499207607,0.5719063545150501,68541585,631,147
2,8,0.7419354838709677,0.9090909090909091,80126568,31,23
2,25,0.6153846153846154,0.9032258064516129,74029256,65,40
2,11,0.56,0.8571428571428571,16369045,25,14
1,153,0.35443037974683544,0.7322834645669292,73650773,237,84
1,213,0.30618892508143325,0.7123552123552124,66883264,307,94
0,407,0.1054945054945055,0.13132694938440492,73906042,455,48
1,71,0.3238095238095238,0.55,80136901,105,34
2,1,0.5,0.5,73865281,2,1
2,153,0.5513196480938416,0.9847560975609756,67304335,341,188
0,370,0.09090909090909091,0.15757575757575756,80140150,407,37
2,60,0.5041322314049587,0.9012345679012346,82102328,121,61
2,33,0.6206896551724138,0.863013698630137,80174697,87,54
2,26,0.559322033898305,0.9634146341463414,72417212,59,33
0,80,0.16666666666666666,0.20952380952380953,82041832,96,16
2,2,0.9701492537313433,0.5,80162124,67,65
1,96,0.29411764705882354,0.6418732782369146,70063875,136,40
1,66,0.4,0.8599033816425121,72801715,110,44
0,243,0.19,0.27040816326530615,68283173,300,57
2,29,0.6627906976744186,0.5714285714285714,64323392,86,57
2,36,0.5,0.25,68416033,72,36
2,71,0.5,0.8260869565217391,65715846,142,71
0,282,0.27319587628865977,0.48314606741573035,65950822,388,106
0,223,0.2440677966101695,0.3625,73412185,295,72
0,850,0.2158671586715867,0.4802126402835204,62751773,1084,234
0,181,0.09045226130653267,0.06635071090047394,70646254,199,18
0,488,0.19471947194719472,0.3578174186778594,68532016,606,118
0,31,0.3673469387755102,0.4166666666666667,80178928,49,18
0,17,0.19047619047619047,0.3023255813953488,67513824,21,4
0,111,0.05128205128205128,0.1918918918918919,63529515,117,6
1,129,0.4055299539170507,0.8537313432835821,74193343,217,88
0,433,0.21981981981981982,0.4783748361730013,68542166,555,122
0,124,0.03875968992248062,0.11469534050179211,63336924,129,5
0,70,0.014084507042253521,0.05291005291005291,63336952,71,1
0,191,0.015463917525773196,0.0327455919395466,63336980,194,3
1,50,0.4117647058823529,0.9415204678362573,69177374,85,35
0,250,0.11347517730496454,0.16752577319587628,82095665,282,32
0,280,0.1411042944785276,0.4844903988183161,63780451,326,46
0,25,0.07407407407407407,0.4017857142857143,67846303,27,2
0,454,0.19217081850533807,0.38214643931795383,63279692,562,108
1,72,0.4782608695652174,0.9121621621621622,79917971,138,66
0,315,0.10256410256410256,0.2549019607843137,62929034,351,36
0,411,0.14375,0.42038216560509556,67796463,480,69
1,66,0.47619047619047616,0.8533333333333334,67154325,126,60
0,319,0.042042042042042045,0.1299254526091587,62838804,333,14
1,237,0.2305194805194805,0.6224899598393574,69587525,308,71
0,84,0.27586206896551724,0.37373737373737376,80136912,116,32
1,178,0.3308270676691729,0.7010309278350515,69617912,266,88
0,40,0.23076923076923078,0.3854166666666667,80128845,52,12
1,99,0.31724137931034485,0.7626459143968871,69986371,145,46
0,125,0.06015037593984962,0.2087378640776699,63775705,133,8
2,60,0.5774647887323944,0.9857142857142858,82023520,142,82
0,490,0.014084507042253521,0.0026560424966799467,60028703,497,7
0,60,0.09090909090909091,0.3192771084337349,61976453,66,6
0,204,0.05116279069767442,0.10141987829614604,61976705,215,11
1,22,0.2903225806451613,0.6724137931034483,73739001,31,9
1,132,0.21893491124260356,0.5857605177993528,67985183,169,37
1,45,0.45121951219512196,0.8765432098765432,68616863,82,37
0,102,0.1774193548387097,0.29245283018867924,73200113,124,22
2,12,0.5,0.8181818181818182,80177411,24,12
0,223,0.19494584837545126,0.30097087378640774,80174690,277,54
1,116,0.41116751269035534,0.9204152249134948,65278570,197,81
1,53,0.24285714285714285,0.5666666666666667,73739043,70,17
1,229,0.273015873015873,0.555765595463138,81967266,315,86
0,795,0.19939577039274925,0.2953846153846154,69607874,993,198
1,406,0.26181818181818184,0.5250783699059561,81967302,550,144
1,457,0.22934232715008432,0.5579514824797843,80070746,593,136
1,12,0.29411764705882354,0.7407407407407407,68286603,17,5
1,130,0.281767955801105,0.5723905723905723,67995144,181,51
0,360,0.14893617021276595,0.17229129662522202,80176762,423,63
1,47,0.17543859649122806,0.5212765957446809,69638681,57,10
1,541,0.31605562579013907,0.7121326299924642,65384410,791,250
0,52,0.11864406779661017,0.1388888888888889,67514013,59,7
1,145,0.34684684684684686,0.8725868725868726,68540101,222,77
2,6,0.5714285714285714,0.8888888888888888,62580721,14,8
1,69,0.49635036496350365,0.96,65825424,137,68
0,203,0.19444444444444445,0.2753623188405797,82005359,252,49
0,242,0.032,0.04426559356136821,60509484,250,8
1,50,0.2537313432835821,0.5222222222222223,62852286,67,17
0,174,0.21266968325791855,0.4105960264900662,69630190,221,47
1,35,0.2708333333333333,0.5784313725490197,69721001,48,13
1,72,0.30097087378640774,0.7381974248927039,68600693,103,31
1,329,0.324435318275154,0.8087248322147651,67557182,487,158
0,73,0.0759493670886076,0.30935251798561153,62529740,79,6
1,189,0.24096385542168675,0.781563126252505,65510991,249,60
0,111,0.04310344827586207,0.1501597444089457,67846352,116,5
1,97,0.4121212121212121,0.8816793893129771,70418425,165,68
0,52,0.1746031746031746,0.43703703703703706,68499725,63,11
1,13,0.3157894736842105,0.6216216216216216,69100822,19,6
1,37,0.1590909090909091,0.7058823529411765,80089660,44,7
1,107,0.2517482517482518,0.6278409090909091,72560950,143,36
0,572,0.13595166163141995,0.18,70207655,662,90
0,116,0.11450381679389313,0.40897097625329815,70621593,131,15
1,105,0.14634146341463414,0.5031645569620253,70823053,123,18
0,65,0.029850746268656716,0.03292181069958848,74019883,67,2
1,83,0.20952380952380953,0.5608695652173913,82103783,105,22
1,130,0.2857142857142857,0.696969696969697,68384246,182,52
0,42,0.08695652173913043,0.32926829268292684,60543203,46,4
0,77,0.08333333333333333,0.4432234432234432,67846436,84,7
0,94,0.22950819672131148,0.46153846153846156,70841421,122,28
1,172,0.23214285714285715,0.5465465465465466,67160002,224,52
1,510,0.2237442922374429,0.5490716180371353,68543251,657,147
0,44,0.18518518518518517,0.4268292682926829,68642182,54,10
0,82,0.1717171717171717,0.4838709677419355,65395834,99,17
0,305,0.11078717201166181,0.1296928327645051,68542761,343,38
0,58,0.14705882352941177,0.22072072072072071,67859862,68,10
0,348,0.1491442542787286,0.2807807807807808,67865616,409,61
0,48,0.21311475409836064,0.47596153846153844,62219010,61,13
0,156,0.19170984455958548,0.4259634888438134,65615753,193,37
0,337,0.2014218009478673,0.4239316239316239,69621874,422,85
1,433,0.29248366013071897,0.6741573033707865,81967299,612,179
1,56,0.2328767123287671,0.6220472440944882,67225935,73,17
1,153,0.4375,0.9156626506024096,74576782,272,119
0,581,0.16522988505747127,0.441747572815534,67810015,696,115
1,209,0.24,0.6174089068825911,68633635,275,66
0,106,0.14516129032258066,0.31010452961672474,80135079,124,18
0,387,0.24561403508771928,0.44510035419126326,80130005,513,126
1,110,0.2948717948717949,0.7281553398058253,76296486,156,46
0,78,0.14285714285714285,0.4834123222748815,61983404,91,13
1,107,0.3006535947712418,0.8448275862068966,62529110,153,46
0,216,0.1111111111111111,0.1073943661971831,67160261,243,27
0,87,0.2627118644067797,0.4973821989528796,67029564,118,31
1,26,0.3333333333333333,0.8064516129032258,67995046,39,13
2,149,0.5443425076452599,0.9519519519519519,72321991,327,178
0,457,0.09325396825396826,0.11316397228637413,68743395,504,47
2,18,0.5135135135135135,0.64,82018974,37,19
1,219,0.39669421487603307,0.6923076923076923,72320864,363,144
1,200,0.46808510638297873,0.9104938271604939,70002555,376,176
0,367,0.15825688073394495,0.2706185567010309,80181319,436,69
1,67,0.32323232323232326,0.6767676767676768,63975380,99,32
1,163,0.3940520446096654,0.8803191489361702,66470866,269,106
0,30,0.0625,0.14130434782608695,80124261,32,2
2,79,0.6146341463414634,0.98125,72198112,205,126
1,47,0.41975308641975306,0.5909090909090909,72469691,81,34
2,161,0.5672043010752689,0.9824120603015075,72315054,372,211
0,45,0.1,0.13392857142857142,70686413,50,5
2,25,0.6753246753246753,0.8484848484848485,66767925,77,52
0,101,0.028846153846153848,0.036303630363036306,82011852,104,3
1,230,0.41475826972010177,0.8531746031746031,73974964,393,163
0,258,0.22054380664652568,0.41133004926108374,74545835,331,73
1,271,0.3033419023136247,0.7100591715976331,68191536,389,118
1,193,0.27169811320754716,0.5688622754491018,81967323,265,72
0,171,0.22272727272727272,0.4354166666666667,945231,220,49
0,401,0.1504237288135593,0.2868421052631579,68537021,472,71
2,70,0.5833333333333334,0.9745762711864406,66907050,168,98
1,71,0.2755102040816326,0.6714975845410628,70045213,98,27
0,86,0.23214285714285715,0.39603960396039606,80133415,112,26
1,189,0.3,0.6511627906976745,80070025,270,81
0,54,0.25,0.35135135135135137,68995465,72,18
0,126,0.19230769230769232,0.2238372093023256,72708965,156,30
1,389,0.24171539961013644,0.5102040816326531,70632156,513,124
2,31,0.5,0.9743589743589743,63198485,62,31
1,81,0.46,0.9358974358974359,63098616,150,69
1,368,0.2505091649694501,0.6217532467532467,62234046,491,123
1,109,0.3057324840764331,0.5511111111111111,76219066,157,48
1,301,0.2917647058823529,0.6923076923076923,70686791,425,124
0,3,0.0,0.0,70253736,3,0
1,352,0.22637362637362637,0.5440613026819924,66931291,455,103
1,142,0.4008438818565401,0.8734177215189873,82126726,237,95
2,22,0.6071428571428571,0.9473684210526315,67214231,56,34
1,17,0.2916666666666667,0.5789473684210527,69180286,24,7
1,34,0.37037037037037035,0.8645833333333334,70719754,54,20
0,9,0.1,0.4146341463414634,80165890,10,1
1,100,0.3333333333333333,0.7227722772277227,70202552,150,50
0,190,0.0821256038647343,0.42668621700879766,67872714,207,17
1,144,0.29411764705882354,0.6233062330623306,82120535,204,60
1,231,0.47139588100686497,0.9227467811158798,69944595,437,206
1,133,0.4088888888888889,0.8307692307692308,80141541,225,92
2,112,0.6151202749140894,0.9806451612903225,68380165,291,179
0,120,0.22077922077922077,0.47297297297297297,70633493,154,34
1,130,0.2073170731707317,0.5727272727272728,76080921,164,34
0,155,0.06060606060606061,0.2505091649694501,76805582,165,10
1,120,0.39086294416243655,0.8283582089552238,82110032,197,77
1,59,0.2891566265060241,0.5535714285714286,69737136,83,24
1,157,0.17801047120418848,0.5050251256281407,72866696,191,34
0,109,0.1484375,0.46607669616519176,78763335,128,19
0,270,0.12052117263843648,0.20930232558139536,70623203,307,37
0,72,0.15294117647058825,0.24731182795698925,73704904,85,13
0,209,0.045662100456621,0.09513742071881606,80124259,219,10
0,62,0.07462686567164178,0.2765957446808511,80124336,67,5
0,271,0.021660649819494584,0.04424778761061947,80124348,277,6
0,62,0.06060606060606061,0.20567375886524822,80124427,66,4
0,57,0.03389830508474576,0.04081632653061224,70568393,59,2
0,96,0.04,0.08597285067873303,70568694,100,4
0,29,0.17142857142857143,0.43,70568764,35,6
1,12,0.29411764705882354,0.6491228070175439,72802772,17,5
0,51,0.03773584905660377,0.12637362637362637,72808855,53,2
0,120,0.1891891891891892,0.3664383561643836,70219044,148,28
1,112,0.43147208121827413,0.8115942028985508,67764046,197,85
0,336,0.2398190045248869,0.3917995444191344,68510071,442,106
2,215,0.6194690265486725,0.9801762114537445,80123638,565,350
1,98,0.4731182795698925,0.9236641221374046,17312015,186,88
1,58,0.3176470588235294,0.8146067415730337,67394075,85,27
0,64,0.2808988764044944,0.47580645161290325,68401074,89,25
2,35,0.7388059701492538,0.9620253164556962,69903603,134,99
1,117,0.4264705882352941,0.8555133079847909,79783900,204,87
1,248,0.4401805869074492,0.8693586698337292,61104771,443,195
1,465,0.44642857142857145,0.950530035335689,69155870,840,375
0,2,0.0,0.0,82250610,2,0
1,158,0.25118483412322273,0.5606407322654462,63098651,211,53
2,12,0.6,0.7391304347826086,78013642,30,18
1,79,0.3416666666666667,0.7439613526570048,81980708,120,41
0,198,0.11210762331838565,0.41002277904328016,60286912,223,25
0,162,0.0898876404494382,0.1523809523809524,62841835,178,16
0,143,0.052980132450331126,0.1414790996784566,62841954,151,8
0,728,0.21382289416846653,0.45507246376811594,66930941,926,198
1,65,0.453781512605042,0.8914285714285715,79783886,119,54
0,115,0.05737704918032787,0.18661971830985916,62841814,122,7
1,76,0.13636363636363635,0.5555555555555556,62841863,88,12
1,43,0.12244897959183673,0.6323529411764706,62841961,49,6
0,135,0.11764705882352941,0.43973941368078173,64369872,153,18
0,357,0.10075566750629723,0.300132802124834,62529544,397,40
0,30,0.16666666666666666,0.42391304347826086,67819920,36,6
0,114,0.03389830508474576,0.05965909090909091,63775663,118,4
1,12,0.29411764705882354,0.84375,68357226,17,5
1,154,0.35564853556485354,0.7807017543859649,82126708,239,85
0,364,0.061855670103092786,0.05303030303030303,54609863,388,24
0,477,0.13114754098360656,0.14540059347181009,82107806,549,72
1,157,0.29596412556053814,0.6018808777429467,67285540,223,66
1,96,0.4514285714285714,0.9146919431279621,69877234,175,79
1,323,0.2962962962962963,0.7183098591549296,82113173,459,136
1,64,0.4434782608695652,0.9565217391304348,69607440,115,51
1,33,0.3125,0.7352941176470589,82126621,48,15
1,184,0.3082706766917293,0.6134831460674157,69044556,266,82
1,16,0.38461538461538464,0.6842105263157895,72392873,26,10
0,71,0.15476190476190477,0.2785714285714286,71761816,84,13
2,5,0.7058823529411765,0.7142857142857143,70350602,17,12
2,6,0.75,0.9722222222222222,61750850,24,18
0,76,0.11627906976744186,0.32673267326732675,68499550,86,10
0,15,0.0,0.0,68499746,15,0
0,37,0.1590909090909091,0.4365079365079365,69478276,44,7
1,4,0.2,0.5714285714285714,70801836,5,1
0,1,0.0,0.0,75148703,1,0
2,121,0.6084142394822006,0.9901719901719902,80081015,309,188
1,11,0.08333333333333333,0.5357142857142857,80124312,12,1
0,42,0.045454545454545456,0.18248175182481752,80124422,44,2
2,4,0.75,0.9210526315789473,80166916,16,12
1,26,0.4090909090909091,0.8133333333333334,69490092,44,18
2,35,0.6354166666666666,0.9859154929577465,67840241,96,61
2,6,0.5,0.6923076923076923,80056305,12,6
1,261,0.36341463414634145,0.8170055452865065,82007148,410,149
0,248,0.1388888888888889,0.4356287425149701,69575450,288,40
1,134,0.37089201877934275,0.779874213836478,61172055,213,79
1,176,0.3824561403508772,0.7995689655172413,66965892,285,109
2,8,0.6,0.7777777777777778,62809341,20,12
1,229,0.3400576368876081,0.7612903225806451,80180105,347,118
0,65,0.3564356435643564,0.40540540540540543,66848446,101,36
0,517,0.20705521472392638,0.489010989010989,80172865,652,135
2,58,0.8253012048192772,0.9393939393939394,1049433,332,274
0,142,0.13414634146341464,0.1780821917808219,68499753,164,22
0,85,0.06593406593406594,0.4120734908136483,62839504,91,6
1,204,0.32894736842105265,0.683371298405467,67994416,304,100
0,132,0.14838709677419354,0.2736842105263158,69416095,155,23
0,422,0.0365296803652968,0.007863695937090432,70643412,438,16
2,100,0.6551724137931034,0.9647058823529412,80137967,290,190
0,150,0.18032786885245902,0.3037249283667622,66422923,183,33
2,21,0.65,0.7407407407407407,61519514,60,39
0,95,0.15178571428571427,0.22660098522167488,67652151,112,17
0,265,0.22514619883040934,0.44464609800362975,70645302,342,77
0,85,0.10526315789473684,0.17258883248730963,70645365,95,10
1,330,0.4668820678513732,0.9359605911330049,68554171,619,289
1,180,0.35018050541516244,0.841642228739003,69091785,277,97
0,169,0.19138755980861244,0.3326226012793177,80121161,209,40
0,321,0.04747774480712166,0.10758377425044091,67800362,337,16
1,73,0.28431372549019607,0.7261904761904762,69502132,102,29
0,65,0.057971014492753624,0.044715447154471545,73914421,69,4
0,420,0.12681912681912683,0.18805309734513273,74886315,481,61
0,119,0.1793103448275862,0.29957805907172996,67159764,145,26
1,249,0.27405247813411077,0.7115384615384616,68536335,343,94
1,189,0.4793388429752066,0.9090909090909091,68040364,363,174
1,171,0.2119815668202765,0.5360230547550432,70609392,217,46
0,73,0.17045454545454544,0.44545454545454544,69417005,88,15
1,60,0.23076923076923078,0.788546255506608,67299526,78,18
1,125,0.4019138755980861,0.8865546218487395,70670320,209,84
0,85,0.23423423423423423,0.3668639053254438,62024732,111,26
0,42,0.17647058823529413,0.4270833333333333,66015824,51,9
0,224,0.04680851063829787,0.03481012658227848,73863874,235,11
0,209,0.06696428571428571,0.39300134589502017,62839266,224,15
1,114,0.3522727272727273,0.6611111111111111,70037674,176,62
0,332,0.14871794871794872,0.2324159021406728,82009769,390,58
1,183,0.4096774193548387,0.9090909090909091,69183254,310,127
2,73,0.5705882352941176,0.9923664122137404,68943602,170,97
0,329,0.08356545961002786,0.061285500747384154,68533213,359,30
0,248,0.06415094339622641,0.22935779816513763,63780472,265,17
0,237,0.08139534883720931,0.3,60543266,258,21
0,274,0.05517241379310345,0.14985590778097982,60973752,290,16
1,20,0.3333333333333333,0.7,69183261,30,10
1,32,0.2558139534883721,0.55,68995304,43,11
1,137,0.45849802371541504,0.9292035398230089,68191550,253,116
1,436,0.38764044943820225,0.8451369216241738,80135363,712,276
1,12,0.4782608695652174,0.8333333333333334,82047578,23,11
0,77,0.1348314606741573,0.22666666666666666,68500026,89,12
1,26,0.21212121212121213,0.6153846153846154,70229845,33,7
1,147,0.28640776699029125,0.7138364779874213,69421681,206,59
0,12,0.25,0.47368421052631576,68563691,16,4
0,83,0.22429906542056074,0.4093567251461988,63051702,107,24
1,165,0.24311926605504589,0.5268817204301075,66264555,218,53
0,127,0.20625,0.35446685878962536,82071320,160,33
1,37,0.4126984126984127,0.928,66354554,63,26
1,210,0.3225806451612903,0.6042402826855123,75061252,310,100
2,156,0.5343283582089552,0.9669669669669669,68191543,335,179
0,820,0.19052319842053306,0.456490727532097,786205,1013,193
1,181,0.19555555555555557,0.6263982102908278,62529173,225,44
1,114,0.4271356783919598,0.9347079037800687,69142794,199,85
1,137,0.19411764705882353,0.7134986225895317,60565134,170,33
1,130,0.2571428571428571,0.7982954545454546,63514703,175,45
1,62,0.29545454545454547,0.8617886178861789,69597871,88,26
0,634,0.15013404825737264,0.2840909090909091,69415801,746,112
2,9,0.6538461538461539,0.75,80135032,26,17
1,164,0.28695652173913044,0.6573208722741433,66051594,230,66
1,296,0.2390745501285347,0.5257861635220126,70760816,389,93
0,264,0.1901840490797546,0.31542461005199307,70207102,326,62
0,23,0.14814814814814814,0.1864406779661017,68533031,27,4
1,67,0.3853211009174312,0.5916666666666667,80180206,109,42
0,147,0.20967741935483872,0.38967136150234744,80176758,186,39
1,7,0.3,0.5,80053911,10,3
2,48,0.5826086956521739,0.961038961038961,80145328,115,67
1,134,0.4369747899159664,0.8148148148148148,80174913,238,104
0,183,0.09852216748768473,0.14893617021276595,81979810,203,20
0,14,0.44,0.25,80168325,25,11
2,0,1.0,1.0,68285784,3,3
2,53,0.5309734513274337,0.7088607594936709,80168330,113,60
2,9,0.6538461538461539,0.625,221305,26,17
2,16,0.6521739130434783,0.9908256880733946,70508956,46,30
0,260,0.13043478260869565,0.1867612293144208,70657713,299,39
0,244,0.05426356589147287,0.05502392344497608,80130298,258,14
0,77,0.125,0.3971631205673759,68257021,88,11
1,34,0.423728813559322,0.8787878787878788,67428606,59,25
0,178,0.0582010582010582,0.15485564304461943,69208153,189,11
1,124,0.40384615384615385,0.8436018957345972,68401291,208,84
1,450,0.29797191887675506,0.73868149324861,70580874,641,191
1,295,0.23772609819121446,0.6711956521739131,67810043,387,92
2,74,0.7665615141955836,0.9820359281437125,80118604,317,243
1,33,0.2978723404255319,0.5168539325842697,68020785,47,14
1,41,0.4533333333333333,0.8307692307692308,80019786,75,34
2,120,0.5275590551181102,0.9589905362776026,67063073,254,134
0,452,0.16911764705882354,0.3073005093378608,80119342,544,92
0,367,0.15825688073394495,0.2609427609427609,82009757,436,69
0,266,0.13355048859934854,0.26146788990825687,70626920,307,41
0,243,0.16494845360824742,0.3492063492063492,70627410,291,48
1,74,0.2815533980582524,0.6533333333333333,80139707,103,29
1,79,0.24761904761904763,0.6580645161290323,69222230,105,26
2,171,0.5569948186528497,0.9605911330049262,77318780,386,215
1,300,0.27184466019417475,0.5817223198594025,69669012,412,112
0,773,0.13146067415730336,0.1610738255033557,80121265,890,117
1,14,0.2631578947368421,0.625,69424453,19,5
0,54,0.16923076923076924,0.30612244897959184,67291665,65,11
2,124,0.504,0.9158415841584159,80180093,250,126
1,60,0.3684210526315789,0.8959537572254336,69417166,95,35
0,204,0.0684931506849315,0.06469500924214418,66892924,219,15
1,423,0.31442463533225284,0.7481343283582089,63099225,617,194
0,125,0.10714285714285714,0.149812734082397,64158395,140,15
0,253,0.22865853658536586,0.4627831715210356,71358875,328,75
1,172,0.2680851063829787,0.6361185983827493,80121277,235,63
2,5,0.5454545454545454,0.9411764705882353,67506544,11,6
0,41,0.14583333333333334,0.45985401459854014,70608552,48,7
0,79,0.21,0.40942028985507245,80121109,100,21
0,261,0.17142857142857143,0.3295668549905838,63277655,315,54
0,77,0.29357798165137616,0.46706586826347307,82004782,109,32
1,91,0.43478260869565216,0.9359605911330049,66817030,161,70
2,29,0.6282051282051282,0.9824561403508771,68009571,78,49
0,310,0.0634441087613293,0.05099502487562189,80119322,331,21
0,90,0.1346153846153846,0.23404255319148937,80119324,104,14
0,309,0.21374045801526717,0.36656891495601174,71389234,393,84
1,112,0.4427860696517413,0.9044943820224719,82051892,201,89
1,148,0.23316062176165803,0.5540540540540541,80098480,193,45
0,186,0.18777292576419213,0.4311111111111111,68542845,229,43
0,107,0.15079365079365079,0.2168284789644013,68497380,126,19
0,208,0.10344827586206896,0.18475073313782991,69106954,232,24
0,358,0.040214477211796246,0.039647577092511016,69107101,373,15
1,277,0.2553763440860215,0.5040322580645161,82126743,372,95
0,561,0.20425531914893616,0.41885964912280704,70073206,705,144
0,323,0.20833333333333334,0.48,70073213,408,85
0,131,0.13245033112582782,0.24860335195530725,80135078,151,20
0,448,0.14666666666666667,0.21929824561403508,81979730,525,77
0,108,0.12903225806451613,0.4850498338870432,67809490,124,16
0,129,0.1456953642384106,0.2721518987341772,72863392,151,22
0,214,0.15079365079365079,0.24948875255623723,72523031,252,38
1,421,0.3154471544715447,0.7663096397273612,65448320,615,194
0,203,0.13983050847457626,0.25984251968503935,73148894,236,33
0,110,0.12,0.25,80124171,125,15
1,222,0.2792207792207792,0.5174825174825175,68995493,308,86
2,21,0.6379310344827587,0.9821428571428571,82088772,58,37
0,35,0.07894736842105263,0.09183673469387756,72546593,38,3
1,610,0.2746730083234245,0.5066124109867752,80161896,841,231
0,294,0.04854368932038835,0.023676880222841225,72522695,309,15
2,1,0.8,0.9285714285714286,69997774,5,4
0,299,0.041666666666666664,0.011608623548922056,68017600,312,13
0,102,0.1206896551724138,0.12637362637362637,63050995,116,14
0,182,0.12077294685990338,0.16589861751152074,63052010,207,25
0,16,0.0,0.0,67094720,16,0
1,12,0.2,0.7872340425531915,67094755,15,3
0,15,0.0,0.0,67094965,15,0
0,16,0.0,0.0,68522125,16,0
0,13,0.07142857142857142,0.42857142857142855,70941535,14,1
0,100,0.2248062015503876,0.42124542124542125,80136830,129,29
0,82,0.16326530612244897,0.4867924528301887,69886803,98,16
1,42,0.4084507042253521,0.8529411764705882,65865121,71,29
2,106,0.5023474178403756,0.963265306122449,75933620,213,107
1,78,0.30357142857142855,0.6650246305418719,82126627,112,34
2,117,0.6112956810631229,0.9828571428571429,68040280,301,184
1,170,0.2511013215859031,0.5085324232081911,67553311,227,57
0,194,0.233201581027668,0.4188235294117647,62803090,253,59
0,161,0.14361702127659576,0.28353658536585363,68018062,188,27
1,222,0.4954545454545455,0.9622266401590457,68026644,440,218
0,148,0.16853932584269662,0.2631578947368421,68536244,178,30
0,198,0.16455696202531644,0.28189300411522633,68497030,237,39
1,148,0.15428571428571428,0.5408653846153846,78763433,175,27
1,475,0.2692307692307692,0.5470085470085471,69680702,650,175
1,111,0.38333333333333336,0.864,69165264,180,69
0,104,0.07964601769911504,0.4625668449197861,62841205,113,9
0,95,0.07766990291262135,0.4889380530973451,70251013,103,8
1,71,0.29,0.7055837563451777,82116853,100,29
0,240,0.16666666666666666,0.2826666666666667,61400934,288,48
1,48,0.1864406779661017,0.5064935064935064,81973005,59,11
0,80,0.058823529411764705,0.33455882352941174,76805575,85,5
1,491,0.2852983988355167,0.7105901374292644,82042895,687,196
1,141,0.4100418410041841,0.9063444108761329,80110142,239,98
1,431,0.2792642140468227,0.7239024390243902,72900625,598,167
0,322,0.1178082191780822,0.1598360655737705,70645834,365,43
1,252,0.26099706744868034,0.5149501661129569,72135252,341,89
1,101,0.34838709677419355,0.6513157894736842,66272311,155,54
2,27,0.578125,0.9722222222222222,73757642,64,37
1,402,0.3568,0.740909090909091,67657184,625,223
1,275,0.28940568475452194,0.6354344122657581,67553493,387,112
1,51,0.42045454545454547,0.9465648854961832,65633911,88,37
0,212,0.11666666666666667,0.25936599423631124,73706542,240,28
0,79,0.14130434782608695,0.4605809128630705,82150074,92,13
1,81,0.15625,0.5157894736842106,82150088,96,15
1,37,0.2127659574468085,0.5686274509803921,82150094,47,10
1,44,0.16981132075471697,0.5611510791366906,64063601,53,9
1,120,0.1724137931034483,0.5598958333333334,70646765,145,25
0,225,0.1141732283464567,0.4608843537414966,64130374,254,29
0,134,0.1625,0.49719101123595505,70474971,160,26
1,6,0.14285714285714285,0.5,80149799,7,1
1,171,0.13636363636363635,0.5788423153692615,67454975,198,27
1,70,0.2222222222222222,0.6852791878172588,80149873,90,20
0,44,0.2,0.3308270676691729,67279884,55,11
0,40,0.047619047619047616,0.019801980198019802,67279891,42,2
0,57,0.109375,0.088,67279975,64,7
0,51,0.05555555555555555,0.058823529411764705,67279996,54,3
0,52,0.08771929824561403,0.09090909090909091,69184255,57,5
0,56,0.05084745762711865,0.033112582781456956,69184773,59,3
2,1,0.6666666666666666,0.6666666666666666,82022880,3,2
0,246,0.16610169491525423,0.2888402625820569,69621713,295,49
1,265,0.3256997455470738,0.6924882629107981,67122552,393,128
1,46,0.3333333333333333,0.7631578947368421,70036302,69,23
1,84,0.35877862595419846,0.7441860465116279,61989410,131,47
1,81,0.2358490566037736,0.5348837209302325,61989452,106,25
0,62,0.1267605633802817,0.2,61989480,71,9
1,122,0.45535714285714285,0.8900523560209425,80124985,224,102
0,285,0.08360128617363344,0.1087866108786611,80140084,311,26
1,16,0.30434782608695654,0.7272727272727273,80137544,23,7
2,5,0.6153846153846154,0.8888888888888888,82051899,13,8
1,71,0.4132231404958678,0.8992805755395683,66304721,121,50
1,597,0.3200455580865604,0.6238738738738738,79255442,878,281
1,69,0.4152542372881356,0.8238993710691824,81989288,118,49
0,241,0.08365019011406843,0.312874251497006,76805666,263,22
0,219,0.17358490566037735,0.35668789808917195,73266326,265,46
0,183,0.05670103092783505,0.036608863198458574,80071180,194,11
0,476,0.1736111111111111,0.3066914498141264,68047651,576,100
0,71,0.1839080459770115,0.3116279069767442,82126622,87,16
0,105,0.027777777777777776,0.06130268199233716,78763062,108,3
1,15,0.34782608695652173,0.7058823529411765,69184080,23,8
1,210,0.36936936936936937,0.8344086021505376,69534283,333,123
1,81,0.2767857142857143,0.6822429906542056,69072255,112,31
1,26,0.3333333333333333,0.6290322580645161,71488424,39,13
2,30,0.7540983606557377,0.9259259259259259,82049157,122,92
1,36,0.3333333333333333,0.686046511627907,65281153,54,18
2,79,0.5380116959064327,0.8679245283018868,72410926,171,92
2,45,0.5544554455445545,0.8666666666666667,80018715,101,56
1,128,0.3191489361702128,0.7191011235955056,81967344,188,60
2,47,0.6299212598425197,0.9553571428571429,73372915,127,80
1,46,0.41025641025641024,0.7049180327868853,80126981,78,32
1,237,0.3323943661971831,0.7416481069042317,81963805,355,118
1,247,0.13333333333333333,0.5121693121693122,70659043,285,38
1,114,0.2597402597402597,0.6634615384615384,68533801,154,40
0,214,0.18007662835249041,0.32134831460674157,80181323,261,47
1,99,0.3076923076923077,0.7302325581395349,80109666,143,44
1,408,0.2867132867132867,0.6572164948453608,80111724,572,164
1,164,0.3387096774193548,0.7824933687002652,67766713,248,84
0,619,0.05927051671732523,0.2213053263315829,64248856,658,39
0,93,0.03125,0.12296983758700696,82049105,96,3
1,66,0.48031496062992124,0.9795918367346939,82124909,127,61
1,122,0.2781065088757396,0.6286764705882353,80136480,169,47
1,509,0.44065934065934065,0.952443857331572,68531323,910,401
1,349,0.4572317262830482,0.9465408805031447,82126707,643,294
0,68,0.09333333333333334,0.07339449541284404,68757346,75,7
0,10,0.09090909090909091,0.0,68757374,11,1
0,47,0.09615384615384616,0.10416666666666667,68757381,52,5
0,272,0.21613832853025935,0.4837758112094395,68391925,347,75
0,104,0.168,0.375968992248062,82166798,125,21
1,66,0.42105263157894735,0.84251968503937,69982962,114,48
1,31,0.32608695652173914,0.8837209302325582,80108560,46,15
0,150,0.06832298136645963,0.321285140562249,82103948,161,11
0,91,0.1651376146788991,0.33962264150943394,82166804,109,18
2,25,0.5535714285714286,0.9782608695652174,81989146,56,31
1,173,0.37545126353790614,0.8529411764705882,68531155,277,104
1,151,0.351931330472103,0.7682119205298014,66326484,233,82
1,341,0.3207171314741036,0.7812018489984591,80160458,502,161
1,44,0.2413793103448276,0.6370370370370371,69570263,58,14
0,242,0.058365758754863814,0.07643312101910828,69107052,257,15
0,132,0.2,0.22142857142857142,60439372,165,33
0,144,0.15789473684210525,0.15333333333333332,60439414,171,27
1,216,0.43007915567282323,0.8560606060606061,82007137,379,163
0,250,0.2113564668769716,0.4444444444444444,66892693,317,67
1,189,0.4341317365269461,0.8714859437751004,68756016,334,145
2,9,0.7096774193548387,0.9090909090909091,78013761,31,22
0,146,0.16091954022988506,0.33060109289617484,80098655,174,28
0,342,0.03932584269662921,0.025510204081632654,69107024,356,14
1,203,0.3366013071895425,0.7468671679197995,67552331,306,103
2,15,0.6511627906976745,0.8571428571428571,70567273,43,28
2,56,0.5254237288135594,0.9642857142857143,72417961,118,62
0,65,0.23529411764705882,0.40336134453781514,65008104,85,20
1,50,0.47368421052631576,0.6341463414634146,72469684,95,45
0,175,0.09326424870466321,0.3897058823529412,62835353,193,18
1,88,0.30158730158730157,0.6834862385321101,69184206,126,38
0,190,0.17391304347826086,0.4758842443729904,63769664,230,40
0,562,0.23328785811732605,0.4871086556169429,68542194,733,171
1,111,0.3657142857142857,0.8533834586466166,69177724,175,64
0,22,0.2903225806451613,0.42857142857142855,66050404,31,9
0,341,0.23370786516853934,0.48058902275769744,80105781,445,104
1,527,0.2629370629370629,0.6049382716049383,68170620,715,188
1,455,0.360056258790436,0.828125,70599480,711,256
1,31,0.24390243902439024,0.5119047619047619,67551911,41,10
1,183,0.25,0.5511551155115512,67554235,244,61
1,406,0.22666666666666666,0.5464362850971922,73637606,525,119
0,269,0.20414201183431951,0.3826086956521739,67554200,338,69
0,517,0.12224108658743633,0.19950433705080545,68539793,589,72
0,198,0.18181818181818182,0.24107142857142858,80152858,242,44
1,109,0.2875816993464052,0.6654411764705882,67551855,153,44
2,13,0.6666666666666666,0.9090909090909091,67823210,39,26
1,175,0.308300395256917,0.7266666666666667,73111696,253,78
1,288,0.31100478468899523,0.6816,67994661,418,130
2,244,0.5522935779816514,0.9823008849557522,63281491,545,301
2,48,0.7108433734939759,0.9230769230769231,80128760,166,118
1,136,0.4944237918215613,0.8924731182795699,80018512,269,133
0,27,0.325,0.4857142857142857,80176084,40,13
0,47,0.04081632653061224,0.06097560975609756,71762642,49,2
1,58,0.35555555555555557,0.792,72776221,90,32
0,33,0.10810810810810811,0.2403846153846154,70678776,37,4
2,114,0.6788732394366197,0.95,80137963,355,241
1,21,0.43243243243243246,0.9285714285714286,79791334,37,16
2,0,1.0,1.0,80176469,4,4
2,0,1.0,1.0,82102171,1,1
2,51,0.575,0.9090909090909091,80176797,120,69
0,92,0.061224489795918366,0.2413793103448276,80124323,98,6
0,78,0.04878048780487805,0.2081447963800905,80124444,82,4
2,2,0.9130434782608695,0.6666666666666666,71199534,23,21
2,110,0.7374701670644391,0.9,80118338,419,309
0,130,0.16129032258064516,0.3270440251572327,69112372,155,25
1,143,0.3222748815165877,0.6831275720164609,80130154,211,68
1,220,0.4037940379403794,0.8702290076335878,65787393,369,149
0,120,0.16666666666666666,0.3034825870646766,64158822,144,24
0,153,0.19473684210526315,0.43,66226846,190,37
0,83,0.056818181818181816,0.18072289156626506,66226874,88,5
1,9,0.35714285714285715,0.72,67569152,14,5
0,72,0.1111111111111111,0.2625,67756416,81,9
0,98,0.10909090909090909,0.32460732984293195,68526290,110,12
0,375,0.08536585365853659,0.05263157894736842,70643223,410,35
1,114,0.44390243902439025,0.9053497942386831,69925751,205,91
0,15,0.0,0.0,66891741,15,0
1,18,0.35714285714285715,0.8461538461538461,66892700,28,10
1,230,0.26282051282051283,0.5592417061611374,73215940,312,82
0,290,0.22459893048128343,0.46469622331691296,80159586,374,84
0,758,0.17248908296943233,0.2895408163265306,68543335,916,158
1,152,0.40625,0.9298245614035088,82126706,256,104
1,111,0.22916666666666666,0.5828729281767956,69895063,144,33
1,373,0.329136690647482,0.7067901234567902,68191501,556,183
0,958,0.054294175715695954,0.02633744855967078,79788212,1013,55
2,17,0.6666666666666666,0.967741935483871,65532565,51,34
2,163,0.5261627906976745,0.9704301075268817,67400410,344,181
1,172,0.3228346456692913,0.7945205479452054,73514014,254,82
1,53,0.345679012345679,0.7043478260869566,80162109,81,28
1,104,0.2777777777777778,0.6128048780487805,70760662,144,40
0,30,0.14285714285714285,0.1826086956521739,70761194,35,5
1,29,0.3829787234042553,0.8860759493670886,80110191,47,18
1,27,0.18181818181818182,0.5394736842105263,913983,33,6
2,22,0.5111111111111111,0.8888888888888888,80181495,45,23
0,321,0.20347394540942929,0.38095238095238093,80159585,403,82
0,247,0.17940199335548174,0.2519280205655527,69177346,301,54
1,350,0.26778242677824265,0.6361355081555834,70597695,478,128
1,153,0.2233502538071066,0.5515463917525774,64915361,197,44
2,12,0.52,0.896551724137931,70491015,25,13
0,118,0.18055555555555555,0.2784313725490196,72293865,144,26
1,496,0.3721518987341772,0.8025078369905956,80136983,790,294
0,139,0.24456521739130435,0.40625,62409354,184,45
1,198,0.3219178082191781,0.638121546961326,69955445,292,94
1,268,0.3881278538812785,0.8562091503267973,80118398,438,170
1,432,0.2859504132231405,0.6632270168855535,65308775,605,173
0,179,0.22510822510822512,0.4411764705882353,70638610,231,52
2,5,0.5833333333333334,0.9166666666666666,80084011,12,7
2,74,0.5795454545454546,0.9375,66848523,176,102
2,1,0.9333333333333333,0.6666666666666666,70634466,15,14
1,176,0.29880478087649404,0.7102564102564103,69622525,251,75
1,39,0.35,0.8333333333333334,63050925,60,21
0,14,0.125,0.11764705882352941,65018905,16,2
1,329,0.25396825396825395,0.5545212765957447,67557735,441,112
2,1,0.6666666666666666,0.8,65867746,3,2
2,109,0.6461038961038961,0.9683544303797469,80062003,308,199
1,65,0.375,0.8714285714285714,69421905,104,39
0,425,0.18582375478927204,0.3791390728476821,67266150,522,97
1,98,0.30985915492957744,0.8076923076923077,80116554,142,44
0,1409,0.20975883342680876,0.4543882403804583,67244520,1783,374
0,430,0.022727272727272728,0.02544529262086514,64241254,440,10
0,583,0.05663430420711974,0.1444976076555024,67800460,618,35
1,74,0.3392857142857143,0.8356164383561644,69165026,112,38
1,62,0.3333333333333333,0.8015873015873016,64238944,93,31
1,90,0.2682926829268293,0.5578231292517006,64238951,123,33
1,21,0.4166666666666667,0.8085106382978723,67993842,36,15
0,223,0.07083333333333333,0.23992673992673993,61948166,240,17
1,10,0.3333333333333333,0.8378378378378378,66046820,15,5
1,52,0.34177215189873417,0.7730496453900709,69133393,79,27
1,282,0.2519893899204244,0.6452020202020202,68497366,377,95
0,161,0.17010309278350516,0.3699731903485255,69800073,194,33
1,11,0.26666666666666666,0.53125,69390594,15,4
2,84,0.5647668393782384,0.9693877551020408,61698560,193,109
0,60,0.03225806451612903,0.07589285714285714,82049106,62,2
1,128,0.2768361581920904,0.6419753086419753,67558043,177,49
2,92,0.742296918767507,0.9,73447591,357,265
1,10,0.2857142857142857,0.5272727272727272,72801925,14,4
2,11,0.5217391304347826,0.9655172413793104,70324870,23,12
0,149,0.17222222222222222,0.22939068100358423,82021922,180,31
0,8,0.1111111111111111,0.27586206896551724,72808736,9,1
2,8,0.5,0.9130434782608695,82002238,16,8
1,234,0.3177842565597668,0.7137681159420289,80137369,343,109
2,5,0.6428571428571429,0.9,80118191,14,9
0,66,0.05714285714285714,0.14,65839956,70,4
1,78,0.3333333333333333,0.7183908045977011,66856650,117,39
1,261,0.2647887323943662,0.5242566510172144,69176744,355,94
1,291,0.3518930957683742,0.7621722846441947,68751193,449,158
0,655,0.1933497536945813,0.3974609375,80125485,812,157
0,191,0.2625482625482625,0.4701492537313433,70486563,259,68
1,167,0.21962616822429906,0.5846560846560847,69168386,214,47
2,1,0.5,0.6666666666666666,70048041,2,1
2,4,0.8181818181818182,0.8,80083283,22,18
1,345,0.30303030303030304,0.6807580174927114,81967253,495,150
1,172,0.31746031746031744,0.7625,81980732,252,80
1,118,0.4460093896713615,0.8963730569948186,70197792,213,95
1,93,0.3404255319148936,0.7536945812807881,66856692,141,48
2,38,0.7226277372262774,0.9473684210526315,82052563,137,99
1,39,0.4264705882352941,0.9074074074074074,68509483,68,29
1,447,0.41568627450980394,0.9176954732510288,63281463,765,318
1,33,0.34,0.7905405405405406,69180475,50,17
0,515,0.07871198568872988,0.06811145510835913,65906435,559,44
0,69,0.15853658536585366,0.4206008583690987,60513985,82,13
0,26,0.07142857142857142,0.041237113402061855,61186895,28,2
1,120,0.25,0.5868263473053892,70906514,160,40
1,73,0.4065040650406504,0.8553459119496856,71288616,123,50
1,62,0.3333333333333333,0.5673076923076923,71288623,93,31
0,260,0.10034602076124567,0.12142857142857143,70071092,289,29
0,269,0.06920415224913495,0.0671462829736211,70071113,289,20
0,290,0.1495601173020528,0.24173027989821882,62940514,341,51
0,183,0.12857142857142856,0.38323353293413176,82150073,210,27
2,26,0.8497109826589595,0.9787234042553191,80181500,173,147
1,12,0.3684210526315789,0.6363636363636364,69997746,19,7
1,60,0.2857142857142857,0.6617647058823529,82018896,84,24
1,75,0.4966442953020134,0.9392523364485982,81975745,149,74
0,154,0.05521472392638037,0.1956521739130435,80126907,163,9
1,17,0.46875,0.9285714285714286,82023688,32,15
1,156,0.35269709543568467,0.7060240963855422,70209405,241,85
1,48,0.29411764705882354,0.5592105263157895,80137383,68,20
1,206,0.2589928057553957,0.7476190476190476,67793033,278,72
1,299,0.44320297951582865,0.8949152542372881,80118368,537,238
1,76,0.3821138211382114,0.6055045871559633,70567770,123,47
1,137,0.4497991967871486,0.7482993197278912,72433564,249,112
1,293,0.2563451776649746,0.574025974025974,80119006,394,101
0,202,0.2109375,0.46798029556650245,70760690,256,54
1,299,0.24111675126903553,0.5654520917678812,67159134,394,95
1,161,0.3611111111111111,0.7943037974683544,80180345,252,91
0,699,0.0411522633744856,0.1270148291424887,68356442,729,30
0,177,0.10152284263959391,0.12238805970149254,64158332,197,20
1,67,0.4806201550387597,0.9724770642201835,75471172,129,62
1,379,0.252465483234714,0.5224625623960066,67435900,507,128
0,197,0.17916666666666667,0.3388888888888889,82011787,240,43
1,207,0.1752988047808765,0.5761245674740484,78763531,251,44
1,44,0.40540540540540543,0.8214285714285714,76081271,74,30
1,121,0.38578680203045684,0.8762541806020067,67149096,197,76
0,246,0.2360248447204969,0.38386308068459657,69177444,322,76
1,54,0.16923076923076924,0.6853932584269663,82150118,65,11
0,7,0.125,0.13333333333333333,262843,8,1
1,487,0.34979973297730305,0.8189189189189189,69157200,749,262
0,273,0.19469026548672566,0.37538461538461537,68535712,339,66
0,154,0.2182741116751269,0.45345345345345345,69412882,197,43
0,237,0.10566037735849057,0.3435114503816794,78763524,265,28
0,285,0.11214953271028037,0.13333333333333333,73906084,321,36
1,108,0.2116788321167883,0.5849802371541502,63769706,137,29
1,431,0.24385964912280703,0.5832305795314426,68543853,570,139
0,203,0.1976284584980237,0.381294964028777,68533563,253,50
1,316,0.36926147704590817,0.7893462469733656,80168013,501,185
0,47,0.09615384615384616,0.21739130434782608,82150095,52,5
2,33,0.5285714285714286,0.927710843373494,75048246,70,37
2,36,0.7333333333333333,0.9347826086956522,70646954,135,99
2,3,0.7692307692307693,0.75,80090171,13,10
1,367,0.2464065708418891,0.5515789473684211,80137642,487,120
0,114,0.16176470588235295,0.425,60638172,136,22
1,101,0.2230769230769231,0.6025641025641025,62916385,130,29
1,280,0.22437673130193905,0.6631393298059964,300615,361,81
1,144,0.45660377358490567,0.9410112359550562,67553731,265,121
0,2,0.3333333333333333,0.4,66253565,3,1
1,39,0.4264705882352941,0.775,82009602,68,29
1,57,0.4818181818181818,0.9328859060402684,82018970,110,53
1,92,0.3825503355704698,0.8533333333333334,67240544,149,57
0,151,0.06790123456790123,0.28860759493670884,64241051,162,11
2,66,0.5251798561151079,0.9369369369369369,80176025,139,73
0,189,0.2125,0.3880952380952381,70545804,240,51
1,278,0.24864864864864866,0.6794380587484036,74020583,370,92
1,314,0.4422735346358792,0.9298642533936652,69219052,563,249
1,200,0.23954372623574144,0.5263157894736842,69607195,263,63
1,228,0.4841628959276018,0.9403292181069959,65798502,442,214
0,242,0.14788732394366197,0.2367549668874172,80091144,284,42
1,147,0.2422680412371134,0.5661764705882353,81976694,194,47
0,215,0.20074349442379183,0.40714285714285714,82095679,269,54
1,118,0.15714285714285714,0.5236768802228412,69168316,140,22
1,40,0.1111111111111111,0.5167785234899329,63428750,45,5
0,60,0.0,0.0,66344390,60,0
1,50,0.45054945054945056,0.907563025210084,82096424,91,41
0,162,0.24299065420560748,0.4829787234042553,73200001,214,52
1,650,0.23708920187793428,0.6477927063339731,64225756,852,202
1,43,0.4691358024691358,0.9642857142857143,68639382,81,38
1,73,0.2912621359223301,0.7651821862348178,80124661,103,30
1,30,0.3181818181818182,0.7790697674418605,68318313,44,14
1,48,0.22580645161290322,0.5148514851485149,75523021,62,14
0,311,0.16172506738544473,0.2828146143437077,70040880,371,60
2,106,0.5431034482758621,0.9659442724458205,80169866,232,126
0,154,0.20207253886010362,0.46359223300970875,80069990,193,39
1,75,0.4230769230769231,0.9106145251396648,74922351,130,55
0,32,0.21951219512195122,0.4189189189189189,82124930,41,9
0,41,0.18,0.2288135593220339,67627525,50,9
1,134,0.3557692307692308,0.8709677419354839,69602932,208,74
1,349,0.3584558823529412,0.7492063492063492,803684,544,195
1,20,0.4594594594594595,0.7894736842105263,80028452,37,17
0,121,0.20394736842105263,0.4647058823529412,67731881,152,31
0,242,0.09022556390977443,0.08333333333333333,66849552,266,24
0,179,0.13942307692307693,0.23115577889447236,67384534,208,29
0,73,0.24742268041237114,0.46218487394957986,80053386,97,24
1,79,0.3923076923076923,0.8954545454545455,69056631,130,51
1,132,0.21428571428571427,0.5013550135501355,72758770,168,36
1,181,0.311787072243346,0.7440476190476191,66892420,263,82
1,201,0.3044982698961938,0.6934097421203438,80083332,289,88
1,170,0.28270042194092826,0.6076388888888888,67558253,237,67
2,18,0.6727272727272727,0.8823529411764706,81966950,55,37
1,169,0.27467811158798283,0.576271186440678,82126649,233,64
0,156,0.20812182741116753,0.42016806722689076,68641965,197,41
0,57,0.017241379310344827,0.028846153846153848,73905993,58,1
1,192,0.4973821989528796,0.9148936170212766,72322166,382,190
1,498,0.3790523690773067,0.8177676537585421,70713153,802,304
1,25,0.40476190476190477,0.8513513513513513,80131237,42,17
0,439,0.1392156862745098,0.15579710144927536,80114643,510,71
0,215,0.16666666666666666,0.23552123552123552,70207781,258,43
1,188,0.4031746031746032,0.8552875695732839,80156294,315,127
1,42,0.3333333333333333,0.8173076923076923,70240800,63,21
1,204,0.25547445255474455,0.5225225225225225,82126747,274,70
1,92,0.264,0.6044776119402985,70760893,125,33
1,379,0.4728789986091794,0.9247842170160296,74478313,719,340
0,131,0.2155688622754491,0.3654970760233918,69724032,167,36
0,259,0.10380622837370242,0.10534351145038168,68538484,289,30
0,230,0.2041522491349481,0.348643006263048,82128654,289,59
0,579,0.2079343365253078,0.35051546391752575,82128655,731,152
0,182,0.19823788546255505,0.3146067415730337,73524654,227,45
1,62,0.30337078651685395,0.7074829931972789,68761665,89,27
1,34,0.48484848484848486,0.9397590361445783,80096401,66,32
0,78,0.16129032258064516,0.4245810055865922,80128257,93,15
0,145,0.11585365853658537,0.29846938775510207,80128314,164,19
0,374,0.1480637813211845,0.24185463659147868,67963231,439,65
2,88,0.5392670157068062,0.9761904761904762,67307275,191,103
1,268,0.4585858585858586,0.8966101694915254,70626521,495,227
0,309,0.022151898734177215,0.014184397163120567,67285785,316,7
0,107,0.10833333333333334,0.23346303501945526,80128275,120,13
0,209,0.17063492063492064,0.22520661157024793,68532975,252,43
1,5,0.4444444444444444,0.7894736842105263,76080851,9,4
1,8,0.38461538461538464,0.9242424242424242,71537522,13,5
1,85,0.3359375,0.723404255319149,69208223,128,43
2,14,0.9399141630901288,0.9166666666666666,63596792,233,219
2,13,0.6176470588235294,0.8125,66284113,34,21
1,35,0.18604651162790697,0.6078431372549019,66404282,43,8
2,380,0.5606936416184971,0.9613034623217923,66811752,865,485
2,33,0.5875,0.7708333333333334,68384253,80,47
0,33,0.23255813953488372,0.4375,82143803,43,10
0,528,0.1864406779661017,0.3917525773195876,69534605,649,121
0,775,0.14835164835164835,0.2676450034940601,70608902,910,135
1,218,0.3057324840764331,0.7023172905525846,69179712,314,96
1,113,0.39893617021276595,0.8527131782945736,62804154,188,75
1,198,0.2978723404255319,0.6904276985743381,70641543,282,84
1,272,0.30612244897959184,0.7086614173228346,69607034,392,120
1,86,0.29508196721311475,0.8158995815899581,68533815,122,36
0,136,0.2046783625730994,0.3984375,65816632,171,35
1,82,0.3492063492063492,0.7164179104477612,66860024,126,44
0,118,0.2716049382716049,0.4982456140350877,67911403,162,44
0,223,0.04700854700854701,0.08997050147492626,66382246,234,11
1,28,0.3488372093023256,0.6538461538461539,80111682,43,15
0,85,0.07608695652173914,0.3318777292576419,63527310,92,7
1,27,0.4,0.9148936170212766,67553955,45,18
1,15,0.4230769230769231,0.8846153846153846,65281314,26,11
1,62,0.48333333333333334,0.8160919540229885,69944476,120,58
2,20,0.574468085106383,0.8181818181818182,69944560,47,27
0,20,0.13043478260869565,0.4090909090909091,80128187,23,3
0,152,0.10059171597633136,0.35502958579881655,80149880,169,17
0,95,0.13636363636363635,0.48770491803278687,80149883,110,15
0,129,0.07857142857142857,0.34210526315789475,80149885,140,11
0,121,0.11678832116788321,0.4334470989761092,80149865,137,16
0,118,0.04838709677419355,0.11538461538461539,69024235,124,6
0,25,0.1935483870967742,0.391304347826087,80128102,31,6
0,106,0.07017543859649122,0.03361344537815126,66424281,114,8
1,160,0.3305439330543933,0.7743732590529248,67281760,239,79
2,3,0.8421052631578947,0.8333333333333334,65008125,19,16
0,252,0.09025270758122744,0.06110283159463487,77676550,277,25
1,88,0.4358974358974359,0.9027237354085603,68211416,156,68
1,266,0.23782234957020057,0.5476718403547672,70816550,349,83
1,77,0.33620689655172414,0.8058252427184466,69177451,116,39
0,4,0.2,0.2727272727272727,69557082,5,1
0,83,0.16161616161616163,0.1888111888111888,63213220,99,16
1,132,0.1592356687898089,0.5944272445820433,65839802,157,25
0,162,0.16494845360824742,0.37110481586402266,68538561,194,32
1,36,0.35714285714285715,0.651685393258427,80119268,56,20
2,14,0.5483870967741935,0.9629629629629629,67646943,31,17
1,59,0.44339622641509435,0.963302752293578,70867293,106,47
0,54,0.22857142857142856,0.4782608695652174,70047663,70,16
0,249,0.04597701149425287,0.17997465145754118,82049094,261,12
2,0,1.0,1.0,69975654,1,1
2,70,0.6022727272727273,0.925,80145466,176,106
2,37,0.5795454545454546,0.84375,66243065,88,51
2,2,0.75,0.8888888888888888,70222243,8,6
1,453,0.31155015197568386,0.7487828627069133,82128665,658,205
2,13,0.8452380952380952,0.9642857142857143,80118606,84,71
2,30,0.5384615384615384,0.9375,80128024,65,35
0,50,0.21875,0.48520710059171596,70063861,64,14
1,24,0.35135135135135137,0.6190476190476191,80053876,37,13
2,166,0.5270655270655271,0.9347826086956522,72322005,351,185
2,82,0.536723163841808,0.9217391304347826,72433522,177,95
2,12,0.7142857142857143,0.96,69587812,42,30
0,51,0.25,0.38271604938271603,82005339,68,17
1,19,0.32142857142857145,0.8181818181818182,69712153,28,9
1,23,0.25806451612903225,0.6435643564356436,69712174,31,8
1,111,0.3231707317073171,0.696969696969697,70508585,164,53
0,71,0.22826086956521738,0.34959349593495936,70676613,92,21
1,164,0.31092436974789917,0.8068181818181818,65354975,238,74
0,430,0.13306451612903225,0.16173361522198731,67554291,496,66
0,287,0.1608187134502924,0.21203438395415472,66767652,342,55
0,497,0.1265377855887522,0.15904761904761905,70207186,569,72
1,130,0.3333333333333333,0.695,69150816,195,65
0,139,0.21910112359550563,0.43731778425655976,80121110,178,39
0,839,0.1168421052631579,0.2964458804523425,63226933,950,111
0,45,0.1,0.35714285714285715,61976586,50,5
1,495,0.2826086956521739,0.6397578203834511,80124687,690,195
1,25,0.45652173913043476,0.9047619047619048,70508515,46,21
0,317,0.10451977401129943,0.2806451612903226,67226096,354,37
1,625,0.2541766109785203,0.6014652014652014,68462674,838,213
1,150,0.336283185840708,0.7446153846153846,67761526,226,76
1,288,0.3924050632911392,0.8871794871794871,80110240,474,186
0,239,0.036290322580645164,0.05573248407643312,60028640,248,9
0,374,0.09223300970873786,0.16129032258064516,67437412,412,38
0,191,0.16956521739130434,0.32934131736526945,80098676,230,39
2,255,0.538878842676311,0.9778672032193159,61406793,553,298
1,155,0.23267326732673269,0.5535714285714286,65299374,202,47
0,209,0.17391304347826086,0.2568306010928962,70669312,253,44
0,137,0.11612903225806452,0.1601123595505618,80118396,155,18
1,459,0.33861671469740634,0.8150594451783355,68531386,694,235
1,189,0.3614864864864865,0.7037037037037037,70186382,296,107
2,64,0.5076923076923077,0.9065420560747663,70646814,130,66
2,21,0.7666666666666667,0.9629629629629629,63209384,90,69
2,13,0.7868852459016393,0.9230769230769231,69406743,61,48
0,19,0.45714285714285713,0.0,70853685,35,16
2,276,0.5166374781085814,0.9671052631578947,80096114,571,295
0,30,0.23076923076923078,0.425,80172913,39,9
0,178,0.1981981981981982,0.27411167512690354,80172917,222,44
1,60,0.3258426966292135,0.5909090909090909,80172933,89,29
2,80,0.5428571428571428,0.9594594594594594,69955361,175,95
1,90,0.25,0.5286195286195287,69395676,120,30
0,14,0.06666666666666667,0.4090909090909091,70417165,15,1
1,46,0.17857142857142858,0.5390070921985816,70608510,56,10
1,81,0.22115384615384615,0.5545851528384279,80132271,104,23
1,59,0.34444444444444444,0.773109243697479,63774333,90,31
1,34,0.37037037037037035,0.8282828282828283,79783354,54,20
0,312,0.1746031746031746,0.4171270718232044,70209713,378,66
0,96,0.14285714285714285,0.2979942693409742,63141631,112,16
0,193,0.03980099502487562,0.029082774049217,63141071,201,8
1,223,0.2920634920634921,0.5967213114754099,67029592,315,92
1,428,0.22603978300180833,0.562618595825427,72907821,553,125
1,124,0.3641025641025641,0.8269230769230769,74576831,195,71
0,87,0.1792452830188679,0.22388059701492538,69184346,106,19
0,60,0.25925925925925924,0.47530864197530864,69184584,81,21
1,40,0.23076923076923078,0.5,70968730,52,12
1,55,0.367816091954023,0.896551724137931,67557252,87,32
1,96,0.3142857142857143,0.8052631578947368,67435942,140,44
0,217,0.24125874125874125,0.4231536926147705,67995060,286,69
1,38,0.2830188679245283,0.625,65360526,53,15
0,39,0.22,0.23076923076923078,80161898,50,11
1,456,0.2487644151565074,0.5361904761904762,72932272,607,151
0,398,0.13665943600867678,0.391578947368421,67801006,461,63
1,25,0.4444444444444444,0.9324324324324325,80176610,45,20
1,9,0.4375,0.9333333333333333,70756791,16,7
0,73,0.1978021978021978,0.37438423645320196,80124765,91,18
1,167,0.3373015873015873,0.7784256559766763,69165243,252,85
1,327,0.22511848341232227,0.512751677852349,68534242,422,95
0,187,0.09223300970873786,0.08545034642032333,69625150,206,19
0,50,0.12280701754385964,0.125,70670460,57,7
1,296,0.21485411140583555,0.5334370139968896,63277746,377,81
1,212,0.3312302839116719,0.7642585551330798,80130315,317,105
0,116,0.11450381679389313,0.18329466357308585,80119054,131,15
1,41,0.4875,0.872093023255814,69733090,80,39
1,143,0.24736842105263157,0.6071428571428571,69056540,190,47
2,148,0.5050167224080268,0.9323529411764706,80163510,299,151
1,55,0.32926829268292684,0.7867647058823529,68535943,82,27
1,92,0.3235294117647059,0.6341463414634146,67203913,136,44
0,279,0.2096317280453258,0.45152722443559096,65029811,353,74
1,145,0.4423076923076923,0.9429530201342282,63774543,260,115
1,365,0.34587813620071683,0.798175598631699,70241234,558,193
0,415,0.07777777777777778,0.10810810810810811,80137330,450,35
1,544,0.38181818181818183,0.8028545941123997,68588485,880,336
0,346,0.20092378752886836,0.37617135207496655,67435823,433,87
2,23,0.54,0.9166666666666666,65866052,50,27
1,78,0.30357142857142855,0.5240963855421686,62400275,112,34
0,375,0.1515837104072398,0.21217712177121772,67630626,442,67
1,173,0.2543103448275862,0.5714285714285714,67552086,232,59
1,287,0.43280632411067194,0.9011725293132329,65008650,506,219
2,44,0.8981481481481481,0.9910714285714286,80125792,432,388
0,328,0.13910761154855644,0.2108843537414966,70626955,381,53
2,11,0.897196261682243,0.9,80145903,107,96
1,147,0.4048582995951417,0.8914027149321267,80089345,247,100
0,281,0.24866310160427807,0.4760914760914761,69177276,374,93
0,561,0.19280575539568345,0.395260663507109,81989974,695,134
1,79,0.24761904761904763,0.5605381165919282,80118966,105,26
1,253,0.44880174291938996,0.9123222748815166,73850784,459,206
2,79,0.5797872340425532,0.9846938775510204,67438294,188,109
2,47,0.8025210084033614,0.9789473684210527,72642311,238,191
2,1,0.6666666666666666,0.5,65812362,3,2
2,83,0.5088757396449705,0.9372197309417041,69039355,169,86
1,93,0.3357142857142857,0.7532894736842105,72932314,140,47
0,258,0.09154929577464789,0.11290322580645161,80114601,284,26
1,126,0.29608938547486036,0.5961538461538461,80114706,179,53
1,56,0.30864197530864196,0.7272727272727273,82021839,81,25
0,88,0.10204081632653061,0.25142857142857145,82021855,98,10
0,227,0.2007042253521127,0.3605313092979127,70870975,284,57
1,109,0.1349206349206349,0.6,62834695,126,17
1,264,0.40540540540540543,0.908183632734531,67160380,444,180
1,82,0.42657342657342656,0.7869822485207101,66872162,143,61
0,349,0.19399538106235567,0.2905405405405405,67552100,433,84
0,71,0.12345679012345678,0.3926940639269406,63269941,81,10
1,369,0.30639097744360905,0.6704161979752531,73747842,532,163
0,229,0.277602523659306,0.49411764705882355,72077831,317,88
0,167,0.16080402010050251,0.3064182194616977,77676585,199,32
0,69,0.014285714285714285,0.037267080745341616,82008945,70,1
0,296,0.05128205128205128,0.010914051841746248,68539653,312,16
0,361,0.14251781472684086,0.3905325443786982,811720,421,60
1,168,0.28205128205128205,0.5953079178885631,81967275,234,66
1,116,0.372972972972973,0.7723214285714286,69636945,185,69
1,97,0.44886363636363635,0.8860294117647058,65967832,176,79
0,47,0.16071428571428573,0.46956521739130436,70324653,56,9
2,446,0.6521060842433697,0.9876390605686032,69622721,1282,836
1,69,0.49264705882352944,0.8473282442748091,54291174,136,67
1,84,0.35877862595419846,0.755656108597285,67805815,131,47
0,614,0.2178343949044586,0.4838709677419355,81965678,785,171
1,55,0.19117647058823528,0.5578231292517006,71080996,68,13
1,176,0.34814814814814815,0.8170731707317073,67994143,270,94
1,128,0.42342342342342343,0.8893280632411067,62510175,222,94
1,164,0.31950207468879666,0.7002457002457002,65352364,241,77
1,7,0.3,0.5,82103837,10,3
1,97,0.2706766917293233,0.6347305389221557,80130623,133,36
1,170,0.33070866141732286,0.7513661202185792,81967329,254,84
0,2,0.0,0.0,69468161,2,0
1,220,0.32926829268292684,0.6337349397590362,70673435,328,108
0,637,0.07007299270072993,0.046625766871165646,79822435,685,48
0,120,0.14285714285714285,0.3926553672316384,67899440,140,20
2,195,0.513715710723192,0.941320293398533,73503311,401,206
1,88,0.3178294573643411,0.8162393162393162,80121192,129,41
1,93,0.18421052631578946,0.5245283018867924,82103784,114,21
0,64,0.015384615384615385,0.020134228187919462,521773,65,1
0,46,0.09803921568627451,0.30952380952380953,521836,51,5
1,46,0.3611111111111111,0.776,71826055,72,26
0,44,0.043478260869565216,0.021052631578947368,79650830,46,2
2,155,0.5110410094637224,0.9377049180327869,68941950,317,162
2,11,0.6666666666666666,0.9583333333333334,79807602,33,22
1,194,0.2421875,0.5263157894736842,67551883,256,62
1,661,0.28771551724137934,0.6609894566098946,68536034,928,267
0,207,0.16194331983805668,0.35313001605136435,73194786,247,40
1,38,0.24,0.6846153846153846,79807581,50,12
0,178,0.1981981981981982,0.3696808510638298,67554382,222,44
2,3,0.875,0.8,67753742,24,21
0,11,0.21428571428571427,0.26666666666666666,69954360,14,3
1,78,0.2641509433962264,0.5608108108108109,70064190,106,28
0,102,0.15702479338842976,0.2430939226519337,68499655,121,19
0,92,0.09803921568627451,0.0847457627118644,68499851,102,10
1,87,0.24347826086956523,0.5056179775280899,68499921,115,28
0,198,0.16806722689075632,0.2157676348547718,80130006,238,40
1,116,0.2883435582822086,0.6423357664233577,67833731,163,47
1,194,0.27611940298507465,0.6062271062271062,73024966,268,74
1,66,0.23255813953488372,0.5439560439560439,68533500,86,20
1,164,0.24770642201834864,0.526595744680851,82046858,218,54
1,141,0.30198019801980197,0.7907608695652174,67513936,202,61
1,232,0.27044025157232704,0.5538694992412747,80120431,318,86
1,16,0.42857142857142855,0.8108108108108109,71288630,28,12
0,154,0.16304347826086957,0.40124740124740127,82039201,184,30
1,182,0.2661290322580645,0.5,67553801,248,66
1,25,0.3902439024390244,0.7272727272727273,69399386,41,16
1,118,0.2670807453416149,0.5175097276264592,80108413,161,43
1,68,0.37037037037037035,0.8854961832061069,82129389,108,40
2,118,0.5062761506276151,0.9055793991416309,82021234,239,121
1,17,0.41379310344827586,0.8837209302325582,69180650,29,12
1,122,0.39,0.9283582089552239,81967360,200,78
0,158,0.18134715025906736,0.31493506493506496,82129382,193,35
1,194,0.23622047244094488,0.5564053537284895,82045965,254,60
0,77,0.1348314606741573,0.16176470588235295,67657863,89,12
1,36,0.35714285714285715,0.8095238095238095,67514104,56,20
1,117,0.4,0.8782287822878229,80107433,195,78
1,63,0.47058823529411764,0.9647058823529412,69165656,119,56
1,320,0.3402061855670103,0.8027888446215139,65355612,485,165
2,28,0.5483870967741935,0.9347826086956522,80176848,62,34
1,145,0.3983402489626556,0.8279569892473119,82021854,241,96
1,13,0.3157894736842105,0.82,70843136,19,6
1,131,0.28804347826086957,0.7184873949579832,70720006,184,53
0,10,0.09090909090909091,0.391304347826087,72392866,11,1
2,3,0.6666666666666666,0.8571428571428571,79792685,9,6
1,3,0.25,0.5909090909090909,69149283,4,1
0,359,0.2345415778251599,0.42012578616352203,74445602,469,110
2,10,0.5,0.8928571428571429,61501601,20,10
0,302,0.21963824289405684,0.38345864661654133,69607825,387,85
0,16,0.2,0.47058823529411764,66305043,20,4
0,46,0.17857142857142858,0.28717948717948716,82126655,56,10
1,14,0.391304347826087,0.9411764705882353,74708991,23,9
1,175,0.2971887550200803,0.7409638554216867,80125653,249,74
2,138,0.5740740740740741,0.9744318181818182,80137982,324,186
1,12,0.3684210526315789,0.875,66304994,19,7
0,139,0.24456521739130435,0.46070460704607047,70829080,184,45
1,45,0.296875,0.8285714285714286,80121127,64,19
1,51,0.34615384615384615,0.8636363636363636,68497093,78,27
1,45,0.4155844155844156,0.8877551020408163,63967932,77,32
0,202,0.1952191235059761,0.44660194174757284,80168508,251,49
0,92,0.21367521367521367,0.4656084656084656,66554376,117,25
1,208,0.2463768115942029,0.5208791208791209,69607720,276,68
0,20,0.23076923076923078,0.4423076923076923,66305155,26,6
0,19,0.17391304347826086,0.18421052631578946,66305162,23,4
1,154,0.3031674208144796,0.746875,68533822,221,67
0,613,0.08233532934131736,0.07090464547677261,80118142,668,55
1,115,0.40414507772020725,0.8432601880877743,82002233,193,78
1,23,0.28125,0.6333333333333333,68211353,32,9
1,102,0.41714285714285715,0.89453125,80097976,175,73
1,242,0.4462242562929062,0.8837719298245614,80125109,437,195
0,116,0.13432835820895522,0.25301204819277107,80159750,134,18
2,239,0.579225352112676,0.9732142857142857,68191984,568,329
1,86,0.3582089552238806,0.8530612244897959,81980715,134,48
1,235,0.3472222222222222,0.836,69176716,360,125
1,213,0.28523489932885904,0.6063348416289592,69680723,298,85
1,121,0.3045977011494253,0.6794871794871795,65756131,174,53
0,55,0.11290322580645161,0.07058823529411765,79568685,62,7
0,66,0.10810810810810811,0.06962025316455696,79568713,74,8
2,20,0.8601398601398601,0.7272727272727273,67797590,143,123
0,125,0.1987179487179487,0.4151436031331593,66903305,156,31
0,234,0.16725978647686832,0.36893203883495146,70660310,281,47
0,46,0.16363636363636364,0.2727272727272727,62046691,55,9
0,14,0.125,0.21739130434782608,80018911,16,2
1,78,0.4,0.9170731707317074,66864252,130,52
0,294,0.08978328173374613,0.10771470160116449,82011826,323,29
0,191,0.18025751072961374,0.35148514851485146,80122390,233,42
1,206,0.2426470588235294,0.5768421052631579,80122395,272,66
1,102,0.2916666666666667,0.6435643564356436,65859612,144,42
0,97,0.10185185185185185,0.26052631578947366,82008943,108,11
1,263,0.15434083601286175,0.535006605019815,80165691,311,48
0,90,0.1346153846153846,0.4395973154362416,82008941,104,14
1,106,0.3333333333333333,0.5185185185185185,68191956,159,53
1,163,0.25229357798165136,0.6330049261083743,70633724,218,55
1,157,0.3403361344537815,0.8176100628930818,68532814,238,81
2,321,0.5926395939086294,0.9865229110512129,70395332,788,467
1,54,0.3333333333333333,0.7421875,70064120,81,27
0,14,0.0,0.0,69204800,14,0
1,10,0.4117647058823529,0.8,69735064,17,7
0,70,0.125,0.27149321266968324,69737374,80,10
1,428,0.31738437001594894,0.7142857142857143,68212123,627,199
0,418,0.24684684684684685,0.43543543543543545,79145696,555,137
1,153,0.424812030075188,0.8665158371040724,69162562,266,113
2,2,0.7777777777777778,0.3333333333333333,66237780,9,7
0,121,0.14788732394366197,0.25663716814159293,72315250,142,21
0,122,0.0962962962962963,0.09090909090909091,72315264,135,13
0,351,0.1912442396313364,0.26,82062465,434,83
1,29,0.4528301886792453,0.9021739130434783,80145907,53,24
0,360,0.1044776119402985,0.11829436038514443,80119383,402,42
0,75,0.25,0.47586206896551725,70818874,100,25
2,146,0.5852272727272727,0.9545454545454546,65600402,352,206
1,132,0.3944954128440367,0.8705882352941177,82002692,218,86
1,73,0.2980769230769231,0.5070422535211268,81975748,104,31
2,46,0.784037558685446,0.9722222222222222,73411065,213,167
1,43,0.44871794871794873,0.8333333333333334,70183043,78,35
2,16,0.7288135593220338,0.7894736842105263,73410876,59,43
1,172,0.37681159420289856,0.8041237113402062,68283096,276,104
1,147,0.3950617283950617,0.8834355828220859,70562044,243,96
1,98,0.45555555555555555,0.9087136929460581,66563833,180,82
1,51,0.4742268041237113,0.908256880733945,62510252,97,46
2,35,0.573170731707317,0.9811320754716981,82153811,82,47
1,343,0.3875,0.8604368932038835,62375824,560,217
0,51,0.05555555555555555,0.21301775147928995,69204765,54,3
0,18,0.25,0.48936170212765956,72749215,24,6
1,208,0.26501766784452296,0.6323185011709602,69383461,283,75
1,109,0.2875816993464052,0.5628140703517588,68531554,153,44
0,118,0.16901408450704225,0.3993055555555556,69587581,142,24
0,19,0.17391304347826086,0.3333333333333333,69621482,23,4
0,556,0.1871345029239766,0.3497797356828194,82011764,684,128
1,463,0.34232954545454547,0.8317307692307693,80121090,704,241
0,415,0.19573643410852712,0.48711656441717793,60896024,516,101
0,444,0.022026431718061675,0.040697674418604654,62838244,454,10
0,21,0.2222222222222222,0.4074074074074074,80098494,27,6
0,84,0.0967741935483871,0.4175257731958763,61983425,93,9
1,62,0.27906976744186046,0.5193798449612403,63213234,86,24
0,70,0.19540229885057472,0.4444444444444444,66051601,87,17
2,22,0.5416666666666666,0.9487179487179487,67971001,48,26
1,86,0.26495726495726496,0.508,69606894,117,31
0,92,0.18584070796460178,0.35135135135135137,70524594,113,21
0,122,0.18120805369127516,0.4192708333333333,80097703,149,27
0,333,0.09510869565217392,0.30503597122302156,67836944,368,35
1,212,0.42702702702702705,0.9014373716632443,69146931,370,158
0,4,0.0,0.0,82201357,4,0
1,146,0.2946859903381642,0.7680412371134021,63278880,207,61
0,220,0.2198581560283688,0.3996101364522417,77676382,282,62
0,90,0.1346153846153846,0.20675105485232068,73914435,104,14
1,108,0.39325842696629215,0.8677685950413223,70910042,178,70
1,137,0.4017467248908297,0.8537735849056604,82096243,229,92
1,56,0.18840579710144928,0.5311004784688995,67742304,69,13
0,186,0.046153846153846156,0.1341991341991342,61946164,195,9
0,294,0.11976047904191617,0.2993710691823899,67226040,334,40
1,123,0.38190954773869346,0.8179190751445087,69558741,199,76
1,43,0.36764705882352944,0.7790697674418605,69634782,68,25
1,91,0.3933333333333333,0.8088235294117647,70781522,150,59
1,232,0.2990936555891239,0.6768916155419223,74978715,331,99
0,107,0.19548872180451127,0.3283582089552239,69056484,133,26
0,280,0.06976744186046512,0.05263157894736842,82095685,301,21
2,7,0.5333333333333333,0.8947368421052632,80130731,15,8
1,229,0.2953846153846154,0.6314432989690721,69967135,325,96
0,256,0.21951219512195122,0.4110236220472441,67555523,328,72
1,234,0.4250614250614251,0.8123393316195373,70713825,407,173
2,10,0.8461538461538461,0.9696969696969697,70395675,65,55
1,29,0.32558139534883723,0.5,66632314,43,14
0,44,0.22807017543859648,0.3050847457627119,68383574,57,13
2,34,0.6458333333333334,0.7272727272727273,69912815,96,62
2,57,0.6298701298701299,0.9838709677419355,69157921,154,97
2,0,1.0,1.0,73819501,3,3
1,161,0.34285714285714286,0.6645367412140575,70576681,245,84
1,281,0.4955116696588869,0.9238578680203046,73321514,557,276
2,23,0.5490196078431373,0.9636363636363636,73348870,51,28
1,300,0.43289224952741023,0.8440944881889764,80079251,529,229
1,9,0.3076923076923077,0.6551724137931034,70562023,13,4
1,19,0.36666666666666664,0.6666666666666666,69644715,30,11
1,243,0.2453416149068323,0.6529680365296804,68536342,322,79
0,79,0.17708333333333334,0.16740088105726872,77015302,96,17
0,243,0.1678082191780822,0.2435129740518962,68534081,292,49
1,79,0.368,0.6746031746031746,70741552,125,46
1,46,0.30303030303030304,0.6739130434782609,69498443,66,20
1,231,0.16606498194945848,0.5964240102171137,82049126,277,46
1,175,0.291497975708502,0.7158590308370044,65944970,247,72
0,47,0.09615384615384616,0.07207207207207207,67617466,52,5
0,54,0.11475409836065574,0.16049382716049382,67617473,61,7
1,149,0.34934497816593885,0.6180555555555556,70634312,229,80
0,35,0.0,0.0,78540791,35,0
1,156,0.24271844660194175,0.5512048192771084,68533745,206,50
1,182,0.4110032362459547,0.8093525179856115,70812882,309,127
2,41,0.5543478260869565,0.9801980198019802,72904132,92,51
0,46,0.17857142857142858,0.2857142857142857,69100934,56,10
0,104,0.23529411764705882,0.45918367346938777,77676935,136,32
1,226,0.23129251700680273,0.5222222222222223,77676543,294,68
1,70,0.36936936936936937,0.6917808219178082,69055714,111,41
0,21,0.08695652173913043,0.037037037037037035,69094354,23,2
1,303,0.3674321503131524,0.8340306834030683,70828506,479,176
0,142,0.1791907514450867,0.33853006681514475,80118671,173,31
1,165,0.3037974683544304,0.7062937062937062,80133411,237,72
0,121,0.07633587786259542,0.09302325581395349,72523213,131,10
0,264,0.10204081632653061,0.17569546120058566,72523220,294,30
0,157,0.07647058823529412,0.09111111111111111,72523276,170,13
2,19,0.5869565217391305,0.9464285714285714,80175667,46,27
1,119,0.2654320987654321,0.5505226480836237,70959994,162,43
1,29,0.3958333333333333,0.7916666666666666,69215153,48,19
1,37,0.4307692307692308,0.8666666666666667,70688254,65,28
1,236,0.39641943734015345,0.8645598194130926,67993835,391,155
2,40,0.574468085106383,0.991304347826087,70234591,94,54
0,73,0.16091954022988506,0.3548387096774194,69390902,87,14
0,130,0.13333333333333333,0.16591928251121077,68299791,150,20
0,268,0.22093023255813954,0.3157894736842105,66272234,344,76
2,0,1.0,1.0,69958000,4,4
1,83,0.4236111111111111,0.9272727272727272,61235006,144,61
2,21,0.7083333333333334,0.9772727272727273,80124710,72,51
0,148,0.2985781990521327,0.463519313304721,66272353,211,63
0,47,0.2878787878787879,0.24691358024691357,80140254,66,19
0,202,0.2109375,0.41387024608501116,70687722,256,54
1,264,0.363855421686747,0.819047619047619,67732805,415,151
0,10,0.09090909090909091,0.37735849056603776,69391203,11,1
1,306,0.2644230769230769,0.5911047345767575,62803041,416,110
2,5,0.6428571428571429,0.9090909090909091,82167963,14,9
0,210,0.22509225092250923,0.3510392609699769,69316884,271,61
0,101,0.2462686567164179,0.3660377358490566,69309212,134,33
0,229,0.25163398692810457,0.4280078895463511,69546540,306,77
0,243,0.09328358208955224,0.3555878084179971,76805652,268,25
2,0,1.0,1.0,75277811,1,1
1,96,0.2727272727272727,0.6581196581196581,69736366,132,36
1,142,0.30392156862745096,0.7352941176470589,82126637,204,62
1,24,0.38461538461538464,0.7166666666666667,69964601,39,15
1,65,0.3627450980392157,0.6567164179104478,74386165,102,37
0,414,0.20384615384615384,0.41287458379578246,70841575,520,106
1,56,0.4766355140186916,0.8598130841121495,69867364,107,51
2,2,0.6666666666666666,0.8,80165166,6,4
2,44,0.7317073170731707,0.9292035398230089,66405143,164,120
1,23,0.425,0.8690476190476191,66101091,40,17
2,24,0.5932203389830508,0.9354838709677419,72198294,59,35
0,499,0.06378986866791744,0.1116564417177914,70254310,533,34
0,8,0.0,0.0,70706174,8,0
0,31,0.11428571428571428,0.3,72909760,35,4
2,13,0.6388888888888888,0.9696969696969697,82023689,36,23
1,23,0.425,0.8225806451612904,80122710,40,17
1,94,0.2824427480916031,0.6137931034482759,66458770,131,37
1,22,0.42105263157894735,0.925,73313891,38,16
1,22,0.26666666666666666,0.5377358490566038,70063616,30,8
0,27,0.0,0.0,80124232,27,0
0,102,0.02857142857142857,0.1125,80124303,105,3
0,60,0.047619047619047616,0.1987179487179487,80124441,63,3
2,14,0.6111111111111112,0.4375,66054471,36,22
2,56,0.8021201413427562,0.9848484848484849,168483,283,227
2,8,0.6190476190476191,0.8571428571428571,69691580,21,13
1,40,0.40298507462686567,0.7575757575757576,590835,67,27
2,25,0.7596153846153846,0.9230769230769231,668444,104,79
1,60,0.3877551020408163,0.8581560283687943,68210723,98,38
0,491,0.2003257328990228,0.40046838407494145,68536503,614,123
1,44,0.46987951807228917,0.9090909090909091,80136472,83,39
1,83,0.3025210084033613,0.7302631578947368,62141485,119,36
0,40,0.14893617021276595,0.22580645161290322,80140195,47,7
1,128,0.2849162011173184,0.6899441340782123,70047642,179,51
1,35,0.2857142857142857,0.5333333333333333,66855852,49,14
0,209,0.09913793103448276,0.16717791411042945,80097234,232,23
1,101,0.4712041884816754,0.9375,64260462,191,90
2,137,0.5124555160142349,0.9012738853503185,80118349,281,144
1,243,0.2702702702702703,0.6007259528130672,67626993,333,90
1,111,0.3620689655172414,0.875,68587435,174,63
0,58,0.18309859154929578,0.2578125,62901363,71,13
1,233,0.30654761904761907,0.7193877551020408,68545834,336,103
1,88,0.4942528735632184,0.925,69148541,174,86
0,204,0.21839080459770116,0.43570057581573896,66931361,261,57
2,28,0.5555555555555556,0.9487179487179487,69692406,63,35
0,252,0.18446601941747573,0.2992957746478873,67553675,309,57
1,45,0.40789473684210525,0.8316831683168316,79989630,76,31
0,265,0.10774410774410774,0.1,67963266,297,32
1,443,0.33182503770739064,0.7552602436323367,69739236,663,220
1,406,0.18309859154929578,0.5010266940451745,73194856,497,91
1,38,0.2692307692307692,0.5735294117647058,82163426,52,14
0,192,0.21311475409836064,0.38114754098360654,80135347,244,52
0,89,0.12745098039215685,0.47194719471947194,67226075,102,13
0,100,0.09090909090909091,0.09907120743034056,70617036,110,10
0,134,0.13548387096774195,0.37815126050420167,66226804,155,21
1,32,0.38461538461538464,0.7307692307692307,79849063,52,20
2,50,0.5934959349593496,0.9844961240310077,74982285,123,73
0,50,0.10714285714285714,0.2727272727272727,72909592,56,6
0,108,0.23404255319148937,0.4794520547945205,67038433,141,33
1,340,0.28721174004192873,0.5905511811023622,67657163,477,137
1,25,0.2647058823529412,0.7952755905511811,80176799,34,9
1,246,0.3147632311977716,0.750524109014675,65984086,359,113
0,68,0.24444444444444444,0.47398843930635837,80135430,90,22
1,371,0.4073482428115016,0.8556291390728477,80136857,626,255
1,199,0.4147058823529412,0.92018779342723,69154771,340,141
1,618,0.2677725118483412,0.6435304198800342,73194982,844,226
1,297,0.1907356948228883,0.5244956772334294,70642670,367,70
2,165,0.5030120481927711,0.9633867276887872,73181360,332,167
1,384,0.3435897435897436,0.8055190538764783,69177626,585,201
0,686,0.19103773584905662,0.3597662771285476,68540024,848,162
0,106,0.13821138211382114,0.17857142857142858,69481783,123,17
0,10,0.23076923076923078,0.42857142857142855,69481790,13,3
0,69,0.23333333333333334,0.4860335195530726,67038475,90,21
1,124,0.3439153439153439,0.7830188679245284,67553262,189,65
1,26,0.36585365853658536,0.828125,70331100,41,15
0,139,0.21468926553672316,0.31343283582089554,67627392,177,38
0,427,0.170873786407767,0.2800361336946703,66087294,515,88
0,345,0.214123006833713,0.3486238532110092,80118955,439,94
0,290,0.14201183431952663,0.27801418439716313,70641592,338,48
0,77,0.10465116279069768,0.08547008547008547,72817276,86,9
0,34,0.2608695652173913,0.3950617283950617,69177675,46,12
0,254,0.030534351145038167,0.09007981755986318,62836522,262,8
0,159,0.08092485549132948,0.4,62849955,173,14
0,84,0.07692307692307693,0.4634146341463415,68356596,91,7
2,24,0.7108433734939759,0.9894736842105263,77318871,83,59
1,217,0.29545454545454547,0.6210045662100456,67281823,308,91
1,49,0.30985915492957744,0.6081871345029239,80162640,71,22
0,520,0.12310286677908938,0.19944979367262725,68561640,593,73
2,29,0.8104575163398693,0.9629629629629629,74314751,153,124
0,423,0.01627906976744186,0.030478955007256895,62837726,430,7
1,158,0.3603238866396761,0.7671232876712328,69127982,247,89
1,280,0.29292929292929293,0.5762004175365344,67803071,396,116
1,353,0.42787682333873583,0.7,68341056,617,264
2,67,0.5705128205128205,0.9523809523809523,69511862,156,89
0,223,0.0860655737704918,0.08872458410351201,80071271,244,21
1,140,0.4573643410852713,0.9198717948717948,82049177,258,118
0,603,0.1222707423580786,0.1568627450980392,68047672,687,84
0,38,0.09523809523809523,0.19047619047619047,70229775,42,4
2,76,0.5846994535519126,0.9617486338797814,80153678,183,107
1,266,0.2590529247910863,0.6292749658002736,80135239,359,93
1,95,0.3262411347517731,0.8008474576271186,65100035,141,46
1,182,0.3973509933774834,0.8461538461538461,80055325,302,120
1,61,0.32967032967032966,0.6408450704225352,80180903,91,30
2,9,0.64,0.9705882352941176,82041901,25,16
0,218,0.17110266159695817,0.31333333333333335,67291406,263,45
2,59,0.6927083333333334,0.9736842105263158,80084032,192,133
1,273,0.28534031413612565,0.6432360742705571,80145288,382,109
1,162,0.40441176470588236,0.8581818181818182,70631512,272,110
1,27,0.35714285714285715,0.7941176470588235,62497225,42,15
2,78,0.5806451612903226,0.9504132231404959,82009748,186,108
1,176,0.3125,0.6980728051391863,80120433,256,80
1,100,0.34210526315789475,0.6737967914438503,80134715,152,52
1,33,0.26666666666666666,0.6212121212121212,80113495,45,12
0,159,0.08092485549132948,0.19607843137254902,80124234,173,14
2,6,0.9076923076923077,0.9090909090909091,76161715,65,59
2,59,0.764,0.9175257731958762,80174910,250,191
0,153,0.31390134529147984,0.4022346368715084,68384344,223,70
1,130,0.2737430167597765,0.6697247706422018,80127850,179,49
0,76,0.10588235294117647,0.22093023255813954,80140076,85,9
2,54,0.5263157894736842,0.859375,69972693,114,60
0,172,0.16097560975609757,0.18672199170124482,66767624,205,33
0,247,0.2108626198083067,0.44285714285714284,80181320,313,66
0,194,0.1415929203539823,0.1784776902887139,70615020,226,32
1,204,0.3108108108108108,0.6763925729442971,80127933,296,92
0,22,0.21428571428571427,0.47058823529411764,66305120,28,6
1,299,0.27427184466019416,0.6262230919765166,74708865,412,113
1,86,0.3064516129032258,0.645320197044335,61501020,124,38
0,473,0.233387358184765,0.4601412714429869,69586160,617,144
1,327,0.2618510158013544,0.5630461922596754,68763926,443,116
1,180,0.21052631578947367,0.519455252918288,82012546,228,48
0,824,0.17928286852589642,0.28924833491912466,67705953,1004,180
1,78,0.3953488372093023,0.8527397260273972,80117929,129,51
0,335,0.07202216066481995,0.0944055944055944,63141330,361,26
1,159,0.3116883116883117,0.6380697050938338,67911361,231,72
1,65,0.43478260869565216,0.9346733668341709,69946863,115,50
0,33,0.029411764705882353,0.07352941176470588,80124290,34,1
0,140,0.0728476821192053,0.28717948717948716,80124374,151,11
0,464,0.0775347912524851,0.182175622542595,80124409,503,39
1,77,0.4122137404580153,0.8446969696969697,80163671,131,54
1,56,0.3488372093023256,0.7197452229299363,80137162,86,30
0,3,0.4,0.2222222222222222,80145898,5,2
2,3,0.5,0.8,82013613,6,3
0,184,0.2170212765957447,0.2878787878787879,69235054,235,51
1,2,0.3333333333333333,0.6666666666666666,82013599,3,1
0,158,0.12222222222222222,0.2826855123674912,70500143,180,22
2,1,0.9090909090909091,0.5,80145852,11,10
1,94,0.36054421768707484,0.7670250896057348,82002234,147,53
2,16,0.7538461538461538,0.9047619047619048,67844441,65,49
2,50,0.7487437185929648,0.9054054054054054,60907511,199,149
1,106,0.3291139240506329,0.7286432160804021,73579380,158,52
0,249,0.0708955223880597,0.1087866108786611,66087455,268,19
0,129,0.11643835616438356,0.22943722943722944,66087546,146,17
1,20,0.48717948717948717,0.8928571428571429,82052040,39,19
1,282,0.24193548387096775,0.551304347826087,80070823,372,90
1,34,0.30612244897959184,0.673469387755102,72932251,49,15
1,22,0.26666666666666666,0.5128205128205128,67557742,30,8
1,92,0.2868217054263566,0.7840909090909091,69724172,129,37
2,15,0.8728813559322034,0.967741935483871,18756444,118,103
1,231,0.33043478260869563,0.7192982456140351,73579373,345,114
1,203,0.33003300330033003,0.7570498915401301,67555964,303,100
0,294,0.19452054794520549,0.3653516295025729,68642420,365,71
0,71,0.24468085106382978,0.41708542713567837,69184283,94,23
0,52,0.10344827586206896,0.13286713286713286,68534123,58,6
0,246,0.14285714285714285,0.1610738255033557,67159190,287,41
0,118,0.2185430463576159,0.3942307692307692,70645883,151,33
0,59,0.03278688524590164,0.03614457831325301,80122845,61,2
1,25,0.3055555555555556,0.5384615384615384,80135083,36,11
0,303,0.12173913043478261,0.14566284779050737,67291315,345,42
1,68,0.19047619047619047,0.5,80135161,84,16
1,264,0.3684210526315789,0.7787769784172662,82010920,418,154
1,35,0.375,0.8021978021978022,82101056,56,21
1,64,0.49206349206349204,0.859375,70216020,126,62
2,70,0.5483870967741935,0.8888888888888888,69227172,155,85
1,125,0.3902439024390244,0.689922480620155,80019044,205,80
1,13,0.2777777777777778,0.5333333333333333,65282980,18,5
0,14,0.2631578947368421,0.4838709677419355,65282994,19,5
0,106,0.1092436974789916,0.3891891891891892,69701842,119,13
0,785,0.09977064220183486,0.13979933110367893,72522933,872,87
1,8,0.42857142857142855,0.6923076923076923,65286522,14,6
0,413,0.19019607843137254,0.36947094535993064,81979684,510,97
1,18,0.35714285714285715,0.8043478260869565,65281384,28,10
2,14,0.5333333333333333,0.7894736842105263,70544243,30,16
2,2,0.8181818181818182,0.75,65279410,11,9
0,29,0.17142857142857143,0.14084507042253522,65286340,35,6
1,13,0.35,0.8076923076923077,65286956,20,7
1,15,0.375,0.84375,65293221,24,9
1,267,0.3171355498721228,0.7308917197452229,62478360,391,124
1,2,0.3333333333333333,0.6666666666666666,66379173,3,1
0,36,0.16279069767441862,0.1686746987951807,66857721,43,7
1,245,0.3287671232876712,0.6648550724637681,67911396,365,120
1,18,0.3793103448275862,0.7837837837837838,65293144,29,11
0,248,0.11428571428571428,0.41904761904761906,60382574,280,32
0,155,0.037267080745341616,0.06282722513089005,60543392,161,6
0,583,0.11800302571860817,0.2252155172413793,70642306,661,78
1,59,0.3218390804597701,0.648936170212766,82047561,87,28
2,21,0.6557377049180327,0.9666666666666667,80124824,61,40
2,3,0.5,0.8333333333333334,71082032,6,3
1,263,0.4665314401622718,0.929718875502008,64196370,493,230
1,120,0.22580645161290322,0.5619834710743802,70185332,155,35
2,12,0.5714285714285714,0.9411764705882353,70174825,28,16
2,4,0.7142857142857143,0.8181818181818182,70719600,14,10
2,6,0.8536585365853658,0.8181818181818182,70537110,41,35
2,0,1.0,1.0,70408016,1,1
2,39,0.6388888888888888,0.6666666666666666,75576445,108,69
0,27,0.47058823529411764,0.3333333333333333,75577152,51,24
2,0,1.0,1.0,77283654,2,2
1,51,0.37037037037037035,0.7444444444444445,80180249,81,30
1,415,0.3262987012987013,0.6603221083455344,79726815,616,201
2,5,0.7916666666666666,0.875,66159520,24,19
0,780,0.1095890410958904,0.1301482701812191,68047616,876,96
1,191,0.49604221635883905,0.9534883720930233,69692966,379,188
0,63,0.045454545454545456,0.05069124423963134,69417222,66,3
1,158,0.3130434782608696,0.7021276595744681,80136845,230,72
0,215,0.08898305084745763,0.11678832116788321,68018181,236,21
1,122,0.21794871794871795,0.5826086956521739,80098795,156,34
0,34,0.19047619047619047,0.25,70525413,42,8
1,160,0.2857142857142857,0.6956521739130435,69622336,224,64
2,100,0.5327102803738317,0.9398148148148148,74058572,214,114
0,195,0.12556053811659193,0.2857142857142857,67252094,223,28
0,264,0.19756838905775076,0.4107744107744108,67553661,329,65
1,221,0.18450184501845018,0.5716981132075472,63525084,271,50
0,51,0.23880597014925373,0.4601226993865031,69056330,67,16
2,107,0.6178571428571429,0.9203980099502488,80137976,280,173
2,55,0.5045045045045045,0.9655172413793104,67553871,111,56
1,109,0.2534246575342466,0.6752767527675276,77676662,146,37
1,65,0.375,0.7225806451612903,69215202,104,39
1,133,0.2569832402234637,0.6869565217391305,60023985,179,46
1,81,0.352,0.868421052631579,66493294,125,44
1,364,0.2571428571428571,0.6502659574468085,67160555,490,126
2,139,0.5272108843537415,0.9620689655172414,72322173,294,155
1,213,0.26804123711340205,0.5486486486486486,68532723,291,78
0,255,0.07272727272727272,0.09191176470588236,82011828,275,20
0,79,0.23300970873786409,0.45901639344262296,857472,103,24
2,138,0.5241379310344828,0.9656992084432717,65915745,290,152
0,270,0.20353982300884957,0.4384057971014493,70642453,339,69
1,74,0.25252525252525254,0.6573033707865169,67324320,99,25
0,315,0.18393782383419688,0.33970276008492567,67324334,386,71
1,86,0.41496598639455784,0.8783068783068783,66493140,147,61
1,26,0.4222222222222222,0.8970588235294118,73460044,45,19
0,109,0.14173228346456693,0.1743119266055046,82116872,127,18
2,28,0.5555555555555556,0.987012987012987,82095536,63,35
0,39,0.22,0.2727272727272727,62497113,50,11
0,489,0.17676767676767677,0.38254310344827586,68535481,594,105
0,267,0.19090909090909092,0.36607142857142855,82036696,330,63
1,8,0.2727272727272727,0.6153846153846154,79783795,11,3
0,379,0.15022421524663676,0.21683673469387754,67428431,446,67
1,382,0.3262786596119929,0.7640086206896551,81980714,567,185
0,311,0.2301980198019802,0.4681139755766621,71444555,404,93
2,67,0.5503355704697986,0.9696969696969697,82059488,149,82
1,297,0.3109048723897912,0.7071547420965059,67557266,431,134
1,37,0.38333333333333336,0.8823529411764706,73026373,60,23
0,270,0.0425531914893617,0.16457461645746166,70314692,282,12
1,55,0.2465753424657534,0.696969696969697,69859972,73,18
0,361,0.2415966386554622,0.49469964664310956,74545842,476,115
0,40,0.1111111111111111,0.15517241379310345,79650893,45,5
1,115,0.425,0.8585858585858586,67871461,200,85
1,66,0.4406779661016949,0.93125,80111255,118,52
1,12,0.3333333333333333,0.6176470588235294,69140911,18,6
0,314,0.16266666666666665,0.2966252220248668,77677103,375,61
2,1,0.5,0.8571428571428571,80137913,2,1
0,269,0.05944055944055944,0.14285714285714285,80124434,286,17
1,139,0.3349282296650718,0.7909604519774012,68393871,209,70
1,96,0.4418604651162791,0.9156118143459916,65293396,172,76
0,548,0.05025996533795494,0.173841059602649,67341904,577,29
1,144,0.2835820895522388,0.5956284153005464,81967315,201,57
1,71,0.36607142857142855,0.8074534161490683,82126714,112,41
1,194,0.24806201550387597,0.6802721088435374,69733573,258,64
1,14,0.391304347826087,0.6538461538461539,79796906,23,9
1,194,0.2706766917293233,0.6303236797274276,73091081,266,72
1,159,0.22058823529411764,0.5069252077562327,68542642,204,45
1,287,0.2807017543859649,0.6654343807763401,66973095,399,112
1,48,0.36,0.8378378378378378,82126717,75,27
0,35,0.05405405405405406,0.14018691588785046,80124426,37,2
2,13,0.9161290322580645,0.7,69666534,155,142
0,70,0.18604651162790697,0.4622222222222222,69143396,86,16
0,269,0.08191126279863481,0.2,69158292,293,24
0,232,0.02109704641350211,0.1297709923664122,69158306,237,5
0,51,0.07272727272727272,0.23863636363636365,69479333,55,4
1,13,0.4583333333333333,0.9178082191780822,69972805,24,11
0,347,0.025280898876404494,0.138671875,70229880,356,9
0,261,0.21621621621621623,0.375,62141555,333,72
1,179,0.23829787234042554,0.6048951048951049,80098431,235,56
0,143,0.20994475138121546,0.47109207708779444,72785923,181,38
1,205,0.2730496453900709,0.5196850393700787,69489322,282,77
0,138,0.2159090909090909,0.4143222506393862,70047635,176,38
1,114,0.39037433155080214,0.9196787148594378,80136478,187,73
1,192,0.3018181818181818,0.739247311827957,80121120,275,83
1,142,0.30392156862745096,0.7601078167115903,80119394,204,62
1,264,0.4823529411764706,0.9691714836223507,65278710,510,246
2,0,1.0,1.0,72804641,3,3
1,230,0.23333333333333334,0.569060773480663,72376325,300,70
1,101,0.37267080745341613,0.8222222222222222,73034080,161,60
1,93,0.40764331210191085,0.8515625,80140052,157,64
1,94,0.44047619047619047,0.6834532374100719,67694690,168,74
0,163,0.23113207547169812,0.3463687150837989,80125041,212,49
1,893,0.3007047768206735,0.5968503937007874,80127288,1277,384
2,19,0.8549618320610687,0.9591836734693877,69692322,131,112
1,33,0.34,0.5555555555555556,68638290,50,17
2,80,0.5061728395061729,0.8984771573604061,70842380,162,82
0,487,0.34893048128342247,0.4700854700854701,80178144,748,261
2,42,0.7123287671232876,0.803921568627451,82049160,146,104
2,30,0.8543689320388349,0.8461538461538461,64957284,206,176
2,14,0.6,0.9761904761904762,82096252,35,21
1,18,0.35714285714285715,0.8333333333333334,80141505,28,10
0,446,0.1963963963963964,0.4190283400809717,68642350,555,109
0,38,0.19148936170212766,0.47058823529411764,73637823,47,9
0,255,0.229607250755287,0.4914772727272727,73818122,331,76
0,32,0.058823529411764705,0.3090909090909091,60542790,34,2
0,312,0.16129032258064516,0.4467455621301775,61594372,372,60
0,145,0.0880503144654088,0.07923497267759563,69840834,159,14
1,48,0.22580645161290322,0.8132295719844358,63525595,62,14
1,194,0.3310344827586207,0.7523809523809524,65248981,290,96
1,42,0.27586206896551724,0.6622516556291391,64369662,58,16
2,10,0.8,0.9333333333333333,69538812,50,40
2,8,0.8461538461538461,0.96,80177432,52,44
2,83,0.6914498141263941,0.9619047619047619,70966420,269,186
0,7,0.2222222222222222,0.375,80134743,9,2
0,9,0.35714285714285715,0.47619047619047616,82051776,14,5
2,78,0.8181818181818182,0.9751552795031055,80118203,429,351
1,9,0.25,0.5666666666666667,68546471,12,3
1,218,0.28052805280528054,0.6255230125523012,80108021,303,85
2,181,0.5068119891008175,0.9411764705882353,73850721,367,186
1,249,0.3897058823529412,0.8170289855072463,82007140,408,159
0,102,0.07272727272727272,0.44907407407407407,74607351,110,8
0,81,0.16494845360824742,0.3442028985507246,65009161,97,16
1,125,0.30939226519337015,0.623015873015873,69285755,181,56
2,15,0.53125,0.96875,68441072,32,17
1,157,0.38910505836575876,0.8685258964143426,68953906,257,100
1,100,0.1935483870967742,0.584192439862543,78762845,124,24
1,122,0.34408602150537637,0.7848605577689243,80180465,186,64
0,168,0.18048780487804877,0.39947780678851175,82143795,205,37
1,451,0.3029366306027821,0.6314655172413793,67994864,647,196
0,176,0.03825136612021858,0.0613107822410148,70001603,183,7
0,106,0.07017543859649122,0.22807017543859648,63527443,114,8
1,83,0.4429530201342282,0.9661016949152542,70207522,149,66
1,137,0.37155963302752293,0.7880794701986755,70598976,218,81
0,120,0.24050632911392406,0.4781491002570694,67174212,158,38
0,13,0.13333333333333333,0.16216216216216217,82145530,15,2
1,54,0.2987012987012987,0.8175182481751825,811433,77,23
1,174,0.40816326530612246,0.8639455782312925,69666835,294,120
1,91,0.2540983606557377,0.5428571428571428,70072261,122,31
1,163,0.30042918454935624,0.5698924731182796,75061490,233,70
0,319,0.20448877805486285,0.30474452554744524,70645120,401,82
1,741,0.2735294117647059,0.63391557496361,69560806,1020,279
0,425,0.2100371747211896,0.4525993883792049,70686966,538,113
1,53,0.3977272727272727,0.8923076923076924,68905830,88,35
1,79,0.3416666666666667,0.7477876106194691,68668516,120,41
1,274,0.43388429752066116,0.8855869242199108,80161882,484,210
0,189,0.11267605633802817,0.32065217391304346,69204835,213,24
0,87,0.2564102564102564,0.4460093896713615,80109253,117,30
1,46,0.22033898305084745,0.7950310559006211,62532316,59,13
0,243,0.039525691699604744,0.017964071856287425,82045198,253,10
0,384,0.14666666666666667,0.23790322580645162,82000025,450,66
0,199,0.0871559633027523,0.4607250755287009,68356351,218,19
2,0,1.0,1.0,80181928,1,1
1,91,0.32592592592592595,0.6894409937888198,70348040,135,44
1,17,0.19047619047619047,0.6065573770491803,82152061,21,4
0,116,0.07936507936507936,0.18085106382978725,69106940,126,10
0,257,0.07553956834532374,0.1595744680851064,69106982,278,21
2,5,0.7368421052631579,0.875,63158550,19,14
1,29,0.2926829268292683,0.6172839506172839,66463663,41,12
0,126,0.18181818181818182,0.2764505119453925,68641986,154,28
0,412,0.1522633744855967,0.2220708446866485,68628945,486,74
0,51,0.19047619047619047,0.39215686274509803,69100801,63,12
1,221,0.39452054794520547,0.8743589743589744,70176302,365,144
1,291,0.3860759493670886,0.7912457912457912,66321654,474,183
0,126,0.16556291390728478,0.2951388888888889,80176727,151,25
1,14,0.391304347826087,0.8775510204081632,68454666,23,9
1,60,0.3103448275862069,0.6808510638297872,78863652,87,27
1,137,0.44308943089430897,0.9090909090909091,79792314,246,109
0,87,0.13,0.2783171521035599,82039209,100,13
2,24,0.5102040816326531,0.9166666666666666,80176671,49,25
1,352,0.2845528455284553,0.5320284697508897,71288763,492,140
1,83,0.2966101694915254,0.6735751295336787,69607041,118,35
1,4,0.42857142857142855,0.8461538461538461,79792713,7,3
1,87,0.48214285714285715,0.9222222222222223,80141321,168,81
0,234,0.13653136531365315,0.2693333333333333,66964226,271,37
1,6,0.4,0.8181818181818182,80128897,10,4
1,42,0.27586206896551724,0.6464646464646465,69608266,58,16
0,30,0.11764705882352941,0.2,80119304,34,4
1,59,0.34444444444444444,0.7272727272727273,70655102,90,31
0,36,0.14285714285714285,0.24675324675324675,80121098,42,6
1,13,0.48,0.9393939393939394,69708632,25,12
1,56,0.44554455445544555,0.9363636363636364,68400514,101,45
2,44,0.5368421052631579,0.96,70216454,95,51
1,62,0.27906976744186046,0.6428571428571429,67435795,86,24
1,61,0.41346153846153844,0.8397790055248618,69172894,104,43
0,289,0.030201342281879196,0.12533333333333332,70848386,298,9
2,12,0.5384615384615384,0.9,69589254,26,14
0,90,0.0425531914893617,0.012396694214876033,82126664,94,4
1,104,0.34591194968553457,0.8070175438596491,81971150,159,55
1,23,0.28125,0.5714285714285714,69389894,32,9
0,239,0.14642857142857144,0.2795497185741088,72899841,280,41
0,59,0.11940298507462686,0.15668202764976957,81979813,67,8
0,85,0.17475728155339806,0.3539325842696629,69613761,103,18
0,304,0.1532033426183844,0.3188585607940447,70618254,359,55
1,111,0.28846153846153844,0.7301587301587301,69704432,156,45
1,246,0.256797583081571,0.6349924585218703,72522135,331,85
0,138,0.22033898305084745,0.4567901234567901,66461941,177,39
0,184,0.08,0.18383838383838383,74923786,200,16
0,115,0.03361344537815126,0.064343163538874,74924206,119,4
1,62,0.3111111111111111,0.7783018867924528,80154133,90,28
0,119,0.2222222222222222,0.3860759493670886,80180285,153,34
0,213,0.16796875,0.15822784810126583,80178942,256,43
0,15,0.16666666666666666,0.3333333333333333,69964713,18,3
2,116,0.6732394366197183,0.9885714285714285,82050119,355,239
2,26,0.543859649122807,0.9074074074074074,80160404,57,31
0,16,0.1111111111111111,0.045454545454545456,69183191,18,2
0,141,0.13496932515337423,0.17771883289124668,67963252,163,22
1,24,0.3142857142857143,0.821917808219178,80108903,35,11
0,55,0.140625,0.33112582781456956,70081081,64,9
2,26,0.5357142857142857,0.9864864864864865,82043024,56,30
1,83,0.30833333333333335,0.6726190476190477,69184024,120,37
0,3,0.25,0.14285714285714285,70771106,4,1
1,14,0.2222222222222222,0.76,82103915,18,4
0,30,0.11764705882352941,0.024691358024691357,81967368,34,4
1,381,0.2729007633587786,0.5958279009126467,81967254,524,143
0,60,0.21052631578947367,0.4175824175824176,82126615,76,16
1,54,0.23943661971830985,0.54421768707483,70121184,71,17
0,204,0.21235521235521235,0.35294117647058826,70645806,259,55
1,269,0.30310880829015546,0.7053941908713693,69607636,386,117
1,122,0.28654970760233917,0.6381578947368421,70960001,171,49
1,54,0.4065934065934066,0.7950819672131147,80127702,91,37
0,71,0.13414634146341464,0.2375,72900163,82,11
0,86,0.1134020618556701,0.1382488479262673,72900205,97,11
0,10,0.09090909090909091,0.11363636363636363,82150136,11,1
2,33,0.6764705882352942,0.9512195121951219,72818725,102,69
0,406,0.21165048543689322,0.325434439178515,70800401,515,109
0,199,0.2196078431372549,0.4692737430167598,80152860,255,56
0,132,0.18012422360248448,0.29850746268656714,73245872,161,29
1,91,0.3053435114503817,0.7148936170212766,80168510,131,40
1,27,0.425531914893617,0.9384615384615385,67384772,47,20
0,457,0.18683274021352314,0.24686595949855353,80118962,562,105
0,443,0.13307240704500978,0.3923809523809524,69886411,511,68
1,76,0.4108527131782946,0.8530805687203792,69558720,129,53
0,177,0.19545454545454546,0.33564814814814814,68533360,220,43
0,425,0.08798283261802575,0.06190476190476191,67435886,466,41
0,113,0.0423728813559322,0.041666666666666664,80124187,118,5
0,101,0.2109375,0.35398230088495575,80109876,128,27
0,278,0.0313588850174216,0.1225296442687747,66876726,287,9
1,166,0.2813852813852814,0.6566757493188011,80135279,231,65
0,432,0.2313167259786477,0.39039039039039036,80132865,562,130
2,3,0.5714285714285714,0.6,69484142,7,4
2,3,0.5714285714285714,0.5,69484702,7,4
1,11,0.21428571428571427,0.6595744680851063,70675703,14,3
1,57,0.4722222222222222,0.826530612244898,71362690,108,51
1,203,0.35555555555555557,0.784965034965035,70080983,315,112
2,14,0.5172413793103449,0.9666666666666667,82002255,29,15
2,10,0.5,0.9285714285714286,72417786,20,10
0,38,0.07317073170731707,0.32903225806451614,80116855,41,3
0,89,0.09183673469387756,0.4253731343283582,80116946,98,9
1,10,0.4117647058823529,0.7878787878787878,82047579,17,7
1,69,0.4051724137931034,0.8944444444444445,80180351,116,47
0,47,0.1896551724137931,0.42168674698795183,67793201,58,11
2,4,0.8666666666666667,0.8571428571428571,70770861,30,26
1,53,0.3764705882352941,0.803921568627451,65267062,85,32
2,0,1.0,1.0,82024316,4,4
0,119,0.1619718309859155,0.33649289099526064,69106891,142,23
0,174,0.1553398058252427,0.3016759776536313,82001868,206,32
1,76,0.4198473282442748,0.8461538461538461,80051790,131,55
1,29,0.30952380952380953,0.6483516483516484,80051965,42,13
2,8,0.9529411764705882,0.9411764705882353,80062276,170,162
1,39,0.2641509433962264,0.7321428571428571,69031235,53,14
0,593,0.17294281729428174,0.29401408450704225,63277774,717,124
0,199,0.23461538461538461,0.48756218905472637,69993511,260,61
0,341,0.22850678733031674,0.2928709055876686,66272206,442,101
0,221,0.07531380753138076,0.1027900146842878,81979735,239,18
0,132,0.14838709677419354,0.2934131736526946,82038985,155,23
0,47,0.11320754716981132,0.1792452830188679,82116851,53,6
1,313,0.42568807339449544,0.9327354260089686,80121047,545,232
1,73,0.26262626262626265,0.6368421052631579,69562913,99,26
1,176,0.2931726907630522,0.6584766584766585,69176611,249,73
1,35,0.3269230769230769,0.7432432432432432,65716273,52,17
1,6,0.3333333333333333,0.7619047619047619,70909293,9,3
0,95,0.12844036697247707,0.4206008583690987,67889262,109,14
0,61,0.07575757575757576,0.19205298013245034,80149848,66,5
0,257,0.05514705882352941,0.2760416666666667,62835066,272,15
0,4,0.0,0.0,64322370,4,0
2,2,0.7777777777777778,0.6666666666666666,80118460,9,7
1,248,0.30726256983240224,0.7619047619047619,70627382,358,110
1,66,0.30526315789473685,0.6518518518518519,80176730,95,29
0,266,0.11627906976744186,0.16607142857142856,68539401,301,35
1,135,0.40789473684210525,0.8805460750853242,68467924,228,93
0,184,0.1320754716981132,0.14841849148418493,68883325,212,28
1,43,0.17307692307692307,0.6826923076923077,69638674,52,9
1,102,0.34615384615384615,0.7906976744186046,67154374,156,54
1,36,0.23404255319148937,0.5789473684210527,713405,47,11
1,147,0.3256880733944954,0.6480836236933798,66272332,218,71
1,16,0.38461538461538464,0.6666666666666666,70494200,26,10
1,57,0.46226415094339623,0.9047619047619048,79146032,106,49
0,127,0.14189189189189189,0.20261437908496732,80114244,148,21
0,3,0.0,0.0,68432560,3,0
1,78,0.3445378151260504,0.8839285714285714,78863673,119,41
1,49,0.40963855421686746,0.8848920863309353,79145990,83,34
2,103,0.5209302325581395,0.7619047619047619,80178148,215,112
1,232,0.23432343234323433,0.6577319587628866,68749863,303,71
0,179,0.19369369369369369,0.2528409090909091,72077824,222,43
1,24,0.29411764705882354,0.6666666666666666,68497191,34,10
1,74,0.24489795918367346,0.6380368098159509,63050862,98,24
1,61,0.4351851851851852,0.9444444444444444,82126713,108,47
1,109,0.49537037037037035,0.9392712550607287,60199391,216,107
2,51,0.7487684729064039,0.9428571428571428,68240046,203,152
1,560,0.33649289099526064,0.8090909090909091,68532534,844,284
0,467,0.09320388349514563,0.10595238095238095,82178173,515,48
1,90,0.22413793103448276,0.6186770428015564,70618023,116,26
1,34,0.1282051282051282,0.512396694214876,64322622,39,5
0,260,0.08771929824561403,0.3542319749216301,67887666,285,25
1,148,0.263681592039801,0.5786802030456852,70829115,201,53
1,113,0.2848101265822785,0.5775862068965517,69896785,158,45
1,130,0.2777777777777778,0.6426512968299711,71236816,180,50
1,322,0.47299509001636664,0.9680851063829787,70814723,611,289
0,179,0.19730941704035873,0.3941798941798942,80070865,223,44
1,190,0.375,0.8365019011406845,64938251,304,114
1,2,0.3333333333333333,0.6,69153091,3,1
0,188,0.08737864077669903,0.12258064516129032,81893569,206,18
0,250,0.1103202846975089,0.17465224111282843,80097115,281,31
2,4,0.5,0.9473684210526315,69153070,8,4
1,36,0.2653061224489796,0.5384615384615384,71191960,49,13
1,23,0.25806451612903225,0.6065573770491803,68286302,31,8
1,135,0.2857142857142857,0.695906432748538,68725692,189,54
1,111,0.3313253012048193,0.7692307692307693,76043373,166,55
0,502,0.08394160583941605,0.0956140350877193,80097486,548,46
0,283,0.08116883116883117,0.112,80097493,308,25
0,191,0.200836820083682,0.42786069651741293,82036702,239,48
1,287,0.331002331002331,0.8034682080924855,64130346,429,142
0,9,0.1,0.21875,82206189,10,1
1,15,0.4230769230769231,0.9411764705882353,74048716,26,11
1,361,0.35071942446043164,0.7062314540059347,66839850,556,195
0,150,0.23857868020304568,0.4068627450980392,68044410,197,47
0,311,0.20865139949109415,0.3775633293124246,82124916,393,82
0,37,0.13953488372093023,0.16083916083916083,80176728,43,6
1,22,0.2903225806451613,0.5918367346938775,69389922,31,9
0,58,0.04918032786885246,0.15666666666666668,82008939,61,3
1,46,0.4588235294117647,0.582089552238806,80089912,85,39
1,49,0.234375,0.5253164556962026,70646912,64,15
1,47,0.4777777777777778,0.9016393442622951,80141322,90,43
0,102,0.11304347826086956,0.1987179487179487,70568281,115,13
1,141,0.3155339805825243,0.6795366795366795,69039593,206,65
2,1,0.6666666666666666,0.9,79791292,3,2
1,13,0.35,0.7555555555555555,82091017,20,7
0,16,0.058823529411764705,0.15151515151515152,70678860,17,1
0,20,0.13043478260869565,0.3058823529411765,80126777,23,3
0,17,0.19047619047619047,0.23809523809523808,80140106,21,4
1,20,0.2857142857142857,0.6785714285714286,80141466,28,8
2,2,0.6,0.8333333333333334,82139993,5,3
0,650,0.1698595146871009,0.3057228915662651,69239842,783,133
0,115,0.18439716312056736,0.2942708333333333,82124926,141,26
0,144,0.1724137931034483,0.46956521739130436,70252791,174,30
1,309,0.21573604060913706,0.5353805073431241,68391890,394,85
0,788,0.23569350145489815,0.4759581881533101,80102981,1031,243
1,219,0.30914826498422715,0.6798780487804879,80180103,317,98
1,418,0.3079470198675497,0.6063618290258449,62510336,604,186
1,64,0.3402061855670103,0.8181818181818182,70564466,97,33
1,193,0.24015748031496062,0.5135135135135135,67942784,254,61
1,96,0.47540983606557374,0.9491525423728814,70585984,183,87
1,161,0.47896440129449835,0.9409937888198758,63352191,309,148
1,13,0.4090909090909091,0.9375,69180720,22,9
0,219,0.21505376344086022,0.4430379746835443,69498660,279,60
0,75,0.20212765957446807,0.34765625,82116860,94,19
2,126,0.6450704225352113,0.9066666666666666,73442362,355,229
1,142,0.36036036036036034,0.726890756302521,80062486,222,80
1,152,0.3090909090909091,0.5975232198142415,68040896,220,68
0,722,0.059895833333333336,0.10749185667752444,80124309,768,46
0,223,0.07468879668049792,0.21700223713646533,80124443,241,18
1,114,0.3770491803278688,0.7385892116182573,66272262,183,69
0,224,0.10756972111553785,0.13947990543735225,67291385,251,27
0,36,0.0,0.0,80134649,36,0
0,18,0.05263157894736842,0.05405405405405406,80134650,19,1
1,139,0.3930131004366812,0.9205607476635514,62140785,229,90
0,48,0.02040816326530612,0.0880503144654088,66035921,49,1
2,26,0.6867469879518072,0.9272727272727272,76545434,83,57
2,1,0.6666666666666666,0.875,80181499,3,2
2,29,0.6375,0.8928571428571429,80125800,80,51
1,507,0.3130081300813008,0.6885416666666667,70676354,738,231
1,197,0.298932384341637,0.6371681415929203,70642250,281,84
1,707,0.2470713525026624,0.6098901098901099,69383552,939,232
1,48,0.37662337662337664,0.8571428571428571,80130630,77,29
0,11,0.15384615384615385,0.3076923076923077,70760991,13,2
2,32,0.6235294117647059,0.9428571428571428,82008299,85,53
1,108,0.32919254658385094,0.6260162601626016,65934015,161,53
1,298,0.30697674418604654,0.6211656441717791,74347756,430,132
1,60,0.23076923076923078,0.5149700598802395,68241446,78,18
2,101,0.5345622119815668,0.9695652173913043,72271073,217,116
1,135,0.47674418604651164,0.9507575757575758,70586033,258,123
1,32,0.2,0.532258064516129,73313912,40,8
0,442,0.11952191235059761,0.22697368421052633,80118315,502,60
0,79,0.07058823529411765,0.2112676056338028,80118317,85,6
0,71,0.20224719101123595,0.3007518796992481,72445744,89,18
1,162,0.325,0.5,70565495,240,78
2,23,0.5,0.9528301886792453,69172852,46,23
0,49,0.14035087719298245,0.2962962962962963,69724011,57,8
2,9,0.5714285714285714,0.75,80093615,21,12
2,3,0.9230769230769231,0.75,82039821,39,36
1,49,0.27941176470588236,0.5617977528089888,70186396,68,19
1,42,0.3114754098360656,0.7222222222222222,80125047,61,19
1,39,0.35,0.6320754716981132,73869894,60,21
0,50,0.10714285714285714,0.09090909090909091,62766165,56,6
1,295,0.2236842105263158,0.5166270783847982,80071124,380,85
0,99,0.1951219512195122,0.34110787172011664,64994594,123,24
1,348,0.24347826086956523,0.5636856368563685,69578572,460,112
0,232,0.15942028985507245,0.25205930807248766,79520112,276,44
0,77,0.15384615384615385,0.41935483870967744,69417572,91,14
0,127,0.1962025316455696,0.4476744186046512,69417341,158,31
1,678,0.41501294219154444,0.882636655948553,80178637,1159,481
1,253,0.26453488372093026,0.5996309963099631,70863485,344,91
1,27,0.2702702702702703,0.6333333333333333,70828520,37,10
1,425,0.4946492271105826,0.9635499207606973,69056372,841,416
0,135,0.17177914110429449,0.4583333333333333,69416130,163,28
1,36,0.2653061224489796,0.5857142857142857,65930851,49,13
0,134,0.1464968152866242,0.2007042253521127,67657870,157,23
1,18,0.3076923076923077,0.6721311475409836,66855824,26,8
1,54,0.28,0.5894039735099338,69184451,75,21
2,2,0.5,0.875,68169213,4,2
1,5,0.4444444444444444,0.875,68509063,9,4
0,247,0.18211920529801323,0.3765182186234818,80097395,302,55
0,39,0.1875,0.47058823529411764,69416221,48,9
0,115,0.21232876712328766,0.47058823529411764,68497163,146,31
0,7,0.2222222222222222,0.3,73709300,9,2
1,78,0.30973451327433627,0.7935483870967742,69421212,113,35
0,54,0.20588235294117646,0.38125,68434513,68,14
1,141,0.3155339805825243,0.747093023255814,80131286,206,65
0,170,0.21296296296296297,0.3225806451612903,81980716,216,46
2,170,0.6018735362997658,0.9875776397515528,69621552,427,257
2,89,0.5679611650485437,0.9681978798586572,77600376,206,117
1,199,0.2815884476534296,0.6849087893864013,73245746,277,78
1,58,0.3176470588235294,0.8064516129032258,68779445,85,27
1,118,0.2804878048780488,0.7267605633802817,80071236,164,46
0,106,0.08620689655172414,0.08502024291497975,80122391,116,10
1,251,0.20317460317460317,0.5065913370998116,77676795,315,64
0,159,0.11173184357541899,0.09737827715355805,70642320,179,20
0,446,0.10978043912175649,0.10532544378698225,82128635,501,55
2,27,0.5573770491803278,0.9137931034482759,72846732,61,34
2,11,0.6071428571428571,0.8333333333333334,72823800,28,17
2,33,0.7105263157894737,0.9375,70523733,114,81
0,217,0.21942446043165467,0.3952254641909814,70566783,278,61
0,94,0.12962962962962962,0.13414634146341464,68173980,108,14
0,11,0.08333333333333333,0.16666666666666666,67190074,12,1
0,123,0.05384615384615385,0.061611374407582936,69416844,130,7
0,566,0.0766721044045677,0.28875582168995345,62839063,613,47
0,117,0.040983606557377046,0.1488469601677149,62840330,122,5
2,23,0.7125,0.9423076923076923,69957965,80,57
1,219,0.4048913043478261,0.9300184162062615,70768033,368,149
1,93,0.2619047619047619,0.6534653465346535,70061796,126,33
1,73,0.4016393442622951,0.8571428571428571,82119998,122,49
1,9,0.3076923076923077,0.6666666666666666,80176614,13,4
1,57,0.20833333333333334,0.5045045045045045,73977715,72,15
1,32,0.4074074074074074,0.9125,69187426,54,22
0,540,0.216255442670537,0.4155712841253792,68545316,689,149
0,301,0.2037037037037037,0.4704861111111111,77676704,378,77
0,15,0.11764705882352941,0.1,70719131,17,2
0,198,0.11210762331838565,0.28842832469775476,78763475,223,25
1,21,0.4878048780487805,0.9318181818181818,79785790,41,20
0,125,0.23780487804878048,0.39880952380952384,70959980,164,39
0,207,0.009569377990430622,0.004048582995951417,73245522,209,2
0,108,0.009174311926605505,0.003952569169960474,73245543,109,1
0,17,0.22727272727272727,0.4090909090909091,80128843,22,5
0,16,0.2,0.3392857142857143,73623270,20,4
2,4,0.6363636363636364,0.8461538461538461,68284622,11,7
1,61,0.3068181818181818,0.631578947368421,75273093,88,27
0,100,0.17355371900826447,0.35555555555555557,72863413,121,21
0,13,0.07142857142857142,0.2988505747126437,70581875,14,1
2,31,0.5571428571428572,0.9615384615384616,67553864,70,39
0,253,0.11228070175438597,0.11702127659574468,67291392,285,32
1,207,0.3257328990228013,0.6626984126984127,69712111,307,100
1,975,0.26024279210925644,0.6111744583808438,80121085,1318,343
1,77,0.3474576271186441,0.743421052631579,62815361,118,41
1,171,0.29338842975206614,0.6415525114155252,66440955,242,71
1,20,0.42857142857142855,0.7894736842105263,68401536,35,15
1,37,0.28846153846153844,0.5462962962962963,69964370,52,15
1,191,0.48655913978494625,0.9362139917695473,67306981,372,181
1,179,0.3719298245614035,0.8524096385542169,67552226,285,106
1,143,0.42105263157894735,0.9254385964912281,70474544,247,104
2,77,0.5523255813953488,0.9612676056338029,68554185,172,95
2,29,0.6463414634146342,0.9789473684210527,70758016,82,53
0,21,0.045454545454545456,0.09433962264150944,70685741,22,1
0,3,0.0,0.0,80126761,3,0
0,197,0.2151394422310757,0.4473684210526316,69172880,251,54
1,13,0.13333333333333333,0.5625,67435046,15,2
2,2,0.6,0.8,82151151,5,3
1,100,0.3006993006993007,0.6388888888888888,73459666,143,43
0,123,0.18,0.30405405405405406,82005355,150,27
1,14,0.3,0.7391304347826086,70675493,20,6
0,46,0.11538461538461539,0.310126582278481,70680393,52,6
1,42,0.25,0.5107913669064749,76941620,56,14
1,161,0.29385964912280704,0.6479481641468683,80145716,228,67
1,47,0.29850746268656714,0.6788321167883211,70568190,67,20
1,83,0.20192307692307693,0.5536912751677853,70638582,104,21
1,119,0.2654320987654321,0.5788113695090439,80145298,162,43
2,10,0.5652173913043478,0.9523809523809523,82052053,23,13
0,197,0.16170212765957448,0.3326732673267327,72522842,235,38
0,94,0.168141592920354,0.3107344632768362,67815160,113,19
2,16,0.6363636363636364,0.8333333333333334,68035310,44,28
1,346,0.26849894291754756,0.6579710144927536,68536510,473,127
1,7,0.46153846153846156,0.9047619047619048,67040463,13,6
0,195,0.22310756972111553,0.47368421052631576,82054692,251,56
0,75,0.21875,0.367816091954023,70525371,96,21
2,60,0.5918367346938775,0.9339622641509434,69390776,147,87
0,130,0.16666666666666666,0.252212389380531,70646604,156,26
0,111,0.15267175572519084,0.1781609195402299,79822484,131,20
2,11,0.5925925925925926,0.9166666666666666,77329553,27,16
2,3,0.7857142857142857,0.8571428571428571,64900150,14,11
1,85,0.39285714285714285,0.7878787878787878,70241143,140,55
1,43,0.23214285714285715,0.6037735849056604,69160434,56,13
0,243,0.2161290322580645,0.42314990512333966,82116604,310,67
1,34,0.30612244897959184,0.6436781609195402,69195420,49,15
2,33,0.5,0.972972972972973,54904234,66,33
2,42,0.5670103092783505,0.9333333333333333,80118350,97,55
0,42,0.06666666666666667,0.3358208955223881,62850431,45,3
0,36,0.23404255319148937,0.31868131868131866,82126730,47,11
0,7,0.3,0.22727272727272727,80136909,10,3
0,239,0.032388663967611336,0.0931174089068826,67872833,247,8
1,17,0.46875,0.9459459459459459,70509334,32,15
2,1,0.5,0.6666666666666666,70051975,2,1
2,34,0.6222222222222222,0.983739837398374,80003371,90,56
1,16,0.4074074074074074,0.7058823529411765,80126924,27,11
2,3,0.8,0.8888888888888888,72315082,15,12
2,13,0.5185185185185185,0.9333333333333333,75048036,27,14
2,15,0.6808510638297872,0.9375,70120736,47,32
2,5,0.7916666666666666,0.9534883720930233,65931824,24,19
1,75,0.3119266055045872,0.8307692307692308,70615440,109,34
0,356,0.1834862385321101,0.41839080459770117,80172876,436,80
1,175,0.32170542635658916,0.7345360824742269,70350105,258,83
1,97,0.3263888888888889,0.7452054794520548,80079783,144,47
0,424,0.24822695035460993,0.4881422924901186,62409291,564,140
1,246,0.35092348284960423,0.8097560975609757,70176295,379,133
0,142,0.07792207792207792,0.14285714285714285,68495553,154,12
0,185,0.16666666666666666,0.30425531914893617,79520140,222,37
0,138,0.16363636363636364,0.3619631901840491,64929550,165,27
1,72,0.3333333333333333,0.8248587570621468,73200071,108,36
1,40,0.2727272727272727,0.7603305785123967,82126683,55,15
0,44,0.2,0.26666666666666666,82126684,55,11
0,99,0.2204724409448819,0.40711462450592883,82126687,127,28
1,266,0.35121951219512193,0.7774030354131535,82062664,410,144
1,64,0.28888888888888886,0.6467391304347826,80124770,90,26
1,49,0.4895833333333333,0.9349112426035503,80156293,96,47
1,182,0.38305084745762713,0.8908296943231441,67159386,295,113
2,9,0.5,0.88,69501936,18,9
1,215,0.44587628865979384,0.8755555555555555,80125402,388,173
0,284,0.2,0.34214002642007924,80118973,355,71
1,102,0.33766233766233766,0.7341772151898734,72322082,154,52
1,351,0.34146341463414637,0.7410071942446043,73590251,533,182
0,58,0.07936507936507936,0.03286384976525822,67160086,63,5
1,183,0.17567567567567569,0.5178571428571429,70659981,222,39
1,44,0.4358974358974359,0.9338235294117647,70940513,78,34
2,4,0.5555555555555556,0.8181818181818182,70718004,9,5
0,97,0.039603960396039604,0.04242424242424243,71762621,101,4
0,25,0.038461538461538464,0.22131147540983606,72909585,26,1
0,39,0.11363636363636363,0.3298429319371728,73007144,44,5
0,3,0.0,0.0,70489454,3,0
0,47,0.020833333333333332,0.28,70489482,48,1
0,70,0.014084507042253521,0.2265193370165746,70746011,71,1
0,34,0.05555555555555555,0.38461538461538464,70746340,36,2
0,54,0.01818181818181818,0.26573426573426573,70746641,55,1
0,54,0.03571428571428571,0.29927007299270075,70746711,56,2
1,19,0.17391304347826086,0.6825396825396826,70746725,23,4
1,26,0.4090909090909091,0.9166666666666666,80166920,44,18
2,19,0.81,0.9545454545454546,76545455,100,81
0,15,0.21052631578947367,0.2833333333333333,70843822,19,4
0,135,0.21965317919075145,0.31443298969072164,71288784,173,38
2,0,1.0,1.0,82039424,2,2
0,9,0.1,0.4,67822580,10,1
1,11,0.21428571428571427,0.8333333333333334,67822601,14,3
0,22,0.26666666666666666,0.45901639344262296,66551884,30,8
1,14,0.36363636363636365,0.55,66551891,22,8
1,5,0.2857142857142857,0.6470588235294118,77160804,7,2
1,184,0.30038022813688214,0.6150793650793651,68614000,263,79
2,3,0.8,0.9583333333333334,77581532,15,12
1,76,0.4794520547945205,0.9505494505494505,69091596,146,70
1,51,0.4,0.8116883116883117,82120002,85,34
2,222,0.5236051502145923,0.9673366834170855,67160366,466,244
1,111,0.4714285714285714,0.8733624454148472,80153702,210,99
0,24,0.04,0.10526315789473684,69508936,25,1
1,138,0.18823529411764706,0.5081967213114754,80098830,170,32
2,60,0.5714285714285714,0.8928571428571429,889994,140,80
2,21,0.5882352941176471,0.8064516129032258,890463,51,30
2,24,0.6129032258064516,0.9166666666666666,890652,62,38
0,129,0.22289156626506024,0.449438202247191,63051674,166,37
0,31,0.06060606060606061,0.014925373134328358,66264576,33,2
1,64,0.14666666666666667,0.528169014084507,68357072,75,11
1,332,0.27510917030567683,0.5261845386533666,69992363,458,126
0,49,0.2222222222222222,0.33858267716535434,69183562,63,14
0,161,0.17435897435897435,0.3837471783295711,73421502,195,34
0,66,0.25,0.47593582887700536,69183464,88,22
1,22,0.3333333333333333,0.7361111111111112,70633115,33,11
2,1,0.5,0.8571428571428571,68954592,2,1
1,75,0.2268041237113402,0.5486725663716814,80003385,97,22
0,15,0.16666666666666666,0.38235294117647056,69021022,18,3
1,68,0.3644859813084112,0.5803571428571429,80061044,107,39
1,23,0.41025641025641024,0.8070175438596491,82009596,39,16
0,315,0.11764705882352941,0.12454873646209386,80181318,357,42
0,35,0.16666666666666666,0.32710280373831774,67564616,42,7
2,5,0.5,0.875,80046092,10,5
1,136,0.4925373134328358,0.8512110726643599,80027892,268,132
2,101,0.5302325581395348,0.8980891719745223,80018610,215,114
0,67,0.14102564102564102,0.3392857142857143,67299701,78,11
1,132,0.41333333333333333,0.933933933933934,81967291,225,93
1,410,0.2756183745583039,0.5884718498659517,69607104,566,156
0,580,0.12912912912912913,0.20516717325227962,82041090,666,86
0,1031,0.17848605577689244,0.3234256926952141,82041091,1255,224
0,300,0.06832298136645963,0.23295454545454544,64251131,322,22
0,35,0.16666666666666666,0.3475177304964539,61329765,42,7
1,104,0.37349397590361444,0.8450704225352113,64202761,166,62
1,79,0.2616822429906542,0.5336322869955157,70742532,107,28
0,56,0.125,0.1,69082832,64,8
0,144,0.23404255319148937,0.47604790419161674,67513152,188,44
1,52,0.42857142857142855,0.8959537572254336,73137176,91,39
2,45,0.6153846153846154,0.9876543209876543,69522215,117,72
0,158,0.03067484662576687,0.15498154981549817,82003721,163,5
1,88,0.30708661417322836,0.7375886524822695,70527282,127,39
1,130,0.19254658385093168,0.5931232091690545,70654780,161,31
0,3,0.25,0.3333333333333333,69555563,4,1
0,131,0.12666666666666668,0.0979020979020979,73650885,150,19
1,123,0.26785714285714285,0.6856368563685636,69540142,168,45
1,243,0.2936046511627907,0.7048903878583473,70524384,344,101
2,2,0.75,0.6666666666666666,82039845,8,6
2,4,0.6666666666666666,0.8888888888888888,67813760,12,8
2,5,0.8275862068965517,0.75,68556733,29,24
2,10,0.6,0.95,70919254,25,15
2,182,0.8004385964912281,0.9655172413793104,66338853,912,730
2,62,0.6242424242424243,0.9571428571428572,70690935,165,103
1,4,0.2,0.6,69311543,5,1
0,1,0.0,0.0,69723822,1,0
2,10,0.5238095238095238,0.2857142857142857,75852336,21,11
0,11,0.3125,0.43478260869565216,80137407,16,5
2,28,0.5172413793103449,0.9315068493150684,82023698,58,30
1,68,0.2916666666666667,0.65,82113171,96,28
1,120,0.24050632911392406,0.6006711409395973,68060545,158,38
1,101,0.35668789808917195,0.7591623036649214,63767704,157,56
1,43,0.2711864406779661,0.6923076923076923,68475162,59,16
0,223,0.17712177121771217,0.41067285382830626,63609595,271,48
1,310,0.24574209245742093,0.5498442367601246,68645003,411,101
1,134,0.3333333333333333,0.7723342939481268,66357844,201,67
0,38,0.11627906976744186,0.48872180451127817,62530202,43,5
0,226,0.03829787234042553,0.04719101123595506,73245564,235,9
0,540,0.03052064631956912,0.021714285714285714,82011860,557,17
0,62,0.0,0.0,74019890,62,0
1,69,0.38392857142857145,0.8685446009389671,61561332,112,43
2,115,0.5106382978723404,0.9166666666666666,80180190,235,120
0,158,0.04242424242424243,0.08240534521158129,63781032,165,7
0,107,0.27702702702702703,0.38235294117647056,80125896,148,41
0,226,0.03829787234042553,0.05555555555555555,74020310,235,9
1,19,0.2962962962962963,0.6101694915254238,80141506,27,8
0,199,0.15677966101694915,0.44029850746268656,81965608,236,37
1,283,0.30637254901960786,0.7626527050610821,66930612,408,125
0,94,0.21008403361344538,0.43023255813953487,63051583,119,25
1,71,0.35454545454545455,0.849624060150376,64260441,110,39
1,27,0.20588235294117646,0.7717391304347826,80135173,34,7
0,85,0.19811320754716982,0.31958762886597936,82128649,106,21
1,160,0.33884297520661155,0.656441717791411,70002044,242,82
1,40,0.3442622950819672,0.7669172932330827,67372354,61,21
1,224,0.28888888888888886,0.671559633027523,81980713,315,91
0,419,0.15863453815261044,0.3717146433041302,82009727,498,79
0,115,0.2013888888888889,0.3559322033898305,67554361,144,29
2,123,0.551094890510949,0.9591836734693877,62512282,274,151
1,529,0.26629680998613037,0.6199701937406855,73700501,721,192
1,4,0.3333333333333333,0.75,72480611,6,2
0,4,0.0,0.0,80117832,4,0
0,2,0.0,0.0,80122878,2,0
0,32,0.058823529411764705,0.24793388429752067,70746844,34,2
2,10,0.5,0.9615384615384616,82002323,20,10
1,265,0.3808411214953271,0.746641074856046,80180012,428,163
1,327,0.3353658536585366,0.782392026578073,66470985,492,165
1,67,0.4224137931034483,0.9028571428571428,70632583,116,49
1,18,0.3793103448275862,0.8,70221585,29,11
1,160,0.38697318007662834,0.9046511627906977,65617076,261,101
0,20,0.0,0.0,73072622,20,0
1,119,0.36363636363636365,0.8307692307692308,80119022,187,68
1,348,0.3081510934393638,0.7767379679144385,82008904,503,155
2,105,0.5291479820627802,0.975,70533036,223,118
1,363,0.3741379310344828,0.8881578947368421,81927753,580,217
1,92,0.2868217054263566,0.6451612903225806,73802512,129,37
1,87,0.2926829268292683,0.6574074074074074,70463890,123,36
1,50,0.34210526315789475,0.717391304347826,74001116,76,26
0,429,0.08333333333333333,0.3195319531953195,68811491,468,39
0,277,0.17559523809523808,0.29347826086956524,66939096,336,59
2,5,0.5454545454545454,0.8888888888888888,76672484,11,6
1,59,0.2804878048780488,0.6375838926174496,72895466,82,23
0,247,0.23052959501557632,0.3493975903614458,81967305,321,74
0,62,0.19480519480519481,0.22727272727272727,80133432,77,15
0,104,0.08771929824561403,0.1178343949044586,72523346,114,10
0,116,0.15328467153284672,0.3313782991202346,72523353,137,21
1,126,0.31521739130434784,0.7428571428571429,69091771,184,58
0,31,0.1388888888888889,0.13513513513513514,81956132,36,5
2,30,0.6103896103896104,0.86,72790655,77,47
2,40,0.5652173913043478,0.9230769230769231,72790641,92,52
1,52,0.35,0.6854838709677419,80162110,80,28
1,26,0.3157894736842105,0.7608695652173914,80180589,38,12
0,129,0.10416666666666667,0.12903225806451613,82002687,144,15
0,125,0.14965986394557823,0.2833333333333333,82002688,147,22
2,17,0.711864406779661,0.8461538461538461,8014874,59,42
2,7,0.8157894736842105,0.9166666666666666,8014853,38,31
0,5,0.16666666666666666,0.25,70675234,6,1
1,83,0.3025210084033613,0.6180555555555556,72801323,119,36
0,12,0.14285714285714285,0.32075471698113206,72808491,14,2
1,78,0.47297297297297297,0.8963414634146342,82088771,148,70
0,214,0.16731517509727625,0.3287292817679558,68538701,257,43
1,144,0.34841628959276016,0.7948717948717948,70748300,221,77
0,60,0.22077922077922077,0.2773109243697479,69733433,77,17
1,242,0.2754491017964072,0.5658536585365853,69177136,334,92
1,39,0.2909090909090909,0.6866666666666666,70669571,55,16
2,66,0.5822784810126582,0.8846153846153846,890582,158,92
1,52,0.35,0.7677419354838709,73300010,80,28
1,126,0.3114754098360656,0.7663934426229508,63051786,183,57
0,76,0.21649484536082475,0.4105960264900662,63050841,97,21
1,337,0.27370689655172414,0.7182235834609495,68642035,464,127
1,77,0.27358490566037735,0.5914396887159533,70760865,106,29
0,96,0.1794871794871795,0.29931972789115646,66892602,117,21
0,38,0.13636363636363635,0.16666666666666666,69638835,44,6
0,211,0.09051724137931035,0.4307479224376731,63182504,232,21
1,260,0.35802469135802467,0.7506361323155216,68401893,405,145
2,10,0.6428571428571429,0.9767441860465116,75120920,28,18
1,120,0.29411764705882354,0.6283524904214559,67748975,170,50
1,111,0.3583815028901734,0.689873417721519,70879655,173,62
1,24,0.3142857142857143,0.6185567010309279,82002244,35,11
0,14,0.0,0.0,70677600,14,0
2,0,1.0,1.0,66235743,1,1
2,20,0.8245614035087719,0.9285714285714286,68744816,114,94
2,15,0.6052631578947368,0.55,221270,38,23
2,236,0.5504761904761905,0.9369369369369369,80155219,525,289
2,32,0.5,0.625,80168327,64,32
2,47,0.591304347826087,0.9909502262443439,80030580,115,68
0,46,0.17857142857142858,0.29850746268656714,69078583,56,10
0,8,0.1111111111111111,0.10526315789473684,68784800,9,1
1,160,0.23809523809523808,0.554089709762533,70627235,210,50
1,113,0.2893081761006289,0.7766666666666666,68534333,159,46
1,100,0.4350282485875706,0.8571428571428571,81975742,177,77
1,86,0.2773109243697479,0.6652542372881356,68598593,119,33
1,157,0.4471830985915493,0.8871391076115486,67304293,284,127
1,259,0.2222222222222222,0.5262345679012346,67833780,333,74
0,119,0.15,0.23178807947019867,69027826,140,21
1,127,0.37745098039215685,0.7431192660550459,68040203,204,77
2,3,0.6666666666666666,0.9473684210526315,69547975,9,6
1,83,0.33064516129032256,0.6766917293233082,67551953,124,41
1,187,0.3392226148409894,0.7802874743326489,68537385,283,96
1,395,0.2857142857142857,0.7225490196078431,80119052,553,158
1,141,0.36771300448430494,0.8284960422163589,80124764,223,82
0,202,0.15126050420168066,0.16129032258064516,70179186,238,36
0,246,0.12142857142857143,0.17699115044247787,60032532,280,34
1,49,0.45555555555555555,0.8969072164948454,69069840,90,41
1,48,0.49473684210526314,0.7647058823529411,69533205,95,47
1,39,0.4264705882352941,0.9044117647058824,69978426,68,29
0,783,0.18691588785046728,0.36519790888722925,68544525,963,180
0,147,0.1787709497206704,0.4847715736040609,70627550,179,32
1,37,0.3508771929824561,0.8441558441558441,65024211,57,20
1,37,0.38333333333333336,0.8478260869565217,80135821,60,23
0,7,0.2222222222222222,0.42105263157894735,66110716,9,2
1,113,0.45145631067961167,0.855072463768116,81989155,206,93
2,19,0.5365853658536586,0.9333333333333333,81989157,41,22
1,54,0.37209302325581395,0.7910447761194029,70800975,86,32
0,48,0.15789473684210525,0.21621621621621623,74361070,57,9
1,102,0.423728813559322,0.8622222222222222,68211332,177,75
2,22,0.6071428571428571,0.9583333333333334,72331756,56,34
1,137,0.38839285714285715,0.7411167512690355,62510581,224,87
1,62,0.27906976744186046,0.6294117647058823,73200120,86,24
1,56,0.2727272727272727,0.5972222222222222,71358833,77,21
0,101,0.2518518518518518,0.49504950495049505,60455101,135,34
1,109,0.4293193717277487,0.898876404494382,63767606,191,82
1,95,0.43452380952380953,0.9305555555555556,63767613,168,73
1,203,0.2536764705882353,0.5060240963855421,72135392,272,69
0,211,0.1134453781512605,0.19152276295133439,82039210,238,27
0,95,0.22131147540983606,0.47639484978540775,68688004,122,27
2,11,0.5,0.9259259259259259,70829941,22,11
0,86,0.21818181818181817,0.48412698412698413,63767585,110,24
1,84,0.2222222222222222,0.5136986301369864,63767592,108,24
0,293,0.20810810810810812,0.3897058823529412,67263644,370,77
0,557,0.07475083056478406,0.043513295729250605,67595675,602,45
2,24,0.8,0.9814814814814815,70080192,120,96
0,29,0.09375,0.05405405405405406,80140086,32,3
0,202,0.192,0.43636363636363634,80140123,250,48
2,1,0.8,0.5,80134718,5,4
1,224,0.37777777777777777,0.7983539094650206,70576590,360,136
2,10,0.5238095238095238,0.9615384615384616,79854131,21,11
1,4,0.2,0.6666666666666666,67703531,5,1
0,7,0.0,0.0,67703881,7,0
1,29,0.3829787234042553,0.6290322580645161,80158284,47,18
2,27,0.5423728813559322,0.9285714285714286,80158305,59,32
2,10,0.6875,0.8235294117647058,62829375,32,22
2,13,0.5,0.8214285714285714,73623130,26,13
1,4,0.42857142857142855,0.8,69164375,7,3
1,35,0.4262295081967213,0.8529411764705882,68046391,61,26
0,87,0.05434782608695652,0.18081180811808117,80089632,92,5
0,615,0.24354243542435425,0.45987654320987653,70286580,813,198
1,69,0.35514018691588783,0.7853403141361257,65278024,107,38
1,92,0.264,0.5286885245901639,66857301,125,33
0,461,0.17531305903398928,0.31666666666666665,82107805,559,98
1,5,0.375,0.65,70801843,8,3
0,11,0.21428571428571427,0.20689655172413793,70006293,14,3
1,161,0.496875,0.9441176470588235,79783893,320,159
0,113,0.15037593984962405,0.2777777777777778,80119323,133,20
0,164,0.07865168539325842,0.06582278481012659,80119336,178,14
1,211,0.3104575163398693,0.7580299785867237,69622350,306,95
1,42,0.25,0.85,64222466,56,14
1,138,0.26595744680851063,0.6,65307403,188,50
1,45,0.4827586206896552,0.9174311926605505,70741622,87,42
2,23,0.6229508196721312,0.9365079365079365,80174928,61,38
1,98,0.41317365269461076,0.7698412698412699,80175655,167,69
1,40,0.4666666666666667,0.92,69489385,75,35
1,13,0.3157894736842105,0.6451612903225806,68190696,19,6
1,58,0.4020618556701031,0.7857142857142857,70582323,97,39
0,261,0.10616438356164383,0.3118811881188119,65683695,292,31
1,119,0.47345132743362833,0.9173228346456693,66926076,226,107
1,505,0.3184885290148448,0.7049504950495049,69133225,741,236
0,31,0.11428571428571428,0.0891089108910891,73709265,35,4
0,405,0.19,0.34424242424242424,80070851,500,95
1,272,0.2727272727272727,0.5274542429284526,80180901,374,102
0,169,0.26521739130434785,0.45209580838323354,80180902,230,61
1,83,0.3851851851851852,0.8611111111111112,82126701,135,52
1,130,0.2571428571428571,0.704225352112676,68633096,175,45
1,111,0.3967391304347826,0.889937106918239,64410514,184,73
2,53,0.5583333333333333,0.975,71944012,120,67
0,213,0.20522388059701493,0.4217391304347826,68642371,268,55
0,142,0.22826086956521738,0.44244604316546765,69705125,184,42
0,3,0.0,0.0,70474271,3,0
0,236,0.1259259259259259,0.08633093525179857,68535355,270,34
1,36,0.34545454545454546,0.6833333333333333,80125494,55,19
0,47,0.020833333333333332,0.07575757575757576,62840463,48,1
1,67,0.3431372549019608,0.7012987012987013,70598990,102,35
1,38,0.20833333333333334,0.5460992907801419,66110765,48,10
0,45,0.25,0.3188405797101449,69464962,60,15
2,175,0.5308310991957105,0.961439588688946,70612696,373,198
1,527,0.3182406209573092,0.7803085966201323,80120440,773,246
1,48,0.43529411764705883,0.875,72455390,85,37
2,25,0.6527777777777778,0.5263157894736842,382095,72,47
1,61,0.42990654205607476,0.8279569892473119,82021853,107,46
1,114,0.32941176470588235,0.7744360902255639,70823256,170,56
2,23,0.54,0.922077922077922,70752934,50,27
1,94,0.24193548387096775,0.6098360655737705,70649313,124,30
0,8,0.0,0.0,70691264,8,0
1,73,0.45925925925925926,0.9154929577464789,81971176,135,62
0,21,0.34375,0.34146341463414637,80019772,32,11
2,7,0.72,0.9375,80125902,25,18
2,62,0.581081081081081,0.9700598802395209,73330943,148,86
2,0,1.0,1.0,82041287,4,4
1,140,0.3607305936073059,0.8356643356643356,67942385,219,79
1,213,0.28040540540540543,0.5951807228915663,70190561,296,83
1,5,0.4444444444444444,0.8181818181818182,68288955,9,4
1,222,0.4825174825174825,0.8153846153846154,76571481,429,207
1,34,0.47692307692307695,0.7358490566037735,80018645,65,31
1,22,0.40540540540540543,0.704225352112676,63289121,37,15
1,22,0.45,0.8809523809523809,73599456,40,18
2,26,0.559322033898305,0.99,82018859,59,33
2,28,0.5333333333333333,0.7142857142857143,70173761,60,32
0,35,0.05405405405405406,0.16,80072146,37,2
1,316,0.31896551724137934,0.7388535031847133,64927905,464,148
0,410,0.19765166340508805,0.4197860962566845,73346945,511,101
1,93,0.3841059602649007,0.8786127167630058,80080994,151,58
0,201,0.11842105263157894,0.1987075928917609,82000023,228,27
0,13,0.23529411764705882,0.23333333333333334,3052,17,4
2,54,0.6707317073170732,0.9565217391304348,80181570,164,110
2,147,0.6818181818181818,0.9716312056737588,70614432,462,315
0,157,0.15135135135135136,0.2054263565891473,70646156,185,28
1,167,0.3860294117647059,0.8240343347639485,80071565,272,105
1,100,0.3197278911564626,0.8235294117647058,67942763,147,47
1,397,0.40922619047619047,0.9029374201787995,67994262,672,275
0,77,0.06097560975609756,0.04032258064516129,80119335,82,5
0,154,0.193717277486911,0.29927007299270075,80180232,191,37
1,236,0.3058823529411765,0.598314606741573,70713090,340,104
0,196,0.1729957805907173,0.34917355371900827,67963182,237,41
0,29,0.14705882352941177,0.24242424242424243,82143780,34,5
1,367,0.2732673267326733,0.623352165725047,80180464,505,138
0,204,0.16049382716049382,0.21182266009852216,61365654,243,39
0,359,0.16317016317016317,0.34238310708898945,70641571,429,70
1,158,0.41044776119402987,0.7928388746803069,66872176,268,110
0,296,0.11377245508982035,0.18292682926829268,73906070,334,38
0,111,0.1897810218978102,0.4339622641509434,82018247,137,26
1,151,0.27403846153846156,0.5901162790697675,82116887,208,57
0,393,0.04611650485436893,0.10123456790123457,64241282,412,19
0,98,0.0392156862745098,0.09734513274336283,80124339,102,4
0,102,0.07272727272727272,0.2553191489361702,80124431,110,8
1,27,0.4,0.8294573643410853,70654290,45,18
1,209,0.3279742765273312,0.6456140350877193,80118618,311,102
0,346,0.22767857142857142,0.38898163606010017,69177143,448,102
0,145,0.22872340425531915,0.43333333333333335,82142124,188,43
0,10,0.23076923076923078,0.4444444444444444,65290316,13,3
0,177,0.17674418604651163,0.39690721649484534,68534515,215,38
1,74,0.3620689655172414,0.8765957446808511,66737713,116,42
1,67,0.4017857142857143,0.8712121212121212,69184535,112,45
0,296,0.16853932584269662,0.2943201376936317,67159316,356,60
0,153,0.13559322033898305,0.24019607843137256,73148852,177,24
0,216,0.13253012048192772,0.49568221070811747,60509561,249,33
0,75,0.025974025974025976,0.028985507246376812,73245585,77,2
0,30,0.2682926829268293,0.49382716049382713,73651032,41,11
1,267,0.3082901554404145,0.7245508982035929,69091666,386,119
0,85,0.22727272727272727,0.4066666666666667,67666305,110,25
0,24,0.22580645161290322,0.1111111111111111,80176622,31,7
0,326,0.12834224598930483,0.1988071570576541,70491603,374,48
0,66,0.043478260869565216,0.06593406593406594,69107122,69,3
1,59,0.3655913978494624,0.7124183006535948,70686553,93,34
1,103,0.42777777777777776,0.8621908127208481,72390822,180,77
0,6,0.14285714285714285,0.4,68234481,7,1
1,38,0.3770491803278688,0.7692307692307693,68212242,61,23
0,11,0.15384615384615385,0.2826086956521739,70843052,13,2
1,106,0.3291139240506329,0.6565656565656566,80176787,158,52
1,71,0.4132231404958678,0.9777777777777777,66535462,121,50
1,16,0.36,0.8214285714285714,69058290,25,9
1,27,0.4375,0.8732394366197183,80125550,48,21
0,80,0.17525773195876287,0.2154696132596685,82116874,97,17
0,117,0.01680672268907563,0.07603305785123966,62839784,119,2
0,7,0.0,0.0,82102543,7,0
0,12,0.0,0.0,82102898,12,0
1,86,0.21100917431192662,0.5211864406779662,68297852,109,23
1,264,0.2542372881355932,0.6440129449838188,70515382,354,90
0,63,0.125,0.4077669902912621,69005902,72,9
0,17,0.05555555555555555,0.15254237288135594,70467005,18,1
1,90,0.3023255813953488,0.6306818181818182,82007143,129,39
1,139,0.24864864864864866,0.5,69058514,185,46
0,167,0.15656565656565657,0.3848101265822785,70474453,198,31
1,64,0.3263157894736842,0.6625,80180329,95,31
1,175,0.2009132420091324,0.6491228070175439,62850123,219,44
1,128,0.189873417721519,0.6327014218009479,62850291,158,30
0,283,0.034129692832764506,0.23748544819557627,63631834,293,10
0,53,0.19696969696969696,0.47904191616766467,80154144,66,13
0,164,0.18811881188118812,0.3326923076923077,80118970,202,38
0,115,0.03361344537815126,0.20489977728285078,82134983,119,4
1,14,0.3333333333333333,0.6176470588235294,80160439,21,7
1,16,0.38461538461538464,0.6333333333333333,70798882,26,10
1,461,0.34978843441466856,0.8331479421579533,80121297,709,248
1,234,0.25949367088607594,0.6050156739811913,70049266,316,82
1,75,0.1935483870967742,0.5527950310559007,68604025,93,18
0,66,0.10810810810810811,0.3897058823529412,70468503,74,8
0,125,0.14383561643835616,0.17783505154639176,80120470,146,21
0,369,0.11510791366906475,0.17117117117117117,67800992,417,48
1,8,0.1111111111111111,0.5238095238095238,82110026,9,1
1,78,0.3275862068965517,0.8088737201365188,80131305,116,38
1,153,0.4612676056338028,0.9319371727748691,76080970,284,131
0,162,0.05263157894736842,0.0738255033557047,69509062,171,9
0,115,0.0,0.0,69509216,115,0
1,95,0.23387096774193547,0.6233062330623306,73668560,124,29
1,39,0.2777777777777778,0.6229508196721312,80072265,54,15
2,89,0.6454183266932271,0.9873949579831933,79326135,251,162
0,22,0.18518518518518517,0.4946236559139785,82103833,27,5
0,203,0.20392156862745098,0.45476190476190476,69165432,255,52
1,112,0.27741935483870966,0.7347670250896058,82143792,155,43
2,19,0.525,0.967741935483871,80149459,40,21
2,0,1.0,1.0,75033203,1,1
2,123,0.5886287625418061,0.9837662337662337,80096051,299,176
1,56,0.3170731707317073,0.7897727272727273,67789120,82,26
0,309,0.13202247191011235,0.19340974212034384,70614845,356,47
1,57,0.43,0.8616352201257862,68030536,100,43
0,42,0.125,0.1171875,73524682,48,6
1,160,0.30131004366812225,0.6642599277978339,67555460,229,69
0,107,0.11570247933884298,0.16304347826086957,67519375,121,14
1,66,0.2413793103448276,0.6176470588235294,70047572,87,21
1,86,0.23214285714285715,0.503731343283582,69640221,112,26
1,40,0.2982456140350877,0.6862745098039216,69184794,57,17
1,120,0.281437125748503,0.6907730673316709,68763604,167,47
1,142,0.42971887550200805,0.9144144144144144,67080601,249,107
1,28,0.17647058823529413,0.5,71618736,34,6
1,228,0.3952254641909814,0.8336798336798337,70039361,377,149
2,1,0.8333333333333334,0.0,68556712,6,5
1,312,0.3784860557768924,0.8860759493670886,70642936,502,190
1,187,0.20425531914893616,0.5523560209424084,66227000,235,48
0,112,0.18840579710144928,0.4444444444444444,66227035,138,26
2,3,0.75,0.8333333333333334,69011845,12,9
1,195,0.4161676646706587,0.9310344827586207,65278521,334,139
1,431,0.346969696969697,0.830168776371308,72658523,660,229
1,68,0.38738738738738737,0.7396449704142012,70575141,111,43
2,9,0.625,0.9285714285714286,70542871,24,15
2,10,0.5833333333333334,0.7647058823529411,69973232,24,14
2,16,0.9053254437869822,0.9655172413793104,69522054,169,153
0,73,0.13095238095238096,0.06951871657754011,80180287,84,11
0,6,0.14285714285714285,0.3333333333333333,80067505,7,1
0,11,0.08333333333333333,0.2608695652173913,70682031,12,1
0,313,0.054380664652567974,0.08993576017130621,80124242,331,18
0,4,0.0,0.0,82003730,4,0
0,34,0.15,0.375,82003734,40,6
0,33,0.15384615384615385,0.2,80123725,39,6
0,24,0.2,0.35555555555555557,80123735,30,6
0,305,0.03481012658227848,0.10460251046025104,64182622,316,11
1,114,0.22448979591836735,0.5095785440613027,67159666,147,33
0,256,0.18210862619808307,0.4499314128943759,80070753,313,57
0,174,0.19069767441860466,0.3544973544973545,69622462,215,41
2,81,0.5867346938775511,0.926605504587156,80155217,196,115
1,56,0.48148148148148145,0.8940397350993378,80145719,108,52
1,38,0.45714285714285713,0.9464285714285714,80169880,70,32
1,567,0.3258026159334126,0.7925430210325047,67557483,841,274
0,106,0.152,0.12345679012345678,73524633,125,19
0,202,0.2047244094488189,0.3798449612403101,73914484,254,52
0,64,0.189873417721519,0.48868778280542985,82103793,79,15
1,226,0.2206896551724138,0.5058139534883721,66930556,290,64
1,165,0.35546875,0.8456591639871383,69154575,256,91
1,46,0.352112676056338,0.875968992248062,82126599,71,25
1,155,0.42592592592592593,0.875,71372581,270,115
1,45,0.3918918918918919,0.8817204301075269,67282082,74,29
1,102,0.23308270676691728,0.6361607142857143,80154129,133,31
2,15,0.5454545454545454,0.975609756097561,80158343,33,18
0,14,0.17647058823529413,0.40384615384615385,69737024,17,3
1,90,0.3918918918918919,0.7829457364341085,68383672,148,58
0,42,0.125,0.3137254901960784,67376540,48,6
0,639,0.16251638269986893,0.39967637540453077,62413806,763,124
2,39,0.5760869565217391,0.922077922077922,72655702,92,53
1,15,0.3181818181818182,0.8924731182795699,69003151,22,7
0,50,0.0196078431372549,0.012195121951219513,69208195,51,1
0,27,0.03571428571428571,0.10344827586206896,82022538,28,1
2,13,0.6060606060606061,0.8387096774193549,67728304,33,20
0,110,0.03508771929824561,0.10849056603773585,80124284,114,4
0,176,0.03296703296703297,0.05977382875605816,80149851,182,6
0,257,0.21646341463414634,0.40233236151603496,82047583,328,71
0,225,0.06639004149377593,0.316688567674113,80149832,241,16
2,46,0.8666666666666667,0.9797979797979798,80181505,345,299
1,28,0.391304347826087,0.8970588235294118,79990162,46,18
0,73,0.1978021978021978,0.41363636363636364,80128898,91,18
2,9,0.55,0.56,70179851,20,11
2,2,0.7142857142857143,0.6,79453115,7,5
0,8,0.42857142857142855,0.0,66054464,14,6
0,271,0.18373493975903615,0.2549019607843137,60432883,332,61
1,211,0.2895622895622896,0.693200663349917,73245732,297,86
1,44,0.45,0.6333333333333333,69986105,80,36
0,219,0.15444015444015444,0.3160919540229885,69240094,259,40
1,63,0.37,0.8482758620689655,67556132,100,37
1,174,0.33076923076923076,0.7443609022556391,71019935,260,86
1,442,0.2633333333333333,0.5625,67942525,600,158
1,46,0.2698412698412698,0.7051282051282052,80178115,63,17
2,35,0.7244094488188977,0.96,82039888,127,92
0,74,0.25252525252525254,0.4866666666666667,73738805,99,25
2,86,0.5845410628019324,0.9585492227979274,67753735,207,121
1,107,0.2620689655172414,0.6479400749063671,67324306,145,38
2,81,0.6610878661087866,0.9693251533742331,69589016,239,158
1,48,0.30434782608695654,0.5901639344262295,69180174,69,21
0,228,0.19148936170212766,0.3784722222222222,70080955,282,54
0,83,0.16161616161616163,0.36464088397790057,77902440,99,16
1,86,0.45222929936305734,0.9240924092409241,81971161,157,71
2,119,0.5795053003533569,0.9842767295597484,82088774,283,164
1,549,0.24066390041493776,0.5760869565217391,67291714,723,174
0,183,0.17937219730941703,0.3202933985330073,70645764,223,40
1,75,0.34210526315789475,0.847926267281106,65022342,114,39
1,77,0.21428571428571427,0.5376344086021505,72523003,98,21
0,137,0.2346368715083799,0.3653250773993808,80145292,179,42
0,31,0.27906976744186046,0.4155844155844156,78159270,43,12
0,116,0.03333333333333333,0.0855457227138643,64240785,120,4
0,259,0.16720257234726688,0.36809815950920244,68542971,311,52
0,36,0.12195121951219512,0.30656934306569344,141176,41,5
1,24,0.22580645161290322,0.6808510638297872,141274,31,7
0,30,0.14285714285714285,0.34146341463414637,66222541,35,5
0,60,0.13043478260869565,0.2702702702702703,66222611,69,9
0,26,0.07142857142857142,0.22033898305084745,66403442,28,2
0,10,0.09090909090909091,0.24390243902439024,67315073,11,1
1,76,0.3391304347826087,0.6936416184971098,70080262,115,39
2,1,0.96,0.6666666666666666,82143785,25,24
0,53,0.05357142857142857,0.07692307692307693,70080976,56,3
0,64,0.030303030303030304,0.04201680672268908,70081053,66,2
0,123,0.0390625,0.055900621118012424,70081410,128,5
0,95,0.16666666666666666,0.2648221343873518,71762691,114,19
2,3,0.987603305785124,0.6666666666666666,70411271,242,239
2,13,0.5185185185185185,0.9117647058823529,70632660,27,14
1,65,0.375,0.793939393939394,80145764,104,39
2,119,0.7407407407407407,0.926605504587156,65534665,459,340
1,95,0.35374149659863946,0.8963414634146342,73637732,147,52
0,164,0.029585798816568046,0.1023391812865497,64248534,169,5
1,73,0.34234234234234234,0.7790697674418605,70729435,111,38
1,59,0.4485981308411215,0.936,75660662,107,48
1,56,0.391304347826087,0.8378378378378378,69073655,92,36
1,85,0.23423423423423423,0.8072727272727273,69151873,111,26
0,12,0.07692307692307693,0.3559322033898305,70199661,13,1
0,14,0.0,0.0,80128802,14,0
0,10,0.0,0.0,70199654,10,0
0,14,0.0,0.0,70199675,14,0
0,11,0.0,0.0,70199703,11,0
0,8,0.0,0.0,70199745,8,0
0,36,0.07692307692307693,0.34057971014492755,70199780,39,3
0,13,0.0,0.0,70199801,13,0
0,235,0.06,0.17475728155339806,74020331,250,15
1,88,0.3230769230769231,0.7228915662650602,80133410,130,42
1,34,0.38181818181818183,0.8641975308641975,68338704,55,21
1,99,0.23255813953488372,0.5368421052631579,80128499,129,30
1,80,0.27927927927927926,0.6328125,81992707,111,31
0,133,0.24,0.4318936877076412,80070074,175,42
0,541,0.15863141524105753,0.31598793363499245,61329751,643,102
0,7,0.0,0.0,70240695,7,0
0,259,0.06498194945848375,0.3271461716937355,62840981,277,18
1,48,0.3333333333333333,0.7142857142857143,80051685,72,24
0,127,0.23030303030303031,0.26804123711340205,80055745,165,38
1,196,0.35947712418300654,0.6285714285714286,80055766,306,110
2,72,0.5263157894736842,0.9354838709677419,80128563,152,80
0,371,0.08395061728395062,0.1104368932038835,70627291,405,34
1,185,0.24180327868852458,0.5101351351351351,66471265,244,59
0,357,0.07989690721649484,0.10133060388945753,80097472,388,31
0,118,0.10606060606060606,0.1834862385321101,70200354,132,14
0,218,0.17110266159695817,0.3936348408710218,81979988,263,45
1,76,0.48299319727891155,0.904,69955165,147,71
1,481,0.48056155507559395,0.7438202247191011,70121954,926,445
1,91,0.3357664233576642,0.7463414634146341,70252392,137,46
0,23,0.20689655172413793,0.4594594594594595,71081234,29,6
0,242,0.07279693486590039,0.03793103448275862,82096268,261,19
1,41,0.31666666666666665,0.7391304347826086,80127420,60,19
0,81,0.22857142857142856,0.3969849246231156,69183975,105,24
0,41,0.046511627906976744,0.06542056074766354,70181195,43,2
0,8,0.1111111111111111,0.13043478260869565,70181216,9,1
0,54,0.03571428571428571,0.03225806451612903,72775094,56,2
2,0,1.0,1.0,69994351,1,1
0,64,0.1111111111111111,0.27932960893854747,80124272,72,8
2,24,0.8032786885245902,0.9824561403508771,70566083,122,98
1,6,0.25,0.5625,70693343,8,2
1,210,0.31596091205211724,0.8038095238095239,68763660,307,97
0,1,0.0,0.0,67643996,1,0
1,421,0.4011379800853485,0.8967334035827187,80111206,703,282
1,80,0.4520547945205479,0.8811881188118812,70545216,146,66
0,299,0.0856269113149847,0.07923930269413629,80104626,327,28
0,278,0.23204419889502761,0.4651600753295669,70646051,362,84
1,6,0.25,0.7083333333333334,69653094,8,2
0,192,0.1794871794871795,0.4509090909090909,68538554,234,42
1,37,0.3620689655172414,0.8690476190476191,69152181,58,21
2,8,0.5789473684210527,0.8636363636363636,73652166,19,11
0,314,0.20506329113924052,0.4451345755693582,70802956,395,81
1,70,0.48905109489051096,0.9485981308411215,82138825,137,67
2,0,1.0,1.0,80137593,3,3
0,13,0.13333333333333333,0.17391304347826086,72775080,15,2
0,75,0.12790697674418605,0.22727272727272727,73919930,86,11
0,7,0.125,0.391304347826087,70706622,8,1
0,44,0.12,0.2169811320754717,73295621,50,6
0,105,0.08695652173913043,0.1694915254237288,82022540,115,10
2,0,1.0,1.0,80177748,2,2
0,147,0.10365853658536585,0.2722222222222222,69157900,164,17
0,167,0.20476190476190476,0.4153225806451613,69157963,210,43
1,6,0.25,0.6226415094339622,70063896,8,2
2,52,0.6176470588235294,0.6666666666666666,77884835,136,84
2,78,0.6195121951219512,0.950354609929078,80089534,205,127
1,106,0.49523809523809526,0.9438596491228071,66611314,210,104
1,85,0.24778761061946902,0.5210727969348659,69558412,113,28
1,244,0.3645833333333333,0.8542713567839196,67281893,384,140
2,14,0.6666666666666666,0.9705882352941176,60602465,42,28
0,330,0.16030534351145037,0.27491408934707906,82039204,393,63
1,49,0.27941176470588236,0.6829268292682927,73738980,68,19
2,113,0.6705539358600583,0.9829351535836177,82007555,343,230
0,150,0.10714285714285714,0.14754098360655737,80119339,168,18
1,218,0.4123989218328841,0.890020366598778,73975083,371,153
1,215,0.2687074829931973,0.6054545454545455,68521516,294,79
0,174,0.2018348623853211,0.3826086956521739,70800814,218,44
1,30,0.2857142857142857,0.6307692307692307,82005353,42,12
0,120,0.0625,0.06948640483383686,69416536,128,8
1,27,0.2702702702702703,0.6911764705882353,63050981,37,10
0,199,0.05238095238095238,0.26727509778357234,74607323,210,11
1,35,0.4927536231884058,0.8301886792452831,80180175,69,34
0,717,0.19256756756756757,0.48523622047244097,60249322,888,171
1,271,0.40308370044052866,0.8031746031746032,80176774,454,183
1,110,0.26174496644295303,0.5524475524475524,82126734,149,39
1,159,0.28378378378378377,0.5802816901408451,68545890,222,63
1,57,0.37362637362637363,0.8347107438016529,80136844,91,34
1,358,0.37302977232924694,0.8236842105263158,70748496,571,213
1,47,0.3815789473684211,0.9307692307692308,69056393,76,29
1,83,0.33064516129032256,0.6338028169014085,80180211,124,41
0,240,0.22330097087378642,0.44047619047619047,78983996,309,69
2,0,1.0,1.0,70858536,3,3
2,34,0.75,0.9761904761904762,70412860,136,102
1,21,0.4166666666666667,0.9090909090909091,80053421,36,15
1,130,0.36585365853658536,0.8041666666666667,69173272,205,75
1,61,0.3146067415730337,0.7049180327868853,68241516,89,28
1,228,0.2645161290322581,0.6494845360824743,67942770,310,82
0,99,0.029411764705882353,0.1424581005586592,68811603,102,3
1,78,0.16129032258064516,0.5523465703971119,69479445,93,15
0,163,0.02976190476190476,0.08895705521472393,62840631,168,5
0,283,0.15522388059701492,0.259958071278826,67150734,335,52
0,63,0.2125,0.3353658536585366,69422486,80,17
0,468,0.09652509652509653,0.20027624309392264,63771204,518,50
1,31,0.41509433962264153,0.8115942028985508,80172942,53,22
1,159,0.364,0.7723076923076924,70661003,250,91
1,119,0.4541284403669725,0.863013698630137,68666423,218,99
0,27,0.25,0.4,68666430,36,9
0,486,0.18864774624373956,0.27466666666666667,67652011,599,113
1,103,0.33974358974358976,0.6170212765957447,69628692,156,53
2,43,0.5222222222222223,0.9278350515463918,67512956,90,47
0,51,0.1774193548387097,0.17647058823529413,80180187,62,11
2,131,0.5201465201465202,0.9580152671755725,62661802,273,142
2,26,0.6829268292682927,0.9743589743589743,67788896,82,56
1,167,0.39492753623188404,0.8035264483627204,72322033,276,109
1,63,0.25882352941176473,0.6621004566210046,70761005,85,22
1,35,0.43548387096774194,0.9133858267716536,80037986,62,27
1,218,0.3789173789173789,0.823943661971831,69594826,351,133
0,70,0.10256410256410256,0.10377358490566038,68398120,78,8
1,356,0.21929824561403508,0.5429262394195888,70614824,456,100
0,68,0.21839080459770116,0.34355828220858897,82116846,87,19
0,52,0.11864406779661017,0.39906103286384975,62850396,59,7
1,201,0.46684350132625996,0.900355871886121,80062206,377,176
0,5,0.0,0.0,80089163,5,0
1,26,0.23529411764705882,0.6702127659574468,67978225,34,8
0,337,0.020348837209302327,0.1268939393939394,63633612,344,7
0,160,0.13513513513513514,0.4381443298969072,70629874,185,25
0,242,0.09701492537313433,0.11885245901639344,67592924,268,26
0,77,0.0,0.0,67469934,77,0
0,11,0.15384615384615385,0.4473684210526316,65110836,13,2
0,44,0.13725490196078433,0.3888888888888889,69160623,51,7
0,57,0.05,0.24,69910533,60,3
2,3,0.5,0.875,74027772,6,3
0,140,0.05405405405405406,0.38762886597938145,64026886,148,8
0,118,0.03278688524590164,0.31411530815109345,80149921,122,4
1,34,0.19047619047619047,0.5227272727272727,70629321,42,8
0,98,0.07547169811320754,0.4376657824933687,64399580,106,8
0,124,0.21019108280254778,0.4305555555555556,67429124,157,33
1,155,0.23267326732673269,0.7445414847161572,69890520,202,47
0,102,0.08928571428571429,0.40625,70463526,112,10
0,52,0.037037037037037035,0.11483253588516747,69890786,54,2
1,42,0.19230769230769232,0.6423841059602649,69188105,52,10
0,2,0.0,0.0,69188483,2,0
1,159,0.39080459770114945,0.8833333333333333,80180171,261,102
1,78,0.15217391304347827,0.6181818181818182,63262290,92,14
0,6,0.0,0.0,69407282,6,0
1,54,0.2894736842105263,0.7032258064516129,69643140,76,22
1,194,0.17446808510638298,0.6515912897822446,70923034,235,41
0,29,0.17142857142857143,0.37777777777777777,70621355,35,6
0,22,0.12,0.18181818181818182,70831880,25,3
1,465,0.12593984962406016,0.5009191176470589,64077034,532,67
1,18,0.25,0.7,71619065,24,6
1,16,0.2727272727272727,0.7674418604651163,69886306,22,6
0,148,0.13450292397660818,0.20491803278688525,80055731,171,23
0,315,0.0031645569620253164,0.05189620758483034,67468282,316,1
0,144,0.02040816326530612,0.1847457627118644,80150885,147,3
1,170,0.1414141414141414,0.5635593220338984,64399286,198,28
0,91,0.08080808080808081,0.4470284237726098,70922320,99,8
0,283,0.027491408934707903,0.17567567567567569,68467616,291,8
0,56,0.0967741935483871,0.4581497797356828,70468531,62,6
0,59,0.04838709677419355,0.26881720430107525,64400000,62,3
0,140,0.13580246913580246,0.3292181069958848,69468763,162,22
0,10,0.0,0.0,64399531,10,0
0,58,0.0,0.0,64399790,58,0
1,47,0.2033898305084746,0.6481481481481481,67454961,59,12
0,120,0.06976744186046512,0.38292011019283745,70482321,129,9
0,572,0.022222222222222223,0.15378610460577674,63265272,585,13
0,102,0.06422018348623854,0.2751322751322751,63166943,109,7
0,28,0.06666666666666667,0.12149532710280374,64069040,30,2
0,36,0.07692307692307693,0.3288590604026846,67917353,39,3
0,88,0.08333333333333333,0.42643391521197005,63981981,96,8
1,115,0.1015625,0.5142857142857142,63169050,128,13
0,259,0.007662835249042145,0.06630581867388363,65133663,261,2
2,36,0.6170212765957447,0.9895833333333334,70916671,94,58
0,113,0.15671641791044777,0.4732394366197183,69217085,134,21
0,55,0.017857142857142856,0.0970873786407767,67040736,56,1
0,51,0.0,0.0,67051502,51,0
0,14,0.0,0.0,80150880,14,0
0,111,0.034782608695652174,0.12472647702407003,62838986,115,4
0,75,0.12790697674418605,0.458955223880597,64076614,86,11
0,349,0.16706443914081145,0.46685472496473907,70909062,419,70
0,233,0.016877637130801686,0.11862396204033215,65135413,237,4
0,95,0.08653846153846154,0.34124629080118696,69024186,104,9
0,101,0.00980392156862745,0.0891566265060241,67469640,102,1
0,54,0.01818181818181818,0.24923076923076923,80150908,55,1
1,45,0.23728813559322035,0.5522388059701493,68907412,59,14
0,42,0.045454545454545456,0.2579185520361991,67888205,44,2
0,288,0.102803738317757,0.4818523153942428,70923650,321,33
0,231,0.08695652173913043,0.4300653594771242,67887855,253,22
1,134,0.14102564102564102,0.548,63578956,156,22
1,148,0.263681592039801,0.7253012048192771,70615426,201,53
1,26,0.23529411764705882,0.8255813953488372,64220751,34,8
0,23,0.14814814814814814,0.46226415094339623,82150106,27,4
0,46,0.11538461538461539,0.4084507042253521,80163186,52,6
0,76,0.07317073170731707,0.35833333333333334,67917542,82,6
0,229,0.0653061224489796,0.45255474452554745,70468601,245,16
1,38,0.07317073170731707,0.600896860986547,80149941,41,3
1,37,0.05128205128205128,0.5754189944134078,80149942,39,2
0,104,0.028037383177570093,0.26976744186046514,80150893,107,3
1,56,0.15151515151515152,0.6770833333333334,64235171,66,10
1,73,0.26262626262626265,0.7371428571428571,70629391,99,26
0,42,0.045454545454545456,0.325,82049097,44,2
0,105,0.009433962264150943,0.06378986866791744,70468433,106,1
0,6,0.0,0.0,70916545,6,0
0,216,0.09623430962343096,0.42634315424610053,70923524,239,23
0,425,0.011627906976744186,0.08262108262108261,65132522,430,5
0,28,0.125,0.42016806722689076,67846275,32,4
1,19,0.24,0.7721518987341772,67917514,25,6
1,11,0.21428571428571427,0.7083333333333334,68193293,14,3
1,139,0.09740259740259741,0.5199004975124378,63628726,154,15
0,37,0.0,0.0,67888982,37,0
0,109,0.00909090909090909,0.10722610722610723,70468643,110,1
0,173,0.09895833333333333,0.48440366972477067,64183336,192,19
0,35,0.0,0.0,67896374,35,0
0,423,0.05580357142857143,0.2299168975069252,69879236,448,25
0,171,0.1,0.47776183644189385,74439946,190,19
0,248,0.08487084870848709,0.3815950920245399,80128645,271,23
0,287,0.05901639344262295,0.29435483870967744,80128646,305,18
0,211,0.0365296803652968,0.14896755162241887,80128647,219,8
1,60,0.13043478260869565,0.6287878787878788,80128660,69,9
0,101,0.10619469026548672,0.4621212121212121,80149821,113,12
0,26,0.0,0.0,63629055,26,0
0,28,0.06666666666666667,0.28735632183908044,70059472,30,2
0,52,0.037037037037037035,0.2153846153846154,67887351,54,2
1,46,0.1320754716981132,0.631578947368421,65364061,53,7
0,64,0.0,0.0,69006070,64,0
0,87,0.03333333333333333,0.3582089552238806,80149937,90,3
0,113,0.058333333333333334,0.3399122807017544,68801103,120,7
0,83,0.20192307692307693,0.43902439024390244,80135048,104,21
1,26,0.21212121212121213,0.7444444444444445,70629853,33,7
0,146,0.02666666666666667,0.2543689320388349,80150017,150,4
0,103,0.0,0.0,82206142,103,0
0,128,0.022900763358778626,0.2205607476635514,65671564,131,3
0,98,0.216,0.3875598086124402,69538196,125,27
0,47,0.14545454545454545,0.25773195876288657,69736310,55,8
0,21,0.19230769230769232,0.42857142857142855,70761215,26,5
1,13,0.1875,0.5714285714285714,70584493,16,3
0,87,0.06451612903225806,0.1365079365079365,70908663,93,6
0,107,0.20149253731343283,0.41353383458646614,68642280,134,27
0,161,0.13440860215053763,0.4934725848563969,68350730,186,25
0,85,0.022988505747126436,0.09767441860465116,66025253,87,2
0,31,0.0,0.0,66025414,31,0
0,37,0.02631578947368421,0.18565400843881857,66025666,38,1
0,144,0.006896551724137931,0.03789126853377265,67896416,145,1
0,67,0.12987012987012986,0.4149377593360996,66756382,77,10
0,23,0.041666666666666664,0.4855072463768116,80149962,24,1
0,25,0.07407407407407407,0.3756906077348066,67051635,27,2
0,6,0.25,0.4166666666666667,80135233,8,2
0,67,0.04285714285714286,0.12871287128712872,70654591,70,3
1,133,0.2692307692307692,0.7300884955752213,68779270,182,49
0,75,0.0,0.0,80149970,75,0
0,41,0.0,0.0,80150866,41,0
0,164,0.029585798816568046,0.234375,80150868,169,5
0,27,0.0,0.0,82205988,27,0
0,7,0.3,0.47058823529411764,80167303,10,3
0,59,0.1323529411764706,0.36496350364963503,70629433,68,9
0,101,0.08181818181818182,0.1822429906542056,70629503,110,9
1,7,0.2222222222222222,0.7777777777777778,69910953,9,2
1,84,0.07692307692307693,0.5861111111111111,67888905,91,7
0,85,0.03409090909090909,0.34405940594059403,69006035,88,3
1,21,0.4473684210526316,0.9545454545454546,70629496,38,17
1,52,0.16129032258064516,0.5654450261780105,82103884,62,10
0,253,0.003937007874015748,0.04171494785631518,67468352,254,1
0,164,0.029585798816568046,0.2208904109589041,80149826,169,5
1,194,0.1950207468879668,0.6144578313253012,67603221,241,47
0,216,0.2087912087912088,0.2850467289719626,69644554,273,57
0,302,0.022653721682847898,0.08142493638676845,66876894,309,7
0,184,0.046632124352331605,0.18018018018018017,76805561,193,9
0,11,0.0,0.0,80150512,11,0
0,8,0.0,0.0,80150708,8,0
1,96,0.2727272727272727,0.6416666666666667,80119201,132,36
0,44,0.16981132075471697,0.4915254237288136,82150122,53,9
0,36,0.02702702702702703,0.15028901734104047,70848393,37,1
0,34,0.08108108108108109,0.4791666666666667,64237103,37,3
0,45,0.08163265306122448,0.25142857142857145,64359981,49,4
0,144,0.06493506493506493,0.30998248686514884,82134960,154,10
1,29,0.3409090909090909,0.6949152542372882,82007135,44,15
2,9,0.5263157894736842,0.9354838709677419,64473556,19,10
1,4,0.3333333333333333,0.6666666666666666,70821373,6,2
0,1,0.0,0.0,70821583,1,0
1,6,0.4,0.8571428571428571,82006878,10,4
1,44,0.37142857142857144,0.8449612403100775,69195196,70,26
1,125,0.2897727272727273,0.7888563049853372,70487704,176,51
1,34,0.20930232558139536,0.7539267015706806,69162744,43,9
1,58,0.30120481927710846,0.8,80124663,83,25
1,102,0.07272727272727272,0.5344418052256532,70468552,110,8
1,103,0.2695035460992908,0.6536796536796536,80162163,141,38
0,276,0.1686746987951807,0.2873134328358209,73524605,332,56
1,193,0.26053639846743293,0.5198019801980198,80125025,261,68
1,63,0.4793388429752066,0.9,80180327,121,58
1,113,0.27564102564102566,0.7,64130360,156,43
0,12,0.0,0.0,67051362,12,0
1,147,0.1787709497206704,0.716297786720322,68227383,179,32
1,27,0.2894736842105263,0.7142857142857143,67905775,38,11
1,34,0.34615384615384615,0.8230088495575221,67900896,52,18
1,114,0.17391304347826086,0.6056338028169014,69890422,138,24
1,6,0.4,0.9629629629629629,69910316,10,4
1,227,0.11673151750972763,0.5933609958506224,69005811,257,30
0,124,0.023622047244094488,0.23156089193825044,70468223,127,3
1,64,0.13513513513513514,0.5163934426229508,80128488,74,10
1,9,0.25,0.7555555555555555,70923405,12,3
0,111,0.008928571428571428,0.06753246753246753,66876796,112,1
0,52,0.018867924528301886,0.11811023622047244,66876803,53,1
0,106,0.018518518518518517,0.07780320366132723,70314706,108,2
0,8,0.0,0.0,80150607,8,0
0,26,0.10344827586206896,0.19,69886775,29,3
1,11,0.15384615384615385,0.5873015873015873,80162837,13,2
0,4,0.0,0.0,82006716,4,0
1,150,0.13793103448275862,0.5234375,64399034,174,24
0,39,0.15217391304347827,0.23478260869565218,80135292,46,7
0,189,0.09569377990430622,0.48736462093862815,80149945,209,20
0,7,0.0,0.0,82102516,7,0
0,40,0.0,0.0,82102884,40,0
0,114,0.05,0.4194214876033058,80150883,120,6
1,49,0.24615384615384617,0.7164179104477612,82143790,65,16
0,14,0.06666666666666667,0.20754716981132076,80162874,15,1
1,27,0.25,0.5465116279069767,69185340,36,9
0,20,0.09090909090909091,0.4666666666666667,64234660,22,2
1,90,0.1,0.5290322580645161,70482720,100,10
0,37,0.11904761904761904,0.25477707006369427,82150124,42,5
1,15,0.3181818181818182,0.7777777777777778,80180993,22,7
1,48,0.45454545454545453,0.7391304347826086,80055836,88,40
0,222,0.14942528735632185,0.1407185628742515,72425661,261,39
1,20,0.23076923076923078,0.5,72426382,26,6
0,110,0.017857142857142856,0.19230769230769232,80150894,112,2
1,38,0.3968253968253968,0.8271604938271605,64697031,63,25
0,76,0.12643678160919541,0.4515235457063712,65947371,87,11
1,52,0.46938775510204084,0.968,66053554,98,46
0,111,0.017699115044247787,0.173828125,70467306,113,2
0,24,0.0,0.0,70917931,24,0
1,75,0.07407407407407407,0.5245398773006135,80149981,81,6
0,53,0.08620689655172414,0.33879781420765026,69895812,58,5
0,38,0.13636363636363635,0.38461538461538464,69895882,44,6
0,89,0.1188118811881188,0.3217993079584775,78763293,101,12
0,8,0.0,0.0,80173406,8,0
0,45,0.0,0.0,82049120,45,0
2,10,0.7872340425531915,0.9642857142857143,70632282,47,37
0,3,0.0,0.0,80150600,3,0
1,135,0.20588235294117646,0.5454545454545454,82103785,170,35
1,99,0.2773722627737226,0.5646551724137931,68883542,137,38
1,5,0.375,0.8333333333333334,69519835,8,3
0,5,0.2857142857142857,0.42857142857142855,80168252,7,2
2,8,0.6363636363636364,0.9523809523809523,70670166,22,14
0,60,0.11764705882352941,0.4791666666666667,67122244,68,8
1,44,0.42105263157894735,0.967741935483871,67326791,76,32
0,149,0.13372093023255813,0.48484848484848486,70922355,172,23
0,117,0.064,0.23809523809523808,66541524,125,8
0,116,0.025210084033613446,0.24431818181818182,69006014,119,3
1,69,0.2159090909090909,0.6666666666666666,67226152,88,19
1,156,0.11363636363636363,0.6378676470588235,69638422,176,20
1,130,0.2571428571428571,0.6446280991735537,69621783,175,45
1,58,0.14705882352941177,0.58125,64230740,68,10
0,6,0.0,0.0,69527850,6,0
1,76,0.43703703703703706,0.8347826086956521,70700882,135,59
0,186,0.0053475935828877,0.06028833551769332,65658166,187,1
0,170,0.0449438202247191,0.36439499304589706,80149964,178,8
0,63,0.0,0.0,67468296,63,0
0,247,0.012,0.08177570093457943,67468303,250,3
1,30,0.11764705882352941,0.5454545454545454,82006528,34,4
0,10,0.0,0.0,80162836,10,0
0,15,0.11764705882352941,0.2,80162880,17,2
0,3,0.0,0.0,82118274,3,0
0,95,0.09523809523809523,0.30177514792899407,64063055,105,10
1,51,0.05555555555555555,0.5082644628099173,70468272,54,3
0,220,0.039301310043668124,0.33011272141706927,82205858,229,9
0,11,0.08333333333333333,0.3333333333333333,82118237,12,1
1,82,0.20388349514563106,0.6181102362204725,82008947,103,21
1,155,0.20512820512820512,0.5135802469135803,69943083,195,40
1,174,0.21266968325791855,0.5375,70760284,221,47
1,8,0.38461538461538464,0.9333333333333333,71619261,13,5
0,20,0.09090909090909091,0.15217391304347827,69559924,22,2
0,12,0.14285714285714285,0.4,82034196,14,2
1,10,0.23076923076923078,0.7647058823529411,82034197,13,3
1,19,0.20833333333333334,0.6989247311827957,82034198,24,5
1,46,0.31343283582089554,0.8571428571428571,65966726,67,21
0,1,0.0,0.0,80150539,1,0
0,8,0.0,0.0,80150584,8,0
0,6,0.0,0.0,80150590,6,0
1,6,0.14285714285714285,0.64,80150604,7,1
2,6,0.5714285714285714,0.9285714285714286,66469193,14,8
0,123,0.046511627906976744,0.25851703406813625,70917763,129,6
1,39,0.1875,0.7133757961783439,69481391,48,9
1,46,0.14814814814814814,0.7320574162679426,69481496,54,8
1,53,0.14516129032258066,0.5868544600938967,80149815,62,9
0,33,0.029411764705882353,0.10743801652892562,70463190,34,1
0,15,0.11764705882352941,0.3508771929824561,69527766,17,2
1,8,0.38461538461538464,0.9024390243902439,80135729,13,5
0,2,0.0,0.0,69058122,2,0
0,14,0.0,0.0,80176291,14,0
0,170,0.005847953216374269,0.07504078303425775,64502011,171,1
0,225,0.0546218487394958,0.21870882740447958,64076572,238,13
0,83,0.011904761904761904,0.1323529411764706,80150891,84,1
0,133,0.0,0.0,80150895,133,0
0,128,0.007751937984496124,0.08860759493670886,80150897,129,1
0,90,0.0,0.0,80150899,90,0
1,48,0.2,0.7091836734693877,65363781,60,12
0,30,0.11764705882352941,0.26881720430107525,69201314,34,4
2,28,0.5087719298245614,0.9739130434782609,69058262,57,29
0,97,0.21138211382113822,0.43354430379746833,70769713,123,26
0,274,0.017921146953405017,0.12447257383966245,82134950,279,5
1,13,0.2777777777777778,0.8852459016393442,70917903,18,5
1,56,0.38461538461538464,0.8823529411764706,73514021,91,35
0,26,0.1875,0.33695652173913043,66027563,32,6
0,12,0.07692307692307693,0.23404255319148937,82102626,13,1
0,38,0.0,0.0,82102896,38,0
2,18,0.5813953488372093,0.8913043478260869,69404475,43,25
0,16,0.2,0.3508771929824561,71689583,20,4
0,144,0.07096774193548387,0.18393782383419688,67594863,155,11
1,72,0.34545454545454546,0.8776595744680851,70917546,110,38
0,68,0.16049382716049382,0.3828125,73700746,81,13
0,125,0.0234375,0.1167608286252354,74607050,128,3
0,1,0.0,0.0,80168262,1,0
2,33,0.56,0.8571428571428571,67580632,75,42
0,8,0.0,0.0,80150722,8,0
0,92,0.09803921568627451,0.25263157894736843,82150089,102,10
0,21,0.16,0.4461538461538462,80135093,25,4
0,236,0.016666666666666666,0.027777777777777776,62840190,240,4
1,95,0.391025641025641,0.7509578544061303,70766332,156,61
0,120,0.01639344262295082,0.1583710407239819,65133691,122,2
0,23,0.0,0.0,80150881,23,0
0,27,0.0,0.0,80150007,27,0
0,226,0.017391304347826087,0.13625,67468275,230,4
1,123,0.19607843137254902,0.686046511627907,64068844,153,30
0,25,0.1935483870967742,0.4050632911392405,82036403,31,6
1,47,0.27692307692307694,0.796875,67699695,65,18
0,357,0.05305039787798409,0.2566943674976916,62834310,377,20
0,65,0.029850746268656716,0.1712538226299694,82134958,67,2
1,46,0.16363636363636364,0.5548780487804879,16137226,55,9
0,201,0.01951219512195122,0.0340632603406326,62837110,205,4
0,168,0.034482758620689655,0.11033519553072625,68356365,174,6
0,4,0.0,0.0,80150518,4,0
0,9,0.0,0.0,80150710,9,0
0,75,0.05063291139240506,0.25112107623318386,70923062,79,4
0,24,0.1724137931034483,0.4,82090250,29,5
0,15,0.0,0.0,65716525,15,0
0,134,0.014705882352941176,0.1490125673249551,65132571,136,2
0,164,0.029585798816568046,0.2608047690014903,70467754,169,5
1,13,0.23529411764705882,0.8409090909090909,67873323,17,4
0,130,0.1503267973856209,0.35276967930029157,65526545,153,23
0,159,0.04216867469879518,0.20853080568720378,62840372,166,7
1,549,0.29615384615384616,0.8405797101449275,69890744,780,231
1,18,0.21739130434782608,0.881578947368421,80153553,23,5
0,72,0.06493506493506493,0.3595505617977528,62836095,77,5
0,141,0.007042253521126761,0.05362776025236593,66025022,142,1
0,155,0.00641025641025641,0.03602305475504323,66025246,156,1
0,139,0.07333333333333333,0.40535372848948376,68356603,150,11
1,6,0.25,0.7272727272727273,67978204,8,2
1,27,0.12903225806451613,0.5573770491803278,67888100,31,4
1,30,0.4915254237288136,0.9130434782608695,80150946,59,29
1,129,0.06521739130434782,0.5072765072765073,67888940,138,9
0,128,0.022900763358778626,0.10679611650485436,70216573,131,3
1,139,0.4085106382978723,0.7682119205298014,80180282,235,96
0,188,0.035897435897435895,0.32620320855614976,64026830,195,7
0,138,0.014285714285714285,0.14186851211072665,65132515,140,2
0,217,0.0,0.0,65675120,217,0
0,108,0.04424778761061947,0.3626609442060086,65675610,113,5
0,59,0.03278688524590164,0.345565749235474,80149949,61,2
0,109,0.018018018018018018,0.17484008528784648,80149998,111,2
0,82,0.0,0.0,80150006,82,0
1,14,0.06666666666666667,0.6879432624113475,80150014,15,1
0,57,0.0,0.0,80150020,57,0
0,118,0.04838709677419355,0.4481409001956947,80150917,124,6
0,124,0.015873015873015872,0.19413919413919414,82205947,126,2
0,61,0.031746031746031744,0.3425925925925926,70468020,63,2
0,128,0.030303030303030304,0.29136690647482016,80150913,132,4
0,47,0.14545454545454545,0.44025157232704404,69911975,55,8
0,103,0.16260162601626016,0.4551282051282051,70909265,123,20
0,4,0.0,0.0,67977945,4,0
0,43,0.044444444444444446,0.31627906976744186,67896290,45,2
0,14,0.0,0.0,80150844,14,0
1,41,0.3050847457627119,0.7777777777777778,80135282,59,18
1,29,0.14705882352941177,0.6344086021505376,67359684,34,5
0,75,0.0,0.0,80150901,75,0
0,6,0.0,0.0,80150847,6,0
2,87,0.5112359550561798,0.9821428571428571,66806453,178,91
1,107,0.17054263565891473,0.5992366412213741,64282176,129,22
1,92,0.2755905511811024,0.8615384615384616,67510191,127,35
1,24,0.1111111111111111,0.5357142857142857,64234555,27,3
1,8,0.2,0.7692307692307693,69910260,10,2
1,22,0.2903225806451613,0.7419354838709677,79976645,31,9
0,70,0.125,0.3837837837837838,82150091,80,10
0,114,0.017241379310344827,0.19334719334719336,67004623,116,2
0,39,0.1875,0.48175182481751827,73650465,48,9
1,153,0.32599118942731276,0.8675213675213675,80154125,227,74
0,142,0.059602649006622516,0.281767955801105,67888611,151,9
0,159,0.05357142857142857,0.25098039215686274,67122356,168,9
1,90,0.19642857142857142,0.5070422535211268,69895826,112,22
1,39,0.1875,0.6312056737588653,64930453,48,9
0,15,0.0625,0.1927710843373494,67435025,16,1
1,171,0.4083044982698962,0.8637532133676092,66050362,289,118
1,30,0.16666666666666666,0.6261682242990654,82150114,36,6
0,102,0.04672897196261682,0.26055045871559634,62841016,107,5
0,49,0.15517241379310345,0.4734042553191489,82008940,58,9
2,5,0.8,0.9285714285714286,73588942,25,20
1,19,0.05,0.5428571428571428,80149950,20,1
0,2,0.0,0.0,63634025,2,0
0,39,0.025,0.27488151658767773,69005776,40,1
0,109,0.035398230088495575,0.35793357933579334,70468181,113,4
1,230,0.255663430420712,0.7200674536256324,79146046,309,79
2,2,0.5,0.875,82150068,4,2
0,39,0.15217391304347827,0.49612403100775193,81878418,46,7
0,102,0.009708737864077669,0.09234234234234234,80150870,103,1
0,184,0.0891089108910891,0.3666026871401152,68994863,202,18
1,31,0.20512820512820512,0.5465116279069767,68641461,39,8
0,22,0.0,0.0,68641475,22,0
1,3,0.25,0.8888888888888888,69910841,4,1
0,19,0.0,0.0,67122335,19,0
0,211,0.145748987854251,0.3560606060606061,70629370,247,36
1,87,0.14705882352941177,0.5317460317460317,64130283,102,15
0,109,0.00909090909090909,0.016853932584269662,68356372,110,1
0,27,0.1,0.16822429906542055,69895070,30,3
1,87,0.35555555555555557,0.796875,68725734,135,48
1,8,0.1111111111111111,0.6756756756756757,74607302,9,1
1,23,0.08,0.5238095238095238,78540686,25,2
0,71,0.0273972602739726,0.07356948228882834,78540742,73,2
1,10,0.23076923076923078,0.7368421052631579,63808101,13,3
1,53,0.3614457831325301,0.7142857142857143,69198766,83,30
2,37,0.7873563218390804,0.9885057471264368,69100206,174,137
2,53,0.5,0.8823529411764706,80176026,106,53
2,90,0.5909090909090909,0.9818840579710145,72270912,220,130
2,36,0.7583892617449665,0.976,80122547,149,113
1,239,0.3452054794520548,0.6624203821656051,80130376,365,126
1,28,0.24324324324324326,0.5714285714285714,69204184,37,9
0,38,0.07317073170731707,0.16822429906542055,70678594,41,3
0,4,0.2,0.46153846153846156,70691341,5,1
0,6,0.14285714285714285,0.29411764705882354,70692426,7,1
1,38,0.22448979591836735,0.56,70515256,49,11
1,40,0.23076923076923078,0.5588235294117647,70515270,52,12
0,77,0.18085106382978725,0.3620689655172414,67429152,94,17
1,90,0.31297709923664124,0.7269076305220884,69177486,131,41
0,289,0.05863192182410423,0.22043010752688172,80128625,307,18
2,4,0.5,0.8461538461538461,80162175,8,4
1,42,0.14285714285714285,0.5454545454545454,68357065,49,7
1,92,0.31851851851851853,0.7481751824817519,65027221,135,43
2,54,0.5045871559633027,0.9457364341085271,68285973,109,55
1,158,0.3946360153256705,0.9057471264367816,82096419,261,103
1,58,0.35555555555555557,0.8378378378378378,82116876,90,32
1,363,0.30326295585412666,0.7017114914425427,72906694,521,158
0,39,0.23529411764705882,0.49523809523809526,68628966,51,12
0,81,0.19,0.26104417670682734,74870551,100,19
0,133,0.18404907975460122,0.4768392370572207,62909896,163,30
1,33,0.4406779661016949,0.8,69924701,59,26
0,186,0.06532663316582915,0.24776785714285715,70001533,199,13
1,358,0.21318681318681318,0.5066225165562914,63957215,455,97
0,147,0.045454545454545456,0.024489795918367346,82063320,154,7
0,4,0.0,0.0,80153698,4,0
1,216,0.3394495412844037,0.7965738758029979,82126805,327,111
0,42,0.2222222222222222,0.33636363636363636,69138664,54,12
1,267,0.4744094488188976,0.9727095516569201,68542292,508,241
1,43,0.39436619718309857,0.9540229885057471,80135840,71,28
2,145,0.6112600536193029,0.9756838905775076,80126954,373,228
1,29,0.3695652173913043,0.7857142857142857,73635065,46,17
1,109,0.35502958579881655,0.7135678391959799,80158087,169,60
2,0,1.0,1.0,82015772,1,1
0,31,0.45614035087719296,0.48148148148148145,63675192,57,26
2,22,0.5925925925925926,0.45,63675213,54,32
2,41,0.6339285714285714,0.9354838709677419,66848516,112,71
2,3,0.9333333333333333,0.8,62465613,45,42
2,65,0.5806451612903226,0.9402985074626866,74575081,155,90
0,174,0.19069767441860466,0.41920374707259955,80118419,215,41
1,213,0.3861671469740634,0.8997668997668997,70632030,347,134
1,227,0.3100303951367781,0.7642980935875217,80097955,329,102
2,64,0.5076923076923077,0.9596774193548387,66825941,130,66
0,184,0.016042780748663103,0.022172949002217297,63141281,187,3
0,39,0.0,0.0,66087735,39,0
0,39,0.07142857142857142,0.16417910447761194,66087805,42,3
0,29,0.09375,0.14035087719298245,82102380,32,3
1,17,0.32,0.5434782608695652,65914744,25,8
1,456,0.3684210526315789,0.8761776581426649,67557126,722,266
1,290,0.4268774703557312,0.8594249201277955,70998305,506,216
1,45,0.16666666666666666,0.5819672131147541,300426,54,9
0,64,0.015384615384615385,0.04201680672268908,63141834,65,1
0,60,0.0,0.0,66885945,60,0
0,162,0.13829787234042554,0.22624434389140272,68621686,188,26
2,6,0.8604651162790697,0.9411764705882353,70713195,43,37
1,218,0.2781456953642384,0.5751633986928104,69176723,302,84
1,176,0.453416149068323,0.9349005424954792,80159834,322,146
0,54,0.19402985074626866,0.33035714285714285,66892371,67,13
0,74,0.12941176470588237,0.39705882352941174,70633591,85,11
0,551,0.045060658578856154,0.14794007490636704,68130804,577,26
2,59,0.7255813953488373,0.9931506849315068,80181569,215,156
1,27,0.37209302325581395,0.7540983606557377,69666793,43,16
0,33,0.029411764705882353,0.09230769230769231,70080962,34,1
0,73,0.1797752808988764,0.47368421052631576,70081060,89,16
0,91,0.042105263157894736,0.15204678362573099,82003712,95,4
0,96,0.010309278350515464,0.052083333333333336,82003724,97,1
2,27,0.6538461538461539,0.9493670886075949,80178949,78,51
1,8,0.2,0.6888888888888889,67620945,10,2
0,8,0.2,0.2564102564102564,73801406,10,2
0,53,0.1016949152542373,0.34951456310679613,66111164,59,6
1,20,0.25925925925925924,0.6888888888888889,66111444,27,7
0,69,0.11538461538461539,0.17543859649122806,66226832,78,9
2,11,0.6071428571428571,0.5,66533096,28,17
2,15,0.7058823529411765,0.6875,70892290,51,36
1,50,0.46808510638297873,0.7692307692307693,63337680,94,44
1,74,0.37815126050420167,0.6923076923076923,72321963,119,45
1,88,0.44654088050314467,0.9081081081081082,69994526,159,71
0,322,0.20297029702970298,0.44341372912801486,67221182,404,82
1,19,0.36666666666666664,0.8333333333333334,70862393,30,11
1,109,0.2482758620689655,0.5359281437125748,73245774,145,36
0,101,0.2109375,0.35294117647058826,69183240,128,27
0,89,0.1834862385321101,0.2676767676767677,69183842,109,20
0,82,0.1717171717171717,0.233502538071066,69184654,99,17
0,191,0.11981566820276497,0.132890365448505,65435104,217,26
0,37,0.1590909090909091,0.46226415094339623,70500150,44,7
1,179,0.2924901185770751,0.6545012165450121,73148012,253,74
1,10,0.3333333333333333,0.825,70660506,15,5
1,10,0.23076923076923078,0.5714285714285714,73701145,13,3
1,14,0.391304347826087,0.8076923076923077,74086670,23,9
1,150,0.42084942084942084,0.87109375,70421974,259,109
1,135,0.20118343195266272,0.686084142394822,63525070,169,34
0,21,0.19230769230769232,0.2765957446808511,69964636,26,5
1,35,0.4262295081967213,0.9090909090909091,80131301,61,26
1,35,0.4852941176470588,0.9538461538461539,66825325,68,33
1,71,0.330188679245283,0.7891891891891892,80124660,106,35
2,35,0.5454545454545454,0.9238095238095239,73415125,77,42
2,12,0.6470588235294118,0.972972972972973,65007432,34,22
0,145,0.19889502762430938,0.3602941176470588,82128666,181,36
0,125,0.10714285714285714,0.46153846153846156,80089695,140,15
1,19,0.40625,0.8292682926829268,70688100,32,13
1,141,0.45977011494252873,0.9234567901234568,69531511,261,120
1,115,0.460093896713615,0.9065040650406504,69733461,213,98
1,10,0.23076923076923078,0.5483870967741935,72962386,13,3
1,55,0.12698412698412698,0.5254237288135594,62850326,63,8
1,30,0.3617021276595745,0.8,64918665,47,17
0,153,0.203125,0.40782122905027934,73195850,192,39
1,30,0.25,0.821917808219178,62842045,40,10
0,325,0.15364583333333334,0.4119047619047619,61948971,384,59
0,85,0.03409090909090909,0.05963302752293578,62841912,88,3
1,88,0.2903225806451613,0.8782051282051282,69560631,124,36
0,153,0.06134969325153374,0.05828220858895705,67285631,163,10
0,277,0.2175141242937853,0.43033509700176364,68533010,354,77
0,115,0.09448818897637795,0.24571428571428572,75264882,127,12
0,54,0.2602739726027397,0.40963855421686746,82055989,73,19
1,95,0.291044776119403,0.59375,80127578,134,39
1,182,0.32592592592592595,0.7283950617283951,80124970,270,88
1,57,0.3595505617977528,0.7771428571428571,80152460,89,32
1,12,0.42857142857142855,0.8166666666666667,70509131,21,9
0,48,0.22580645161290322,0.31297709923664124,82126780,62,14
0,388,0.1762208067940552,0.4340071343638526,64249955,471,83
0,14,0.2631578947368421,0.4489795918367347,67421725,19,5
1,161,0.38076923076923075,0.8537859007832899,68393906,260,99
2,114,0.5107296137339056,0.9586206896551724,80165880,233,119
0,63,0.2222222222222222,0.4,70645876,81,18
0,594,0.03414634146341464,0.008431703204047217,70072072,615,21
1,18,0.47058823529411764,0.8913043478260869,81976035,34,16
2,103,0.5928853754940712,0.8157894736842105,72472400,253,150
0,81,0.024096385542168676,0.031446540880503145,80122887,83,2
0,35,0.10256410256410256,0.3116883116883117,70674611,39,4
2,1,0.8888888888888888,0.5,69703802,9,8
2,10,0.8214285714285714,0.9661016949152542,70595826,56,46
0,54,0.14285714285714285,0.3300970873786408,80125973,63,9
2,8,0.5555555555555556,0.85,72555280,18,10
1,43,0.4819277108433735,0.9716981132075472,65447165,83,40
1,204,0.2916666666666667,0.5506329113924051,62497155,288,84
0,255,0.10211267605633803,0.13373253493013973,70835863,284,29
0,41,0.19607843137254902,0.3150684931506849,70760963,51,10
1,203,0.21621621621621623,0.6171875,72585184,259,56
1,197,0.29136690647482016,0.6142857142857143,80136388,278,81
2,88,0.5343915343915344,0.9278846153846154,69386870,189,101
0,352,0.03825136612021858,0.12392426850258176,68130720,366,14
1,124,0.40096618357487923,0.9051383399209486,69091722,207,83
1,222,0.32727272727272727,0.5933014354066986,69588022,330,108
0,553,0.19738751814223512,0.39699074074074076,71567895,689,136
0,171,0.16176470588235295,0.3188976377952756,67303845,204,33
1,53,0.3764705882352941,0.6991150442477876,80172968,85,32
1,96,0.26153846153846155,0.56,80181292,130,34
2,13,0.717391304347826,0.9,69048014,46,33
1,245,0.4166666666666667,0.8921568627450981,74355855,420,175
2,24,0.7857142857142857,0.8717948717948718,80119152,112,88
0,214,0.24381625441696114,0.3620689655172414,63959756,283,69
1,47,0.4777777777777778,0.8319327731092437,73869873,90,43
2,61,0.5933333333333334,0.9030303030303031,67316200,150,89
0,63,0.27586206896551724,0.4411764705882353,80127842,87,24
1,9,0.25,0.5789473684210527,67591356,12,3
0,298,0.11834319526627218,0.16356877323420074,69974394,338,40
1,60,0.3023255813953488,0.6983240223463687,70711263,86,26
0,104,0.22962962962962963,0.48792270531400966,70397845,135,31
1,59,0.358695652173913,0.7934782608695652,82132587,92,33
1,121,0.27976190476190477,0.5982905982905983,69607895,168,47
1,22,0.35294117647058826,0.75,70530796,34,12
2,44,0.5643564356435643,0.9634146341463414,67464446,101,57
0,4,0.0,0.0,73634624,4,0
0,89,0.1834862385321101,0.1797752808988764,74708844,109,20
0,12,0.14285714285714285,0.0,65286634,14,2
0,501,0.06529850746268656,0.11519607843137254,80124241,536,35
1,269,0.35336538461538464,0.7912885662431942,67552310,416,147
1,44,0.40540540540540543,0.8652482269503546,80125195,74,30
0,22,0.15384615384615385,0.3492063492063492,82028931,26,4
1,42,0.48148148148148145,0.8421052631578947,80018575,81,39
0,55,0.2361111111111111,0.3118279569892473,79796864,72,17
1,42,0.4878048780487805,0.8835616438356164,80178977,82,40
0,194,0.21774193548387097,0.38823529411764707,70686756,248,54
1,13,0.48,0.8235294117647058,80155223,25,12
0,302,0.12209302325581395,0.19180633147113593,67747295,344,42
0,31,0.0,0.0,72808540,31,0
0,47,0.17543859649122806,0.40594059405940597,72543905,57,10
2,83,0.5146198830409356,0.8235294117647058,69954080,171,88
2,12,0.8481012658227848,0.9666666666666667,80056480,79,67
2,15,0.5161290322580645,0.925,80181396,31,16
1,57,0.43564356435643564,0.8961038961038961,70200130,101,44
0,18,0.14285714285714285,0.1791044776119403,70912744,21,3
1,205,0.29310344827586204,0.6781914893617021,74708872,290,85
1,47,0.4268292682926829,0.8514851485148515,71011871,82,35
2,59,0.5874125874125874,0.9454545454545454,69388424,143,84
1,147,0.33783783783783783,0.7957894736842105,80180158,222,75
2,0,1.0,1.0,68311614,5,5
1,124,0.32608695652173914,0.7639593908629442,80134997,184,60
0,361,0.18140589569160998,0.3153153153153153,70769720,441,80
1,74,0.25252525252525254,0.5625,66110352,99,25
1,8,0.42857142857142855,0.8695652173913043,65282336,14,6
0,191,0.1906779661016949,0.2795275590551181,68950056,236,45
1,138,0.2023121387283237,0.500990099009901,65615746,173,35
0,12,0.25,0.41379310344827586,65282035,16,4
1,55,0.36046511627906974,0.7889908256880734,80135839,86,31
0,96,0.08571428571428572,0.06435643564356436,69603653,105,9
1,316,0.23671497584541062,0.5461689587426326,68543972,414,98
0,151,0.22164948453608246,0.4851258581235698,80103492,194,43
1,104,0.3202614379084967,0.7436974789915967,82143805,153,49
2,1,0.8,0.6666666666666666,80053722,5,4
1,13,0.2777777777777778,0.7111111111111111,70746865,18,5
0,32,0.15789473684210525,0.15555555555555556,60195086,38,6
1,104,0.40229885057471265,0.9221311475409836,82085411,174,70
1,9,0.25,0.53125,65288440,12,3
0,10,0.23076923076923078,0.15384615384615385,65289581,13,3
2,163,0.6164705882352941,0.9710144927536232,67753714,425,262
0,79,0.23300970873786409,0.44357976653696496,72135294,103,24
1,246,0.34748010610079577,0.7634854771784232,67159582,377,131
1,133,0.3282828282828283,0.7859649122807018,67558260,198,65
0,15,0.0625,0.1702127659574468,70568134,16,1
1,12,0.42857142857142855,0.8378378378378378,82010261,21,9
0,27,0.06896551724137931,0.125,70683354,29,2
0,10,0.0,0.0,70694232,10,0
1,35,0.38596491228070173,0.5609756097560976,80176073,57,22
2,11,0.8571428571428571,0.9523809523809523,66844624,77,66
2,34,0.6046511627906976,0.9375,82018809,86,52
0,8,0.2727272727272727,0.3939393939393939,74676273,11,3
0,207,0.15163934426229508,0.34577603143418467,69416732,244,37
1,42,0.3,0.7596899224806202,69417292,60,18
1,268,0.2276657060518732,0.5963855421686747,68537931,347,79
1,48,0.36,0.9291338582677166,69421520,75,27
1,78,0.30973451327433627,0.8737373737373737,69421751,113,35
1,10,0.375,0.868421052631579,68401613,16,6
1,156,0.42435424354243545,0.9535864978902954,62140764,271,115
1,134,0.2677595628415301,0.6310160427807486,68785374,183,49
0,403,0.20512820512820512,0.46537396121883656,67160016,507,104
1,144,0.41700404858299595,0.8255813953488372,78110830,247,103
0,16,0.1111111111111111,0.22388059701492538,70685811,18,2
0,119,0.10526315789473684,0.23170731707317074,69416683,133,14
1,124,0.3333333333333333,0.7911646586345381,80109561,186,62
1,122,0.27380952380952384,0.5823293172690763,73713192,168,46
0,35,0.2391304347826087,0.3673469387755102,80178937,46,11
0,44,0.21428571428571427,0.45255474452554745,69415941,56,12
0,222,0.10121457489878542,0.07267441860465117,68512010,247,25
0,174,0.06451612903225806,0.0196078431372549,68512045,186,12
0,133,0.10135135135135136,0.0694980694980695,68512066,148,15
0,110,0.10569105691056911,0.19337016574585636,80128903,123,13
0,35,0.125,0.29310344827586204,70568505,40,5
0,12,0.0,0.0,80122895,12,0
0,35,0.10256410256410256,0.05405405405405406,82126812,39,4
0,157,0.11299435028248588,0.1913978494623656,80118145,177,20
0,125,0.1258741258741259,0.21487603305785125,66887471,143,18
0,250,0.16666666666666666,0.28929765886287623,67159106,300,50
1,102,0.19047619047619047,0.5263157894736842,68352333,126,24
1,20,0.2857142857142857,0.53125,80163146,28,8
1,105,0.304635761589404,0.7538461538461538,66384605,151,46
1,168,0.4563106796116505,0.8928571428571429,70617981,309,141
1,16,0.2727272727272727,0.5333333333333333,80136719,22,6
1,67,0.3020833333333333,0.8045977011494253,70174090,96,29
1,183,0.33935018050541516,0.7857142857142857,67589214,277,94
1,25,0.24242424242424243,0.6,82005335,33,8
2,3,0.9361702127659575,0.0,67457635,47,44
1,11,0.26666666666666666,0.8024691358024691,69482840,15,4
1,224,0.39622641509433965,0.8187919463087249,82007141,371,147
0,16,0.30434782608695654,0.4782608695652174,65890874,23,7
1,77,0.3418803418803419,0.845360824742268,69177311,117,40
0,109,0.12096774193548387,0.35135135135135137,80155842,124,15
2,10,0.5454545454545454,0.9393939393939394,69666786,22,12
0,20,0.25925925925925924,0.36363636363636365,68211346,27,7
1,44,0.35294117647058826,0.7857142857142857,82002260,68,24
0,74,0.08641975308641975,0.11627906976744186,64158304,81,7
0,36,0.16279069767441862,0.4077669902912621,70621614,43,7
1,29,0.23684210526315788,0.5588235294117647,67690546,38,9
0,61,0.2077922077922078,0.44594594594594594,69498520,77,16
0,101,0.07339449541284404,0.15677966101694915,82103876,109,8
0,44,0.2,0.3465909090909091,75236350,55,11
1,40,0.3548387096774194,0.7532467532467533,69184801,62,22
1,288,0.2653061224489796,0.5896739130434783,82126722,392,104
0,1,0.0,0.0,69701156,1,0
0,4,0.0,0.0,69701814,4,0
1,176,0.3282442748091603,0.6371681415929203,68191333,262,86
1,18,0.45454545454545453,0.9571428571428572,69172810,33,15
1,117,0.24025974025974026,0.7719298245614035,69704586,154,37
2,49,0.8237410071942446,0.967391304347826,68137643,278,229
2,3,0.8,0.75,61434583,15,12
0,162,0.1,0.22879177377892032,69415913,180,18
0,299,0.10746268656716418,0.20176991150442478,70642411,335,36
1,113,0.3468208092485549,0.7704918032786885,82126752,173,60
2,7,0.6666666666666666,0.88,80137392,21,14
2,5,0.6153846153846154,0.8571428571428571,79989973,13,8
0,95,0.19491525423728814,0.3583061889250814,61501146,118,23
0,30,0.14285714285714285,0.3888888888888889,68352326,35,5
0,144,0.14285714285714285,0.3131868131868132,69416823,168,24
1,6,0.3333333333333333,0.75,80133812,9,3
2,6,0.7692307692307693,0.9411764705882353,80019744,26,20
0,61,0.22784810126582278,0.38235294117647056,71439466,79,18
2,21,0.6181818181818182,0.9827586206896551,70051296,55,34
1,140,0.29292929292929293,0.5275590551181102,17012611,198,58
1,176,0.29880478087649404,0.5943204868154158,65690422,251,75
1,168,0.3978494623655914,0.87527352297593,80167004,279,111
0,296,0.17548746518105848,0.4967532467532468,70909300,359,63
0,115,0.025423728813559324,0.06736842105263158,62838972,118,3
1,33,0.47619047619047616,0.9565217391304348,64259664,63,30
0,131,0.10884353741496598,0.2891566265060241,70919555,147,16
0,166,0.1658291457286432,0.4256926952141058,64000111,199,33
1,19,0.42424242424242425,0.8767123287671232,73026366,33,14
0,81,0.20588235294117646,0.4330357142857143,73709160,102,21
2,20,0.5348837209302325,0.9272727272727272,80070200,43,23
0,9,0.0,0.0,70760382,9,0
1,124,0.26627218934911245,0.7127272727272728,63279363,169,45
1,186,0.41324921135646686,0.950530035335689,80154126,317,131
1,17,0.32,0.7794117647058824,67555453,25,8
2,4,0.5,0.875,70119756,8,4
0,29,0.14705882352941177,0.07462686567164178,80160443,34,5
0,90,0.0625,0.11787072243346007,74923905,96,6
0,31,0.11428571428571428,0.28440366972477066,74924143,35,4
0,336,0.15789473684210525,0.37142857142857144,80180488,399,63
0,38,0.0,0.0,82049118,38,0
1,9,0.3076923076923077,0.8571428571428571,80135215,13,4
0,108,0.04424778761061947,0.08235294117647059,69887293,113,5
1,32,0.3469387755102041,0.8307692307692308,69389271,49,17
1,61,0.4019607843137255,0.933649289099526,69177710,102,41
1,333,0.23972602739726026,0.7067099567099567,68413254,438,105
1,14,0.2222222222222222,0.6428571428571429,69911422,18,4
2,20,0.5652173913043478,0.9322033898305084,73870713,46,26
1,22,0.4358974358974359,0.8266666666666667,69498366,39,17
0,77,0.16304347826086957,0.22972972972972974,77485513,92,15
0,99,0.12389380530973451,0.46875,78762824,113,14
0,55,0.1791044776119403,0.25252525252525254,67543406,67,12
2,60,0.6078431372549019,0.9642857142857143,72270891,153,93
0,99,0.175,0.30278884462151395,72817290,120,21
0,206,0.1693548387096774,0.36568457538994803,80098935,248,42
1,29,0.30952380952380953,0.8761904761904762,80128273,42,13
0,153,0.203125,0.43333333333333335,68530854,192,39
0,95,0.24603174603174602,0.38650306748466257,67666291,126,31
0,236,0.17192982456140352,0.28157894736842104,70646513,285,49
2,16,0.5555555555555556,0.9772727272727273,69010991,36,20
1,385,0.33391003460207613,0.8460721868365181,79145983,578,193
0,68,0.18072289156626506,0.41148325358851673,82150080,83,15
0,123,0.023809523809523808,0.007317073170731708,82011837,126,3
0,144,0.04,0.02100840336134454,82011838,150,6
0,5,0.2857142857142857,0.4791666666666667,69164452,7,2
0,176,0.11557788944723618,0.11594202898550725,70178591,199,23
0,106,0.04504504504504504,0.10526315789473684,80124192,111,5
1,200,0.4550408719346049,0.8915254237288136,79682470,367,167
0,42,0.125,0.18333333333333332,66552451,48,6
1,93,0.19827586206896552,0.5633187772925764,69390993,116,23
1,402,0.35161290322580646,0.7568922305764411,69003354,620,218
1,68,0.41379310344827586,0.91005291005291,65915290,116,48
0,1,0.0,0.0,68989466,1,0
0,154,0.09411764705882353,0.15804597701149425,66087525,170,16
1,528,0.3116036505867014,0.7096774193548387,69573973,767,239
1,159,0.2772727272727273,0.5389221556886228,80107293,220,61
1,138,0.2849740932642487,0.6904176904176904,80128678,193,55
2,24,0.6923076923076923,0.98,72286886,78,54
0,63,0.23170731707317074,0.4344262295081967,60755583,82,19
1,60,0.34782608695652173,0.8071065989847716,65277842,92,32
0,36,0.16279069767441862,0.26732673267326734,69964433,43,7
0,133,0.11920529801324503,0.18840579710144928,67291413,151,18
0,153,0.18181818181818182,0.3177083333333333,70618373,187,34
0,186,0.16964285714285715,0.36101083032490977,80118669,224,38
0,120,0.22580645161290322,0.41578947368421054,63051002,155,35
1,134,0.2596685082872928,0.54,65931152,181,47
1,52,0.35802469135802467,0.810126582278481,70670376,81,29
0,59,0.1917808219178082,0.125,70673841,73,14
0,290,0.22043010752688172,0.4032258064516129,69157830,372,82
1,126,0.3076923076923077,0.6416938110749185,80137386,182,56
1,93,0.37583892617449666,0.7909967845659164,80137387,149,56
2,5,0.8148148148148148,0.8461538461538461,68666451,27,22
2,1,0.5,0.88,70229320,2,1
1,8,0.2727272727272727,0.5,81900940,11,3
1,76,0.3391304347826087,0.7486338797814208,72802513,115,39
0,20,0.09090909090909091,0.21428571428571427,72808561,22,2
1,64,0.3118279569892473,0.5833333333333334,67911375,93,29
1,212,0.273972602739726,0.6,82129386,292,80
1,155,0.33760683760683763,0.7788461538461539,68779494,234,79
0,39,0.1875,0.39325842696629215,82103847,48,9
0,347,0.12814070351758794,0.15661375661375662,54460413,398,51
1,93,0.32116788321167883,0.6735395189003437,71439452,137,44
1,33,0.3888888888888889,0.865979381443299,69180811,54,21
0,40,0.21568627450980393,0.45652173913043476,70677852,51,11
1,64,0.3904761904761905,0.8536585365853658,73538752,105,41
0,209,0.05,0.02736842105263158,80114272,220,11
1,290,0.30120481927710846,0.6462035541195477,67995340,415,125
0,76,0.05,0.22727272727272727,78540700,80,4
0,147,0.045454545454545456,0.18024263431542462,78540763,154,7
1,247,0.3022598870056497,0.5802469135802469,67752671,354,107
1,27,0.46,0.9324324324324325,65293382,50,23
1,121,0.27976190476190477,0.6470588235294118,80128679,168,47
0,334,0.03188405797101449,0.01938610662358643,68017691,345,11
1,148,0.4618181818181818,0.9517241379310345,70657650,275,127
1,11,0.47619047619047616,0.875,70609896,21,10
1,79,0.4316546762589928,0.684931506849315,68658345,139,60
0,6,0.14285714285714285,0.13043478260869565,68805842,7,1
0,15,0.16666666666666666,0.2909090909090909,70755041,18,3
0,49,0.19672131147540983,0.27835051546391754,69729205,61,12
1,66,0.2235294117647059,0.6118421052631579,68641916,85,19
0,27,0.12903225806451613,0.2289156626506024,66110541,31,4
1,98,0.2283464566929134,0.5720338983050848,66110772,127,29
0,62,0.11428571428571428,0.20967741935483872,66110814,70,8
1,49,0.35526315789473684,0.8518518518518519,70121653,76,27
1,187,0.25793650793650796,0.6119791666666666,68642000,252,65
0,116,0.21621621621621623,0.4005602240896359,67555530,148,32
1,93,0.3841059602649007,0.9015748031496063,70073255,151,58
2,2,0.8181818181818182,0.6666666666666666,69490771,11,9
0,74,0.2127659574468085,0.2894736842105263,76116334,94,20
0,11,0.0,0.0,70679924,11,0
0,9,0.0,0.0,70692580,9,0
1,138,0.1834319526627219,0.5888223552894212,68241362,169,31
2,3,0.625,0.95,67802553,8,5
1,32,0.15789473684210525,0.580952380952381,69534073,38,6
0,19,0.13636363636363635,0.43661971830985913,70049511,22,3
0,17,0.05555555555555555,0.16,70801892,18,1
0,45,0.08163265306122448,0.19727891156462585,75148031,49,4
1,36,0.42857142857142855,0.9294117647058824,68668880,63,27
1,71,0.29,0.6821192052980133,80072272,100,29
1,55,0.19117647058823528,0.554140127388535,80124526,68,13
0,195,0.1702127659574468,0.3404255319148936,72523010,235,40
1,103,0.2196969696969697,0.596078431372549,67594793,132,29
0,62,0.19480519480519481,0.2765957446808511,80051951,77,15
2,13,0.6060606060606061,0.975,54291041,33,20
0,326,0.15979381443298968,0.27305389221556886,80172004,388,62
1,40,0.3442622950819672,0.8642857142857143,68784443,61,21
1,91,0.38513513513513514,0.883495145631068,70207690,148,57
0,246,0.06463878326996197,0.316,64182370,263,17
0,187,0.026041666666666668,0.03656307129798903,80128613,192,5
0,175,0.1784037558685446,0.3580508474576271,72900611,213,38
1,3,0.4,0.8571428571428571,68744270,5,2
1,69,0.4,0.8013245033112583,54291195,115,46
0,208,0.14049586776859505,0.15764705882352942,67215393,242,34
1,214,0.31189710610932475,0.6712328767123288,78439452,311,97
2,99,0.5263157894736842,0.9132653061224489,70256053,209,110
2,63,0.6985645933014354,0.8405797101449275,73956876,209,146
1,50,0.23076923076923078,0.52,80135337,65,15
1,12,0.14285714285714285,0.7297297297297297,67620574,14,2
0,40,0.024390243902439025,0.1513157894736842,67620700,41,1
0,188,0.025906735751295335,0.18181818181818182,69946905,193,5
0,71,0.013888888888888888,0.10396039603960396,69946926,72,1
0,43,0.0,0.0,70238245,43,0
0,39,0.025,0.16911764705882354,70239463,40,1
0,8,0.0,0.0,70746102,8,0
0,41,0.023809523809523808,0.10810810810810811,70746172,42,1
0,20,0.0,0.0,70746354,20,0
0,37,0.0,0.0,70746690,37,0
0,30,0.0,0.0,70746774,30,0
1,29,0.42,0.76,69483673,50,21
0,291,0.05211726384364821,0.01232394366197183,67304510,307,16
1,165,0.2361111111111111,0.5833333333333334,82036700,216,51
1,325,0.4144144144144144,0.8388746803069054,72648023,555,230
0,204,0.02857142857142857,0.040229885057471264,73917802,210,6
1,114,0.2875,0.7640845070422535,70627081,160,46
1,92,0.2755905511811024,0.5714285714285714,69179775,127,35
1,72,0.38461538461538464,0.9005847953216374,69481832,117,45
0,145,0.039735099337748346,0.09352517985611511,72766015,151,6
0,126,0.1,0.3409090909090909,72768682,140,14
1,166,0.4429530201342282,0.9115384615384615,73331041,298,132
0,68,0.08108108108108109,0.23711340206185566,80124273,74,6
1,129,0.3645320197044335,0.8210290827740492,69482826,203,74
1,14,0.44,0.953125,70509390,25,11
1,253,0.37530864197530867,0.7816901408450704,68175926,405,152
0,78,0.27102803738317754,0.4277456647398844,70865256,107,29
2,5,0.5,0.8888888888888888,72803556,10,5
0,14,0.125,0.12121212121212122,72808911,16,2
1,79,0.4233576642335766,0.8545454545454545,80137385,137,58
1,168,0.2186046511627907,0.5506172839506173,80128497,215,47
1,130,0.2261904761904762,0.7254901960784313,64282183,168,38
0,188,0.19658119658119658,0.3420523138832998,69056505,234,46
0,178,0.21585903083700442,0.46296296296296297,70242641,227,49
1,232,0.45023696682464454,0.9418181818181818,70870373,422,190
1,138,0.2620320855614973,0.564748201438849,70660625,187,49
2,92,0.77,0.9554455445544554,80180999,400,308
1,14,0.2631578947368421,0.8043478260869565,70468615,19,5
0,45,0.16666666666666666,0.49635036496350365,64067724,54,9
1,161,0.11049723756906077,0.6346749226006192,64358490,181,20
2,4,0.6,0.4,69667325,10,6
1,20,0.2,0.5384615384615384,80149790,25,5
1,17,0.19047619047619047,0.6470588235294118,67455003,21,4
1,113,0.4292929292929293,0.8284671532846716,81976036,198,85
1,88,0.296,0.6650485436893204,69630253,125,37
0,145,0.026845637583892617,0.07974481658692185,62840351,149,4
1,113,0.39572192513368987,0.8786764705882353,69179026,187,74
0,24,0.22580645161290322,0.43137254901960786,77676725,31,7
1,20,0.25925925925925924,0.6438356164383562,69214243,27,7
0,226,0.15037593984962405,0.14905149051490515,67592931,266,40
2,19,0.7840909090909091,0.96875,63983353,88,69
1,77,0.40310077519379844,0.9024390243902439,60134676,129,52
0,191,0.08173076923076923,0.07391304347826087,82009760,208,17
0,487,0.21829855537720708,0.4524336283185841,70627130,623,136
1,104,0.2876712328767123,0.5650406504065041,82085425,146,42
1,143,0.4541984732824427,0.8144796380090498,72323783,262,119
1,8,0.2727272727272727,0.6842105263157895,69729184,11,3
0,173,0.1477832512315271,0.17054263565891473,67703454,203,30
0,92,0.0891089108910891,0.09917355371900827,80109701,101,9
1,15,0.375,0.7037037037037037,80056410,24,9
0,2,0.0,0.0,70684614,2,0
0,8,0.1111111111111111,0.18181818181818182,72808596,9,1
1,11,0.3125,0.5909090909090909,70865263,16,5
0,11,0.15384615384615385,0.3103448275862069,70865270,13,2
1,50,0.4791666666666667,0.9247311827956989,80124820,96,46
1,25,0.2647058823529412,0.5789473684210527,80124802,34,9
1,172,0.2833333333333333,0.5933333333333334,82124932,240,68
1,137,0.2789473684210526,0.720626631853786,70252756,190,53
1,373,0.3602058319039451,0.8468965517241379,80107881,583,210
0,106,0.23741007194244604,0.423963133640553,66857196,139,33
1,65,0.36893203883495146,0.7878787878787878,72776186,103,38
0,46,0.19298245614035087,0.48484848484848486,68173973,57,11
1,11,0.42105263157894735,0.85,69039292,19,8
1,152,0.3895582329317269,0.8892128279883382,69176793,249,97
1,77,0.2803738317757009,0.6645569620253164,70646016,107,30
0,122,0.10948905109489052,0.3470319634703196,67620980,137,15
0,112,0.02608695652173913,0.0,73399543,115,3
0,2,0.0,0.0,68498283,2,0
1,2,0.3333333333333333,0.8333333333333334,68498325,3,1
0,3,0.0,0.0,68498360,3,0
0,3,0.0,0.0,68498521,3,0
0,3,0.0,0.0,68498563,3,0
0,3,0.0,0.0,69478374,3,0
0,11,0.0,0.0,69478402,11,0
0,2,0.0,0.0,69479011,2,0
0,4,0.0,0.0,69479235,4,0
1,10,0.23076923076923078,0.6756756756756757,70230160,13,3
2,16,0.5675675675675675,0.9576271186440678,79990204,37,21
2,13,0.6666666666666666,0.9705882352941176,79792545,39,26
2,3,0.7692307692307693,0.8571428571428571,80141351,13,10
2,5,0.8571428571428571,0.9545454545454546,65780953,35,30
1,31,0.41509433962264153,0.6666666666666666,57042503,53,22
1,74,0.3508771929824561,0.8097560975609757,82126647,114,40
1,52,0.36585365853658536,0.7769784172661871,80175644,82,30
0,358,0.15764705882352942,0.19596541786743515,68532961,425,67
1,110,0.3888888888888889,0.7461139896373057,66272283,180,70
1,68,0.1282051282051282,0.5286885245901639,62850410,78,10
1,81,0.3135593220338983,0.6666666666666666,67506565,118,37
0,50,0.20634920634920634,0.35714285714285715,74863341,63,13
1,19,0.32142857142857145,0.7111111111111111,65083480,28,9
1,105,0.2905405405405405,0.738255033557047,80135818,148,43
0,174,0.09375,0.2815533980582524,69204905,192,18
2,26,0.7475728155339806,0.9824561403508771,71216600,103,77
2,5,0.6153846153846154,0.5555555555555556,63130921,13,8
1,96,0.29411764705882354,0.6678571428571428,82119996,136,40
1,71,0.3879310344827586,0.7878787878787878,68189583,116,45
0,168,0.06666666666666667,0.015384615384615385,68784121,180,12
1,73,0.25510204081632654,0.644927536231884,63050820,98,25
1,61,0.29069767441860467,0.6857142857142857,63051142,86,25
1,24,0.3333333333333333,0.6349206349206349,67404491,36,12
0,167,0.18932038834951456,0.40569395017793597,68538680,206,39
0,62,0.225,0.3509933774834437,69165523,80,18
1,25,0.10714285714285714,0.5478260869565217,64182391,28,3
0,6,0.14285714285714285,0.0,70629034,7,1
1,479,0.3088023088023088,0.7541152263374485,69948795,693,214
0,22,0.15384615384615385,0.2608695652173913,71761830,26,4
2,23,0.5106382978723404,0.921875,82021843,47,24
0,129,0.25,0.4312796208530806,57175524,172,43
1,173,0.2880658436213992,0.76,68540115,243,70
0,102,0.11304347826086956,0.19047619047619047,70629300,115,13
0,181,0.1380952380952381,0.34560906515580736,70629475,210,29
0,5,0.0,0.0,71081801,5,0
1,33,0.37735849056603776,0.8529411764705882,69184003,53,20
1,168,0.4206896551724138,0.9018789144050104,67930786,290,122
0,4,0.0,0.0,82102491,4,0
0,7,0.0,0.0,82102900,7,0
0,269,0.11513157894736842,0.1399662731871838,81999979,304,35
0,4,0.2,0.13333333333333333,79843981,5,1
1,21,0.34375,0.7647058823529411,65279263,32,11
0,12,0.0,0.0,65713725,12,0
0,55,0.09836065573770492,0.26627218934911245,82103877,61,6
0,178,0.10101010101010101,0.1383399209486166,80071194,198,20
1,38,0.2549019607843137,0.5614035087719298,70818895,51,13
0,33,0.08333333333333333,0.2616822429906542,70467733,36,3
1,149,0.4601449275362319,0.9649122807017544,80120457,276,127
1,107,0.19548872180451127,0.525096525096525,63999432,133,26
1,303,0.2109375,0.5275310834813499,68530714,384,81
0,68,0.16049382716049382,0.4789473684210526,80154096,81,13
0,124,0.1564625850340136,0.34069400630914826,68036283,147,23
0,90,0.1,0.09,68533192,100,10
1,104,0.1746031746031746,0.6317280453257791,70467495,126,22
0,214,0.10460251046025104,0.3261231281198003,69886572,239,25
0,317,0.116991643454039,0.319634703196347,69886586,359,42
1,20,0.2,0.5869565217391305,70474880,25,5
0,95,0.04040404040404041,0.1016949152542373,69887132,99,4
0,113,0.0423728813559322,0.09287925696594428,70597835,118,5
1,180,0.33579335793357934,0.7792207792207793,82096421,271,91
1,22,0.3888888888888889,0.9230769230769231,69043520,36,14
0,67,0.0945945945945946,0.1694915254237288,70678216,74,7
0,3,0.0,0.0,70680043,3,0
0,4,0.0,0.0,70693112,4,0
2,3,0.7,0.5,82020083,10,7
0,454,0.10805500982318271,0.14792899408284024,80140085,509,55
2,3,0.75,0.8,68358962,12,9
0,146,0.07006369426751592,0.314453125,66876901,157,11
1,221,0.2706270627062706,0.6876574307304786,68541753,303,82
0,23,0.041666666666666664,0.0,70539756,24,1
0,32,0.23809523809523808,0.4444444444444444,69464892,42,10
2,19,0.6779661016949152,0.9491525423728814,69585663,59,40
0,140,0.11392405063291139,0.1939799331103679,65458603,158,18
1,32,0.2727272727272727,0.6039603960396039,68191991,44,12
0,100,0.16666666666666666,0.28512396694214875,63282184,120,20
0,88,0.23478260869565218,0.47244094488188976,69538105,115,27
0,225,0.0546218487394958,0.20613496932515338,62837852,238,13
1,12,0.14285714285714285,0.6081081081081081,68130846,14,2
0,7,0.0,0.0,68130916,7,0
0,115,0.11538461538461539,0.1680327868852459,65273656,130,15
1,37,0.27450980392156865,0.5268817204301075,64929032,51,14
0,33,0.1951219512195122,0.4158415841584158,70792603,41,8
1,11,0.35294117647058826,0.813953488372093,65290036,17,6
2,45,0.6590909090909091,0.9444444444444444,79760044,132,87
1,116,0.1888111888111888,0.5168539325842697,74923800,143,27
0,59,0.25316455696202533,0.4177215189873418,80018246,79,20
0,20,0.0,0.0,70678811,20,0
0,13,0.13333333333333333,0.3333333333333333,80126836,15,2
0,7,0.0,0.0,70678202,7,0
1,117,0.29518072289156627,0.6615384615384615,70422023,166,49
0,26,0.1875,0.36538461538461536,69895903,32,6
2,59,0.8591885441527446,0.9333333333333333,64957165,419,360
1,123,0.3089887640449438,0.7551724137931034,788326,178,55
0,289,0.142433234421365,0.171875,68535362,337,48
2,8,0.5294117647058824,0.5,63668801,17,9
1,85,0.2543859649122807,0.5422222222222223,73200043,114,29
1,47,0.3088235294117647,0.6722689075630253,62497645,68,21
0,223,0.22837370242214533,0.34134615384615385,62497603,289,66
1,93,0.3111111111111111,0.6949152542372882,69184402,135,42
0,47,0.020833333333333332,0.015706806282722512,67837910,48,1
1,116,0.18309859154929578,0.6376404494382022,80089590,142,26
0,257,0.01532567049808429,0.03207547169811321,63336973,261,4
0,104,0.028037383177570093,0.09701492537313433,63337071,107,3
2,67,0.5347222222222222,0.8872180451127819,70867181,144,77
1,101,0.4388888888888889,0.9305555555555556,69534290,180,79
1,302,0.3668763102725367,0.8313856427378965,66471006,477,175
2,11,0.5,0.8,66792544,22,11
1,197,0.303886925795053,0.678391959798995,81967319,283,86
1,32,0.21951219512195122,0.5157894736842106,69421583,41,9
1,374,0.2737864077669903,0.605,70649572,515,141
0,144,0.16279069767441862,0.378125,66111290,172,28
0,76,0.15555555555555556,0.40331491712707185,66111563,90,14
0,76,0.10588235294117647,0.18269230769230768,67376505,85,9
1,33,0.45901639344262296,0.9565217391304348,71434685,61,28
1,29,0.3958333333333333,0.7913043478260869,75115362,48,19
0,20,0.23076923076923078,0.4805194805194805,82012239,26,6
2,1,0.5,0.6666666666666666,67786845,2,1
0,5,0.2857142857142857,0.3333333333333333,67786866,7,2
1,13,0.3157894736842105,0.5,67787020,19,6
0,163,0.08426966292134831,0.13488372093023257,70081396,178,15
2,31,0.5303030303030303,0.8,72187556,66,35
2,1,0.5,0.75,70563213,2,1
1,328,0.3080168776371308,0.673352435530086,69692994,474,146
1,52,0.2972972972972973,0.6333333333333333,80133430,74,22
1,187,0.34615384615384615,0.8195121951219512,80133417,286,99
0,83,0.03488372093023256,0.04225352112676056,69416760,86,3
0,140,0.24731182795698925,0.42953020134228187,70713944,186,46
0,68,0.20930232558139536,0.35,69863430,86,18
0,196,0.15879828326180256,0.2816399286987522,66892945,233,37
0,141,0.07236842105263158,0.06451612903225806,66892966,152,11
1,16,0.36,0.7674418604651163,67304426,25,9
1,29,0.3409090909090909,0.7733333333333333,74725721,44,15
2,1,0.9,0.75,73829952,10,9
2,255,0.5557491289198606,0.9654545454545455,62592313,574,319
2,41,0.5638297872340425,0.9139784946236559,71020481,94,53
1,172,0.1848341232227488,0.5395833333333333,69577536,211,39
1,61,0.39,0.8713450292397661,64158430,100,39
0,40,0.23076923076923078,0.29591836734693877,71458716,52,12
1,53,0.2318840579710145,0.5578947368421052,73635156,69,16
2,15,0.5,0.7894736842105263,77329525,30,15
0,88,0.1619047619047619,0.3276595744680851,62766186,105,17
2,28,0.5942028985507246,0.98,82052028,69,41
2,42,0.5280898876404494,0.9069767441860465,69732803,89,47
0,57,0.05,0.1349206349206349,70679651,60,3
2,1,0.6666666666666666,0.875,70494830,3,2
2,20,0.6491228070175439,0.9552238805970149,70617470,57,37
0,31,0.03125,0.0,70620963,32,1
0,78,0.2777777777777778,0.21428571428571427,68384414,108,30
1,6,0.45454545454545453,0.8888888888888888,69212836,11,5
0,140,0.09090909090909091,0.17105263157894737,66110940,154,14
0,13,0.13333333333333333,0.484375,67618600,15,2
0,291,0.03322259136212625,0.08829568788501027,64984724,301,10
0,276,0.15337423312883436,0.3628808864265928,61772984,326,50
1,136,0.4666666666666667,0.9191374663072777,73181353,255,119
0,44,0.2,0.40789473684210525,80089702,55,11
0,344,0.1867612293144208,0.29743589743589743,70645533,423,79
0,101,0.1984126984126984,0.3728813559322034,80110611,126,25
1,62,0.3673469387755102,0.8413793103448276,71036952,98,36
1,12,0.3333333333333333,0.5945945945945946,82019054,18,6
0,147,0.19230769230769232,0.4265129682997118,68538624,182,35
1,169,0.37174721189591076,0.7706093189964157,63716912,269,100
2,2,0.7142857142857143,0.9090909090909091,73321024,7,5
1,215,0.3562874251497006,0.8228782287822878,67552184,334,119
1,137,0.21714285714285714,0.5244956772334294,69701261,175,38
0,306,0.235,0.4506769825918762,73513993,400,94
0,279,0.211864406779661,0.4046875,74849782,354,75
1,6,0.25,0.868421052631579,68021716,8,2
0,1,0.0,0.0,65110633,1,0
0,104,0.20610687022900764,0.4558139534883721,69621216,131,27
1,295,0.24744897959183673,0.5636856368563685,72429980,392,97
1,5,0.16666666666666666,0.7058823529411765,66933321,6,1
0,32,0.030303030303030304,0.0784313725490196,67475765,33,1
1,47,0.3561643835616438,0.8061224489795918,80133801,73,26
2,13,0.6486486486486487,0.85,80174698,37,24
1,153,0.2644230769230769,0.6222222222222222,67636905,208,55
0,19,0.0,0.0,67464026,19,0
1,47,0.2033898305084746,0.6649746192893401,69497785,59,12
1,62,0.38,0.9080459770114943,67791710,100,38
1,5,0.16666666666666666,0.5,65382450,6,1
0,7,0.0,0.0,67464075,7,0
1,104,0.40229885057471265,0.9278846153846154,80133806,174,70
2,25,0.5098039215686274,0.7142857142857143,62237483,51,26
0,28,0.0967741935483871,0.36363636363636365,68025482,31,3
0,38,0.05,0.15178571428571427,63992852,40,2
0,195,0.23228346456692914,0.4762845849802372,73459722,254,59
0,8,0.1111111111111111,0.08695652173913043,68613986,9,1
0,44,0.08333333333333333,0.23870967741935484,66933251,48,4
2,2,0.6666666666666666,0.6666666666666666,82019748,6,4
2,1,0.875,0.5,69733972,8,7
0,82,0.11827956989247312,0.3173076923076923,80127377,93,11
0,36,0.12195121951219512,0.30303030303030304,69280932,41,5
1,113,0.29375,0.5630498533724341,70925666,160,47
0,13,0.13333333333333333,0.1951219512195122,74924234,15,2
1,133,0.41409691629955947,0.7348066298342542,72534525,227,94
2,10,0.782608695652174,0.96,69039341,46,36
0,24,0.14285714285714285,0.1875,80055073,28,4
1,42,0.23636363636363636,0.6617647058823529,69895896,55,13
1,133,0.2962962962962963,0.8,77106120,189,56
0,25,0.1935483870967742,0.2857142857142857,69182120,31,6
1,43,0.3484848484848485,0.8384615384615385,82126634,66,23
2,28,0.7083333333333334,0.9846153846153847,65393020,96,68
0,85,0.1326530612244898,0.1380952380952381,68644975,98,13
0,82,0.1368421052631579,0.4146341463414634,69320804,95,13
0,78,0.08235294117647059,0.16049382716049382,78763405,85,7
0,32,0.1111111111111111,0.3333333333333333,63993286,36,4
1,447,0.2436548223350254,0.5587419056429233,68286722,591,144
0,8,0.1111111111111111,0.48148148148148145,69163346,9,1
1,73,0.35398230088495575,0.7318435754189944,80110212,113,40
1,55,0.1791044776119403,0.5078534031413613,70908264,67,12
1,47,0.36486486486486486,0.8549618320610687,80090843,74,27
0,72,0.06493506493506493,0.3020408163265306,67846366,77,5
0,44,0.043478260869565216,0.14285714285714285,67846345,46,2
1,71,0.4083333333333333,0.8883495145631068,80137577,120,49
1,86,0.26495726495726496,0.8317152103559871,60286506,117,31
0,47,0.21666666666666667,0.46,69551293,60,13
0,82,0.19607843137254902,0.3445378151260504,80127008,102,20
1,71,0.19318181818181818,0.543010752688172,70413826,88,17
1,93,0.32608695652173914,0.7908163265306123,75327294,138,45
1,100,0.4350282485875706,0.9251101321585903,80127347,177,77
1,49,0.125,0.5078125,63992992,56,7
1,44,0.2,0.7916666666666666,80135187,55,11
1,511,0.28330995792426367,0.552,69150746,713,202
0,26,0.13333333333333333,0.43010752688172044,67475394,30,4
0,7,0.0,0.0,67475443,7,0
0,22,0.043478260869565216,0.18461538461538463,67475471,23,1
0,48,0.1111111111111111,0.3284671532846715,67475534,54,6
0,9,0.0,0.0,69895385,9,0
0,5,0.16666666666666666,0.2857142857142857,70395640,6,1
1,39,0.13333333333333333,0.6521739130434783,60028920,45,6
0,86,0.12244897959183673,0.234375,74725252,98,12
0,71,0.19318181818181818,0.45021645021645024,80135245,88,17
1,178,0.30739299610894943,0.6862244897959183,82126795,257,79
1,33,0.35294117647058826,0.8137254901960784,82126771,51,18
1,80,0.24528301886792453,0.5729537366548043,70527296,106,26
1,149,0.20320855614973263,0.6619385342789598,67895681,187,38
1,109,0.2158273381294964,0.5504587155963303,60812136,139,30
2,17,0.5405405405405406,0.9736842105263158,67638655,37,20
1,180,0.35251798561151076,0.8838383838383839,79145941,278,98
0,38,0.20833333333333334,0.42696629213483145,77676753,48,10
0,123,0.10218978102189781,0.07581227436823104,79650970,137,14
1,61,0.32222222222222224,0.8058823529411765,65018744,90,29
2,12,0.5,0.92,69691895,24,12
1,61,0.3146067415730337,0.7065217391304348,82126787,89,28
1,112,0.28205128205128205,0.5127118644067796,66856426,156,44
1,89,0.28225806451612906,0.6509433962264151,68763723,124,35
2,93,0.5674418604651162,0.967741935483871,80125553,215,122
1,25,0.21875,0.6020408163265306,69704495,32,7
0,352,0.1330049261083744,0.3415977961432507,70909055,406,54
1,29,0.19444444444444445,0.6090225563909775,78166312,36,7
2,104,0.5207373271889401,0.9493670886075949,70113484,217,113
0,10,0.09090909090909091,0.2,69165845,11,1
1,174,0.2809917355371901,0.7702349869451697,80135193,242,68
2,0,1.0,1.0,82012227,1,1
1,13,0.23529411764705882,0.64,82018903,17,4
0,125,0.2138364779874214,0.38345864661654133,73918593,159,34
1,174,0.3958333333333333,0.554140127388535,70637315,288,114
0,145,0.17142857142857143,0.47530864197530864,66390800,175,30
0,9,0.1,0.058823529411764705,69724333,10,1
1,219,0.29354838709677417,0.7146739130434783,70627760,310,91
0,54,0.03571428571428571,0.11688311688311688,80124321,56,2
0,41,0.0,0.0,80124385,41,0
0,102,0.03773584905660377,0.17229729729729729,80124411,106,4
1,133,0.36666666666666664,0.7819314641744548,82106948,210,77
2,27,0.64,0.9795918367346939,68258470,75,48
0,5,0.0,0.0,70692622,5,0
0,27,0.06896551724137931,0.21019108280254778,70693644,29,2
2,1,0.5,0.875,80126779,2,1
2,230,0.5463510848126233,0.9665071770334929,69511834,507,277
1,26,0.23529411764705882,0.6428571428571429,80141477,34,8
2,10,0.5652173913043478,0.96875,80165173,23,13
0,38,0.0,0.0,69633844,38,0
0,48,0.07692307692307693,0.3374233128834356,69633886,52,4
0,29,0.06451612903225806,0.3305785123966942,69633914,31,2
0,38,0.05,0.28,69633970,40,2
0,44,0.0,0.0,69634026,44,0
0,29,0.0,0.0,69634243,29,0
1,177,0.3058823529411765,0.67,82143800,255,78
1,233,0.3285302593659942,0.64,73702356,347,114
1,56,0.37777777777777777,0.7551020408163265,80022012,90,34
0,100,0.15966386554621848,0.25825825825825827,66892952,119,19
0,136,0.21839080459770116,0.36666666666666664,62141751,174,38
1,35,0.36363636363636365,0.8365384615384616,68211311,55,20
0,201,0.04739336492890995,0.15981012658227847,80128628,211,10
2,69,0.5843373493975904,0.9842931937172775,73321801,166,97
1,127,0.3385416666666667,0.7239819004524887,70631435,192,65
1,176,0.1889400921658986,0.5921325051759835,70190302,217,41
0,296,0.22105263157894736,0.3047091412742382,80176761,380,84
1,388,0.44650499286733236,0.8588390501319261,80180303,701,313
1,151,0.40551181102362205,0.8943894389438944,80003623,254,103
0,223,0.23367697594501718,0.4968051118210863,70093086,291,68
0,453,0.08853118712273642,0.10810810810810811,82011831,497,44
0,166,0.023529411764705882,0.011214953271028037,82012538,170,4
2,0,1.0,1.0,79816114,2,2
1,31,0.29545454545454547,0.746268656716418,68256986,44,13
0,110,0.11290322580645161,0.3004694835680751,80124251,124,14
2,0,1.0,1.0,67744656,7,7
2,1,0.875,0.5,74320701,8,7
2,28,0.5333333333333333,0.8571428571428571,80158261,60,32
0,127,0.0,0.0,82158889,127,0
0,129,0.007692307692307693,0.056179775280898875,82158890,130,1
1,28,0.28205128205128205,0.6902654867256637,69204611,39,11
2,47,0.5252525252525253,0.9415584415584416,70612605,99,52
2,1,0.875,0.6666666666666666,65715174,8,7
2,1,0.9876543209876543,0.5,54880714,81,80
1,219,0.29354838709677417,0.548051948051948,80180958,310,91
1,316,0.22926829268292684,0.5675675675675675,67324355,410,94
0,22,0.2413793103448276,0.49019607843137253,66090332,29,7
1,64,0.2967032967032967,0.6209150326797386,82116877,91,27
1,357,0.19047619047619047,0.5585738539898133,80128852,441,84
0,77,0.01282051282051282,0.0374331550802139,63337113,78,1
0,45,0.021739130434782608,0.11678832116788321,63337134,46,1
1,138,0.28865979381443296,0.5882352941176471,74045622,194,56
0,131,0.10884353741496598,0.20090293453724606,82000077,147,16
1,165,0.2918454935622318,0.6878172588832487,82126672,233,68
0,197,0.1722689075630252,0.36302895322939865,70626801,238,41
2,131,0.5867507886435331,0.9848484848484849,69056771,317,186
1,46,0.38666666666666666,0.8023255813953488,70518056,75,29
0,131,0.14935064935064934,0.2938388625592417,82095672,154,23
1,29,0.2926829268292683,0.6233766233766234,69183324,41,12
0,160,0.17098445595854922,0.2703583061889251,68534116,193,33
1,19,0.2962962962962963,0.8378378378378378,80150934,27,8
0,10,0.09090909090909091,0.29411764705882354,63804482,11,1
0,31,0.29545454545454547,0.43902439024390244,67867002,44,13
1,121,0.23417721518987342,0.6153846153846154,73637592,158,37
0,42,0.023255813953488372,0.014084507042253521,70081305,43,1
0,171,0.03932584269662921,0.060085836909871244,71762600,178,7
1,62,0.44642857142857145,0.7572815533980582,69170073,112,50
0,66,0.0958904109589041,0.22033898305084745,69208174,73,7
1,35,0.4852941176470588,0.9404761904761905,80019982,68,33
0,84,0.14285714285714285,0.23809523809523808,80141473,98,14
2,0,1.0,1.0,70314482,4,4
1,70,0.3269230769230769,0.773972602739726,80135050,104,34
0,358,0.19550561797752808,0.26200873362445415,67447310,445,87
1,50,0.2537313432835821,0.5039370078740157,70860811,67,17
1,45,0.3076923076923077,0.6477272727272727,80132304,65,20
1,49,0.4166666666666667,0.87,62497232,84,35
1,132,0.25,0.535593220338983,82126620,176,44
1,58,0.4423076923076923,0.8991596638655462,65496746,104,46
1,14,0.3,0.7551020408163265,69639304,20,6
0,241,0.22258064516129034,0.46275752773375595,82054693,310,69
0,200,0.16666666666666666,0.3151969981238274,66931564,240,40
0,53,0.1016949152542373,0.22131147540983606,54204892,59,6
0,79,0.22549019607843138,0.34328358208955223,74708676,102,23
1,122,0.23270440251572327,0.5572916666666666,66723671,159,37
0,88,0.13725490196078433,0.1392857142857143,70769741,102,14
0,109,0.08403361344537816,0.4910941475826972,67434514,119,10
0,198,0.175,0.2914691943127962,70179382,240,42
1,23,0.3783783783783784,0.7424242424242424,71489831,37,14
0,251,0.13745704467353953,0.2445141065830721,69926486,291,40
0,27,0.20588235294117646,0.19718309859154928,63213213,34,7
0,180,0.10891089108910891,0.18670886075949367,73366356,202,22
1,12,0.3333333333333333,0.7142857142857143,80128510,18,6
1,219,0.21223021582733814,0.5446623093681917,80131174,278,59
0,165,0.15384615384615385,0.4050632911392405,80154137,195,30
0,200,0.052132701421800945,0.23304347826086957,66877041,211,11
0,120,0.04,0.16267942583732056,70314636,125,5
0,94,0.2033898305084746,0.41201716738197425,80070802,118,24
1,10,0.375,0.5909090909090909,65890825,16,6
1,24,0.4146341463414634,0.875,69152573,41,17
0,12,0.07692307692307693,0.2602739726027397,69204933,13,1
1,68,0.33980582524271846,0.6466666666666666,67282551,103,35
1,242,0.3183098591549296,0.6359649122807017,69458655,355,113
0,145,0.22872340425531915,0.4209039548022599,82126673,188,43
0,310,0.2548076923076923,0.48613678373382624,81967321,416,106
0,3,0.0,0.0,71358910,3,0
1,71,0.3173076923076923,0.7743589743589744,70072296,104,33
1,51,0.32,0.696969696969697,72393454,75,24
0,188,0.22633744855967078,0.48072562358276644,66309236,243,55
0,59,0.25316455696202533,0.44052863436123346,74338894,79,20
0,9,0.1,0.2,66960691,10,1
1,220,0.23875432525951557,0.5266666666666666,67556930,289,69
1,66,0.3944954128440367,0.88,65675211,109,43
0,81,0.25,0.41875,66263610,108,27
0,61,0.17567567567567569,0.4011627906976744,74923975,74,13
1,86,0.38571428571428573,0.8412017167381974,82096423,140,54
1,60,0.4339622641509434,0.9655172413793104,82034382,106,46
1,263,0.30971128608923887,0.6652360515021459,69021442,381,118
1,61,0.3838383838383838,0.8571428571428571,68401445,99,38
1,119,0.4251207729468599,0.8799019607843137,69955151,207,88
1,100,0.3150684931506849,0.6294964028776978,66554404,146,46
0,6,0.0,0.0,70681653,6,0
1,19,0.20833333333333334,0.5689655172413793,66892763,24,5
0,203,0.05581395348837209,0.02702702702702703,68741085,215,12
1,11,0.3125,0.6875,62413400,16,5
1,302,0.3288888888888889,0.7208271787296898,67995382,450,148
0,86,0.19626168224299065,0.3018867924528302,68621112,107,21
1,45,0.3181818181818182,0.7428571428571429,72382373,66,21
1,232,0.32558139534883723,0.7266355140186916,69154106,344,112
0,68,0.2,0.46368715083798884,70047950,85,17
0,41,0.10869565217391304,0.07936507936507936,60439365,46,5
1,70,0.36363636363636365,0.7822222222222223,70742476,110,40
0,145,0.06451612903225806,0.34868421052631576,66876411,155,10
0,220,0.07563025210084033,0.3400286944045911,66876635,238,18
0,113,0.03418803418803419,0.06230529595015576,63293615,117,4
0,124,0.07462686567164178,0.32727272727272727,63527275,134,10
0,154,0.10982658959537572,0.1582089552238806,68885432,173,19
1,185,0.30970149253731344,0.6439909297052154,67994535,268,83
2,9,0.90625,0.9375,80118601,96,87
0,76,0.15555555555555556,0.234375,69622406,90,14
1,169,0.35984848484848486,0.8191489361702128,75644632,264,95
0,4,0.0,0.0,68497310,4,0
1,128,0.36633663366336633,0.8702064896755162,82126741,202,74
1,22,0.4358974358974359,0.7916666666666666,69733475,39,17
1,58,0.30952380952380953,0.6756756756756757,69165355,84,26
0,369,0.12142857142857143,0.2205071664829107,69416270,420,51
1,161,0.2747747747747748,0.6402214022140221,70761075,222,61
0,265,0.0798611111111111,0.3059360730593607,788165,288,23
0,99,0.16806722689075632,0.17488789237668162,70179256,119,20
1,8,0.42857142857142855,0.9090909090909091,80053673,14,6
0,42,0.19230769230769232,0.47706422018348627,72900513,52,10
1,114,0.41836734693877553,0.757201646090535,80163477,196,82
0,28,0.0967741935483871,0.0967741935483871,63141624,31,3
1,301,0.28841607565011823,0.6077669902912621,80127929,423,122
1,86,0.23893805309734514,0.5897435897435898,82011836,113,27
2,2,0.6,0.6666666666666666,82009529,5,3
0,361,0.032171581769437,0.03229974160206718,788144,373,12
1,8,0.4666666666666667,0.9166666666666666,78983982,15,7
2,10,0.6296296296296297,0.8888888888888888,73599645,27,17
1,189,0.3460207612456747,0.7916666666666666,75644646,289,100
2,9,0.5,0.9444444444444444,68211402,18,9
1,47,0.3380281690140845,0.8451612903225807,72382324,71,24
0,162,0.22488038277511962,0.4255874673629243,74990230,209,47
1,214,0.31189710610932475,0.7163120567375887,65355913,311,97
0,26,0.07142857142857142,0.0875,69158061,28,2
2,31,0.5373134328358209,0.9636363636363636,82014485,67,36
0,17,0.15,0.2777777777777778,69072241,20,3
1,24,0.38461538461538464,0.9090909090909091,66856041,39,15
0,42,0.23636363636363636,0.43137254901960786,80108252,55,13
1,49,0.24615384615384617,0.5109489051094891,65279102,65,16
1,89,0.3776223776223776,0.8370786516853933,69184675,143,54
1,90,0.40397350993377484,0.8571428571428571,68531603,151,61
1,122,0.49794238683127573,0.9637305699481865,69154134,243,121
1,57,0.2962962962962963,0.625,63850003,81,24
0,55,0.27631578947368424,0.46153846153846156,61744634,76,21
0,363,0.18058690744920994,0.3796711509715994,69621902,443,80
0,228,0.05394190871369295,0.17402269861286254,68798170,241,13
1,31,0.3111111111111111,0.8372093023255814,63282912,45,14
1,39,0.4507042253521127,0.9361702127659575,65674994,71,32
1,53,0.4854368932038835,0.95,68512815,103,50
0,24,0.2,0.4126984126984127,69180496,30,6
0,202,0.00980392156862745,0.01910828025477707,74607316,204,2
1,64,0.2727272727272727,0.5561797752808989,80128547,88,24
1,54,0.12903225806451613,0.5954198473282443,82049134,62,8
0,48,0.1724137931034483,0.2072072072072072,68406996,58,10
0,76,0.21649484536082475,0.38349514563106796,80108784,97,21
1,83,0.23148148148148148,0.5096153846153846,68642245,108,25
0,15,0.21052631578947367,0.3695652173913043,65910635,19,4
2,22,0.5,0.9482758620689655,61582430,44,22
0,16,0.1111111111111111,0.2926829268292683,69498464,18,2
0,112,0.0743801652892562,0.14457831325301204,69107010,121,9
1,41,0.4875,0.8775510204081632,68383581,80,39
1,94,0.2932330827067669,0.6754385964912281,80136823,133,39
1,25,0.32432432432432434,0.5555555555555556,68401494,37,12
0,91,0.20175438596491227,0.47368421052631576,69415906,114,23
0,222,0.1328125,0.3046875,69417460,256,34
1,144,0.34841628959276016,0.7079207920792079,70890645,221,77
2,46,0.7125,0.9863013698630136,79989714,160,114
2,2,0.7142857142857143,0.9375,75149676,7,5
1,6,0.4,0.8823529411764706,70704844,10,4
1,4,0.3333333333333333,0.6,82129394,6,2
1,48,0.3424657534246575,0.8625,66339441,73,25
0,119,0.05555555555555555,0.018726591760299626,69100864,126,7
1,180,0.3308550185873606,0.725,80118189,269,89
2,79,0.5297619047619048,0.9185185185185185,80130371,168,89
2,25,0.6323529411764706,0.8833333333333333,67321702,68,43
2,15,0.8076923076923077,0.9534883720930233,80176359,78,63
1,159,0.35365853658536583,0.6690647482014388,80124974,246,87
2,28,0.5942028985507246,0.9090909090909091,73653426,69,41
1,37,0.45588235294117646,0.8301886792452831,70563381,68,31
0,201,0.1336206896551724,0.3283582089552239,72866780,232,31
2,6,0.6,0.9333333333333333,80155225,15,9
1,75,0.32432432432432434,0.6304347826086957,70233660,111,36
2,2,0.6666666666666666,0.8,70184961,6,4
1,94,0.4125,0.8104838709677419,66755206,160,66
1,39,0.30357142857142855,0.72,80133810,56,17
1,302,0.24120603015075376,0.5071090047393365,80159582,398,96
1,133,0.4088888888888889,0.8145161290322581,68883472,225,92
2,39,0.5357142857142857,0.9870967741935484,72932293,84,45
1,92,0.43902439024390244,0.9181818181818182,65293445,164,72
0,13,0.13333333333333333,0.22,70183953,15,2
0,417,0.05869074492099323,0.017953321364452424,79815862,443,26
0,272,0.2046783625730994,0.37920489296636084,73524626,342,70
1,57,0.16176470588235295,0.5129310344827587,63771211,68,11
2,10,0.5454545454545454,0.9655172413793104,80160444,22,12
1,12,0.29411764705882354,0.8444444444444444,69737003,17,5
0,263,0.13486842105263158,0.26260504201680673,70643265,304,41
0,6,0.14285714285714285,0.0,69390615,7,1
1,48,0.2727272727272727,0.6363636363636364,69621503,66,18
2,2,0.8333333333333334,0.6666666666666666,71080394,12,10
1,74,0.3884297520661157,0.8518518518518519,68531344,121,47
0,656,0.15025906735751296,0.2288065843621399,68538064,772,116
1,152,0.2796208530805687,0.6476683937823834,65004625,211,59
2,9,0.859375,0.95,67064872,64,55
1,88,0.38028169014084506,0.8394495412844036,71260462,142,54
0,262,0.18125,0.4311050477489768,80097710,320,58
1,224,0.2797427652733119,0.7088846880907372,80112235,311,87
0,79,0.18556701030927836,0.36507936507936506,68648755,97,18
2,16,0.6595744680851063,0.9772727272727273,70717325,47,31
0,68,0.05555555555555555,0.1118421052631579,73245431,72,4
1,68,0.3644859813084112,0.8348214285714286,73000935,107,39
1,41,0.4057971014492754,0.7142857142857143,60240131,69,28
2,15,0.5833333333333334,0.9574468085106383,67979576,36,21
2,1,0.9545454545454546,0.5,80152802,22,21
0,160,0.1919191919191919,0.25158562367864695,65307522,198,38
1,86,0.38571428571428573,0.8774703557312253,72382366,140,54
1,151,0.40784313725490196,0.8419452887537994,79787456,255,104
0,64,0.058823529411764705,0.08152173913043478,63812161,68,4
2,4,0.5,0.8333333333333334,82009530,8,4
2,8,0.7419354838709677,0.9523809523809523,80055003,31,23
2,3,0.5714285714285714,0.5,75264315,7,4
2,11,0.7441860465116279,0.8695652173913043,66920154,43,32
2,16,0.7333333333333333,0.75,69139301,60,44
1,99,0.49746192893401014,0.8677248677248677,80178635,197,98
2,32,0.6235294117647059,0.9857142857142858,68546996,85,53
1,125,0.3932038834951456,0.8734567901234568,70870044,206,81
1,27,0.22857142857142856,0.5681818181818182,70687183,35,8
1,72,0.28,0.509090909090909,74059090,100,28
0,53,0.208955223880597,0.25,69184815,67,14
1,96,0.32867132867132864,0.7699530516431925,68434324,143,47
0,25,0.13793103448275862,0.22388059701492538,76890793,29,4
1,85,0.4620253164556962,0.8883928571428571,70673442,158,73
2,17,0.6666666666666666,0.9464285714285714,82008293,51,34
1,12,0.25,0.625,70646100,16,4
1,42,0.27586206896551724,0.5185185185185185,67218634,58,16
0,345,0.12436548223350254,0.1893063583815029,68537063,394,49
1,11,0.45,0.7692307692307693,80167229,20,9
1,133,0.24431818181818182,0.5563380281690141,82166801,176,43
1,188,0.32857142857142857,0.6766917293233082,74058593,280,92
0,27,0.34146341463414637,0.4642857142857143,70350112,41,14
1,124,0.45132743362831856,0.8547486033519553,70121604,226,102
0,43,0.10416666666666667,0.07407407407407407,68317872,48,5
2,43,0.7794871794871795,0.9895833333333334,81968066,195,152
2,76,0.5657142857142857,0.9080459770114943,80054863,175,99
1,66,0.3888888888888889,0.7844311377245509,82002230,108,42
0,13,0.13333333333333333,0.06896551724137931,80119097,15,2
0,14,0.0,0.0,72909711,14,0
0,5,0.0,0.0,72909746,5,0
2,97,0.6446886446886447,0.7027027027027027,70546245,273,176
1,119,0.32386363636363635,0.6710097719869706,74353370,176,57
1,33,0.45,0.9174311926605505,80156243,60,27
1,27,0.22857142857142856,0.5818181818181818,69558454,35,8
2,1,0.6666666666666666,0.5,68587393,3,2
1,301,0.22422680412371135,0.5128205128205128,67160625,388,87
1,119,0.2958579881656805,0.6824034334763949,82095528,169,50
0,225,0.23728813559322035,0.35958005249343833,74545765,295,70
2,94,0.5803571428571429,0.9701492537313433,80022075,224,130
1,58,0.30120481927710846,0.7086092715231788,73738973,83,25
1,46,0.30303030303030304,0.7615384615384615,70919611,66,20
1,2,0.3333333333333333,0.5,80128899,3,1
2,6,0.5384615384615384,0.75,72802611,13,7
2,1,0.5,0.0,82041914,2,1
0,56,0.06666666666666667,0.20710059171597633,70685993,60,4
0,26,0.0,0.0,70692314,26,0
0,42,0.08695652173913043,0.2361111111111111,66110926,46,4
0,15,0.0,0.0,70238336,15,0
0,47,0.06,0.14925373134328357,70239302,50,3
2,29,0.6588235294117647,0.9534883720930233,69901440,85,56
1,35,0.4696969696969697,0.9384615384615385,69666541,66,31
0,310,0.23076923076923078,0.49132176234979974,80121231,403,93
1,179,0.32196969696969696,0.7108108108108108,67995354,264,85
1,12,0.4,0.7096774193548387,74635162,20,8
0,132,0.12582781456953643,0.225,73245711,151,19
1,241,0.2445141065830721,0.540796963946869,80121124,319,78
1,341,0.32741617357001973,0.5868852459016394,80178943,507,166
1,74,0.45588235294117646,0.9482758620689655,70642264,136,62
0,67,0.22988505747126436,0.4253393665158371,69184171,87,20
1,193,0.24313725490196078,0.5884543761638734,68666836,255,62
0,310,0.09090909090909091,0.06756756756756757,82128633,341,31
0,203,0.15767634854771784,0.24624624624624625,82095673,241,38
1,11,0.3888888888888889,0.7,80172967,18,7
1,39,0.4090909090909091,0.8478260869565217,80173000,66,27
0,269,0.2088235294117647,0.3826247689463956,68535873,340,71
2,72,0.5909090909090909,0.9444444444444444,80137027,176,104
0,100,0.12280701754385964,0.21,68299742,114,14
1,15,0.375,0.7906976744186046,69180111,24,9
1,31,0.29545454545454547,0.7638888888888888,69184185,44,13
1,20,0.23076923076923078,0.6119402985074627,68633082,26,6
1,191,0.2765151515151515,0.6236842105263158,80132406,264,73
1,17,0.2608695652173913,0.5531914893617021,80134791,23,6
1,23,0.25806451612903225,0.75,70413833,31,8
0,146,0.21505376344086022,0.4595959595959596,63141505,186,40
2,1,0.5,0.6666666666666666,70633136,2,1
0,285,0.2692307692307692,0.48952095808383234,73435502,390,105
2,80,0.5375722543352601,0.9626168224299065,69627922,173,93
0,21,0.25,0.4406779661016949,80162648,28,7
2,2,0.6666666666666666,0.5,75663294,6,4
2,96,0.6175298804780877,0.7924528301886793,66279752,251,155
1,61,0.34408602150537637,0.6513761467889908,82132586,93,32
1,24,0.2727272727272727,0.6181818181818182,82155248,33,9
2,7,0.7741935483870968,0.9285714285714286,80145465,31,24
1,2,0.3333333333333333,0.6666666666666666,80118250,3,1
0,3,0.0,0.0,80118304,3,0
1,15,0.4642857142857143,0.9714285714285714,70803026,28,13
2,15,0.7,0.9811320754716981,67650184,50,35
1,78,0.3275862068965517,0.851985559566787,73672872,116,38
1,103,0.2847222222222222,0.6525974025974026,82126638,144,41
0,181,0.16203703703703703,0.30303030303030304,80097262,216,35
1,35,0.4166666666666667,0.8125,80133773,60,25
0,85,0.17475728155339806,0.49038461538461536,69153203,103,18
0,90,0.10891089108910891,0.04932735426008968,68545351,101,11
2,9,0.5,0.8,70925365,18,9
1,680,0.25027563395810365,0.5953488372093023,70760543,907,227
0,25,0.1935483870967742,0.38095238095238093,67775281,31,6
1,13,0.35,0.8787878787878788,68426190,20,7
0,2,0.0,0.0,80069654,2,0
1,3,0.4,0.7777777777777778,80069794,5,2
0,84,0.11578947368421053,0.4530386740331492,69469162,95,11
1,306,0.2679425837320574,0.5909774436090226,68763793,418,112
1,60,0.3181818181818182,0.5272727272727272,68274920,88,28
0,141,0.0472972972972973,0.04406779661016949,80181316,148,7
0,152,0.14124293785310735,0.09961685823754789,66767666,177,25
1,148,0.48788927335640137,0.9518413597733711,65191140,289,141
0,54,0.15625,0.4233128834355828,80124231,64,10
0,68,0.05555555555555555,0.15853658536585366,80124404,72,4
0,167,0.10215053763440861,0.14583333333333334,80071040,186,19
0,67,0.056338028169014086,0.3583061889250814,64183126,71,4
0,73,0.02666666666666667,0.05466237942122187,64183371,75,2
2,0,1.0,1.0,82090153,16,16
2,22,0.6,0.9473684210526315,81967950,55,33
0,54,0.22857142857142856,0.3333333333333333,65930900,70,16
1,288,0.21525885558583105,0.5117994100294986,70202363,367,79
0,151,0.17032967032967034,0.44258373205741625,70202370,182,31
0,18,0.1,0.058823529411764705,66035312,20,2
2,10,0.6,0.8703703703703703,69576325,25,15
2,2,0.75,0.6666666666666666,69089881,8,6
0,113,0.02586206896551724,0.014150943396226415,70567861,116,3
0,101,0.06481481481481481,0.049019607843137254,70575470,108,7
1,20,0.375,0.7142857142857143,80128714,32,12
2,2,0.5,0.75,70062580,4,2
0,18,0.18181818181818182,0.2978723404255319,67553640,22,4
0,33,0.13157894736842105,0.15625,67627245,38,5
0,429,0.11728395061728394,0.11570247933884298,80180390,486,57
1,81,0.3305785123966942,0.7740384615384616,69165383,121,40
2,17,0.5142857142857142,0.9555555555555556,73599435,35,18
0,33,0.23255813953488372,0.3709677419354839,65289686,43,10
1,53,0.3026315789473684,0.7244094488188977,80123616,76,23
2,6,0.7,0.9375,70854343,20,14
1,4,0.42857142857142855,0.8888888888888888,65292661,7,3
1,135,0.25824175824175827,0.5765124555160143,69603562,182,47
1,46,0.4177215189873418,0.9424460431654677,66613771,79,33
0,92,0.2,0.4875,80098872,115,23
1,6,0.45454545454545453,0.8292682926829268,82049181,11,5
1,34,0.32,0.8924731182795699,66264562,50,16
0,112,0.0743801652892562,0.2315270935960591,69006903,121,9
1,59,0.21333333333333335,0.7889908256880734,69597920,75,16
1,57,0.24,0.6441441441441441,80176483,75,18
1,42,0.4878048780487805,0.9032258064516129,69206991,82,40
0,5,0.16666666666666666,0.2857142857142857,67793495,6,1
1,142,0.297029702970297,0.7444444444444445,69622364,202,60
1,103,0.34810126582278483,0.8947368421052632,68641895,158,55
0,245,0.11231884057971014,0.39594843462246776,63780360,276,31
0,207,0.1446280991735537,0.2257001647446458,66887450,242,35
1,234,0.31976744186046513,0.7357142857142858,82124936,344,110
2,12,0.8421052631578947,0.9,82033188,76,64
0,79,0.19387755102040816,0.4475806451612903,70061803,98,19
2,56,0.5294117647058824,0.9779735682819384,72417954,119,63
1,37,0.4126984126984127,0.9150943396226415,69180524,63,26
1,78,0.3389830508474576,0.8675496688741722,69621566,118,40
0,117,0.2732919254658385,0.4729064039408867,79726794,161,44
0,6,0.0,0.0,67668944,6,0
0,2,0.0,0.0,69873930,2,0
0,248,0.1760797342192691,0.3499005964214712,68534354,301,53
0,144,0.05263157894736842,0.21158129175946547,80128624,152,8
1,123,0.4057971014492754,0.8492462311557789,65256660,207,84
1,4,0.3333333333333333,0.7333333333333333,73421572,6,2
0,147,0.11976047904191617,0.23809523809523808,64931013,167,20
0,11,0.21428571428571427,0.4090909090909091,69681381,14,3
1,44,0.2413793103448276,0.514018691588785,70587692,58,14
0,16,0.058823529411764705,0.0625,66226825,17,1
0,73,0.1797752808988764,0.33695652173913043,72382310,89,16
1,59,0.24358974358974358,0.572972972972973,80121145,78,19
2,34,0.6991150442477876,0.9868421052631579,69733384,113,79
2,7,0.631578947368421,0.8571428571428571,80124943,19,12
0,13,0.1875,0.2702702702702703,80124945,16,3
0,155,0.2688679245283019,0.49759615384615385,69180363,212,57
0,378,0.08695652173913043,0.1093210586881473,80114230,414,36
0,536,0.03074141048824593,0.008350730688935281,80114265,553,17
0,354,0.08762886597938144,0.09654350417163289,70532833,388,34
1,6,0.3333333333333333,0.7647058823529411,80165730,9,3
0,306,0.18181818181818182,0.22736842105263158,62624261,374,68
2,46,0.5855855855855856,0.941747572815534,69704320,111,65
1,3,0.4,0.6666666666666666,69311683,5,2
1,59,0.4380952380952381,0.8932038834951457,69988912,105,46
0,64,0.08571428571428572,0.07766990291262135,70576156,70,6
0,13,0.13333333333333333,0.3225806451612903,70908803,15,2
0,20,0.047619047619047616,0.07407407407407407,80135087,21,1
1,29,0.3409090909090909,0.8055555555555556,80134773,44,15
1,235,0.37994722955145116,0.8110687022900763,67511500,379,144
1,32,0.3333333333333333,0.7361111111111112,66802743,48,16
2,15,0.5,0.9230769230769231,66802771,30,15
1,95,0.4476744186046512,0.9224806201550387,66917242,172,77
0,136,0.09933774834437085,0.22429906542056074,69508915,151,15
1,37,0.4861111111111111,0.9565217391304348,66742592,72,35
0,63,0.08695652173913043,0.225130890052356,64221864,69,6
1,25,0.16666666666666666,0.5625,67225921,30,5
1,47,0.38961038961038963,0.8484848484848485,69165145,77,30
0,1,0.0,0.0,70250782,1,0
0,78,0.09302325581395349,0.21266968325791855,80135096,86,8
1,22,0.4358974358974359,0.8979591836734694,66742571,39,17
0,92,0.2459016393442623,0.42962962962962964,82008920,122,30
1,146,0.4729241877256318,0.9174041297935103,69840470,277,131
0,235,0.19795221843003413,0.4584070796460177,82113164,293,58
1,26,0.3953488372093023,0.8723404255319149,74713660,43,17
1,122,0.2129032258064516,0.5436893203883495,70072065,155,33
1,41,0.4533333333333333,0.8823529411764706,70718795,75,34
1,20,0.3548387096774194,0.8333333333333334,80126536,31,11
1,50,0.4186046511627907,0.8,70719264,86,36
1,29,0.40816326530612246,0.75,70563465,49,20
2,19,0.5476190476190477,0.9090909090909091,68363624,42,23
1,119,0.33146067415730335,0.7931034482758621,66743222,178,59
1,64,0.3333333333333333,0.6086956521739131,70612304,96,32
1,143,0.4163265306122449,0.9163346613545816,68782490,245,102
2,7,0.7083333333333334,0.9333333333333333,68363652,24,17
1,46,0.3611111111111111,0.753968253968254,70854112,72,26
0,11,0.08333333333333333,0.22641509433962265,70199773,12,1
1,9,0.35714285714285715,0.8627450980392157,70417214,14,5
0,204,0.04672897196261682,0.12151898734177215,70109550,214,10
1,6,0.3333333333333333,0.8181818181818182,65286543,9,3
2,14,0.5172413793103449,0.9761904761904762,65290113,29,15
1,7,0.4166666666666667,0.8636363636363636,65281202,12,5
0,90,0.03225806451612903,0.018867924528301886,67285603,93,3
1,87,0.2809917355371901,0.7320574162679426,70061845,121,34
0,27,0.12903225806451613,0.0625,65282966,31,4
2,77,0.5217391304347826,0.9901477832512315,67230604,161,84
1,18,0.21739130434782608,0.5068493150684932,65282371,23,5
0,8,0.2,0.43478260869565216,65292605,10,2
0,13,0.23529411764705882,0.4411764705882353,65293102,17,4
1,35,0.36363636363636365,0.8372093023255814,66856062,55,20
1,168,0.2727272727272727,0.6528925619834711,69176891,231,63
1,14,0.4166666666666667,0.782608695652174,65289644,24,10
0,21,0.08695652173913043,0.0196078431372549,66035214,23,2
2,5,0.6666666666666666,0.9090909090909091,65286641,15,10
1,70,0.18604651162790697,0.5888888888888889,69416543,86,16
0,20,0.2,0.36538461538461536,74363604,25,5
1,241,0.2696969696969697,0.7078651685393258,67835173,330,89
1,155,0.2548076923076923,0.5396039603960396,80125034,208,53
0,47,0.21666666666666667,0.42011834319526625,60812402,60,13
1,120,0.4339622641509434,0.8188976377952756,70115143,212,92
1,17,0.37037037037037035,0.8666666666666667,70803012,27,10
0,80,0.22330097087378642,0.33727810650887574,69183884,103,23
1,51,0.2714285714285714,0.5838150289017341,70741846,70,19
0,201,0.06511627906976744,0.06147540983606557,80097381,215,14
2,51,0.5096153846153846,0.8958333333333334,80042970,104,53
2,18,0.6538461538461539,0.967741935483871,70799295,52,34
1,68,0.4962962962962963,0.953125,69621734,135,67
1,122,0.4325581395348837,0.892,69637071,215,93
1,64,0.3904761904761905,0.8041237113402062,70221473,105,41
1,150,0.494949494949495,0.9469026548672567,80161884,297,147
2,81,0.6048780487804878,0.8846153846153846,68554360,205,124
0,137,0.19883040935672514,0.37393767705382436,67627371,171,34
2,218,0.5691699604743083,0.898238747553816,70235746,506,288
1,37,0.3018867924528302,0.6129032258064516,82002249,53,16
0,19,0.20833333333333334,0.4166666666666667,78763174,24,5
1,112,0.28662420382165604,0.652014652014652,67553836,157,45
1,213,0.30618892508143325,0.7339622641509433,80120432,307,94
0,119,0.0916030534351145,0.4089775561097257,66876432,131,12
0,205,0.023809523809523808,0.09515570934256055,66877083,210,5
2,5,0.6666666666666666,0.8666666666666667,79783774,15,10
1,4,0.3333333333333333,0.7272727272727273,70781564,6,2
0,86,0.14,0.22077922077922077,72208640,100,14
0,4,0.2,0.2962962962962963,70395584,5,1
2,30,0.5081967213114754,0.898989898989899,70074011,61,31
0,118,0.04065040650406504,0.02962962962962963,63141043,123,5
0,126,0.23170731707317074,0.41846153846153844,80123746,164,38
0,155,0.054878048780487805,0.032397408207343416,81980453,164,9
1,57,0.2962962962962963,0.6909090909090909,70252364,81,24
1,173,0.29098360655737704,0.692722371967655,69154736,244,71
0,145,0.20765027322404372,0.28753993610223644,65749012,183,38
0,340,0.014492753623188406,0.02892960462873674,62838881,345,5
0,9,0.0,0.0,67053840,9,0
1,65,0.35,0.8047337278106509,70005943,100,35
0,176,0.1619047619047619,0.29213483146067415,82166799,210,34
0,17,0.15,0.23076923076923078,70917553,20,3
0,42,0.16,0.1,62497295,50,8
1,97,0.35333333333333333,0.6787330316742082,69128010,150,53
2,1,0.6666666666666666,0.5,82023761,3,2
1,82,0.2743362831858407,0.6978021978021978,68642294,113,31
0,81,0.20588235294117646,0.25510204081632654,69607174,102,21
1,89,0.2644628099173554,0.5632183908045977,74653544,121,32
1,139,0.29081632653061223,0.639751552795031,71820651,196,57
1,186,0.3357142857142857,0.766743648960739,66919083,280,94
0,152,0.23618090452261306,0.4889502762430939,82120533,199,47
0,18,0.0,0.0,62834940,18,0
0,431,0.02927927927927928,0.07591836734693877,62837320,444,13
1,82,0.4421768707482993,0.8864628820960698,67307016,147,65
0,65,0.12162162162162163,0.13768115942028986,67652165,74,9
1,12,0.4,0.8695652173913043,64698095,20,8
1,25,0.4186046511627907,0.9523809523809523,67218641,43,18
1,2,0.3333333333333333,0.5,82159208,3,1
1,19,0.3448275862068966,0.6060606060606061,70231014,29,10
1,61,0.4019607843137255,0.9281045751633987,69607076,102,41
1,64,0.189873417721519,0.6104651162790697,63771386,79,15
1,81,0.325,0.55,68401942,120,39
0,19,0.20833333333333334,0.4358974358974359,65291002,24,5
2,86,0.5473684210526316,0.9823788546255506,72271031,190,104
2,11,0.9098360655737705,0.9333333333333333,80178968,122,111
2,2,0.9555555555555556,0.5,80132794,45,43
0,66,0.08333333333333333,0.09523809523809523,80141455,72,6
1,36,0.28,0.5555555555555556,80027962,50,14
1,179,0.23829787234042554,0.5129682997118156,66892413,235,56
0,115,0.16666666666666666,0.23958333333333334,73652145,138,23
0,102,0.08108108108108109,0.023809523809523808,72917355,111,9
1,94,0.4161490683229814,0.8678414096916299,80176876,161,67
0,149,0.019736842105263157,0.04100946372239748,80124163,152,3
0,40,0.09090909090909091,0.2564102564102564,70746494,44,4
1,27,0.41304347826086957,0.9402985074626866,63466662,46,19
0,58,0.275,0.44375,80163480,80,22
1,4,0.2,0.55,69458536,5,1
1,174,0.2926829268292683,0.6020408163265306,67994913,246,72
1,29,0.2564102564102564,0.5487804878048781,70812805,39,10
1,246,0.27647058823529413,0.5798922800718133,69183331,340,94
1,316,0.2834467120181406,0.6495726495726496,73816295,441,125
1,75,0.47183098591549294,0.7282608695652174,80056424,142,67
1,266,0.2507042253521127,0.6337837837837837,61699085,355,89
1,32,0.21951219512195122,0.5196078431372549,80113516,41,9
1,53,0.4111111111111111,0.8551724137931035,81971180,90,37
0,15,0.0,0.0,68497723,15,0
1,25,0.3055555555555556,0.7294117647058823,68497821,36,11
0,6,0.0,0.0,69006602,6,0
1,14,0.3333333333333333,0.84,69478311,21,7
1,16,0.4074074074074074,0.875,69666765,27,11
0,222,0.2550335570469799,0.4989429175475687,67558274,298,76
1,144,0.27638190954773867,0.5536912751677853,67995123,199,55
2,13,0.5806451612903226,0.9148936170212766,68546975,31,18
2,6,0.5384615384615384,0.9142857142857143,80163456,13,7
0,98,0.18333333333333332,0.22429906542056074,70719740,120,22
0,169,0.1990521327014218,0.3523809523809524,70234773,211,42
1,159,0.40892193308550184,0.8076923076923077,70077371,269,110
2,216,0.5364806866952789,0.9274447949526814,82009745,466,250
1,481,0.3098995695839311,0.7306985294117647,70252700,697,216
1,84,0.34375,0.6553191489361702,68678456,128,44
1,50,0.45652173913043476,0.8908045977011494,80067232,92,42
1,36,0.29411764705882354,0.5862068965517241,80113530,51,15
0,1,0.0,0.0,67246305,1,0
2,2,0.5,0.3333333333333333,68402404,4,2
2,4,0.6923076923076923,0.8888888888888888,64103963,13,9
0,58,0.13432835820895522,0.4205607476635514,80124188,67,9
1,107,0.47549019607843135,0.9402985074626866,70670292,204,97
0,214,0.17692307692307693,0.3424124513618677,82036697,260,46
0,50,0.21875,0.3382352941176471,80118952,64,14
1,125,0.4517543859649123,0.8314176245210728,76213956,228,103
0,204,0.06422018348623854,0.096045197740113,68017845,218,14
0,329,0.17336683417085427,0.3879668049792531,82011793,398,69
1,103,0.1557377049180328,0.5249266862170088,72866654,122,19
1,214,0.24647887323943662,0.5621019108280255,66931375,284,70
1,72,0.25773195876288657,0.6055555555555555,67558162,97,25
1,56,0.3170731707317073,0.831081081081081,69608336,82,26
1,2,0.3333333333333333,0.875,70175133,3,1
0,3,0.25,0.2222222222222222,70175413,4,1
1,27,0.35714285714285715,0.8785046728971962,70760046,42,15
1,387,0.34628378378378377,0.8610778443113772,82038329,592,205
0,4,0.2,0.0,72802450,5,1
0,84,0.011764705882352941,0.029850746268656716,80049473,85,1
0,64,0.07246376811594203,0.3064516129032258,80049536,69,5
0,30,0.0625,0.1568627450980392,80130185,32,2
0,77,0.2376237623762376,0.46153846153846156,80130299,101,24
0,47,0.12962962962962962,0.4225352112676056,70109704,54,7
2,1,0.9285714285714286,0.6666666666666666,70770686,14,13
2,4,0.7142857142857143,0.9,70479346,14,10
0,183,0.2245762711864407,0.42954545454545456,69056820,236,53
0,116,0.12781954887218044,0.19718309859154928,82011776,133,17
2,12,0.625,0.9583333333333334,73870020,32,20
1,5,0.4444444444444444,0.9,80046071,9,4
2,3,0.5,0.4,66691982,6,3
0,205,0.19921875,0.28350515463917525,70645491,256,51
2,16,0.6,0.95,67801566,40,24
0,158,0.08139534883720931,0.14285714285714285,69106856,172,14
0,12,0.14285714285714285,0.2903225806451613,70175672,14,2
1,342,0.47465437788018433,0.9164420485175202,80096044,651,309
0,59,0.20270270270270271,0.4256410256410256,80124769,74,15
1,66,0.46774193548387094,0.9172932330827067,68601253,124,58
1,110,0.29936305732484075,0.559748427672956,69660570,157,47
1,96,0.25,0.5743801652892562,67160464,128,32
0,3,0.0,0.0,70175616,3,0
2,72,0.645320197044335,0.9900990099009901,74443796,203,131
2,43,0.6717557251908397,0.9431818181818182,80178986,131,88
0,19,0.09523809523809523,0.16,80141469,21,2
2,48,0.7108433734939759,0.8627450980392157,68366263,166,118
1,101,0.28368794326241137,0.6596858638743456,79026122,141,40
1,54,0.3076923076923077,0.6708860759493671,65524760,78,24
2,1,0.9333333333333333,0.5,80127003,15,14
0,269,0.14873417721518986,0.23024523160762944,80135350,316,47
2,12,0.5555555555555556,0.9666666666666667,74086600,27,15
2,3,0.5,0.6666666666666666,82096288,6,3
1,52,0.49514563106796117,0.9361702127659575,71362704,103,51
2,1,0.5,0.5,70121765,2,1
1,8,0.4666666666666667,0.9615384615384616,82032903,15,7
2,15,0.53125,0.9166666666666666,80126963,32,17
2,1,0.9811320754716981,0.5,80127030,53,52
0,74,0.20430107526881722,0.17391304347826086,80126984,93,19
2,0,1.0,1.0,82144696,1,1
2,6,0.7391304347826086,0.75,70608580,23,17
2,4,0.6363636363636364,0.8,80128840,11,7
1,294,0.4378585086042065,0.9079837618403248,80003364,523,229
2,12,0.9130434782608695,0.9444444444444444,73426836,138,126
2,0,1.0,1.0,82037550,2,2
2,1,0.9166666666666666,0.5,82054008,12,11
1,39,0.25,0.6460176991150443,69160224,52,13
1,8,0.38461538461538464,0.9166666666666666,80028823,13,5
1,91,0.40131578947368424,0.8847352024922118,80176638,152,61
1,7,0.3,0.7647058823529411,82145525,10,3
2,8,0.9157894736842105,0.6,80126595,95,87
1,21,0.19230769230769232,0.5675675675675675,78763230,26,5
2,0,1.0,1.0,80136570,3,3
2,1,0.5,0.0,80176436,2,1
1,26,0.2571428571428571,0.5384615384615384,66648253,35,9
2,0,1.0,1.0,82055433,7,7
2,0,1.0,1.0,69316380,3,3
2,7,0.78125,0.92,80158308,32,25
2,21,0.5,0.9134615384615384,80158227,42,21
1,117,0.40609137055837563,0.8579545454545454,73390436,197,80
2,2,0.8461538461538461,0.6666666666666666,80152803,13,11
2,0,1.0,1.0,80136695,2,2
2,80,0.5031055900621118,0.9312977099236641,80125426,161,81
2,45,0.82421875,0.9342105263157895,72457315,256,211
2,2,0.8888888888888888,0.5,80117724,18,16
2,8,0.8181818181818182,0.9444444444444444,82171882,44,36
0,4,0.2,0.13333333333333333,66623753,5,1
0,14,0.2222222222222222,0.4,82096260,18,4
1,18,0.41935483870967744,0.6363636363636364,80172006,31,13
2,17,0.6792452830188679,0.9285714285714286,65619400,53,36
2,95,0.5539906103286385,0.9384057971014492,69206781,213,118
2,3,0.925,0.5,80159738,40,37
1,49,0.35526315789473684,0.8431372549019608,70674072,76,27
2,3,0.9032258064516129,0.8,75663280,31,28
2,1,0.5,0.3333333333333333,82093725,2,1
1,20,0.4444444444444444,0.9069767441860465,70753263,36,16
1,15,0.25,0.6956521739130435,70753284,20,5
2,13,0.6829268292682927,0.9090909090909091,68037760,41,28
1,17,0.34615384615384615,0.8088235294117647,70229943,26,9
2,0,1.0,1.0,80176414,5,5
2,26,0.5,0.782608695652174,80172964,52,26
2,15,0.625,0.9666666666666667,80126957,40,25
2,2,0.6666666666666666,0.5,80054513,6,4
2,0,1.0,1.0,80169314,2,2
2,0,1.0,1.0,82145172,1,1
2,35,0.5205479452054794,0.8970588235294118,72474115,73,38
2,0,1.0,1.0,68546751,2,2
2,0,1.0,1.0,70851424,5,5
1,34,0.30612244897959184,0.6049382716049383,67636891,49,15
2,29,0.5,0.8070175438596491,80158264,58,29
1,112,0.3253012048192771,0.5885167464114832,68995010,166,54
2,4,0.8260869565217391,0.8,70073416,23,19
2,35,0.5882352941176471,0.9,75636050,85,50
2,0,1.0,1.0,82126257,3,3
0,6,0.14285714285714285,0.0,80172915,7,1
0,21,0.19230769230769232,0.25925925925925924,80172916,26,5
2,1,0.6666666666666666,0.8,68330115,3,2
2,7,0.8627450980392157,0.95,67142481,51,44
2,11,0.7659574468085106,0.9722222222222222,70206381,47,36
2,0,1.0,1.0,82047743,37,37
1,14,0.48148148148148145,0.8367346938775511,80158228,27,13
2,44,0.7555555555555555,0.9895833333333334,72511215,180,136
2,5,0.7727272727272727,0.9166666666666666,80176052,22,17
2,0,1.0,1.0,82039310,21,21
2,0,1.0,1.0,82033531,8,8
0,14,0.2222222222222222,0.4,69611185,18,4
0,10,0.16666666666666666,0.1935483870967742,69611353,12,2
0,6,0.25,0.2857142857142857,82023696,8,2
2,9,0.55,0.9714285714285714,82023697,20,11
2,14,0.75,0.9629629629629629,80118213,56,42
1,341,0.30265848670756645,0.6794117647058824,70601510,489,148
2,0,1.0,1.0,69979903,7,7
2,5,0.5833333333333334,0.7647058823529411,80052560,12,7
2,7,0.72,0.8461538461538461,68959793,25,18
0,152,0.10059171597633136,0.2132564841498559,80135099,169,17
1,11,0.3888888888888889,0.6666666666666666,69957930,18,7
2,2,0.5,0.5,19487930,4,2
2,4,0.8095238095238095,0.8888888888888888,80117713,21,17
2,0,1.0,1.0,80136544,5,5
2,2,0.9622641509433962,0.5,80159742,53,51
2,22,0.6,0.9423076923076923,80158079,55,33
2,5,0.5833333333333334,0.6666666666666666,75032986,12,7
2,2,0.9375,0.5,80126931,32,30
2,3,0.8235294117647058,0.7142857142857143,80117718,17,14
0,14,0.125,0.3269230769230769,72910194,16,2
2,29,0.7716535433070866,0.9857142857142858,80134720,127,98
0,10,0.09090909090909091,0.29411764705882354,80141479,11,1
1,69,0.4609375,0.8,67168066,128,59
1,161,0.39473684210526316,0.640625,72445611,266,105
2,1,0.75,0.5,82041716,4,3
2,24,0.5555555555555556,0.9782608695652174,80156296,54,30
2,22,0.8225806451612904,0.9512195121951219,80127698,124,102
1,81,0.325,0.7672413793103449,80027976,120,39
1,86,0.4304635761589404,0.8383838383838383,80062220,151,65
2,4,0.9402985074626866,0.8,80159544,67,63
2,0,1.0,1.0,80126552,3,3
2,1,0.9827586206896551,0.5,69389523,58,57
1,10,0.2857142857142857,0.6666666666666666,82050502,14,4
2,2,0.875,0.6666666666666666,80159161,16,14
1,47,0.3088235294117647,0.6956521739130435,72390850,68,21
1,56,0.2328767123287671,0.6,66133354,73,17
1,106,0.3333333333333333,0.7597765363128491,68112653,159,53
1,90,0.3877551020408163,0.8512110726643599,70768376,147,57
1,60,0.4594594594594595,0.8968609865470852,70061411,111,51
1,9,0.4375,0.7777777777777778,82020084,16,7
0,6,0.14285714285714285,0.1875,82020086,7,1
1,10,0.375,0.6363636363636364,79960125,16,6
1,74,0.29523809523809524,0.6335403726708074,964425,105,31
1,148,0.37815126050420167,0.8847262247838616,82126742,238,90
0,199,0.05687203791469194,0.23655913978494625,69007344,211,12
0,288,0.22371967654986524,0.49640287769784175,82011849,371,83
0,19,0.17391304347826086,0.43859649122807015,70491631,23,4
1,26,0.48,0.8333333333333334,69168183,50,24
2,1,0.5,0.6666666666666666,66180296,2,1
2,2,0.8823529411764706,0.6666666666666666,70670915,17,15
1,121,0.21935483870967742,0.5311203319502075,80055332,155,34
0,183,0.031746031746031744,0.17732558139534885,69965196,189,6
2,23,0.5306122448979592,0.9365079365079365,80166918,49,26
0,57,0.05,0.20634920634920634,80127373,60,3
1,3,0.4,0.75,82052051,5,2
1,70,0.4166666666666667,0.9328859060402684,65288475,120,50
0,107,0.21897810218978103,0.49230769230769234,60763416,137,30
0,87,0.22321428571428573,0.42323651452282157,72817255,112,25
1,109,0.2684563758389262,0.6989247311827957,69421821,149,40
0,84,0.2222222222222222,0.4320388349514563,66892910,108,24
0,366,0.226215644820296,0.4197916666666667,82124915,473,107
1,11,0.35294117647058826,0.896551724137931,70759045,17,6
1,45,0.36619718309859156,0.7924528301886793,70710171,71,26
2,10,0.5652173913043478,0.9230769230769231,70760221,23,13
2,3,0.8,0.8571428571428571,82153542,15,12
1,192,0.23809523809523808,0.5756756756756757,68540143,252,60
0,22,0.08333333333333333,0.0,77710815,24,2
2,14,0.5,0.9230769230769231,69104266,28,14
1,276,0.16363636363636364,0.573404255319149,68798100,330,54
0,278,0.11464968152866242,0.16337285902503293,66087336,314,36
1,197,0.313588850174216,0.6177606177606177,68040343,287,90
1,78,0.47651006711409394,0.8592592592592593,68040350,149,71
0,74,0.11904761904761904,0.1232876712328767,67703524,84,10
0,140,0.20903954802259886,0.4766666666666667,67159715,177,37
0,73,0.1511627906976744,0.3,70539770,86,13
1,64,0.3118279569892473,0.7802197802197802,80124648,93,29
1,211,0.29900332225913623,0.6696428571428571,68040525,301,90
1,146,0.27,0.5581395348837209,74708914,200,54
0,150,0.21052631578947367,0.42857142857142855,77676375,190,40
0,19,0.13636363636363635,0.359375,82143808,22,3
1,198,0.21428571428571427,0.6244343891402715,75283201,252,54
0,217,0.04405286343612335,0.11594202898550725,69703172,227,10
1,14,0.44,0.8125,80118379,25,11
1,96,0.37254901960784315,0.8783068783068783,70474936,153,57
1,39,0.390625,0.7878787878787878,82096309,64,25
1,3,0.4,0.8181818181818182,70418180,5,2
1,188,0.26848249027237353,0.5752212389380531,69538224,257,69
2,0,1.0,1.0,82041717,2,2
0,150,0.07975460122699386,0.2126984126984127,80124433,163,13
1,23,0.39473684210526316,0.7583333333333333,80145772,38,15
1,14,0.3,0.5362318840579711,80145887,20,6
0,25,0.0,0.0,70703080,25,0
0,26,0.037037037037037035,0.17307692307692307,70706076,27,1
1,58,0.24675324675324675,0.5121951219512195,80096373,77,19
2,1,0.9090909090909091,0.5,70637021,11,10
1,34,0.40350877192982454,0.8433734939759037,80180479,57,23
0,135,0.20118343195266272,0.42326732673267325,70073185,169,34
1,133,0.3036649214659686,0.7227979274611399,69177255,191,58
1,23,0.34285714285714286,0.8441558441558441,67134046,35,12
1,35,0.4067796610169492,0.8,80158080,59,24
2,32,0.5555555555555556,0.970873786407767,70508683,72,40
1,196,0.24904214559386972,0.6363636363636364,69388151,261,65
1,90,0.3706293706293706,0.7784090909090909,626633,143,53
0,142,0.20670391061452514,0.3835616438356164,82016313,179,37
0,17,0.10526315789473684,0.04878048780487805,70494634,19,2
2,88,0.5510204081632653,0.9671361502347418,82062663,196,108
0,595,0.10391566265060241,0.13233923578751164,70642495,664,69
1,142,0.3425925925925926,0.7920792079207921,80133413,216,74
0,39,0.1875,0.1864406779661017,80172912,48,9
1,194,0.3240418118466899,0.6472081218274112,78110802,287,93
0,11,0.15384615384615385,0.037037037037037035,80061051,13,2
1,8,0.4666666666666667,0.8837209302325582,80165891,15,7
1,69,0.3893805309734513,0.8174904942965779,68547486,113,44
1,62,0.4095238095238095,0.828,69128094,105,43
0,8,0.0,0.0,70678293,8,0
0,7,0.2222222222222222,0.4827586206896552,80126774,9,2
1,50,0.3150684931506849,0.7662337662337663,82126729,73,23
1,51,0.41379310344827586,0.7966101694915254,69951693,87,36
1,78,0.3389830508474576,0.7663043478260869,70508774,118,40
0,1,0.0,0.0,69152601,1,0
2,1,0.5,0.6666666666666666,69629511,2,1
1,125,0.37185929648241206,0.8172043010752689,82010238,199,74
0,105,0.07894736842105263,0.0749063670411985,66309222,114,9
1,255,0.28370786516853935,0.6753554502369669,67942826,356,101
1,171,0.4337748344370861,0.8111702127659575,66872204,302,131
0,11,0.21428571428571427,0.4090909090909091,80163148,14,3
1,174,0.29838709677419356,0.7219626168224299,68156361,248,74
0,94,0.12149532710280374,0.20809248554913296,82095680,107,13
0,223,0.11857707509881422,0.20433996383363473,69417145,253,30
0,13,0.2777777777777778,0.41935483870967744,60305154,18,5
0,19,0.09523809523809523,0.2682926829268293,70850724,21,2
0,92,0.12380952380952381,0.2222222222222222,70850794,105,13
1,268,0.25761772853185594,0.5714285714285714,82126763,361,93
0,133,0.19393939393939394,0.27672955974842767,82126661,165,32
1,107,0.19548872180451127,0.5400516795865633,68423551,133,26
0,19,0.05,0.2828282828282828,69525806,20,1
0,225,0.17279411764705882,0.29180327868852457,70027132,272,47
0,110,0.14728682170542637,0.35446685878962536,67812836,129,19
2,21,0.5625,0.9047619047619048,69635153,48,27
1,89,0.2644628099173554,0.640495867768595,80128586,121,32
1,106,0.15873015873015872,0.5650557620817844,69005930,126,20
0,13,0.0,0.0,69526345,13,0
0,140,0.25133689839572193,0.4862068965517241,81967308,187,47
1,39,0.35,0.865546218487395,70633395,60,21
0,159,0.04216867469879518,0.04011461318051576,70567882,166,7
0,131,0.06428571428571428,0.07876712328767123,70575484,140,9
1,37,0.22916666666666666,0.5766423357664233,82053043,48,11
0,133,0.08275862068965517,0.1894150417827298,60514272,145,12
1,16,0.4482758620689655,0.7916666666666666,273973,29,13
0,54,0.15625,0.10843373493975904,80125042,64,10
2,8,0.7777777777777778,0.6666666666666666,70179795,36,28
0,7,0.2222222222222222,0.45,70758765,9,2
0,63,0.17105263157894737,0.32083333333333336,70760403,76,13
1,35,0.4444444444444444,0.9154929577464789,65007320,63,28
0,268,0.021897810218978103,0.026888604353393086,80128612,274,6
1,17,0.37037037037037035,0.8870967741935484,70256984,27,10
0,52,0.1875,0.34146341463414637,68545400,64,12
1,27,0.25,0.6721311475409836,69638380,36,9
2,40,0.5402298850574713,0.925531914893617,67410623,87,47
0,1,0.0,0.0,70411236,1,0
1,68,0.2765957446808511,0.5520833333333334,82116879,94,26
1,243,0.2936046511627907,0.7114228456913828,65355864,344,101
1,138,0.1686746987951807,0.5055928411633109,69577515,166,28
0,113,0.2206896551724138,0.34523809523809523,80109435,145,32
1,15,0.4444444444444444,0.75,68040273,27,12
1,232,0.38133333333333336,0.8243451463790447,65847831,375,143
0,118,0.16312056737588654,0.25666666666666665,82126625,141,23
1,25,0.4444444444444444,0.926829268292683,80137542,45,20
0,49,0.18333333333333332,0.46558704453441296,70761222,60,11
0,199,0.2196078431372549,0.48284313725490197,69886943,255,56
0,100,0.18699186991869918,0.4342629482071713,68533416,123,23
0,40,0.047619047619047616,0.183206106870229,67467785,42,2
0,11,0.08333333333333333,0.44285714285714284,67468030,12,1
1,42,0.35384615384615387,0.7184466019417476,79792531,65,23
1,159,0.33472803347280333,0.7962466487935657,80128500,239,80
0,11,0.15384615384615385,0.22580645161290322,73977946,13,2
2,0,1.0,1.0,80118172,3,3
1,79,0.19387755102040816,0.5898305084745763,67862886,98,19
0,37,0.1590909090909091,0.25,80135090,44,7
1,267,0.2562674094707521,0.6932153392330384,68633103,359,92
0,14,0.125,0.25,70063525,16,2
0,1,0.0,0.0,80178164,1,0
1,68,0.39823008849557523,0.9074889867841409,66856545,113,45
0,97,0.12612612612612611,0.39672131147540984,80135352,111,14
0,123,0.1276595744680851,0.2508710801393728,80155849,141,18
0,242,0.20655737704918034,0.3275316455696203,71389171,305,63
1,119,0.23225806451612904,0.7184986595174263,82008927,155,36
0,132,0.26256983240223464,0.4716981132075472,70781893,179,47
1,311,0.3438818565400844,0.6198083067092651,80128012,474,163
1,19,0.32142857142857145,0.8,68603955,28,9
0,78,0.12359550561797752,0.3557692307692308,67900091,89,11
0,32,0.0,0.0,67467442,32,0
0,36,0.0,0.0,67467561,36,0
0,183,0.22127659574468084,0.35080645161290325,70404803,235,52
0,40,0.16666666666666666,0.2972972972972973,80135045,48,8
1,53,0.24285714285714285,0.6136363636363636,80135049,70,17
1,36,0.2653061224489796,0.6739130434782609,80135091,49,13
0,198,0.11607142857142858,0.23370786516853934,68383014,224,26
0,73,0.17045454545454544,0.4748603351955307,69886992,88,15
0,81,0.0898876404494382,0.28217821782178215,69887146,89,8
1,207,0.425,0.8829268292682927,82007142,360,153
2,27,0.5,0.9871794871794872,79792272,54,27
0,15,0.0,0.0,69526100,15,0
0,32,0.1111111111111111,0.4788732394366197,69526275,36,4
0,227,0.029914529914529916,0.08675263774912075,70250971,234,7
0,29,0.19444444444444445,0.424,70829465,36,7
1,113,0.32335329341317365,0.706081081081081,80176697,167,54
0,8,0.1111111111111111,0.3793103448275862,67466651,9,1
1,15,0.11764705882352941,0.5730337078651685,69525932,17,2
0,20,0.09090909090909091,0.3170731707317073,69525960,22,2
0,19,0.05,0.21739130434782608,69525981,20,1
2,25,0.7368421052631579,0.9861111111111112,80130693,95,70
1,31,0.2619047619047619,0.54,63286825,42,11
0,99,0.16806722689075632,0.22633744855967078,82116886,119,20
1,53,0.4175824175824176,0.8217821782178217,69047531,91,38
1,118,0.30994152046783624,0.5761589403973509,81933258,171,53
0,5,0.375,0.3333333333333333,65257073,8,3
2,2,0.9375,0.0,80132792,32,30
2,10,0.6428571428571429,0.8888888888888888,70717955,28,18
2,0,1.0,1.0,80081204,17,17
2,14,0.6744186046511628,0.0,68804694,43,29
1,69,0.3490566037735849,0.6312056737588653,79976722,106,37
1,176,0.42105263157894735,0.9453125,67911382,304,128
1,313,0.25653206650831356,0.5281767955801105,70686742,421,108
0,310,0.06060606060606061,0.043222003929273084,62940360,330,20
0,31,0.18421052631578946,0.41025641025641024,80128893,38,7
1,255,0.2755681818181818,0.696027633851468,80124651,352,97
0,8,0.1111111111111111,0.35135135135135137,80150016,9,1
2,21,0.6037735849056604,0.9117647058823529,70781746,53,32
0,10,0.2857142857142857,0.4782608695652174,73977974,14,4
0,305,0.14325842696629212,0.20919540229885059,69480824,356,51
0,33,0.13157894736842105,0.4418604651162791,67862830,38,5
0,163,0.06321839080459771,0.21656050955414013,70862463,174,11
1,63,0.29213483146067415,0.8023255813953488,64064763,89,26
0,6,0.0,0.0,67466770,6,0
0,25,0.07407407407407407,0.37962962962962965,80150787,27,2
1,89,0.32061068702290074,0.7510729613733905,82116880,131,42
0,76,0.2692307692307692,0.49222797927461137,82126654,104,28
1,150,0.2537313432835821,0.5097402597402597,67630682,201,51
0,83,0.1782178217821782,0.28488372093023256,69056764,101,18
0,80,0.25925925925925924,0.4878048780487805,70814394,108,28
0,297,0.11869436201780416,0.24473684210526317,82122250,337,40
2,3,0.8421052631578947,0.8,82037168,19,16
2,10,0.6153846153846154,0.6666666666666666,73102393,26,16
0,22,0.15384615384615385,0.14285714285714285,68112625,26,4
1,117,0.2909090909090909,0.6638888888888889,70638624,165,48
2,2,0.6,0.8888888888888888,80133924,5,3
0,2,0.0,0.0,80133932,2,0
1,96,0.14285714285714285,0.5138339920948617,80153518,112,16
2,1,0.5,0.8333333333333334,66785796,2,1
1,20,0.2,0.6486486486486487,80172595,25,5
2,15,0.5161290322580645,0.7916666666666666,73609655,31,16
1,103,0.1693548387096774,0.5261627906976745,78763356,124,21
1,22,0.12,0.6956521739130435,67434801,25,3
0,5,0.16666666666666666,0.15789473684210525,73650486,6,1
0,126,0.023255813953488372,0.013227513227513227,70001120,129,3
0,1,0.0,0.0,82102789,1,0
0,3,0.0,0.0,82102928,3,0
1,15,0.3181818181818182,0.8095238095238095,279426,22,7
0,63,0.015625,0.09090909090909091,66025925,64,1
0,154,0.06666666666666667,0.12222222222222222,64329055,165,11
0,75,0.0625,0.09649122807017543,69160483,80,5
1,36,0.4,0.9024390243902439,705572,60,24
1,101,0.4127906976744186,0.7480916030534351,80118327,172,71
1,256,0.12627986348122866,0.523590333716916,82049132,293,37
0,300,0.12536443148688048,0.3194444444444444,60312756,343,43
2,29,0.6588235294117647,0.9883720930232558,80081001,85,56
0,59,0.1323529411764706,0.4329896907216495,80135075,68,9
2,1,0.5,0.5,80135305,2,1
2,38,0.5632183908045977,0.9448818897637795,68745096,87,49
1,39,0.4507042253521127,0.9230769230769231,76512856,71,32
0,218,0.18045112781954886,0.34441805225653205,80176782,266,48
1,66,0.30526315789473685,0.6,69739194,95,29
1,14,0.4166666666666667,0.7586206896551724,62581260,24,10
0,317,0.13858695652173914,0.39478957915831664,66416756,368,51
0,61,0.1527777777777778,0.3939393939393939,68312265,72,11
1,333,0.23623853211009174,0.6716417910447762,70240730,436,103
0,91,0.061855670103092786,0.39487179487179486,70917273,97,6
0,4,0.0,0.0,82206094,4,0
0,6,0.14285714285714285,0.15789473684210525,69511855,7,1
0,131,0.02962962962962963,0.08641975308641975,62838930,135,4
0,5,0.0,0.0,66784613,5,0
0,7,0.125,0.3870967741935484,66786762,8,1
1,22,0.37142857142857144,0.6785714285714286,69729191,35,13
0,292,0.029900332225913623,0.10429447852760736,66876922,301,9
0,204,0.07272727272727272,0.3544520547945205,80128627,220,16
0,9,0.1,0.4722222222222222,82049137,10,1
0,39,0.23529411764705882,0.42342342342342343,69499073,51,12
0,2,0.0,0.0,70759276,2,0
0,16,0.058823529411764705,0.19642857142857142,69857662,17,1
1,174,0.275,0.6175115207373272,73514063,240,66
1,29,0.3409090909090909,0.752,80135267,44,15
1,181,0.1542056074766355,0.7151394422310757,69005986,214,33
1,211,0.15261044176706828,0.5403508771929825,63170296,249,38
0,24,0.14285714285714285,0.11538461538461539,66892364,28,4
1,84,0.3488372093023256,0.6818181818181818,80125424,129,45
1,442,0.22996515679442509,0.523225241016652,80116631,574,132
1,62,0.4095238095238095,0.8080808080808081,73410631,105,43
1,18,0.3793103448275862,0.8135593220338984,80125044,29,11
1,33,0.49230769230769234,0.8518518518518519,73941721,65,32
2,7,0.72,0.75,62884906,25,18
0,94,0.24193548387096775,0.49624060150375937,80027913,124,30
0,1,0.0,0.0,72539985,1,0
1,95,0.2692307692307692,0.6417322834645669,69608252,130,35
0,51,0.07272727272727272,0.32105263157894737,60541782,55,4
1,10,0.2857142857142857,0.68,65716203,14,4
1,73,0.37606837606837606,0.835820895522388,73400593,117,44
2,0,1.0,1.0,68286960,7,7
2,62,0.5571428571428572,0.9885714285714285,72561363,140,78
1,8,0.38461538461538464,0.65,75588723,13,5
0,309,0.0830860534124629,0.10204081632653061,54609870,337,28
0,436,0.035398230088495575,0.08579088471849866,64182734,452,16
0,55,0.12698412698412698,0.3456221198156682,82008938,63,8
1,38,0.3770491803278688,0.8776978417266187,65103381,61,23
2,67,0.5347222222222222,0.9244186046511628,80119163,144,77
0,48,0.15789473684210525,0.20512820512820512,82046914,57,9
2,38,0.6666666666666666,0.9705882352941176,82096255,114,76
0,25,0.10714285714285714,0.13793103448275862,70633206,28,3
1,27,0.4489795918367347,0.8831168831168831,70759661,49,22
2,6,0.6470588235294118,0.8888888888888888,70688142,17,11
0,78,0.037037037037037035,0.07818930041152264,70001092,81,3
0,139,0.08552631578947369,0.10874704491725769,80118393,152,13
1,88,0.2,0.6380090497737556,70629335,110,22
0,72,0.07692307692307693,0.18048780487804877,54417531,78,6
0,105,0.10256410256410256,0.17796610169491525,68312293,117,12
2,2,0.5,0.6666666666666666,80128458,4,2
0,63,0.07352941176470588,0.27419354838709675,61976796,68,5
0,6,0.14285714285714285,0.2857142857142857,64191876,7,1
2,21,0.7162162162162162,0.9444444444444444,72445695,74,53
0,280,0.1566265060240964,0.45422535211267606,72907870,332,52
1,159,0.19696969696969696,0.576271186440678,70190491,198,39
0,77,0.0375,0.1,67846331,80,3
0,7,0.0,0.0,70063924,7,0
0,18,0.14285714285714285,0.27906976744186046,70214263,21,3
0,18,0.05263157894736842,0.12658227848101267,70214270,19,1
1,37,0.4714285714285714,0.91875,72803143,70,33
0,59,0.11940298507462686,0.21052631578947367,72808512,67,8
0,51,0.13559322033898305,0.2796610169491525,72809212,59,8
2,18,0.5909090909090909,0.9545454545454546,82133037,44,26
0,50,0.12280701754385964,0.36134453781512604,80124267,57,7
0,87,0.011363636363636364,0.05421686746987952,80124283,88,1
1,102,0.28169014084507044,0.5734870317002881,70063840,142,40
0,137,0.08053691275167785,0.21405750798722045,80124265,149,12
2,24,0.6842105263157895,0.631578947368421,69406722,76,52
1,46,0.2459016393442623,0.5882352941176471,72801841,61,15
1,26,0.3333333333333333,0.6329113924050633,81978955,39,13
1,55,0.26666666666666666,0.5231788079470199,69165922,75,20
0,81,0.024096385542168676,0.01020408163265306,73245410,83,2
1,83,0.25225225225225223,0.5534883720930233,80129993,111,28
2,25,0.6875,0.9615384615384616,80137978,80,55
1,93,0.34965034965034963,0.7395833333333334,70206892,143,50
0,138,0.18823529411764706,0.3072289156626506,67627364,170,32
1,25,0.3902439024390244,0.7906976744186046,82009592,41,16
1,10,0.3333333333333333,0.7368421052631579,68042933,15,5
1,159,0.3375,0.7448979591836735,67706821,240,81
1,93,0.256,0.5263157894736842,82116861,125,32
0,207,0.19140625,0.38926174496644295,68497065,256,49
1,52,0.35,0.7931034482758621,70626262,80,28
1,63,0.3225806451612903,0.6747572815533981,82023508,93,30
0,183,0.17937219730941703,0.36936936936936937,67963175,223,40
0,73,0.16091954022988506,0.2247191011235955,82116837,87,14
0,66,0.18518518518518517,0.2761904761904762,72135322,81,15
1,41,0.2545454545454545,0.5925925925925926,66723594,55,14
1,107,0.24647887323943662,0.610223642172524,70207361,142,35
0,20,0.23076923076923078,0.41379310344827586,69632451,26,6
1,41,0.4533333333333333,0.9411764705882353,69997690,75,34
0,136,0.24861878453038674,0.4458874458874459,81967324,181,45
1,158,0.34710743801652894,0.8413173652694611,72270744,242,84
1,10,0.16666666666666666,0.6,65392810,12,2
1,99,0.1885245901639344,0.5040650406504065,68642301,122,23
0,102,0.1968503937007874,0.3829113924050633,68545344,127,25
0,33,0.10810810810810811,0.248,70746781,37,4
2,56,0.6646706586826348,0.9626168224299065,80083584,167,111
2,54,0.5,0.9071428571428571,81900939,108,54
2,2,0.5,0.9047619047619048,70063406,4,2
1,16,0.2727272727272727,0.5333333333333333,66604006,22,6
2,0,1.0,1.0,80137622,3,3
2,73,0.6178010471204188,0.6296296296296297,70121884,191,118
0,17,0.2608695652173913,0.25,66166912,23,6
1,17,0.39285714285714285,0.6923076923076923,66166926,28,11
1,148,0.45985401459854014,0.916955017301038,66412003,274,126
1,77,0.27358490566037735,0.6690909090909091,60989005,106,29
0,2,0.0,0.0,69185410,2,0
1,142,0.2604166666666667,0.6666666666666666,69421401,192,50
0,273,0.031914893617021274,0.01876172607879925,69509090,282,9
0,34,0.0,0.0,67279835,34,0
0,55,0.140625,0.152,67279842,64,9
0,76,0.11627906976744186,0.10683760683760683,82116845,86,10
1,38,0.2692307692307692,0.6470588235294118,82116849,52,14
0,117,0.21476510067114093,0.39385474860335196,82126756,149,32
1,137,0.31840796019900497,0.7323943661971831,69606705,201,64
0,71,0.2111111111111111,0.43457943925233644,70047691,90,19
1,230,0.3215339233038348,0.7952973720608575,68164124,339,109
0,38,0.15555555555555556,0.46357615894039733,69416046,45,7
0,24,0.04,0.009009009009009009,69417523,25,1
2,10,0.6774193548387096,0.9130434782608695,72425570,31,21
0,279,0.211864406779661,0.4951923076923077,80124669,354,75
1,16,0.4482758620689655,0.8518518518518519,70741531,29,13
0,36,0.02702702702702703,0.017094017094017096,70741601,37,1
0,26,0.16129032258064516,0.3333333333333333,70810831,31,5
0,365,0.12470023980815348,0.13918305597579425,65824150,417,52
1,199,0.26022304832713755,0.6062176165803109,68532954,269,70
0,154,0.08875739644970414,0.1705685618729097,54138854,169,15
0,206,0.10822510822510822,0.143646408839779,69625255,231,25
0,5,0.16666666666666666,0.23076923076923078,70646422,6,1
2,9,0.5,0.8709677419354839,68025202,18,9
0,287,0.20277777777777778,0.36103151862464183,67551673,360,73
1,22,0.45,0.9384615384615385,80172021,40,18
1,185,0.26877470355731226,0.5198019801980198,69180601,253,68
1,120,0.44954128440366975,0.9046052631578947,65810731,218,98
1,54,0.25,0.5611510791366906,64158731,72,18
0,313,0.19121447028423771,0.4303030303030303,67555180,387,74
1,28,0.4166666666666667,0.7391304347826086,70831985,48,20
2,6,0.5714285714285714,0.9583333333333334,82018862,14,8
1,41,0.3492063492063492,0.8125,68509616,63,22
1,79,0.27522935779816515,0.6008583690987125,69183142,109,30
1,174,0.29838709677419356,0.7320388349514563,70531706,248,74
1,251,0.33773087071240104,0.7510460251046025,539294,379,128
1,257,0.30913978494623656,0.7504187604690117,66931270,372,115
1,77,0.32456140350877194,0.6557377049180327,80126983,114,37
1,134,0.3853211009174312,0.8859060402684564,68530924,218,84
0,19,0.13636363636363635,0.15625,80128842,22,3
1,31,0.46551724137931033,0.9428571428571428,68401186,58,27
1,156,0.37349397590361444,0.7874015748031497,68401452,249,93
2,16,0.5897435897435898,0.9696969696969697,70545286,39,23
1,90,0.29133858267716534,0.6268656716417911,57042524,127,37
1,79,0.3130434782608696,0.7065217391304348,66856503,115,36
0,82,0.26785714285714285,0.43119266055045874,69700281,112,30
1,90,0.11764705882352941,0.5209003215434084,62850473,102,12
0,16,0.0,0.0,60232480,16,0
1,8,0.2727272727272727,0.8125,69596443,11,3
1,4,0.42857142857142855,0.6666666666666666,70253785,7,3
2,26,0.543859649122807,0.9836065573770492,80003672,57,31
1,73,0.27,0.6884057971014492,73983175,100,27
0,476,0.19185059422750425,0.3900789177001127,68541081,589,113
0,190,0.12442396313364056,0.16062176165803108,80053540,217,27
1,169,0.42517006802721086,0.8791946308724832,80118589,294,125
1,67,0.1728395061728395,0.5140845070422535,69390916,81,14
1,34,0.32,0.7037037037037037,70645113,50,16
0,27,0.1,0.4375,69395620,30,3
0,33,0.2826086956521739,0.375,668626,46,13
0,41,0.24074074074074073,0.32,8017884,54,13
2,23,0.6933333333333334,0.8928571428571429,80055381,75,52
0,24,0.25,0.3870967741935484,82142127,32,8
1,8,0.2,0.5,70674786,10,2
0,34,0.17073170731707318,0.4339622641509434,70692874,41,7
2,0,1.0,1.0,69483141,1,1
2,1,0.75,0.8,70704991,4,3
1,67,0.27956989247311825,0.573394495412844,70063441,93,26
1,293,0.2747524752475248,0.6578249336870027,70618534,404,111
0,5,0.16666666666666666,0.0,65614752,6,1
1,6,0.45454545454545453,0.8181818181818182,65642192,11,5
2,8,0.68,0.92,80122543,25,17
1,160,0.3548387096774194,0.7904040404040404,68393913,248,88
1,210,0.3712574850299401,0.8888888888888888,68393920,334,124
1,201,0.3044982698961938,0.6689814814814815,70719761,289,88
1,57,0.27848101265822783,0.6242774566473989,82116878,79,22
0,107,0.24113475177304963,0.4296875,82126619,141,34
1,2,0.3333333333333333,0.625,70415492,3,1
1,136,0.4380165289256198,0.8866666666666667,66412010,242,106
2,58,0.7339449541284404,0.981651376146789,80137971,218,160
0,74,0.10843373493975904,0.21739130434782608,80097465,83,9
0,188,0.12149532710280374,0.046632124352331605,67627350,214,26
2,25,0.7641509433962265,0.9818181818181818,69318130,106,81
1,104,0.3202614379084967,0.786096256684492,60892083,153,49
1,13,0.3157894736842105,0.5714285714285714,70631463,19,6
2,56,0.5757575757575758,0.6739130434782609,181076,132,76
1,30,0.2857142857142857,0.5,61366354,42,12
1,23,0.25806451612903225,0.6862745098039216,69234900,31,8
0,127,0.1360544217687075,0.13545816733067728,73524570,147,20
2,5,0.6153846153846154,0.95,80176852,13,8
0,59,0.06349206349206349,0.07692307692307693,80072216,63,4
0,69,0.014285714285714285,0.0125,80072230,70,1
1,23,0.3783783783783784,0.7027027027027027,66263456,37,14
0,2,0.0,0.0,70334831,2,0
2,4,0.6666666666666666,0.75,70761712,12,8
0,430,0.1617933723196881,0.36288848263254114,70638561,513,83
1,211,0.39886039886039887,0.9110169491525424,70659001,351,140
0,294,0.22015915119363394,0.44680851063829785,68545393,377,83
1,106,0.3575757575757576,0.7909836065573771,67841921,165,59
1,568,0.2810126582278481,0.7067961165048544,68530875,790,222
1,64,0.2967032967032967,0.7615384615384615,69180832,91,27
0,162,0.25,0.4604966139954853,65312310,216,54
1,354,0.23376623376623376,0.5770975056689343,80097696,462,108
1,178,0.3945578231292517,0.804,82023509,294,116
0,15,0.16666666666666666,0.23076923076923078,68021184,18,3
1,20,0.3939393939393939,0.8163265306122449,68616835,33,13
0,285,0.20391061452513967,0.4254807692307692,81979801,358,73
0,110,0.20863309352517986,0.2248062015503876,70808500,139,29
0,71,0.1744186046511628,0.19626168224299065,72426312,86,15
2,68,0.6263736263736264,0.9172413793103448,77318801,182,114
1,200,0.38080495356037153,0.7275541795665634,70780731,323,123
1,132,0.4185022026431718,0.7635135135135135,80090276,227,95
1,23,0.43902439024390244,0.75,68274955,41,18
1,230,0.3915343915343915,0.7402135231316725,69167483,378,148
2,71,0.5359477124183006,0.9439252336448598,82010889,153,82
0,142,0.1069182389937107,0.2119205298013245,68754630,159,17
0,8,0.0,0.0,70568064,8,0
0,60,0.01639344262295082,0.031055900621118012,70568316,61,1
2,2,0.75,0.9333333333333333,82013560,8,6
0,25,0.038461538461538464,0.22429906542056074,80124405,26,1
2,68,0.66,0.9951923076923077,80160472,200,132
1,83,0.36153846153846153,0.6518987341772152,80096345,130,47
1,83,0.26548672566371684,0.6333333333333333,74708970,113,30
0,64,0.14666666666666667,0.4646840148698885,64769425,75,11
0,20,0.16666666666666666,0.22727272727272727,67775260,24,4
1,34,0.24444444444444444,0.6724137931034483,77563913,45,11
0,49,0.19672131147540983,0.43902439024390244,82000120,61,12
1,42,0.34375,0.6597938144329897,70646681,64,22
0,166,0.248868778280543,0.46867749419953597,18696650,221,55
0,369,0.06818181818181818,0.18892045454545456,60028493,396,27
0,36,0.16279069767441862,0.4,69168351,43,7
1,61,0.25609756097560976,0.5721649484536082,67775372,82,21
1,30,0.3181818181818182,0.5942028985507246,70508662,44,14
2,14,0.5483870967741935,0.9210526315789473,70751156,31,17
1,158,0.3276595744680851,0.7384196185286104,80135082,235,77
1,4,0.3333333333333333,0.6666666666666666,70494746,6,2
1,248,0.30140845070422534,0.7064516129032258,81967282,355,107
0,67,0.0945945945945946,0.16756756756756758,72522975,74,7
1,63,0.25882352941176473,0.5978260869565217,66575992,85,22
0,32,0.030303030303030304,0.022727272727272728,73863972,33,1
0,99,0.1391304347826087,0.30735930735930733,60312252,115,16
0,222,0.14615384615384616,0.15916955017301038,70646184,260,38
1,76,0.2830188679245283,0.7153284671532847,80140050,106,30
0,3,0.25,0.4,70009674,4,1
0,78,0.22772277227722773,0.45726495726495725,73709153,101,23
2,22,0.6451612903225806,0.95,80155230,62,40
1,440,0.277504105090312,0.5902712815715622,74335772,609,169
0,117,0.13333333333333333,0.13013698630136986,70808514,135,18
0,66,0.043478260869565216,0.04054054054054054,82163303,69,3
0,73,0.20652173913043478,0.39644970414201186,68398134,92,19
2,68,0.615819209039548,0.99,82114244,177,109
2,17,0.6046511627906976,0.9,70781732,43,26
0,143,0.23529411764705882,0.45507246376811594,69108690,187,44
0,82,0.21904761904761905,0.34517766497461927,774382,105,23
1,48,0.25,0.5561797752808989,69971482,64,16
1,73,0.3865546218487395,0.8909952606635071,79816135,119,46
1,10,0.3333333333333333,0.6976744186046512,70843031,15,5
1,10,0.375,0.7083333333333334,72697961,16,6
2,65,0.59375,0.9425287356321839,73977183,160,95
1,11,0.45,0.84375,80118241,20,9
0,80,0.047619047619047616,0.06521739130434782,80135336,84,4
0,59,0.04838709677419355,0.044444444444444446,80117749,62,3
1,20,0.25925925925925924,0.640625,73977701,27,7
0,73,0.013513513513513514,0.02097902097902098,68743493,74,1
2,50,0.5901639344262295,0.9724770642201835,65217516,122,72
2,13,0.5666666666666667,0.967741935483871,82095526,30,17
1,33,0.36538461538461536,0.8666666666666667,66792474,52,19
0,38,0.19148936170212766,0.37168141592920356,80135056,47,9
1,160,0.23076923076923078,0.5476190476190477,70014672,208,48
1,61,0.4019607843137255,0.819047619047619,903595,102,41
1,31,0.41509433962264153,0.8545454545454545,80180252,53,22
1,30,0.375,0.8354430379746836,79792300,48,18
1,8,0.4666666666666667,0.9,79792615,15,7
0,95,0.10377358490566038,0.15104166666666666,68534011,106,11
2,7,0.75,0.9375,80137673,28,21
0,125,0.05303030303030303,0.03436426116838488,73113656,132,7
2,33,0.6206896551724138,0.8596491228070176,80153676,87,54
0,127,0.1476510067114094,0.1897810218978102,69165131,149,22
1,88,0.38028169014084506,0.8035714285714286,65865065,142,54
1,72,0.30097087378640774,0.6967741935483871,67555775,103,31
1,96,0.26717557251908397,0.5555555555555556,67066685,131,35
1,75,0.27884615384615385,0.6233766233766234,82116841,104,29
0,156,0.09302325581395349,0.19406392694063926,69416494,172,16
0,80,0.10112359550561797,0.22592592592592592,69417516,89,9
2,25,0.8201438848920863,0.9722222222222222,80125650,139,114
2,4,0.8888888888888888,0.8333333333333334,74047771,36,32
0,27,0.15625,0.21212121212121213,73634610,32,5
2,47,0.678082191780822,0.75,68171803,146,99
0,20,0.2,0.2564102564102564,68274990,25,5
0,166,0.1941747572815534,0.46855345911949686,73700564,206,40
1,177,0.36101083032490977,0.7924528301886793,68283131,277,100
2,38,0.5189873417721519,0.9655172413793104,73131184,79,41
0,78,0.20408163265306123,0.29914529914529914,82126648,98,20
1,42,0.288135593220339,0.5060240963855421,69418643,59,17
2,70,0.5454545454545454,0.9523809523809523,69697775,154,84
0,143,0.1437125748502994,0.22933333333333333,80114314,167,24
1,36,0.45454545454545453,0.9479166666666666,62507431,66,30
0,240,0.1044776119402985,0.38420107719928187,70908096,268,28
1,47,0.3088235294117647,0.8629032258064516,65400853,68,21
1,44,0.18518518518518517,0.6818181818181818,70917343,54,10
1,173,0.33204633204633205,0.814621409921671,74372900,259,86
0,62,0.046153846153846156,0.13089005235602094,70468244,65,3
0,69,0.2159090909090909,0.4715909090909091,80176719,88,19
1,22,0.21428571428571427,0.5614035087719298,64961645,28,6
1,39,0.4507042253521127,0.75,69589030,71,32
0,114,0.11627906976744186,0.1396103896103896,68648853,129,15
1,13,0.13333333333333333,0.5675675675675675,69638576,15,2
0,13,0.13333333333333333,0.24324324324324326,70468293,15,2
1,281,0.19943019943019943,0.5513361462728551,70121114,351,70
0,43,0.18867924528301888,0.38333333333333336,80176733,53,10
1,4,0.42857142857142855,0.7777777777777778,82205921,7,3
0,71,0.12345679012345678,0.2967032967032967,80165687,81,10
1,65,0.16666666666666666,0.5434782608695652,82150121,78,13
0,79,0.05952380952380952,0.1557377049180328,65131234,84,5
0,118,0.16312056737588654,0.427536231884058,64000853,141,23
1,339,0.24330357142857142,0.6721311475409836,69660374,448,109
0,199,0.05687203791469194,0.2616822429906542,70314622,211,12
0,143,0.027210884353741496,0.061633281972265024,65400734,147,4
0,34,0.02857142857142857,0.11061946902654868,74607001,35,1
0,103,0.1953125,0.2956989247311828,64917916,128,25
1,3,0.25,0.5,69152622,4,1
2,16,0.5294117647058824,0.8529411764705882,79976743,34,18
0,249,0.04961832061068702,0.2223463687150838,62839854,262,13
0,238,0.18493150684931506,0.3800277392510402,82039205,292,54
0,35,0.07894736842105263,0.29245283018867924,78762985,38,3
0,8,0.1111111111111111,0.45454545454545453,68756800,9,1
1,24,0.35135135135135137,0.8627450980392157,69152370,37,13
1,14,0.36363636363636365,0.8809523809523809,80149930,22,8
0,43,0.14,0.2602739726027397,80154131,50,7
0,189,0.055,0.2675438596491228,62834961,200,11
0,75,0.038461538461538464,0.17757009345794392,62840071,78,3
0,370,0.036458333333333336,0.10443864229765012,62841002,384,14
0,35,0.10256410256410256,0.319672131147541,69857795,39,4
1,37,0.1956521739130435,0.6585365853658537,70467201,46,9
1,55,0.1791044776119403,0.5518867924528302,80118428,67,12
0,76,0.012987012987012988,0.038461538461538464,82049114,77,1
0,425,0.14829659318637275,0.26216814159292035,70615454,499,74
0,278,0.23626373626373626,0.4250614250614251,67666221,364,86
0,184,0.14018691588785046,0.33045977011494254,70629412,214,30
0,148,0.1590909090909091,0.4811715481171548,74439890,176,28
1,44,0.13725490196078433,0.5296803652968036,70467362,51,7
1,7,0.3,0.7692307692307693,82206080,10,3
0,80,0.1836734693877551,0.3888888888888889,67160331,98,18
1,126,0.27167630057803466,0.5520231213872833,67557560,173,47
1,13,0.38095238095238093,0.958904109589041,67435816,21,8
0,3,0.0,0.0,82206048,3,0
0,38,0.09523809523809523,0.304,70468482,42,4
1,20,0.23076923076923078,0.6170212765957447,70629524,26,6
0,89,0.08247422680412371,0.17829457364341086,82150132,97,8
1,67,0.21176470588235294,0.5866666666666667,80118429,85,18
1,255,0.33070866141732286,0.8028169014084507,65289336,381,126
1,27,0.25,0.7258064516129032,68311495,36,9
0,15,0.16666666666666666,0.20408163265306123,68543545,18,3
2,10,0.5,0.9714285714285714,68942020,20,10
0,57,0.03389830508474576,0.25177304964539005,82134953,59,2
1,36,0.3684210526315789,0.905982905982906,65713494,57,21
0,116,0.17142857142857143,0.2536764705882353,77676333,140,24
1,120,0.24050632911392406,0.542319749216301,60906482,158,38
2,9,0.64,0.975609756097561,69404300,25,16
2,0,1.0,1.0,71878520,1,1
2,134,0.564935064935065,0.9829351535836177,66387762,308,174
0,8,0.2727272727272727,0.4594594594594595,73875991,11,3
0,171,0.1,0.2753623188405797,80124256,190,19
2,1,0.8888888888888888,0.5,69666730,9,8
1,95,0.2857142857142857,0.6580645161290323,70242585,133,38
0,262,0.10580204778156997,0.4708029197080292,80149829,293,31
0,29,0.17142857142857143,0.273972602739726,74708746,35,6
2,11,0.6944444444444444,0.972972972972973,82013629,36,25
0,10,0.16666666666666666,0.3684210526315789,66110254,12,2
1,4,0.2,0.5,66110583,5,1
0,12,0.2,0.3225806451612903,66110646,15,3
0,13,0.13333333333333333,0.35714285714285715,66110660,15,2
0,49,0.09259259259259259,0.3333333333333333,80149849,54,5
0,364,0.1689497716894977,0.2519893899204244,68533521,438,74
0,324,0.14285714285714285,0.13347921225382933,67307093,378,54
0,89,0.21929824561403508,0.26900584795321636,67307100,114,25
2,1,0.9090909090909091,0.5,66760505,11,10
0,45,0.0425531914893617,0.11290322580645161,80124315,47,2
0,282,0.12149532710280374,0.201980198019802,80176755,321,39
2,15,0.7,0.96,63883204,50,35
1,70,0.46153846153846156,0.8433734939759037,67214784,130,60
1,73,0.21505376344086022,0.569620253164557,80149449,93,20
1,61,0.34408602150537637,0.7466666666666667,70870366,93,32
0,290,0.1642651296829971,0.20243902439024392,80176759,347,57
1,21,0.3,0.6811594202898551,72844100,30,9
1,105,0.3092105263157895,0.7420494699646644,80071313,152,47
2,18,0.6,0.7391304347826086,82008294,45,27
0,37,0.05128205128205128,0.0,60439470,39,2
1,140,0.36936936936936937,0.861198738170347,68742170,222,82
1,41,0.3050847457627119,0.7058823529411765,77485534,59,18
1,112,0.2483221476510067,0.5137931034482759,80131287,149,37
2,1,0.8888888888888888,0.6666666666666666,80049921,9,8
1,49,0.3950617283950617,0.8229166666666666,80136902,81,32
1,419,0.30398671096345514,0.7763012181616833,68542635,602,183
0,7,0.2222222222222222,0.46808510638297873,72804025,9,2
1,74,0.26732673267326734,0.5229357798165137,82163480,101,27
1,78,0.3445378151260504,0.7802197802197802,82163481,119,41
1,91,0.4276729559748428,0.8950276243093923,93373,159,68
1,4,0.2,0.6875,70701225,5,1
1,4,0.2,0.5,70701596,5,1
0,9,0.0,0.0,70706853,9,0
1,106,0.3161290322580645,0.6270491803278688,69208216,155,49
2,3,0.5,0.9375,70843094,6,3
1,16,0.4666666666666667,0.9178082191780822,80145756,30,14
2,0,1.0,1.0,66792614,1,1
2,1,0.75,0.6666666666666666,75346985,4,3
2,11,0.8135593220338984,0.9411764705882353,70700546,59,48
0,49,0.125,0.15555555555555556,68294156,56,7
2,5,0.6153846153846154,0.8,80093573,13,8
2,35,0.527027027027027,0.9,80118344,74,39
1,180,0.3979933110367893,0.7644628099173554,68257875,299,119
1,213,0.31511254019292606,0.8,69421345,311,98
2,34,0.6344086021505376,0.921875,80178987,93,59
0,332,0.14652956298200515,0.20260492040520983,66931186,389,57
1,260,0.2676056338028169,0.6185410334346505,69160413,355,95
0,1,0.0,0.0,74961334,1,0
0,235,0.17253521126760563,0.13930348258706468,80126988,284,49
0,36,0.14285714285714285,0.12903225806451613,80126447,42,6
1,107,0.2913907284768212,0.6279863481228669,80120454,151,44
1,91,0.47398843930635837,0.861271676300578,73653405,173,82
0,155,0.143646408839779,0.29362880886426596,68018132,181,26
0,758,0.08232445520581114,0.08316633266533066,62047650,826,68
0,76,0.22448979591836735,0.359375,82116839,98,22
0,12,0.14285714285714285,0.16666666666666666,69992783,14,2
1,56,0.28205128205128205,0.7142857142857143,68546933,78,22
0,10,0.23076923076923078,0.4411764705882353,70509551,13,3
0,19,0.17391304347826086,0.18,65282000,23,4
0,3,0.0,0.0,69954353,3,0
1,73,0.27,0.5888888888888889,69056666,100,27
0,10,0.09090909090909091,0.07142857142857142,67282145,11,1
1,131,0.3791469194312796,0.8575949367088608,68432546,211,80
1,102,0.2714285714285714,0.5714285714285714,69974730,140,38
1,17,0.34615384615384615,0.6949152542372882,82126631,26,9
1,64,0.39622641509433965,0.8066666666666666,66050376,106,42
0,234,0.10687022900763359,0.15466666666666667,82039203,262,28
0,67,0.1518987341772152,0.15979381443298968,80121133,79,12
1,133,0.3755868544600939,0.8571428571428571,80130755,213,80
0,14,0.0,0.0,80135095,14,0
0,332,0.21513002364066194,0.41729323308270677,82108563,423,91
0,73,0.18888888888888888,0.3146853146853147,69481776,90,17
0,129,0.21341463414634146,0.42091152815013405,69084645,164,35
0,351,0.17798594847775176,0.2903629536921151,66931963,427,76
0,1,0.0,0.0,70494081,1,0
1,10,0.375,0.8,69180734,16,6
0,322,0.21271393643031786,0.4216691068814056,70609196,409,87
1,45,0.43037974683544306,0.9176470588235294,68668873,79,34
1,74,0.36752136752136755,0.8118279569892473,66856363,117,43
1,15,0.4642857142857143,0.8421052631578947,80119185,28,13
0,50,0.21875,0.4161073825503356,70761124,64,14
2,54,0.55,0.9586206896551724,70760193,120,66
0,88,0.08333333333333333,0.15441176470588236,70633500,96,8
0,244,0.14084507042253522,0.26126126126126126,68538533,284,40
1,50,0.23076923076923078,0.6,69058472,65,15
1,63,0.24096385542168675,0.503030303030303,69058493,83,20
0,19,0.36666666666666664,0.2222222222222222,67237751,30,11
1,29,0.48214285714285715,0.890625,77319123,56,27
1,62,0.31868131868131866,0.6046511627906976,82051895,91,29
2,1,0.8333333333333334,0.5,69172656,6,5
2,6,0.6470588235294118,0.96875,69412224,17,11
0,233,0.04897959183673469,0.10303030303030303,80124297,245,12
0,245,0.01606425702811245,0.020161290322580645,80124397,249,4
2,17,0.6304347826086957,0.8095238095238095,69957993,46,29
1,41,0.3492063492063492,0.6691729323308271,72417800,63,22
1,33,0.45,0.9364161849710982,70633990,60,27
1,50,0.4444444444444444,0.7833333333333333,67266220,90,40
0,41,0.14583333333333334,0.27710843373493976,80132938,48,7
0,30,0.0625,0.12903225806451613,80132940,32,2
2,6,0.8636363636363636,0.5,82120648,44,38
0,128,0.23809523809523808,0.4419642857142857,70645932,168,40
0,177,0.19545454545454546,0.39710144927536234,68539114,220,43
0,107,0.2620689655172414,0.4577114427860697,66887422,145,38
1,84,0.4246575342465753,0.9402985074626866,80108721,146,62
1,26,0.49019607843137253,0.948051948051948,68668845,51,25
0,17,0.15,0.24444444444444444,69417264,20,3
0,281,0.21508379888268156,0.401980198019802,66471202,358,77
2,41,0.6403508771929824,0.88,70660954,114,73
0,35,0.05405405405405406,0.37168141592920356,67872896,37,2
1,13,0.4090909090909091,0.7777777777777778,81997891,22,9
2,14,0.5757575757575758,0.8888888888888888,69129683,33,19
1,23,0.23333333333333334,0.59,66225152,30,7
0,31,0.08823529411764706,0.2,82019419,34,3
0,10,0.0,0.0,82019435,10,0
1,33,0.26666666666666666,0.5876288659793815,68534130,45,12
2,21,0.676923076923077,0.6818181818181818,62482210,65,44
0,6,0.25,0.0,70718823,8,2
0,21,0.2222222222222222,0.46511627906976744,67591552,27,6
1,113,0.3192771084337349,0.75,70277130,166,53
1,30,0.3617021276595745,0.7096774193548387,65286893,47,17
1,26,0.38095238095238093,0.819672131147541,65286942,42,16
0,130,0.2571428571428571,0.475,72170021,175,45
0,233,0.068,0.39831697054698456,62839273,250,17
1,9,0.35714285714285715,0.5294117647058824,81976887,14,5
2,71,0.5506329113924051,0.9662162162162162,60338474,158,87
1,21,0.43243243243243246,0.8958333333333334,62703452,37,16
0,67,0.1728395061728395,0.25365853658536586,70040831,81,14
2,43,0.5376344086021505,0.9347826086956522,80160402,93,50
0,336,0.18048780487804877,0.3603192702394527,70760564,410,74
2,4,0.7142857142857143,0.875,69205185,14,10
1,54,0.35714285714285715,0.7671232876712328,65267195,84,30
0,12,0.0,0.0,67887995,12,0
0,137,0.07432432432432433,0.267515923566879,76080935,148,11
0,43,0.06521739130434782,0.23357664233576642,69024382,46,3
1,33,0.08333333333333333,0.5329341317365269,69867980,36,3
0,48,0.07692307692307693,0.25806451612903225,80149839,52,4
0,260,0.23529411764705882,0.453781512605042,67551820,340,80
1,50,0.3055555555555556,0.7010309278350515,68191865,72,22
1,149,0.3521739130434783,0.6974169741697417,66272290,230,81
1,21,0.3225806451612903,0.8135593220338984,82124917,31,10
2,90,0.5161290322580645,0.9585253456221198,70911015,186,96
0,36,0.1,0.19696969696969696,73650423,40,4
1,7,0.36363636363636365,0.7142857142857143,67053763,11,4
0,62,0.16216216216216217,0.25443786982248523,63051891,74,12
0,27,0.06896551724137931,0.07462686567164178,63633633,29,2
1,244,0.2628398791540785,0.6870629370629371,63999005,331,87
0,66,0.1951219512195122,0.33544303797468356,66264226,82,16
0,316,0.07058823529411765,0.4050387596899225,62839336,340,24
0,232,0.04918032786885246,0.18170878459687123,68647166,244,12
0,31,0.16216216216216217,0.47619047619047616,69395543,37,6
0,233,0.02100840336134454,0.051094890510948905,68801173,238,5
1,115,0.31952662721893493,0.8375,63686140,169,54
1,34,0.45161290322580644,0.8455882352941176,82013627,62,28
1,387,0.2937956204379562,0.7523961661341853,68540080,548,161
1,87,0.33076923076923076,0.8592233009708737,80110583,130,43
0,338,0.03977272727272727,0.12754158964879853,80128644,352,14
0,205,0.13135593220338984,0.17268041237113402,68644982,236,31
0,131,0.12666666666666668,0.17543859649122806,70045241,150,19
0,92,0.21367521367521367,0.2736842105263158,73650864,117,25
1,39,0.36065573770491804,0.8584905660377359,80124654,61,22
2,10,0.5454545454545454,0.9393939393939394,69589261,22,12
2,16,0.7288135593220338,0.9714285714285714,80118889,59,43
1,139,0.24043715846994534,0.6018518518518519,70474642,183,44
1,103,0.44021739130434784,0.7908163265306123,66872141,184,81
1,169,0.3574144486692015,0.7736389684813754,80110121,263,94
0,13,0.1875,0.23529411764705882,69611444,16,3
1,39,0.3157894736842105,0.6756756756756757,69464934,57,18
0,99,0.208,0.4134078212290503,66892595,125,26
0,13,0.13333333333333333,0.3269230769230769,74436670,15,2
0,193,0.2217741935483871,0.48148148148148145,81979021,248,55
1,106,0.2980132450331126,0.6325088339222615,69183772,151,45
0,35,0.07894736842105263,0.2389937106918239,78165983,38,3
0,40,0.2727272727272727,0.3627450980392157,80108371,55,15
1,31,0.38,0.7733333333333333,68995486,50,19
0,18,0.14285714285714285,0.19117647058823528,67963210,21,3
0,39,0.0,0.0,67963224,39,0
1,2,0.3333333333333333,0.5,74436642,3,1
0,25,0.13793103448275862,0.32941176470588235,68499914,29,4
0,9,0.1,0.3333333333333333,75147982,10,1
1,82,0.20388349514563106,0.5208333333333334,66416434,103,21
0,28,0.125,0.25510204081632654,69478521,32,4
0,35,0.2391304347826087,0.38961038961038963,82018894,46,11
0,380,0.14027149321266968,0.4266917293233083,66344880,442,62
1,13,0.35,0.6590909090909091,60137525,20,7
0,107,0.15748031496062992,0.3221884498480243,69214222,127,20
2,1,0.6666666666666666,0.5,80176659,3,2
0,84,0.2,0.2916666666666667,73524703,105,21
0,6,0.0,0.0,70682675,6,0
0,22,0.12,0.4095238095238095,70694176,25,3
0,22,0.15384615384615385,0.4351851851851852,70694274,26,4
2,86,0.6779026217228464,0.9910313901345291,70073815,267,181
1,66,0.3944954128440367,0.5443037974683544,80176059,109,43
1,29,0.30952380952380953,0.8253968253968254,69632486,42,13
1,12,0.45454545454545453,0.96875,73421586,22,10
1,107,0.28187919463087246,0.6681818181818182,80070816,149,42
2,9,0.75,0.9772727272727273,69729744,36,27
2,5,0.5833333333333334,0.8571428571428571,80048024,12,7
1,12,0.4,0.8787878787878788,68996291,20,8
1,445,0.30250783699059564,0.6803760282021152,67995270,638,193
2,144,0.5247524752475248,0.9615384615384616,69388641,303,159
1,81,0.36220472440944884,0.9146341463414634,82126694,127,46
1,18,0.3793103448275862,0.6857142857142857,70051233,29,11
0,193,0.1572052401746725,0.22857142857142856,63098581,229,36
1,18,0.47058823529411764,0.9285714285714286,64975743,34,16
2,8,0.8431372549019608,0.8333333333333334,956844,51,43
0,21,0.08695652173913043,0.3333333333333333,63141246,23,2
1,82,0.3387096774193548,0.8152866242038217,69157403,124,42
0,275,0.11003236245954692,0.25303643724696356,300496,309,34
2,1,0.5,0.0,68338634,2,1
0,96,0.102803738317757,0.44274809160305345,69006693,107,11
0,147,0.1878453038674033,0.23170731707317074,80118957,181,34
2,14,0.6410256410256411,0.9782608695652174,65621696,39,25
0,25,0.0,0.0,70600005,25,0
0,139,0.007142857142857143,0.078125,70600271,140,1
1,23,0.4523809523809524,0.8809523809523809,69092646,42,19
2,3,0.7,0.8571428571428571,80135035,10,7
2,0,1.0,1.0,74363380,5,5
2,1,0.9444444444444444,0.8888888888888888,67822874,18,17
0,21,0.0,0.0,68499172,21,0
0,19,0.05,0.3548387096774194,68499445,20,1
1,21,0.16,0.5943396226415094,68500173,25,4
0,22,0.043478260869565216,0.26605504587155965,68500201,23,1
0,22,0.043478260869565216,0.29357798165137616,68500292,23,1
0,21,0.0,0.0,69479543,21,0
0,11,0.0,0.0,69479592,11,0
0,40,0.047619047619047616,0.27586206896551724,70229502,42,2
0,36,0.05263157894736842,0.3055555555555556,70229530,38,2
1,4,0.2,0.8918918918918919,82143726,5,1
2,4,0.5,0.875,74362211,8,4
2,14,0.5333333333333333,0.9411764705882353,80124822,30,16
1,30,0.47368421052631576,0.7450980392156863,70183036,57,27
1,46,0.3333333333333333,0.58,68317816,69,23
1,13,0.35,0.8979591836734694,75456661,20,7
0,79,0.13186813186813187,0.2119205298013245,68299756,91,12
2,10,0.6428571428571429,0.9811320754716981,80056501,28,18
0,153,0.1774193548387097,0.451685393258427,69725222,186,33
1,91,0.34057971014492755,0.6934306569343066,80156295,138,47
1,102,0.3333333333333333,0.7466666666666667,63766136,153,51
1,12,0.29411764705882354,0.9090909090909091,82152066,17,5
0,12,0.0,0.0,67846324,12,0
1,135,0.375,0.8812785388127854,70760914,216,81
1,166,0.24545454545454545,0.5181818181818182,66973172,220,54
0,47,0.16071428571428573,0.3153153153153153,63050834,56,9
1,73,0.4016393442622951,0.8859060402684564,66228512,122,49
2,27,0.5423728813559322,0.9111111111111111,70562401,59,32
0,168,0.24324324324324326,0.4435028248587571,81967307,222,54
2,0,1.0,1.0,69975332,5,5
0,39,0.07142857142857142,0.049586776859504134,73134852,42,3
0,72,0.23404255319148937,0.4797979797979798,70754901,94,22
1,47,0.21666666666666667,0.5169491525423728,67995613,60,13
1,116,0.366120218579235,0.8852459016393442,66264352,183,67
1,18,0.25,0.7333333333333333,82109296,24,6
0,32,0.1111111111111111,0.2677165354330709,82109297,36,4
1,63,0.45689655172413796,0.9397590361445783,62803181,116,53
0,87,0.20909090909090908,0.3672566371681416,76116313,110,23
1,195,0.3887147335423197,0.8514588859416445,63767795,319,124
0,55,0.03508771929824561,0.07053941908713693,63240436,57,2
0,156,0.21212121212121213,0.3646723646723647,82126759,198,42
0,17,0.0,0.0,77676851,17,0
2,9,0.6785714285714286,0.8181818181818182,62580700,28,19
0,167,0.18536585365853658,0.40437158469945356,67985981,205,38
1,238,0.2852852852852853,0.6180836707152496,70049294,333,95
0,234,0.06772908366533864,0.055401662049861494,70645386,251,17
0,87,0.22321428571428573,0.3939393939393939,80180213,112,25
1,200,0.46236559139784944,0.9092664092664092,63779996,372,172
1,35,0.2857142857142857,0.6595744680851063,67870642,49,14
0,39,0.11363636363636363,0.2556390977443609,68499564,44,5
0,59,0.15714285714285714,0.3275862068965517,68499641,70,11
0,45,0.16666666666666666,0.3783783783783784,68199684,54,9
0,49,0.10909090909090909,0.16,68199712,55,6
2,2,0.9130434782608695,0.8,80177431,23,21
1,153,0.2850467289719626,0.6970443349753694,70092876,214,61
1,126,0.27167630057803466,0.6244131455399061,70742504,173,47
1,79,0.31896551724137934,0.7338129496402878,73637746,116,37
0,18,0.05263157894736842,0.24468085106382978,68498353,19,1
0,40,0.06976744186046512,0.3270440251572327,68498514,43,3
1,30,0.3333333333333333,0.7948717948717948,69538665,45,15
1,142,0.3073170731707317,0.653968253968254,68432511,205,63
2,12,0.5714285714285714,0.8823529411764706,82039826,28,16
1,4,0.3333333333333333,0.6666666666666666,68352494,6,2
1,10,0.3333333333333333,0.8181818181818182,69572706,15,5
0,7,0.0,0.0,69958903,7,0
1,32,0.08571428571428572,0.5178571428571429,80124428,35,3
0,86,0.17307692307692307,0.25,66767694,104,18
2,19,0.5681818181818182,0.9855072463768116,73085544,44,25
1,31,0.20512820512820512,0.6095238095238096,64931034,39,8
2,8,0.7037037037037037,0.9583333333333334,80176259,27,19
2,1,0.6666666666666666,0.5,69546701,3,2
1,132,0.40540540540540543,0.9323076923076923,81980731,222,90
1,121,0.29651162790697677,0.6348684210526315,81967351,172,51
0,76,0.11627906976744186,0.26595744680851063,80097500,86,10
1,18,0.3793103448275862,0.7833333333333333,69418671,29,11
1,124,0.4205607476635514,0.6847826086956522,82008316,214,90
0,65,0.1095890410958904,0.06467661691542288,73200092,73,8
0,331,0.2460136674259681,0.48111658456486045,65984002,439,108
1,41,0.3387096774193548,0.7603305785123967,68531813,62,21
2,3,0.625,0.6,70231763,8,5
0,46,0.14814814814814814,0.19469026548672566,80135052,54,8
0,30,0.2857142857142857,0.13333333333333333,72186653,42,12
1,56,0.2911392405063291,0.6470588235294118,73588802,79,23
0,72,0.19101123595505617,0.4899328859060403,69391252,89,17
2,7,0.9156626506024096,0.9333333333333333,80055374,83,76
2,11,0.7755102040816326,0.9166666666666666,69708940,49,38
1,36,0.4626865671641791,0.9017857142857143,75048106,67,31
0,184,0.18584070796460178,0.19559228650137742,81956127,226,42
1,20,0.3333333333333333,0.7230769230769231,69706896,30,10
1,72,0.3739130434782609,0.9485294117647058,66536652,115,43
1,22,0.47619047619047616,0.9523809523809523,79838920,42,20
1,53,0.3614457831325301,0.7732558139534884,70925484,83,30
1,45,0.375,0.8444444444444444,70509355,72,27
0,68,0.02857142857142857,0.05084745762711865,80029040,70,2
1,72,0.3142857142857143,0.7725118483412322,68669062,105,33
0,45,0.21052631578947367,0.3783783783783784,66887380,57,12
1,23,0.4523809523809524,0.9310344827586207,82002224,42,19
1,48,0.30434782608695654,0.6375838926174496,70078316,69,21
0,164,0.2545454545454545,0.38953488372093026,75061056,220,56
0,10,0.0,0.0,80150481,10,0
0,9,0.0,0.0,80150482,9,0
2,27,0.7476635514018691,0.9230769230769231,8018766,107,80
0,34,0.1282051282051282,0.2222222222222222,80128559,39,5
0,9,0.25,0.18181818181818182,80128857,12,3
1,110,0.367816091954023,0.7983193277310925,80180005,174,64
0,64,0.13513513513513514,0.23404255319148937,61172076,74,10
0,48,0.15789473684210525,0.20588235294117646,68192446,57,9
1,49,0.3287671232876712,0.8571428571428571,76586083,73,24
0,253,0.16225165562913907,0.3111954459203036,70605486,302,49
0,163,0.13756613756613756,0.21912350597609562,68499606,189,26
0,28,0.034482758620689655,0.16071428571428573,69478325,29,1
1,12,0.2,0.5428571428571428,70230223,15,3
1,105,0.375,0.8625429553264605,81965833,168,63
1,26,0.35,0.8928571428571429,80125959,40,14
2,5,0.5454545454545454,0.7777777777777778,75588730,11,6
2,2,0.6,0.6666666666666666,70713734,5,3
2,2,0.7142857142857143,0.9090909090909091,70350623,7,5
0,107,0.0,0.0,64240365,107,0
0,157,0.048484848484848485,0.14285714285714285,67307394,165,8
0,112,0.24324324324324326,0.48249027237354086,80108014,148,36
0,113,0.0423728813559322,0.1442687747035573,62841170,118,5
1,43,0.29508196721311475,0.55,80051741,61,18
1,76,0.22448979591836735,0.7394636015325671,73842552,98,22
0,19,0.13636363636363635,0.11864406779661017,68021233,22,3
0,60,0.16666666666666666,0.25165562913907286,68530763,72,12
0,30,0.11764705882352941,0.19047619047619047,66015803,34,4
1,178,0.44891640866873067,0.9396135265700483,75293176,323,145
1,30,0.3023255813953488,0.5645161290322581,80176613,43,13
0,335,0.12073490813648294,0.1525,73637662,381,46
1,35,0.33962264150943394,0.7293233082706767,70063462,53,18
2,25,0.6428571428571429,0.9710144927536232,80129984,70,45
0,91,0.3208955223880597,0.379746835443038,80176067,134,43
1,5,0.16666666666666666,0.6666666666666666,69562871,6,1
0,5,0.0,0.0,73102386,5,0
1,53,0.45918367346938777,0.9186991869918699,66263526,98,45
0,352,0.15180722891566265,0.36027713625866054,63306313,415,63
1,59,0.2804878048780488,0.6212121212121212,66423035,82,23
1,237,0.2305194805194805,0.5467980295566502,66423882,308,71
1,30,0.23076923076923078,0.6910569105691057,65713571,39,9
1,215,0.29508196721311475,0.6361323155216285,67748961,305,90
1,75,0.34782608695652173,0.8644859813084113,80135822,115,40
0,116,0.2108843537414966,0.3507246376811594,70654570,147,31
0,64,0.2,0.41203703703703703,73668546,80,16
1,60,0.4444444444444444,0.9358974358974359,69333264,108,48
0,128,0.17419354838709677,0.20622568093385213,67627322,155,27
0,7,0.0,0.0,69703956,7,0
1,166,0.2350230414746544,0.6555023923444976,69204044,217,51
1,176,0.2845528455284553,0.6765432098765433,67555733,246,70
0,49,0.3,0.49038461538461536,79796871,70,21
1,8,0.3333333333333333,0.5,79796885,12,4
1,113,0.3430232558139535,0.7915407854984894,69949285,172,59
1,3,0.25,0.5652173913043478,69484380,4,1
2,4,0.6363636363636364,0.9230769230769231,80125253,11,7
0,65,0.08450704225352113,0.16393442622950818,66648274,71,6
2,17,0.5142857142857142,0.9375,70586005,35,18
0,92,0.14018691588785046,0.2958579881656805,70612444,107,15
1,23,0.3611111111111111,0.8117647058823529,72803395,36,13
1,80,0.2523364485981308,0.5371428571428571,70646191,107,27
1,65,0.2857142857142857,0.5797101449275363,69184472,91,26
0,54,0.03571428571428571,0.14652014652014653,62840484,56,2
1,20,0.23076923076923078,0.7894736842105263,70597793,26,6
1,45,0.375,0.8396946564885496,69180692,72,27
1,44,0.2903225806451613,0.5620437956204379,69184612,62,18
1,67,0.25555555555555554,0.531578947368421,70741832,90,23
0,68,0.15,0.18604651162790697,81956348,80,12
0,339,0.13076923076923078,0.19919246298788695,81999332,390,51
0,171,0.11855670103092783,0.375,70908243,194,23
0,215,0.0611353711790393,0.06970509383378017,517783,229,14
0,422,0.0387243735763098,0.12073073868149325,62836431,439,17
0,147,0.03289473684210526,0.08167330677290836,80128623,152,5
0,55,0.15384615384615385,0.3063063063063063,64318786,65,10
1,47,0.38961038961038963,0.7874015748031497,67117722,77,30
1,126,0.29213483146067415,0.7549668874172185,64002834,178,52
0,41,0.08888888888888889,0.33116883116883117,80149871,45,4
0,17,0.0,0.0,80149879,17,0
1,17,0.46875,0.8974358974358975,69944371,32,15
1,28,0.2,0.5038167938931297,82150096,35,7
0,100,0.02912621359223301,0.1452991452991453,82095489,103,3
1,97,0.24806201550387597,0.5241935483870968,80109645,129,32
1,362,0.41233766233766234,0.883745963401507,73000942,616,254
0,132,0.10810810810810811,0.34656084656084657,78763426,148,16
1,93,0.2734375,0.5551181102362205,67066706,128,35
0,151,0.19680851063829788,0.3424242424242424,80112270,188,37
1,46,0.3611111111111111,0.8961038961038961,69179600,72,26
1,19,0.32142857142857145,0.7741935483870968,69164382,28,9
2,1,0.9285714285714286,0.75,69501894,14,13
0,67,0.0,0.0,78762936,67,0
0,14,0.06666666666666667,0.2537313432835821,78762943,15,1
2,5,0.7222222222222222,0.75,63177646,18,13
1,43,0.36764705882352944,0.822429906542056,66264156,68,25
1,42,0.23636363636363636,0.5377358490566038,68628861,55,13
1,80,0.3548387096774194,0.7916666666666666,54467630,124,44
0,223,0.07851239669421488,0.11661807580174927,82000082,242,19
0,141,0.15060240963855423,0.3988919667590028,78763272,166,25
0,146,0.12048192771084337,0.4192634560906516,80128486,166,20
1,72,0.35135135135135137,0.82,66856622,111,39
1,79,0.34710743801652894,0.786096256684492,69177360,121,42
0,42,0.23636363636363636,0.4690265486725664,65425395,55,13
1,32,0.4576271186440678,0.9634146341463414,68311453,59,27
0,37,0.02631578947368421,0.102803738317757,78762964,38,1
0,34,0.05555555555555555,0.25252525252525254,78763006,36,2
0,35,0.2222222222222222,0.27941176470588236,70720902,45,10
1,18,0.25,0.5544554455445545,82002231,24,6
1,55,0.2465753424657534,0.5267175572519084,66973151,73,18
1,150,0.2857142857142857,0.5765027322404371,880096,210,60
2,125,0.5733788395904437,0.9624060150375939,70562366,293,168
2,0,1.0,1.0,80156340,3,3
1,55,0.367816091954023,0.8301886792452831,80152629,87,32
0,2,0.0,0.0,82250561,2,0
2,19,0.6724137931034483,0.9830508474576272,63810516,58,39
1,83,0.30833333333333335,0.8172043010752689,77676403,120,37
1,7,0.3,0.5625,69998152,10,3
1,72,0.3333333333333333,0.751219512195122,80111696,108,36
1,56,0.3,0.589041095890411,82018791,80,24
0,107,0.19548872180451127,0.46048109965635736,80121257,133,26
1,10,0.23076923076923078,0.5714285714285714,65752575,13,3
2,25,0.5833333333333334,0.8958333333333334,65288916,60,35
1,46,0.352112676056338,0.8556701030927835,80108924,71,25
2,100,0.6904024767801857,0.9669811320754716,80181914,323,223
2,15,0.53125,0.47368421052631576,82113192,32,17
0,6,0.14285714285714285,0.3076923076923077,82002250,7,1
2,18,0.55,0.9555555555555556,70812875,40,22
0,89,0.23275862068965517,0.49746192893401014,67552401,116,27
2,0,1.0,1.0,70762713,11,11
0,158,0.18974358974358974,0.3373134328358209,69157865,195,37
1,60,0.40594059405940597,0.8920863309352518,80110156,101,41
1,10,0.47368421052631576,0.9615384615384616,74046042,19,9
2,1,0.8,0.8571428571428571,80145456,5,4
1,89,0.3153846153846154,0.7446153846153846,81971184,130,41
0,2,0.0,0.0,67383960,2,0
0,1,0.0,0.0,58865275,1,0
1,43,0.4342105263157895,0.8762886597938144,67127725,76,33
0,332,0.16791979949874686,0.27105666156202146,63681604,399,67
1,55,0.35294117647058826,0.8305084745762712,67789064,85,30
1,79,0.3524590163934426,0.7261146496815286,68400591,122,43
1,22,0.3125,0.5952380952380952,68401956,32,10
0,84,0.2631578947368421,0.4852941176470588,69183156,114,30
1,75,0.27884615384615385,0.6878612716763006,67514111,104,29
0,630,0.1509433962264151,0.288135593220339,69106814,742,112
1,30,0.4642857142857143,0.8333333333333334,63767620,56,26
1,15,0.21052631578947367,0.5319148936170213,70802935,19,4
1,102,0.43646408839779005,0.9385964912280702,82019415,181,79
2,41,0.5638297872340425,0.9878048780487805,69635146,94,53
2,20,0.7101449275362319,0.9629629629629629,62809054,69,49
2,92,0.5157894736842106,0.8793103448275862,70183022,190,98
2,9,0.9217391304347826,0.9166666666666666,65068682,115,106
0,69,0.17857142857142858,0.41148325358851673,70527464,84,15
0,280,0.13846153846153847,0.42350332594235035,63766542,325,45
1,69,0.448,0.9203980099502488,73490473,125,56
0,13,0.07142857142857142,0.1282051282051282,67364255,14,1
1,121,0.35978835978835977,0.8486842105263158,69177402,189,68
0,66,0.175,0.2897727272727273,72817262,80,14
1,47,0.3472222222222222,0.7878787878787878,68785255,72,25
2,18,0.6785714285714286,0.9866666666666667,72417856,56,38
0,114,0.27388535031847133,0.42696629213483145,78118033,157,43
0,148,0.08074534161490683,0.11704834605597965,64221941,161,13
0,190,0.20502092050209206,0.4547069271758437,72368954,239,49
1,140,0.36936936936936937,0.7258687258687259,66271870,222,82
1,71,0.3486238532110092,0.6402877697841727,66271954,109,38
1,148,0.23316062176165803,0.5257270693512305,80154009,193,45
0,135,0.16666666666666666,0.2712765957446808,69962193,162,27
0,57,0.14925373134328357,0.3485714285714286,80176481,67,10
0,97,0.25384615384615383,0.47257383966244726,69176961,130,33
1,24,0.42857142857142855,0.8571428571428571,70063553,42,18
0,3,0.0,0.0,70412496,3,0
1,104,0.49019607843137253,0.9438202247191011,68241390,204,100
1,2,0.3333333333333333,0.6666666666666666,70566713,3,1
1,22,0.3888888888888889,0.7446808510638298,66267152,36,14
1,95,0.3790849673202614,0.7583333333333333,67871475,153,58
0,42,0.08695652173913043,0.37681159420289856,82150098,46,4
1,5,0.2857142857142857,0.7,69597521,7,2
0,419,0.17193675889328064,0.3647342995169082,70618261,506,87
1,27,0.34146341463414637,0.8028169014084507,67591636,41,14
1,146,0.28431372549019607,0.6846846846846847,80121087,204,58
0,194,0.16017316017316016,0.18231046931407943,80118951,231,37
2,10,0.5454545454545454,0.8214285714285714,69733300,22,12
2,47,0.591304347826087,0.9,70710101,115,68
1,10,0.2857142857142857,0.5945945945945946,82102382,14,4
0,37,0.05128205128205128,0.1774193548387097,80124217,39,2
0,35,0.125,0.3482142857142857,80122847,40,5
0,38,0.11627906976744186,0.22608695652173913,80122851,43,5
2,14,0.65,0.7619047619047619,67237863,40,26
1,44,0.42857142857142855,0.9010989010989011,77231595,77,33
1,60,0.3023255813953488,0.7303370786516854,82126692,86,26
0,53,0.05357142857142857,0.04838709677419355,67279870,56,3
0,39,0.25,0.4946236559139785,67279940,52,13
0,225,0.15730337078651685,0.41100917431192663,61585482,267,42
1,17,0.34615384615384615,0.6341463414634146,69180265,26,9
1,179,0.31679389312977096,0.7239583333333334,70612752,262,83
1,279,0.3025,0.6923076923076923,63445732,400,121
1,34,0.2765957446808511,0.54,69606845,47,13
1,16,0.30434782608695654,0.9,80137527,23,7
0,320,0.06705539358600583,0.2417910447761194,61704174,343,23
2,37,0.5647058823529412,0.8627450980392157,976955,85,48
0,28,0.15151515151515152,0.34328358208955223,78763223,33,5
1,51,0.203125,0.8095238095238095,80137529,64,13
1,63,0.3076923076923077,0.8302752293577982,82124923,91,28
1,27,0.3076923076923077,0.6825396825396826,82126754,39,12
2,42,0.6146788990825688,0.9741379310344828,70395374,109,67
1,81,0.24299065420560748,0.5613207547169812,82116840,107,26
0,147,0.18333333333333332,0.486404833836858,80135160,180,33
0,56,0.16417910447761194,0.24324324324324326,82126670,67,11
1,82,0.24770642201834864,0.6035502958579881,66383205,109,27
1,4,0.42857142857142855,0.6666666666666666,63580706,7,3
2,36,0.7534246575342466,0.8596491228070176,65511110,146,110
1,18,0.4857142857142857,0.6666666666666666,66848502,35,17
2,49,0.608,0.9122807017543859,80137961,125,76
1,60,0.375,0.6818181818181818,80180201,96,36
2,70,0.5205479452054794,0.9518072289156626,70700574,146,76
0,18,0.21739130434782608,0.0,80132356,23,5
2,4,0.8518518518518519,0.75,80178955,27,23
0,51,0.05555555555555555,0.1111111111111111,80124167,54,3
2,36,0.5662650602409639,0.9111111111111111,80156749,83,47
0,32,0.1794871794871795,0.4838709677419355,80128280,39,7
1,21,0.36363636363636365,0.6964285714285714,80062416,33,12
0,76,0.14606741573033707,0.3463687150837989,80128277,89,13
0,44,0.08333333333333333,0.24475524475524477,80154114,48,4
1,212,0.41597796143250687,0.8574380165289256,73975034,363,151
2,95,0.5226130653266332,0.9508196721311475,80127936,199,104
2,71,0.5988700564971752,0.9752066115702479,80127979,177,106
0,203,0.19444444444444445,0.36981757877280264,82124921,252,49
0,83,0.13541666666666666,0.28363636363636363,80140165,96,13
1,130,0.2655367231638418,0.6724137931034483,80121140,177,47
1,37,0.24489795918367346,0.5842696629213483,82213158,49,12
0,118,0.08527131782945736,0.23098591549295774,80128311,129,11
0,103,0.02830188679245283,0.02197802197802198,82012536,106,3
0,163,0.22009569377990432,0.4404432132963989,81966304,209,46
1,39,0.35,0.7,69390734,60,21
1,101,0.38414634146341464,0.819047619047619,71288602,164,63
0,26,0.0,0.0,82003717,26,0
0,24,0.0,0.0,82003722,24,0
2,1,0.5,0.5,79648926,2,1
2,12,0.6,0.9032258064516129,69575800,30,18
1,93,0.489010989010989,0.7394957983193278,66281033,182,89
0,7,0.0,0.0,66916283,7,0
2,0,1.0,1.0,69971006,4,4
0,50,0.10714285714285714,0.46774193548387094,64984962,56,6
0,134,0.12987012987012986,0.2620967741935484,69106835,154,20
0,114,0.06557377049180328,0.19480519480519481,69107031,122,8
0,67,0.20238095238095238,0.3111111111111111,69056274,84,17
1,226,0.36338028169014086,0.8022727272727272,62804182,355,129
0,101,0.07339449541284404,0.09502262443438914,63769685,109,8
0,121,0.12318840579710146,0.15819209039548024,70742112,138,17
0,76,0.17391304347826086,0.2923076923076923,70488341,92,16
0,59,0.16901408450704225,0.4759036144578313,80180484,71,12
1,115,0.27672955974842767,0.6101190476190477,80181595,159,44
2,25,0.5283018867924528,0.9655172413793104,273910,53,28
1,111,0.30625,0.6296296296296297,67982166,160,49
1,102,0.39285714285714285,0.7918088737201365,69700274,168,66
2,0,1.0,1.0,66228295,2,2
0,7,0.4166666666666667,0.42857142857142855,68352536,12,5
0,3,0.0,0.0,68474476,3,0
2,23,0.5576923076923077,0.5,75576410,52,29
0,29,0.32558139534883723,0.25,75577166,43,14
0,33,0.23255813953488372,0.4166666666666667,80125056,43,10
1,20,0.3333333333333333,0.7058823529411765,73411905,30,10
0,211,0.1059322033898305,0.07692307692307693,80181294,236,25
0,158,0.17708333333333334,0.34782608695652173,70645400,192,34
0,224,0.07818930041152264,0.12379110251450677,80121261,243,19
1,188,0.3974358974358974,0.8868894601542416,69636980,312,124
0,76,0.17391304347826086,0.25196850393700787,70646205,92,16
1,40,0.3939393939393939,0.9514563106796117,69180454,66,26
2,10,0.6428571428571429,0.9795918367346939,69044703,28,18
1,35,0.33962264150943394,0.7352941176470589,80180474,53,18
0,36,0.14285714285714285,0.2868217054263566,82011817,42,6
0,75,0.08536585365853659,0.46545454545454545,62836711,82,7
1,37,0.27450980392156865,0.5454545454545454,80152630,51,14
0,232,0.2611464968152866,0.47393364928909953,80136839,314,82
1,182,0.3953488372093023,0.8602739726027397,80055311,301,119
1,57,0.18571428571428572,0.5064102564102564,80121130,70,13
1,115,0.31547619047619047,0.7225609756097561,82053048,168,53
2,34,0.728,0.9512195121951219,70121870,125,91
0,69,0.041666666666666664,0.10160427807486631,80124301,72,3
1,86,0.19626168224299065,0.5283018867924528,80141446,107,21
1,38,0.3448275862068966,0.759493670886076,67672822,58,20
1,97,0.2421875,0.609271523178808,82011840,128,31
0,28,0.2222222222222222,0.43037974683544306,68532646,36,8
0,13,0.07142857142857142,0.047619047619047616,69596646,14,1
1,22,0.21428571428571427,0.6790123456790124,70212303,28,6
1,120,0.4594594594594595,0.9391634980988594,70585963,222,102
1,33,0.4107142857142857,0.9130434782608695,67026792,56,23
0,68,0.1282051282051282,0.10843373493975904,82009752,78,10
1,8,0.4666666666666667,0.8823529411764706,68401592,15,7
1,66,0.13157894736842105,0.5111111111111111,62850494,76,10
0,76,0.19148936170212766,0.49282296650717705,72522996,94,18
2,90,0.6311475409836066,0.9881889763779528,68290985,244,154
1,102,0.43956043956043955,0.9047619047619048,73610173,182,80
1,26,0.38095238095238093,0.890625,67789134,42,16
1,65,0.29347826086956524,0.6387096774193548,65018394,92,27
1,32,0.37254901960784315,0.8333333333333334,70913122,51,19
1,68,0.2,0.6575342465753424,65250913,85,17
1,56,0.25333333333333335,0.5454545454545454,66133186,75,19
0,142,0.18857142857142858,0.23433242506811988,70686833,175,33
2,29,0.6704545454545454,0.9354838709677419,66848474,88,59
2,2,0.75,0.8,69904772,8,6
1,91,0.3157894736842105,0.7464114832535885,70005950,133,42
0,141,0.013986013986013986,0.0196078431372549,62840645,143,2
0,57,0.12307692307692308,0.2765957446808511,73914372,65,8
1,44,0.16981132075471697,0.689873417721519,69160945,53,9
0,3,0.0,0.0,70927605,3,0
0,68,0.22727272727272727,0.43646408839779005,68772445,88,20
1,71,0.4409448818897638,0.9765258215962441,69024606,127,56
0,48,0.07692307692307693,0.267515923566879,69659961,52,4
0,77,0.09411764705882353,0.24285714285714285,82008952,85,8
1,117,0.2777777777777778,0.6256684491978609,80121096,162,45
1,105,0.21052631578947367,0.5090439276485789,63281813,133,28
0,83,0.011904761904761904,0.011461318051575931,62840596,84,1
1,235,0.3543956043956044,0.7783505154639175,67203682,364,129
0,138,0.09210526315789473,0.3018867924528302,82008944,152,14
0,36,0.14285714285714285,0.2391304347826087,68546821,42,6
1,12,0.2,0.5,70037583,15,3
0,57,0.16176470588235295,0.43790849673202614,67730054,68,11
2,149,0.5284810126582279,0.952076677316294,72315005,316,167
1,16,0.2727272727272727,0.6590909090909091,69622091,22,6
0,115,0.21768707482993196,0.44329896907216493,70045332,147,32
1,10,0.3333333333333333,0.7714285714285715,69582912,15,5
1,15,0.21052631578947367,0.65625,67889325,19,4
0,25,0.2857142857142857,0.46511627906976744,70645743,35,10
1,17,0.32,0.6904761904761905,70645820,25,8
1,115,0.3465909090909091,0.8079470198675497,81980733,176,61
0,29,0.09375,0.1282051282051282,66201471,32,3
1,4,0.42857142857142855,0.9230769230769231,80001796,7,3
1,109,0.2635135135135135,0.623574144486692,68733462,148,39
1,6,0.3333333333333333,0.625,62358562,9,3
1,70,0.2391304347826087,0.6767676767676768,80154130,92,22
0,62,0.1506849315068493,0.23809523809523808,71081192,73,11
0,49,0.125,0.1893939393939394,71081206,56,7
2,18,0.6896551724137931,0.9459459459459459,72818732,58,40
1,5,0.4444444444444444,0.9230769230769231,65290533,9,4
0,26,0.16129032258064516,0.4375,80181668,31,5
1,43,0.2711864406779661,0.6666666666666666,65913645,59,16
1,70,0.3269230769230769,0.6744186046511628,66614135,104,34
2,28,0.7477477477477478,0.9733333333333334,70399336,111,83
0,20,0.25925925925925924,0.4,70494683,27,7
0,135,0.04929577464788732,0.11926605504587157,67887260,142,7
0,60,0.047619047619047616,0.05555555555555555,67889311,63,3
1,96,0.13513513513513514,0.5101351351351351,80149828,111,15
0,340,0.1122715404699739,0.09472049689440994,70614852,383,43
1,172,0.2146118721461187,0.5136986301369864,68541760,219,47
1,16,0.30434782608695654,0.6842105263157895,65290190,23,7
0,364,0.1689497716894977,0.3306693306693307,72522681,438,74
0,136,0.09933774834437085,0.188,66087504,151,15
1,11,0.45,0.8421052631578947,63766794,20,9
2,48,0.6190476190476191,0.9781021897810219,75048232,126,78
1,108,0.3032258064516129,0.6107142857142858,80135320,155,47
1,7,0.36363636363636365,0.7575757575757576,70062986,11,4
2,2,0.8181818181818182,0.6666666666666666,72804620,11,9
2,5,0.7619047619047619,0.8947368421052632,79792601,21,16
1,18,0.4375,0.9139784946236559,81971187,32,14
1,17,0.34615384615384615,0.684931506849315,80145875,26,9
1,128,0.38164251207729466,0.8379120879120879,67213923,207,79
1,50,0.35064935064935066,0.861878453038674,80176482,77,27
1,43,0.3484848484848485,0.7007299270072993,74564595,66,23
2,136,0.5436241610738255,0.9818731117824774,80127463,298,162
1,70,0.3269230769230769,0.6923076923076923,81956139,104,34
1,47,0.4891304347826087,0.9416666666666667,71388051,92,45
1,48,0.2835820895522388,0.7514792899408284,80121248,67,19
0,199,0.12719298245614036,0.13043478260869565,66767645,228,29
1,132,0.40540540540540543,0.9270833333333334,69166006,222,90
2,9,0.71875,0.96,73226503,32,23
0,28,0.2631578947368421,0.4444444444444444,82126731,38,10
1,145,0.24870466321243523,0.5180412371134021,70617953,193,48
0,2,0.3333333333333333,0.3333333333333333,80133926,3,1
1,371,0.2725490196078431,0.6466380543633763,70641522,510,139
2,99,0.5025125628140703,0.9419795221843004,70925680,199,100
0,44,0.0,0.0,82152135,44,0
0,50,0.0,0.0,82152149,50,0
1,9,0.4,0.8541666666666666,80113523,15,6
1,193,0.2798507462686567,0.5401459854014599,80180278,268,75
0,104,0.1111111111111111,0.12544802867383512,80119328,117,13
1,11,0.47619047619047616,0.9423076923076923,69154022,21,10
1,80,0.27927927927927926,0.6452991452991453,65307431,111,31
1,328,0.24249422632794457,0.5736434108527132,66931935,433,105
1,126,0.27586206896551724,0.6425,70562100,174,48
2,26,0.5094339622641509,0.7741935483870968,69575835,53,27
1,47,0.27692307692307694,0.704,63051695,65,18
2,1,0.75,0.6666666666666666,68746692,4,3
2,6,0.6470588235294118,0.9166666666666666,80149479,17,11
1,124,0.27485380116959063,0.6781002638522428,70061082,171,47
1,18,0.4375,0.8108108108108109,81976039,32,14
1,68,0.3584905660377358,0.702247191011236,82002263,106,38
0,4,0.3333333333333333,0.26666666666666666,82002276,6,2
1,124,0.4608695652173913,0.9182879377431906,72321956,230,106
2,5,0.5833333333333334,0.4,69172565,12,7
0,89,0.22608695652173913,0.48056537102473496,70649733,115,26
1,33,0.15384615384615385,0.5772357723577236,82050487,39,6
0,65,0.1875,0.2457627118644068,69482112,80,15
0,3,0.0,0.0,67836881,3,0
0,184,0.1598173515981735,0.3411016949152542,69207523,219,35
0,34,0.10526315789473684,0.3300970873786408,70646723,38,4
1,13,0.3157894736842105,0.6470588235294118,80165868,19,6
0,256,0.14666666666666667,0.19662921348314608,68741134,300,44
0,35,0.10256410256410256,0.2671232876712329,67812521,39,4
1,36,0.2653061224489796,0.7448979591836735,68311474,49,13
0,128,0.2,0.3333333333333333,78439221,160,32
1,80,0.3548387096774194,0.7783505154639175,82126718,124,44
2,6,0.6842105263157895,0.9166666666666666,80181926,19,13
0,145,0.14705882352941177,0.291196388261851,69416662,170,25
1,20,0.3333333333333333,0.8409090909090909,80156752,30,10
1,69,0.28865979381443296,0.6528925619834711,68531834,97,28
0,205,0.07657657657657657,0.07003891050583658,72522835,222,17
0,150,0.23857868020304568,0.46943765281173594,82126765,197,47
1,331,0.41415929203539825,0.8607809847198642,81989151,565,234
2,2,0.875,0.8571428571428571,69205122,16,14
0,8,0.2,0.4883720930232558,70494592,10,2
0,107,0.02727272727272727,0.07707509881422925,62840323,110,3
0,11,0.0,0.0,62840400,11,0
0,5,0.16666666666666666,0.2,82023224,6,1
0,12,0.2,0.15151515151515152,80045581,15,3
0,134,0.028985507246376812,0.07625649913344887,64984500,138,4
1,76,0.3153153153153153,0.7736842105263158,80055164,111,35
0,323,0.11263736263736264,0.1654275092936803,73906063,364,41
1,15,0.34782608695652173,0.7735849056603774,70063014,23,8
1,93,0.3716216216216216,0.7256637168141593,70120491,148,55
1,42,0.34375,0.7456140350877193,72802814,64,22
0,32,0.058823529411764705,0.16326530612244897,72808834,34,2
0,11,0.0,0.0,72809296,11,0
2,17,0.8045977011494253,0.984251968503937,79990141,87,70
0,34,0.20930232558139536,0.3958333333333333,70209503,43,9
2,1,0.6666666666666666,0.6666666666666666,68746993,3,2
1,17,0.19047619047619047,0.631578947368421,60081700,21,4
0,31,0.11428571428571428,0.14166666666666666,73709251,35,4
1,22,0.3333333333333333,0.625,68401914,33,11
1,47,0.4125,0.7435897435897436,68040392,80,33
2,22,0.5416666666666666,0.9,72805194,48,26
1,35,0.2391304347826087,0.6,69391091,46,11
1,29,0.2564102564102564,0.6944444444444444,69391126,39,10
0,6,0.14285714285714285,0.23809523809523808,80163133,7,1
0,8,0.1111111111111111,0.02631578947368421,82018779,9,1
1,3,0.4,0.75,69611465,5,2
2,1,0.5,0.6,67066923,2,1
2,12,0.8481012658227848,0.96875,80126532,79,67
1,6,0.25,0.6,82019977,8,2
2,19,0.6415094339622641,0.9791666666666666,75120962,53,34
1,47,0.3472222222222222,0.8137254901960784,62498072,72,25
1,246,0.38957816377171217,0.874439461883408,80180355,403,157
1,60,0.22077922077922077,0.6,70228914,77,17
0,54,0.11475409836065574,0.23626373626373626,75283474,61,7
1,73,0.416,0.9411764705882353,65289021,125,52
1,89,0.35507246376811596,0.8578431372549019,80120455,138,49
2,26,0.5094339622641509,0.9411764705882353,80137742,53,27
0,366,0.17194570135746606,0.31746031746031744,72523206,442,76
0,289,0.16954022988505746,0.32054176072234764,68543230,348,59
1,31,0.41509433962264153,0.7647058823529411,80171785,53,22
0,61,0.14084507042253522,0.25625,80097255,71,10
1,10,0.3333333333333333,0.5625,70566706,15,5
1,88,0.3125,0.5952380952380952,66272122,128,40
1,56,0.2911392405063291,0.6339869281045751,64918273,79,23
1,15,0.375,0.6666666666666666,73549840,24,9
1,30,0.4,0.8783783783783784,81971181,50,20
1,85,0.24778761061946902,0.5555555555555556,72390955,113,28
0,75,0.038461538461538464,0.059602649006622516,72392845,78,3
0,150,0.18032786885245902,0.30337078651685395,66892574,183,33
1,136,0.34299516908212563,0.8083333333333333,80135829,207,71
0,15,0.11764705882352941,0.05714285714285714,69191612,17,2
2,7,0.6666666666666666,0.875,80019373,21,14
0,70,0.13580246913580246,0.13402061855670103,67136846,81,11
1,116,0.2054794520547945,0.5866666666666667,80125024,146,30
2,112,0.51931330472103,0.9553903345724907,80125551,233,121
0,10,0.16666666666666666,0.36363636363636365,67872623,12,2
2,103,0.5795918367346938,0.9484536082474226,81979609,245,142
0,36,0.1,0.3230769230769231,82137477,40,4
0,38,0.19148936170212766,0.32142857142857145,66264905,47,9
1,80,0.26605504587155965,0.5988372093023255,80135269,109,29
1,108,0.23404255319148937,0.550561797752809,63051681,141,33
1,27,0.37209302325581395,0.8448275862068966,82050068,43,16
0,78,0.1875,0.4444444444444444,70745731,96,18
1,82,0.28695652173913044,0.7391304347826086,73399011,115,33
1,31,0.45614035087719296,0.9078947368421053,62143774,57,26
2,3,0.8,0.75,69172740,15,12
2,5,0.5833333333333334,0.7857142857142857,69172761,12,7
2,10,0.6153846153846154,0.9285714285714286,80137886,26,16
0,47,0.16071428571428573,0.17647058823529413,57175531,56,9
0,51,0.13559322033898305,0.1322314049586777,68398155,59,8
0,4,0.0,0.0,69546666,4,0
1,154,0.3185840707964602,0.6354166666666666,803761,226,72
1,60,0.4827586206896552,0.9008264462809917,68040294,116,56
1,88,0.3669064748201439,0.8809523809523809,69176856,139,51
1,2,0.3333333333333333,0.75,82002290,3,1
2,0,1.0,1.0,68286890,9,9
1,64,0.2727272727272727,0.5096153846153846,70879641,88,24
1,79,0.21782178217821782,0.5283018867924528,66087056,101,22
0,47,0.24193548387096775,0.34328358208955223,70818881,62,15
1,254,0.3759213759213759,0.8690036900369004,82126641,407,153
2,28,0.5,0.9278350515463918,70757043,56,28
1,25,0.4186046511627907,0.8983050847457628,69179705,43,18
1,108,0.32919254658385094,0.754325259515571,69622301,161,53
0,226,0.08502024291497975,0.08130081300813008,70641690,247,21
1,61,0.47413793103448276,0.8496732026143791,82009603,116,55
2,51,0.6046511627906976,0.9262295081967213,80175641,129,78
1,73,0.3302752293577982,0.6236559139784946,70485716,109,36
2,15,0.53125,0.95,72802506,32,17
0,194,0.015228426395939087,0.01675977653631285,80124302,197,3
0,110,0.017857142857142856,0.026200873362445413,80124377,112,2
1,26,0.4090909090909091,0.8958333333333334,80053841,44,18
1,70,0.27835051546391754,0.6217948717948718,69154701,97,27
0,29,0.21621621621621623,0.2911392405063291,65280026,37,8
1,10,0.47368421052631576,0.875,65288853,19,9
1,14,0.2631578947368421,0.6744186046511628,80133449,19,5
1,5,0.2857142857142857,0.6190476190476191,65278780,7,2
0,20,0.2,0.25,65289112,25,5
2,19,0.6481481481481481,0.9183673469387755,80137977,54,35
0,9,0.18181818181818182,0.25,65286473,11,2
1,13,0.2777777777777778,0.75,65286480,18,5
1,24,0.38461538461538464,0.9344262295081968,65286466,39,15
0,30,0.16666666666666666,0.2222222222222222,65286515,36,6
1,27,0.2894736842105263,0.569620253164557,65289294,38,11
1,8,0.4666666666666667,0.84,72774681,15,7
1,38,0.3333333333333333,0.6195652173913043,70591822,57,19
1,25,0.32432432432432434,0.7625,65288503,37,12
1,23,0.46511627906976744,0.9186046511627907,80175647,43,20
1,4,0.42857142857142855,0.8888888888888888,71388030,7,3
1,30,0.3181818181818182,0.6078431372549019,70690585,44,14
2,10,0.6,0.95,70120813,25,15
2,78,0.5517241379310345,0.9661016949152542,70121506,174,96
0,41,0.16326530612244897,0.3333333333333333,80135051,49,8
2,5,0.5454545454545454,0.4444444444444444,70406161,11,6
2,64,0.6577540106951871,0.8352941176470589,70855554,187,123
0,153,0.1404494382022472,0.41379310344827586,70649180,178,25
1,29,0.30952380952380953,0.6811594202898551,82170150,42,13
0,311,0.0220125786163522,0.026246719160104987,70081270,318,7
1,16,0.23809523809523808,0.5555555555555556,67625992,21,5
0,103,0.1953125,0.45864661654135336,69534535,128,25
1,175,0.38380281690140844,0.8407494145199064,81965834,284,109
1,44,0.46987951807228917,0.8888888888888888,80061555,83,39
1,96,0.3191489361702128,0.745928338762215,80124774,141,45
1,9,0.25,0.5576923076923077,69416641,12,3
1,65,0.336734693877551,0.8019323671497585,72382345,98,33
1,61,0.32222222222222224,0.7100591715976331,67285484,90,29
1,46,0.4457831325301205,0.9411764705882353,80118918,83,37
0,138,0.08609271523178808,0.05136986301369863,62793045,151,13
0,120,0.21052631578947367,0.39076923076923076,70659022,152,32
0,15,0.0625,0.04878048780487805,65288713,16,1
1,29,0.43137254901960786,0.8679245283018868,66412164,51,22
1,12,0.45454545454545453,0.9523809523809523,67591580,22,10
1,48,0.30434782608695654,0.6260162601626016,82126803,69,21
1,79,0.30701754385964913,0.7675438596491229,75892803,114,35
1,22,0.26666666666666666,0.515625,80176686,30,8
1,34,0.37037037037037035,0.8582089552238806,73034073,54,20
0,156,0.07142857142857142,0.09176029962546817,81979814,168,12
0,18,0.18181818181818182,0.42857142857142855,69633935,22,4
2,10,0.5833333333333334,0.9696969696969697,80127342,24,14
1,37,0.24489795918367346,0.6532258064516129,68642161,49,12
0,99,0.04807692307692308,0.2,66876670,104,5
1,165,0.3067226890756303,0.7030878859857482,81967273,238,73
1,183,0.3146067415730337,0.6960227272727273,80108525,267,84
0,180,0.1262135922330097,0.2345679012345679,67747260,206,26
1,79,0.45517241379310347,0.952755905511811,66264051,145,66
1,236,0.2976190476190476,0.6880165289256198,67557161,336,100
1,76,0.22448979591836735,0.8225806451612904,66359055,98,22
2,66,0.5822784810126582,0.9505494505494505,12634406,158,92
0,83,0.1941747572815534,0.46601941747572817,80176703,103,20
0,134,0.22093023255813954,0.4956268221574344,68642455,172,38
1,45,0.3181818181818182,0.7142857142857143,80109995,66,21
2,76,0.6996047430830039,0.9465648854961832,67646880,253,177
0,65,0.13333333333333333,0.3316582914572864,73007214,75,10
1,19,0.42424242424242425,0.6571428571428571,69483330,33,14
2,16,0.5555555555555556,0.8666666666666667,69483631,36,20
1,49,0.35526315789473684,0.8632478632478633,80108896,76,27
1,36,0.34545454545454546,0.7446808510638298,67841242,55,19
2,6,0.6470588235294118,0.8888888888888888,80149514,17,11
1,17,0.34615384615384615,0.84375,70814415,26,9
1,93,0.34965034965034963,0.7711267605633803,65838906,143,50
0,42,0.20754716981132076,0.32989690721649484,70957082,53,11
1,98,0.3875,0.8615384615384616,68531561,160,62
0,71,0.19318181818181818,0.27835051546391754,80125040,88,17
2,1,0.5,0.5,70115220,2,1
0,72,0.1111111111111111,0.11851851851851852,80172878,81,9
0,223,0.2440677966101695,0.3424657534246575,80132316,295,72
0,19,0.20833333333333334,0.10526315789473684,72187542,24,5
1,63,0.34375,0.7433628318584071,70649614,96,33
1,91,0.3157894736842105,0.585,80180253,133,42
1,80,0.23809523809523808,0.5848214285714286,82129383,105,25
0,20,0.13043478260869565,0.2727272727272727,67802532,23,3
2,2,0.5,0.5714285714285714,68401200,4,2
0,15,0.21052631578947367,0.37037037037037035,69058535,19,4
1,211,0.3884057971014493,0.7406143344709898,72433592,345,134
1,24,0.2727272727272727,0.7435897435897436,80135072,33,9
2,0,1.0,1.0,66156881,2,2
0,4,0.3333333333333333,0.16666666666666666,67890795,6,2
1,57,0.4672897196261682,0.9470198675496688,68440981,107,50
1,144,0.2835820895522388,0.5695364238410596,63689654,201,57
0,161,0.06936416184971098,0.1660377358490566,72417464,173,12
0,10,0.0,0.0,70675122,10,0
0,16,0.0,0.0,70703115,16,0
0,13,0.07142857142857142,0.11764705882352941,72910166,14,1
0,12,0.0,0.0,80126749,12,0
2,3,0.85,0.9,77581546,20,17
1,18,0.3793103448275862,0.71875,68426295,29,11
0,24,0.1111111111111111,0.05454545454545454,69588225,27,3
0,4,0.0,0.0,69143291,4,0
2,1,0.5,0.75,69143424,2,1
0,81,0.047058823529411764,0.28426395939086296,62840204,85,4
1,37,0.13953488372093023,0.5080645161290323,62530496,43,6
1,33,0.10810810810810811,0.5375,63781956,37,4
0,27,0.03571428571428571,0.08602150537634409,63781963,28,1
1,40,0.3103448275862069,0.717391304347826,69086052,58,18
0,34,0.17073170731707318,0.42105263157894735,60536805,41,7
1,113,0.2981366459627329,0.7058823529411765,80110282,161,48
0,5,0.0,0.0,67095091,5,0
0,6,0.0,0.0,67095126,6,0
1,5,0.16666666666666666,0.5348837209302325,67095133,6,1
0,1,0.0,0.0,68521866,1,0
1,304,0.2567237163814181,0.5791925465838509,68645066,409,105
1,130,0.3333333333333333,0.7472527472527473,68210870,195,65
0,121,0.07633587786259542,0.3551912568306011,63529550,131,10
1,13,0.4090909090909091,0.7575757575757576,69634285,22,9
0,6,0.0,0.0,67094503,6,0
0,5,0.0,0.0,67094552,5,0
0,19,0.0,0.0,68522034,19,0
1,51,0.41379310344827586,0.9384615384615385,67082652,87,36
1,39,0.2777777777777778,0.5684210526315789,80108392,54,15
1,6,0.45454545454545453,0.9,80055115,11,5
0,236,0.1945392491467577,0.494949494949495,63812091,293,57
0,163,0.2048780487804878,0.4039301310043668,69723941,205,42
1,107,0.2620689655172414,0.5734265734265734,74709005,145,38
0,84,0.21495327102803738,0.47342995169082125,80159751,107,23
2,4,0.6666666666666666,0.972972972972973,80137359,12,8
1,13,0.2777777777777778,0.696969696969697,69417586,18,5
1,55,0.27631578947368424,0.5979381443298969,74289852,76,21
1,41,0.3787878787878788,0.9302325581395349,82145542,66,25
0,129,0.14,0.1826086956521739,68318103,150,21
0,165,0.011976047904191617,0.0018181818181818182,70001435,167,2
1,170,0.30327868852459017,0.6886075949367089,82126636,244,74
1,40,0.3333333333333333,0.7545454545454545,68386640,60,20
1,19,0.4722222222222222,0.9074074074074074,79792342,36,17
2,26,0.6623376623376623,0.9444444444444444,80178988,77,51
1,83,0.43537414965986393,0.8266666666666667,64357594,147,64
1,93,0.34965034965034963,0.7994186046511628,68218521,143,50
0,130,0.051094890510948905,0.19683257918552036,65713165,137,7
1,39,0.3389830508474576,0.717391304347826,82004787,59,20
0,16,0.15789473684210525,0.13793103448275862,62141800,19,3
0,128,0.2289156626506024,0.3924914675767918,70174223,166,38
0,37,0.13953488372093023,0.08888888888888889,69183940,43,6
0,58,0.07936507936507936,0.06369426751592357,69186362,63,5
0,301,0.09337349397590361,0.04773869346733668,69032754,332,31
2,12,0.5862068965517241,0.9459459459459459,80175662,29,17
0,43,0.21818181818181817,0.3283582089552239,82126802,55,12
1,131,0.3247422680412371,0.6962025316455697,70241381,194,63
1,62,0.37373737373737376,0.8125,80176677,99,37
1,328,0.2885032537960954,0.5745062836624776,80176779,461,133
1,48,0.26153846153846155,0.6141732283464567,67554102,65,17
1,71,0.30392156862745096,0.6628571428571428,69702955,102,31
0,443,0.12966601178781925,0.16333333333333333,80130378,509,66
1,30,0.3877551020408163,0.8969072164948454,69165173,49,19
1,153,0.3598326359832636,0.8327402135231317,81967258,239,86
0,260,0.061371841155234655,0.06636155606407322,63757484,277,17
1,19,0.2692307692307692,0.7777777777777778,69416186,26,7
0,13,0.0,0.0,80128804,13,0
1,263,0.3168831168831169,0.8,66423420,385,122
1,121,0.11678832116788321,0.5301455301455301,80128648,137,16
1,11,0.21428571428571427,0.52,80128900,14,3
1,125,0.2469879518072289,0.6797900262467191,65287551,166,41
0,50,0.16666666666666666,0.27044025157232704,68497226,60,10
1,65,0.3157894736842105,0.6024844720496895,67555922,95,30
0,27,0.12903225806451613,0.2976190476190476,82103914,31,4
0,16,0.058823529411764705,0.07692307692307693,82103916,17,1
0,72,0.2087912087912088,0.37572254335260113,67557245,91,19
1,86,0.2833333333333333,0.7339901477832512,69603716,120,34
1,121,0.25766871165644173,0.6792452830188679,82042896,163,42
1,58,0.32558139534883723,0.8129032258064516,80128588,86,28
0,67,0.014705882352941176,0.016778523489932886,67868654,68,1
1,8,0.4666666666666667,0.84375,79792391,15,7
0,62,0.1388888888888889,0.25405405405405407,82040803,72,10
1,30,0.4230769230769231,0.7878787878787878,69047510,52,22
1,34,0.37037037037037035,0.6470588235294118,80037405,54,20
0,1,0.0,0.0,82015857,1,0
2,9,0.71875,0.9736842105263158,82145109,32,23
2,0,1.0,1.0,80139969,5,5
2,42,0.5882352941176471,0.9787234042553191,72315453,102,60
0,36,0.12195121951219512,0.27884615384615385,70680372,41,5
1,72,0.3394495412844037,0.8024691358024691,65617230,109,37
0,101,0.06481481481481481,0.386411889596603,62835094,108,7
0,32,0.1111111111111111,0.11688311688311688,68497205,36,4
1,15,0.34782608695652173,0.8048780487804879,70605696,23,8
0,1,0.0,0.0,80163693,1,0
1,100,0.35064935064935066,0.6790123456790124,66263603,154,54
0,70,0.0410958904109589,0.13227513227513227,80124235,73,3
0,136,0.10526315789473684,0.20224719101123595,80124266,152,16
2,23,0.5106382978723404,0.8681318681318682,72801344,47,24
0,39,0.11363636363636363,0.2441860465116279,70242760,44,5
0,6,0.14285714285714285,0.3333333333333333,80163669,7,1
0,50,0.07407407407407407,0.1297709923664122,68628525,54,4
0,195,0.21686746987951808,0.4236453201970443,70646506,249,54
0,63,0.11267605633802817,0.14012738853503184,82152759,71,8
0,125,0.09420289855072464,0.29874213836477986,80149877,138,13
1,12,0.3333333333333333,0.6666666666666666,67627063,18,6
1,5,0.2857142857142857,0.6956521739130435,66651613,7,2
1,17,0.34615384615384615,0.6842105263157895,80126040,26,9
0,77,0.08333333333333333,0.13389121338912133,69415815,84,7
0,61,0.2077922077922078,0.25862068965517243,63213192,77,16
0,95,0.42771084337349397,0.45652173913043476,68187105,166,71
2,50,0.6124031007751938,0.9705882352941176,73588830,129,79
0,10,0.16666666666666666,0.2127659574468085,82126775,12,2
1,78,0.3709677419354839,0.8439306358381503,82126712,124,46
2,19,0.703125,0.9818181818181818,69229594,64,45
1,56,0.2328767123287671,0.5722543352601156,73644193,73,17
2,27,0.5178571428571429,0.7884615384615384,70867272,56,29
1,507,0.22358346094946402,0.5324459234608985,75459013,653,146
1,9,0.4,0.9047619047619048,70175693,15,6
2,9,0.5,0.8888888888888888,70843885,18,9
0,90,0.14285714285714285,0.2768361581920904,66110261,105,15
0,96,0.13513513513513514,0.2087912087912088,66110674,111,15
0,89,0.09183673469387756,0.12560386473429952,66110695,98,9
1,30,0.21052631578947367,0.5604395604395604,66110751,38,8
0,56,0.15151515151515152,0.3135593220338983,66110884,66,10
0,20,0.0,0.0,69640823,20,0
0,100,0.24812030075187969,0.4855072463768116,68995423,133,33
1,80,0.43661971830985913,0.8716216216216216,68040301,142,62
2,81,0.509090909090909,0.9320388349514563,80155529,165,84
0,25,0.038461538461538464,0.0,70320173,26,1
0,7,0.2222222222222222,0.17857142857142858,80181512,9,2
1,72,0.35714285714285715,0.7577319587628866,67307072,112,40
2,12,0.6666666666666666,0.95,70720251,36,24
1,53,0.28378378378378377,0.6618357487922706,70623784,74,21
2,0,1.0,1.0,80145766,3,3
1,65,0.38095238095238093,0.8559322033898306,69579503,105,40
0,251,0.215625,0.3287671232876712,67263665,320,69
0,92,0.17857142857142858,0.47619047619047616,74725224,112,20
0,71,0.1839080459770115,0.24324324324324326,70719733,87,16
0,105,0.20454545454545456,0.3153526970954357,67556433,132,27
1,88,0.2786885245901639,0.6169154228855721,68741260,122,34
1,200,0.3197278911564626,0.7662835249042146,81976698,294,94
1,11,0.35294117647058826,0.5333333333333333,75552281,17,6
0,109,0.12096774193548387,0.08108108108108109,80141428,124,15
1,42,0.35384615384615387,0.8561643835616438,76695773,65,23
1,61,0.37755102040816324,0.7352941176470589,80180961,98,37
0,68,0.15,0.3630952380952381,65971696,80,12
2,30,0.5652173913043478,0.9411764705882353,70713370,69,39
1,44,0.26666666666666666,0.6850393700787402,73099222,60,16
0,265,0.046762589928057555,0.19283065512978986,64183532,278,13
2,0,1.0,1.0,74089351,2,2
2,33,0.5074626865671642,0.82,65008230,67,34
0,70,0.11392405063291139,0.40331491712707185,80124369,79,9
0,91,0.14150943396226415,0.4226190476190476,80124174,106,15
0,53,0.1016949152542373,0.1895424836601307,70678643,59,6
0,21,0.0,0.0,80126800,21,0
0,6,0.4,0.4666666666666667,72778475,10,4
1,16,0.4666666666666667,0.7777777777777778,69733335,30,14
1,11,0.21428571428571427,0.6,70675290,14,3
0,41,0.16326530612244897,0.33076923076923076,70682906,49,8
0,13,0.23529411764705882,0.4230769230769231,68401683,17,4
1,122,0.24691358024691357,0.6287878787878788,82054694,162,40
1,33,0.36538461538461536,0.625,80158091,52,19
0,46,0.22033898305084745,0.47058823529411764,82126613,59,13
1,196,0.23137254901960785,0.509469696969697,71358735,255,59
2,67,0.7728813559322034,0.9899497487437185,80127882,295,228
1,98,0.3422818791946309,0.7392996108949417,70585921,149,51
0,82,0.046511627906976744,0.12437810945273632,80124330,86,4
0,89,0.07291666666666667,0.27053140096618356,80124415,96,7
2,10,0.6,0.8888888888888888,68423684,25,15
0,90,0.07216494845360824,0.27102803738317754,72766064,97,7
0,135,0.03571428571428571,0.10408921933085502,72768731,140,5
1,41,0.4142857142857143,0.967479674796748,80133420,70,29
2,20,0.5121951219512195,0.868421052631579,80126535,41,21
1,21,0.34375,0.7450980392156863,69691433,32,11
0,96,0.102803738317757,0.15873015873015872,63141953,107,11
0,44,0.15384615384615385,0.0547945205479452,66613876,52,8
0,17,0.15,0.2857142857142857,68642175,20,3
2,15,0.5454545454545454,0.8947368421052632,80175669,33,18
0,109,0.14173228346456693,0.41198501872659177,69416333,127,18
0,161,0.18686868686868688,0.349862258953168,80180226,198,37
1,111,0.2974683544303797,0.6526946107784432,69974751,158,47
1,23,0.43902439024390244,0.8125,80163139,41,18
1,12,0.45454545454545453,0.8974358974358975,80163710,22,10
2,42,0.5280898876404494,0.9732142857142857,82037504,89,47
1,56,0.36363636363636365,0.7923076923076923,68393892,88,32
2,14,0.7021276595744681,0.9444444444444444,72846746,47,33
2,11,0.8533333333333334,0.96,80145894,75,64
1,39,0.38095238095238093,0.8652482269503546,69466565,63,24
0,12,0.0,0.0,70224406,12,0
0,5,0.0,0.0,70697963,5,0
0,14,0.125,0.4835164835164835,68500446,16,2
1,7,0.4166666666666667,0.9166666666666666,69478353,12,5
2,11,0.6451612903225806,0.96875,80122936,31,20
0,2,0.0,0.0,68352473,2,0
2,2,0.6,0.6666666666666666,70189280,5,3
0,5,0.0,0.0,82019975,5,0
1,48,0.12727272727272726,0.5205479452054794,80124368,55,7
0,45,0.11764705882352941,0.19696969696969696,69416802,51,6
1,137,0.4627450980392157,0.9518900343642611,66838646,255,118
0,97,0.039603960396039604,0.1751054852320675,62840232,101,4
1,11,0.45,0.9459459459459459,65293053,20,9
1,107,0.2620689655172414,0.6648501362397821,80103506,145,38
0,50,0.038461538461538464,0.06,70081284,52,2
2,10,0.6296296296296297,0.8518518518518519,80132795,27,17
2,0,1.0,1.0,67923912,1,1
2,12,0.8421052631578947,0.918918918918919,82020037,76,64
1,82,0.22641509433962265,0.5358649789029536,72523360,106,24
1,43,0.4691358024691358,0.9139784946236559,67130924,81,38
1,207,0.49014778325123154,0.8839779005524862,70121611,406,199
1,71,0.2828282828282828,0.5753424657534246,81956124,99,28
1,20,0.23076923076923078,0.6585365853658537,70184842,26,6
2,7,0.5,0.9523809523809523,68400675,14,7
0,49,0.30985915492957744,0.49504950495049505,68400906,71,22
1,45,0.375,0.7976190476190477,63259084,72,27
2,1,0.8888888888888888,0.5,70750820,9,8
1,43,0.39436619718309857,0.85,69024256,71,28
2,8,0.5789473684210527,0.75,80018631,19,11
2,21,0.7,0.9878048780487805,82018849,70,49
1,59,0.3058823529411765,0.6853146853146853,69183492,85,26
2,1,0.6666666666666666,0.5,70669333,3,2
0,42,0.17647058823529413,0.43448275862068964,80124659,51,9
1,9,0.4,0.5,69666814,15,6
0,5,0.0,0.0,54607350,5,0
1,164,0.42857142857142855,0.9147540983606557,80180356,287,123
2,7,0.7741935483870968,0.875,74043515,31,24
0,3,0.0,0.0,70940331,3,0
1,7,0.36363636363636365,0.8421052631578947,64195355,11,4
1,59,0.2976190476190476,0.7870967741935484,79520154,84,25
0,4,0.2,0.16666666666666666,67208421,5,1
0,130,0.057971014492753624,0.28772635814889336,68798282,138,8
2,21,0.5531914893617021,0.9482758620689655,73993010,47,26
2,27,0.5909090909090909,0.9855072463768116,79788380,66,39
0,49,0.2222222222222222,0.3230769230769231,82163477,63,14
1,9,0.18181818181818182,0.5483870967741935,66009986,11,2
0,59,0.21333333333333335,0.3368421052631579,80128846,75,16
0,370,0.0773067331670823,0.08472686733556299,80097311,401,31
1,11,0.3125,0.6071428571428571,67665402,16,5
0,51,0.07272727272727272,0.0660377358490566,82095681,55,4
0,139,0.1419753086419753,0.2023121387283237,68497121,162,23
1,144,0.3394495412844037,0.7702265372168284,69693036,218,74
1,240,0.13978494623655913,0.5681159420289855,72556344,279,39
1,176,0.2757201646090535,0.6514522821576764,73226454,243,67
1,161,0.29694323144104806,0.729490022172949,73298911,229,68
2,0,1.0,1.0,79788583,10,10
2,68,0.5496688741721855,0.9714285714285714,69170052,151,83
2,4,0.6363636363636364,0.875,82023683,11,7
0,39,0.11363636363636363,0.4864864864864865,72157071,44,5
2,0,1.0,1.0,80081211,4,4
0,31,0.08823529411764706,0.20512820512820512,70703675,34,3
2,6,0.7272727272727273,0.875,69708856,22,16
1,84,0.3,0.65,74688845,120,36
2,15,0.7368421052631579,0.975,69202574,57,42
0,253,0.11538461538461539,0.1408695652173913,80122394,286,33
0,102,0.08928571428571429,0.36964980544747084,61976880,112,10
1,153,0.3677685950413223,0.9018867924528302,68536265,242,89
1,189,0.36363636363636365,0.8396436525612472,65289924,297,108
1,65,0.16666666666666666,0.6174863387978142,61976425,78,13
0,203,0.03333333333333333,0.10578279266572638,62839035,210,7
1,132,0.3888888888888889,0.9077380952380952,66793874,216,84
0,127,0.22085889570552147,0.4764705882352941,67182325,163,36
2,47,0.5252525252525253,0.9662162162162162,80117284,99,52
2,24,0.5789473684210527,0.9166666666666666,65288881,57,33
2,22,0.7608695652173914,0.9375,80019702,92,70
1,47,0.2878787878787879,0.5483870967741935,73863881,66,19
0,12,0.2,0.23076923076923078,80153621,15,3
2,12,0.52,0.75,80137029,25,13
2,12,0.8867924528301887,0.9473684210526315,69216441,106,94
2,15,0.5161290322580645,0.8604651162790697,80145720,31,16
1,2,0.3333333333333333,0.5,80177438,3,1
0,24,0.38461538461538464,0.25,80137909,39,15
1,3,0.4,0.8918918918918919,70698173,5,2
1,57,0.41836734693877553,0.8790322580645161,68241404,98,41
1,229,0.24918032786885247,0.5366614664586583,70045304,305,76
1,138,0.22033898305084745,0.6100917431192661,82135548,177,39
1,69,0.37272727272727274,0.8473282442748091,68531820,110,41
1,73,0.2912621359223301,0.7074468085106383,69608126,103,30
1,29,0.3695652173913043,0.5370370370370371,70750995,46,17
0,46,0.14814814814814814,0.21818181818181817,68546835,54,8
0,103,0.11965811965811966,0.17886178861788618,70037450,117,14
0,58,0.07936507936507936,0.16901408450704225,70751023,63,5
1,183,0.33695652173913043,0.8076009501187649,62565524,276,93
0,30,0.11764705882352941,0.08641975308641975,67963154,34,4
0,120,0.11764705882352941,0.2613981762917933,68312286,136,16
0,279,0.16467065868263472,0.31881533101045295,70627592,334,55
0,199,0.20717131474103587,0.4125,70047880,251,52
1,159,0.3375,0.6608695652173913,80180276,240,81
0,76,0.2962962962962963,0.4225352112676056,80051825,108,32
0,58,0.17142857142857143,0.14285714285714285,82114239,70,12
1,149,0.255,0.5863095238095238,70751044,200,51
0,98,0.18333333333333332,0.21710526315789475,80174685,120,22
0,101,0.04716981132075472,0.1813953488372093,68798191,106,5
0,10,0.16666666666666666,0.26,69712132,12,2
1,174,0.30120481927710846,0.564179104477612,68401396,249,75
0,186,0.21518987341772153,0.45821325648414984,60763374,237,51
0,7,0.125,0.2,70047712,8,1
2,1,0.9230769230769231,0.5,66588466,13,12
1,107,0.3184713375796178,0.6866666666666666,80127002,157,50
1,94,0.2878787878787879,0.6516129032258065,80127004,132,38
0,190,0.15178571428571427,0.22193211488250653,65891630,224,34
2,6,0.7142857142857143,0.6363636363636364,80128774,21,15
2,68,0.5244755244755245,0.8181818181818182,80128789,143,75
0,207,0.1038961038961039,0.3135011441647597,63772002,231,24
1,125,0.24242424242424243,0.6134020618556701,70252910,165,40
2,73,0.5100671140939598,0.6565656565656566,68222693,149,76
2,1,0.9166666666666666,0.5,82009547,12,11
1,5,0.16666666666666666,0.5151515151515151,70675171,6,1
2,1,0.96875,0.5,80175991,32,31
2,3,0.5714285714285714,0.8,70316365,7,4
1,65,0.336734693877551,0.6027397260273972,82041831,98,33
1,160,0.30434782608695654,0.7411003236245954,73399025,230,70
0,97,0.08490566037735849,0.2805755395683453,78762782,106,9
0,35,0.10256410256410256,0.12173913043478261,70539763,39,4
0,60,0.14285714285714285,0.1875,67541880,70,10
1,44,0.3125,0.5909090909090909,80107496,64,20
0,57,0.09523809523809523,0.2931726907630522,80165678,63,6
1,5,0.4444444444444444,0.8,70037660,9,4
1,9,0.4375,0.7619047619047619,70802781,16,7
1,76,0.24752475247524752,0.5504201680672269,70047593,101,25
1,66,0.25842696629213485,0.5240384615384616,69964706,89,23
1,142,0.27918781725888325,0.6848137535816619,69421863,197,55
2,1,0.6666666666666666,0.5,67215302,3,2
1,19,0.32142857142857145,0.8541666666666666,66305001,28,9
1,26,0.2777777777777778,0.5569620253164557,80175648,36,10
0,103,0.009615384615384616,0.036585365853658534,82158887,104,1
0,102,0.019230769230769232,0.04938271604938271,82158888,104,2
1,24,0.48936170212765956,0.7111111111111111,68620965,47,23
1,27,0.2702702702702703,0.6439393939393939,70780003,37,10
2,37,0.5747126436781609,0.9868421052631579,80134721,87,50
1,51,0.3013698630136986,0.6637931034482759,73151316,73,22
1,9,0.4,0.9090909090909091,70701092,15,6
1,130,0.2655367231638418,0.5684931506849316,69165215,177,47
1,25,0.45652173913043476,0.921875,80163709,46,21
1,80,0.2857142857142857,0.6285714285714286,82126633,112,32
0,52,0.037037037037037035,0.0,70713881,54,2
1,7,0.2222222222222222,0.8260869565217391,70968891,9,2
0,8,0.2727272727272727,0.45454545454545453,70193214,11,3
1,18,0.3333333333333333,0.8526315789473684,70674471,27,9
1,16,0.30434782608695654,0.6794871794871795,70674506,23,7
1,23,0.30303030303030304,0.6176470588235294,70741566,33,10
2,0,1.0,1.0,72377333,4,4
0,73,0.13095238095238096,0.24150943396226415,80140164,84,11
0,55,0.19117647058823528,0.38509316770186336,70018760,68,13
0,245,0.07547169811320754,0.04180064308681672,70646366,265,20
2,38,0.6576576576576577,0.8857142857142857,80128770,111,73
2,20,0.5348837209302325,0.7446808510638298,80174927,43,23
2,33,0.56,0.956989247311828,68904885,75,42
0,26,0.16129032258064516,0.19047619047619047,60520005,31,5
1,127,0.2658959537572254,0.6606334841628959,63051730,173,46
0,103,0.1889763779527559,0.2857142857142857,64318744,127,24
2,8,0.6363636363636364,0.7857142857142857,80168333,22,14
1,16,0.3333333333333333,0.7741935483870968,82055996,24,8
1,85,0.4620253164556962,0.7623762376237624,80174688,158,73
0,75,0.2647058823529412,0.2857142857142857,80174689,102,27
0,11,0.3125,0.4864864864864865,66267236,16,5
2,5,0.6428571428571429,0.8181818181818182,68291853,14,9
1,70,0.2553191489361702,0.5297297297297298,70252903,94,24
2,5,0.5454545454545454,0.8333333333333334,80134792,11,6
0,36,0.3333333333333333,0.46875,80172974,54,18
1,14,0.3,0.625,77288183,20,6
0,17,0.2916666666666667,0.46,80160435,24,7
0,24,0.25,0.45901639344262296,80160437,32,8
0,191,0.0861244019138756,0.07090464547677261,80125340,209,18
1,29,0.3409090909090909,0.7241379310344828,80134794,44,15
2,12,0.5,0.9,82008302,24,12
2,4,0.5555555555555556,0.8,62512072,9,5
0,93,0.19827586206896552,0.33707865168539325,69091575,116,23
0,68,0.18072289156626506,0.38953488372093026,68047532,83,15
0,170,0.13705583756345177,0.2052980132450331,80091151,197,27
1,7,0.4166666666666667,0.7272727272727273,80135018,12,5
1,14,0.391304347826087,0.8913043478260869,70575155,23,9
2,13,0.6829268292682927,0.7727272727272727,221284,41,28
1,11,0.3125,0.7105263157894737,67365102,16,5
2,79,0.6127450980392157,0.9788359788359788,68321512,204,125
0,500,0.1652754590984975,0.25239005736137665,66931431,599,99
0,36,0.2,0.18888888888888888,67218662,45,9
2,0,1.0,1.0,70109676,1,1
1,61,0.4351851851851852,0.8875,65947840,108,47
1,55,0.40217391304347827,0.8741721854304636,73026352,92,37
0,88,0.07368421052631578,0.24290220820189273,66345412,95,7
0,280,0.06976744186046512,0.07647058823529412,68743353,301,21
0,132,0.175,0.3098159509202454,68545330,160,28
1,100,0.453551912568306,0.8324873096446701,80180184,183,83
1,143,0.24736842105263157,0.5666666666666667,54564062,190,47
2,3,0.6666666666666666,0.9090909090909091,69195483,9,6
1,126,0.24550898203592814,0.5765765765765766,70047733,167,41
0,41,0.21153846153846154,0.4228187919463087,70719775,52,11
0,48,0.12727272727272726,0.4,71761851,55,7
2,5,0.5,0.7857142857142857,62143340,10,5
0,30,0.11764705882352941,0.17647058823529413,70407113,34,4
1,83,0.37593984962406013,0.8763440860215054,66856664,133,50
0,132,0.15384615384615385,0.28421052631578947,68534053,156,24
2,0,1.0,1.0,80178975,1,1
2,1,0.967741935483871,0.5,82038272,31,30
1,50,0.358974358974359,0.7951807228915663,82038359,78,28
2,19,0.5128205128205128,0.975609756097561,69383496,39,20
1,142,0.21978021978021978,0.5458612975391499,70042350,182,40
0,45,0.26229508196721313,0.4948453608247423,68532765,61,16
1,79,0.2818181818181818,0.7126436781609196,60987150,110,31
1,21,0.38235294117647056,0.631578947368421,82001875,34,13
2,43,0.6475409836065574,0.9879518072289156,66423875,122,79
0,25,0.07407407407407407,0.09195402298850575,62136816,27,2
1,181,0.2551440329218107,0.7359050445103857,66755836,243,62
1,177,0.3723404255319149,0.8480243161094225,68536433,282,105
0,37,0.075,0.2803738317757009,70229761,40,3
1,316,0.25995316159250587,0.640973630831643,69383643,427,111
2,18,0.55,0.8108108108108109,80176778,40,22
1,207,0.4,0.6142857142857143,80176752,345,138
1,105,0.49029126213592233,0.8133333333333334,80176754,206,101
1,84,0.42857142857142855,0.9151785714285714,70466123,147,63
1,35,0.4262295081967213,0.8714285714285714,80119096,61,26
2,3,0.7692307692307693,0.8,75967171,13,10
1,43,0.23214285714285715,0.5121951219512195,69417250,56,13
1,45,0.34782608695652173,0.676923076923077,62510273,69,24
0,180,0.22746781115879827,0.4819004524886878,77563843,233,53
2,16,0.5,0.9565217391304348,69415010,32,16
1,11,0.35294117647058826,0.5,70231791,17,6
1,30,0.45454545454545453,0.78,70231812,55,25
1,9,0.4375,0.8888888888888888,69924974,16,7
0,155,0.049079754601226995,0.14084507042253522,64251145,163,8
1,24,0.35135135135135137,0.782608695652174,68334014,37,13
2,7,0.5333333333333333,0.9230769230769231,70078246,15,8
0,270,0.0625,0.2178932178932179,70862421,288,18
1,132,0.47619047619047616,0.8786885245901639,82021235,252,120
0,107,0.06140350877192982,0.21114369501466276,80089625,114,7
2,7,0.65,0.9090909090909091,65534364,20,13
0,28,0.24324324324324326,0.4897959183673469,82116586,37,9
0,50,0.07407407407407407,0.19333333333333333,811664,54,4
0,239,0.08778625954198473,0.2129817444219067,75283236,262,23
1,66,0.3888888888888889,0.9166666666666666,68884424,108,42
1,38,0.3870967741935484,0.8676470588235294,80051923,62,24
0,9,0.25,0.38461538461538464,73634631,12,3
1,29,0.30952380952380953,0.7333333333333333,73634876,42,13
1,158,0.47854785478547857,0.8047808764940239,80180240,303,145
1,18,0.21739130434782608,0.9065420560747663,80137532,23,5
0,224,0.1971326164874552,0.39430284857571213,70060683,279,55
0,10,0.09090909090909091,0.05714285714285714,80067134,11,1
0,8,0.0,0.0,74086691,8,0
1,177,0.20270270270270271,0.5331905781584583,69171242,222,45
1,74,0.3018867924528302,0.7393617021276596,80125654,106,32
0,124,0.2,0.4553191489361702,68536251,155,31
1,23,0.34285714285714286,0.7313432835820896,70910063,35,12
0,65,0.2073170731707317,0.39826839826839827,73245760,82,17
0,57,0.16176470588235295,0.26119402985074625,69551181,68,11
0,106,0.273972602739726,0.44502617801047123,69955872,146,40
0,12,0.2,0.28,70331534,15,3
2,18,0.660377358490566,0.64,80128781,53,35
2,16,0.5151515151515151,0.9782608695652174,80126956,33,17
1,17,0.15,0.5303030303030303,70693952,20,3
0,1,0.0,0.0,70678370,1,0
0,4,0.2,0.29411764705882354,70703451,5,1
1,7,0.2222222222222222,0.5454545454545454,70706055,9,2
0,2,0.0,0.0,73296006,2,0
1,15,0.2857142857142857,0.5263157894736842,75149585,21,6
1,7,0.46153846153846156,0.9393939393939394,80145432,13,6
0,13,0.23529411764705882,0.2857142857142857,82024330,17,4
2,1,0.9411764705882353,0.5,80126938,17,16
0,8,0.0,0.0,82102542,8,0
0,34,0.02857142857142857,0.208,82102897,35,1
0,37,0.0,0.0,67438196,37,0
0,69,0.15853658536585366,0.2556390977443609,65615760,82,13
0,66,0.05714285714285714,0.16996047430830039,70621516,70,4
1,13,0.1875,0.6046511627906976,82102868,16,3
0,90,0.10891089108910891,0.40441176470588236,65839830,101,11
0,175,0.17452830188679244,0.39903846153846156,68295122,212,37
0,125,0.007936507936507936,0.05122950819672131,70467593,126,1
0,26,0.16129032258064516,0.36082474226804123,70828485,31,5
0,111,0.09016393442622951,0.2445054945054945,80128150,122,11
0,142,0.1695906432748538,0.26353790613718414,80175989,171,29
0,8,0.1111111111111111,0.30612244897959184,67868514,9,1
0,13,0.23529411764705882,0.36,69559966,17,4
0,13,0.0,0.0,82102798,13,0
1,57,0.19718309859154928,0.6149732620320856,71619226,71,14
0,104,0.08771929824561403,0.2185430463576159,64251173,114,10
0,43,0.14,0.45390070921985815,69161043,50,7
1,56,0.3563218390804598,0.8524590163934426,67552135,87,31
0,43,0.10416666666666667,0.4652777777777778,60967032,48,5
0,65,0.13333333333333333,0.4263565891472868,63628845,75,10
0,149,0.1130952380952381,0.29836829836829837,66534965,168,19
0,112,0.104,0.33214285714285713,69005972,125,13
0,138,0.04827586206896552,0.2181208053691275,62839532,145,7
0,66,0.05714285714285714,0.1407766990291262,67819171,70,4
1,89,0.32061068702290074,0.7294117647058823,68616793,131,42
1,26,0.21212121212121213,0.6050420168067226,80150938,33,7
1,110,0.4117647058823529,0.847682119205298,69128073,187,77
0,215,0.0851063829787234,0.45685997171145687,64502025,235,20
0,29,0.03333333333333333,0.02857142857142857,70121135,30,1
0,34,0.08108108108108109,0.0375,80125974,37,3
1,84,0.4939759036144578,0.9454545454545454,69208146,166,82
2,5,0.6428571428571429,0.7857142857142857,69581645,14,9
2,14,0.7142857142857143,0.5454545454545454,65780946,49,35
2,9,0.7954545454545454,0.9696969696969697,69589072,44,35
0,95,0.22131147540983606,0.3632286995515695,69411125,122,27
0,75,0.29906542056074764,0.4794520547945205,73650850,107,32
1,13,0.2777777777777778,0.5666666666666667,61365374,18,5
1,218,0.24305555555555555,0.530562347188264,61710145,288,70
1,36,0.41935483870967744,0.9072164948453608,62497505,62,26
1,47,0.4470588235294118,0.925,66614114,85,38
1,144,0.30097087378640774,0.6933701657458563,71284171,206,62
1,18,0.28,0.5813953488372093,69603471,25,7
2,56,0.5447154471544715,0.9781021897810219,62815200,123,67
1,9,0.4,0.6666666666666666,80176612,15,6
1,48,0.43529411764705883,0.75,69533226,85,37
0,4,0.0,0.0,69654242,4,0
2,11,0.5416666666666666,0.8421052631578947,82065187,24,13
1,19,0.3448275862068966,0.7575757575757576,80104920,29,10
0,17,0.15,0.3611111111111111,72910180,20,3
0,50,0.0,0.0,70568645,50,0
1,14,0.2222222222222222,0.6835443037974683,80145728,18,4
1,19,0.4411764705882353,0.8734177215189873,70818475,34,15
2,3,0.8235294117647058,0.875,70494445,17,14
2,11,0.6451612903225806,0.5454545454545454,79816632,31,20
1,38,0.3770491803278688,0.7894736842105263,71458660,61,23
1,54,0.2987012987012987,0.8061224489795918,69510420,77,23
0,136,0.03546099290780142,0.019672131147540985,66887275,141,5
0,154,0.0375,0.034482758620689655,66887296,160,6
2,53,0.5137614678899083,0.9532710280373832,68052810,109,56
1,96,0.32867132867132864,0.75,69537006,143,47
0,56,0.13846153846153847,0.2222222222222222,65943234,65,9
1,146,0.38396624472573837,0.8,67412233,237,91
0,58,0.2054794520547945,0.35714285714285715,82008923,73,15
1,231,0.21694915254237288,0.6943521594684385,18370653,295,64
1,27,0.2894736842105263,0.6304347826086957,69037640,38,11
0,316,0.13186813186813187,0.15397631133671744,81966310,364,48
1,128,0.30434782608695654,0.7554179566563467,82054695,184,56
0,90,0.11764705882352941,0.14925373134328357,79650984,102,12
0,117,0.176056338028169,0.40606060606060607,67731874,142,25
0,55,0.21428571428571427,0.3949579831932773,70207914,70,15
0,36,0.16279069767441862,0.21428571428571427,68391176,43,7
1,95,0.4508670520231214,0.7560975609756098,70542584,173,78
2,1,0.9864864864864865,0.5,80130696,74,73
2,22,0.7471264367816092,0.8,70585641,87,65
2,3,0.8421052631578947,0.8571428571428571,80176664,19,16
0,90,0.23728813559322035,0.4426877470355731,82116856,118,28
2,7,0.5,0.8,74982516,14,7
2,8,0.5294117647058824,0.9583333333333334,69621335,17,9
1,15,0.4444444444444444,0.9215686274509803,69180181,27,12
0,79,0.25471698113207547,0.3877551020408163,65005514,106,27
2,0,1.0,1.0,80118294,1,1
2,9,0.8125,0.6666666666666666,80159287,48,39
0,107,0.11570247933884298,0.285140562248996,69228194,121,14
2,56,0.5087719298245614,0.9583333333333334,68516882,114,58
1,31,0.3541666666666667,0.603448275862069,68400836,48,17
2,13,0.7592592592592593,0.9583333333333334,70057316,54,41
1,18,0.3793103448275862,0.8636363636363636,69081075,29,11
0,70,0.2391304347826087,0.4394904458598726,67038440,92,22
2,22,0.5319148936170213,0.9333333333333333,69587854,47,25
0,74,0.25252525252525254,0.480225988700565,60137511,99,25
0,19,0.2692307692307692,0.3870967741935484,74057963,26,7
2,0,1.0,1.0,72814805,2,2
1,37,0.24489795918367346,0.7701149425287356,67314121,49,12
0,115,0.16666666666666666,0.3983516483516483,73194863,138,23
1,96,0.16521739130434782,0.6459143968871596,69598011,115,19
0,33,0.05714285714285714,0.1773049645390071,82049138,35,2
1,28,0.44,0.9473684210526315,69184563,50,22
0,39,0.1702127659574468,0.24731182795698925,70829780,47,8
0,85,0.05555555555555555,0.273972602739726,62836263,90,5
1,83,0.42758620689655175,0.8852459016393442,67638704,145,62
2,50,0.504950495049505,0.9635036496350365,68774300,101,51
0,14,0.06666666666666667,0.3194444444444444,62840715,15,1
2,36,0.6326530612244898,0.9444444444444444,80174921,98,62
2,36,0.6086956521739131,0.968421052631579,80172018,92,56
1,68,0.3523809523809524,0.7383177570093458,70654745,105,37
0,46,0.041666666666666664,0.0,60520012,48,2
0,174,0.19815668202764977,0.32390745501285345,80070830,217,43
1,220,0.33534743202416917,0.7884057971014493,67038461,331,111
1,30,0.375,0.832,68241803,48,18
1,81,0.4840764331210191,0.9329896907216495,68286071,157,76
1,35,0.2857142857142857,0.6947368421052632,67774952,49,14
0,29,0.21621621621621623,0.3894736842105263,82009583,37,8
0,68,0.08108108108108109,0.1095890410958904,80119098,74,6
1,81,0.4413793103448276,0.8032786885245902,80145715,145,64
1,94,0.32857142857142857,0.7510917030567685,69091764,140,46
1,95,0.39490445859872614,0.7819148936170213,80125425,157,62
1,36,0.35714285714285715,0.8172043010752689,69183555,56,20
1,104,0.30201342281879195,0.7837837837837838,80180167,149,45
2,0,1.0,1.0,68621840,1,1
1,12,0.4,0.7419354838709677,81989142,20,8
1,10,0.4117647058823529,0.9047619047619048,69693785,17,7
1,35,0.39655172413793105,0.6630434782608695,66263470,58,23
0,25,0.07407407407407407,0.3793103448275862,80124304,27,2
1,112,0.2483221476510067,0.6241610738255033,67160324,149,37
1,36,0.3684210526315789,0.8557692307692307,68434303,57,21
0,111,0.08264462809917356,0.10067114093959731,70061852,121,10
1,124,0.45132743362831856,0.8870292887029289,67270420,226,102
1,19,0.42424242424242425,0.972972972972973,69870192,33,14
1,122,0.4672489082969432,0.8058823529411765,69511344,229,107
1,62,0.4095238095238095,0.918918918918919,69183513,105,43
0,83,0.17,0.15354330708661418,82126643,100,17
1,25,0.16666666666666666,0.6347826086956522,75456633,30,5
0,7,0.125,0.3404255319148936,70701470,8,1
0,14,0.0,0.0,72910152,14,0
1,20,0.4594594594594595,0.8888888888888888,82010274,37,17
1,5,0.375,0.9333333333333333,70192514,8,3
1,40,0.40298507462686567,0.9313725490196079,67905761,67,27
1,49,0.2898550724637681,0.5625,70637945,69,20
2,16,0.6363636363636364,0.9583333333333334,62624191,44,28
1,94,0.3188405797101449,0.6754385964912281,80135255,138,44
1,37,0.2127659574468085,0.515625,69724144,47,10
1,254,0.3728395061728395,0.8874296435272045,62952582,405,151
0,37,0.05128205128205128,0.009174311926605505,68399905,39,2
1,94,0.36486486486486486,0.766497461928934,80004001,148,54
1,58,0.23684210526315788,0.6197183098591549,68297824,76,18
0,163,0.07909604519774012,0.3629764065335753,68811582,177,14
0,2,0.0,0.0,66192042,2,0
1,85,0.38848920863309355,0.7976190476190477,63641326,139,54
1,7,0.36363636363636365,0.8461538461538461,71619163,11,4
0,13,0.13333333333333333,0.45901639344262296,71619240,15,2
0,8,0.2,0.4583333333333333,71620045,10,2
0,160,0.11602209944751381,0.3690773067331671,78763370,181,21
0,96,0.1724137931034483,0.3208955223880597,70209776,116,20
0,43,0.12244897959183673,0.40559440559440557,82103811,49,6
0,120,0.0,0.0,80150018,120,0
0,141,0.027586206896551724,0.2621527777777778,80150049,145,4
0,39,0.0,0.0,64399223,39,0
0,113,0.06611570247933884,0.29581151832460734,65348941,121,8
0,37,0.05128205128205128,0.1411764705882353,70482713,39,2
2,1,0.5,0.6666666666666666,64235654,2,1
1,40,0.14893617021276595,0.6174496644295302,69528165,47,7
1,66,0.15384615384615385,0.6311475409836066,70482916,78,12
0,91,0.09,0.4114285714285714,64351553,100,9
1,10,0.16666666666666666,0.5094339622641509,68546401,12,2
0,16,0.058823529411764705,0.0967741935483871,73412591,17,1
1,9,0.25,0.5909090909090909,70463022,12,3
0,84,0.125,0.37168141592920356,82150090,96,12
0,17,0.05555555555555555,0.15714285714285714,64235745,18,1
2,17,0.6730769230769231,0.9682539682539683,69317192,52,35
0,161,0.15263157894736842,0.37037037037037035,72907842,190,29
0,148,0.15428571428571428,0.399581589958159,73124275,175,27
2,14,0.6,0.84,80056452,35,21
1,27,0.41304347826086957,0.8596491228070176,69172544,46,19
1,44,0.45,0.7755102040816326,80176744,80,36
0,98,0.0,0.0,67004756,98,0
1,15,0.16666666666666666,0.5106382978723404,66126795,18,3
1,57,0.109375,0.5286885245901639,67051586,64,7
0,29,0.21621621621621623,0.48484848484848486,67304195,37,8
1,163,0.21634615384615385,0.6155913978494624,66390961,208,45
0,38,0.02564102564102564,0.18723404255319148,67467491,39,1
0,20,0.09090909090909091,0.37333333333333335,64967812,22,2
1,30,0.11764705882352941,0.5392670157068062,70918043,34,4
1,7,0.125,0.65625,64235675,8,1
0,77,0.07228915662650602,0.19771863117870722,44946496,83,6
1,21,0.25,0.5573770491803278,69141254,28,7
1,35,0.14634146341463414,0.5846153846153846,70922523,41,6
1,73,0.13095238095238096,0.5742574257425742,70922971,84,11
0,112,0.008849557522123894,0.1111111111111111,80150919,113,1
0,109,0.14173228346456693,0.48398576512455516,68227173,127,18
0,47,0.020833333333333332,0.10526315789473684,64236606,48,1
1,50,0.24242424242424243,0.6949152542372882,66204341,66,16
0,15,0.11764705882352941,0.4567901234567901,70463372,17,2
1,13,0.2777777777777778,0.7659574468085106,73650493,18,5
0,10,0.09090909090909091,0.3541666666666667,70916741,11,1
0,19,0.0,0.0,64027880,19,0
1,57,0.109375,0.7358490566037735,70923286,64,7
0,1,0.0,0.0,69908720,1,0
0,61,0.016129032258064516,0.1987179487179487,70468062,62,1
1,3,0.25,0.7777777777777778,63728826,4,1
0,160,0.024390243902439025,0.2535211267605634,70467635,164,4
0,200,0.014778325123152709,0.14697802197802198,70468104,203,3
0,137,0.04195804195804196,0.38160136286201024,82206108,143,6
0,203,0.028708133971291867,0.20026881720430106,67004364,209,6
1,7,0.2222222222222222,0.75,69133876,9,2
0,105,0.0625,0.3724137931034483,82134965,112,7
0,242,0.047244094488188976,0.2621359223300971,68356554,254,12
1,24,0.25,0.8524590163934426,63399742,32,8
0,53,0.08620689655172414,0.49019607843137253,67051593,58,5
0,67,0.056338028169014086,0.15384615384615385,18370506,71,4
0,240,0.0625,0.2796143250688705,70476210,256,16
0,13,0.07142857142857142,0.2708333333333333,80162916,14,1
0,3,0.0,0.0,82046926,3,0
0,26,0.13333333333333333,0.4230769230769231,63968625,30,4
0,143,0.033783783783783786,0.3092105263157895,63265286,148,5
0,56,0.17647058823529413,0.4883720930232558,70629356,68,12
0,20,0.0,0.0,71081521,20,0
1,77,0.23,0.6811023622047244,70484274,100,23
1,131,0.16560509554140126,0.6438679245283019,70467026,157,26
1,20,0.23076923076923078,0.7894736842105263,67455311,26,6
0,6,0.0,0.0,80176296,6,0
1,89,0.2764227642276423,0.6304347826086957,66493252,123,34
1,11,0.21428571428571427,0.6785714285714286,80162878,14,3
0,32,0.0,0.0,82206097,32,0
0,13,0.0,0.0,67900084,13,0
1,27,0.20588235294117646,0.7130434782608696,71619254,34,7
1,24,0.14285714285714285,0.5333333333333333,68948901,28,4
0,80,0.024390243902439025,0.28065395095367845,80149968,82,2
0,85,0.011627906976744186,0.06349206349206349,69890772,86,1
1,10,0.4444444444444444,0.9473684210526315,70821772,18,8
0,112,0.034482758620689655,0.1996370235934664,66024966,116,4
0,74,0.05128205128205128,0.3412887828162291,66025701,78,4
1,46,0.16363636363636364,0.5505050505050505,69204744,55,9
0,8,0.0,0.0,69407233,8,0
0,2,0.0,0.0,80138871,2,0
0,3,0.0,0.0,74619755,3,0
0,4,0.0,0.0,70780521,4,0
1,7,0.2222222222222222,0.6923076923076923,70629671,9,2
1,7,0.3,0.8,63859306,10,3
0,48,0.07692307692307693,0.33653846153846156,64234583,52,4
0,113,0.1171875,0.31865284974093266,82008946,128,15
0,50,0.0,0.0,69006154,50,0
1,55,0.1791044776119403,0.6354166666666666,80128487,67,12
0,79,0.08139534883720931,0.13471502590673576,80155841,86,7
0,19,0.05,0.14705882352941177,80155864,20,1
0,32,0.08571428571428572,0.27184466019417475,82103894,35,3
1,132,0.3230769230769231,0.7575757575757576,67160443,195,63
1,81,0.25688073394495414,0.5700934579439252,69949103,109,28
1,3,0.4,0.75,70821723,5,2
0,8,0.0,0.0,70242592,8,0
0,33,0.05714285714285714,0.16778523489932887,70760354,35,2
0,17,0.19047619047619047,0.23076923076923078,74058586,21,4
0,73,0.013513513513513514,0.031446540880503145,67872322,74,1
0,40,0.0,0.0,82049121,40,0
0,158,0.07058823529411765,0.34375,70922726,170,12
0,4,0.0,0.0,80181343,4,0
0,11,0.15384615384615385,0.48717948717948717,70463596,13,2
0,37,0.05128205128205128,0.4358974358974359,68356981,39,2
1,28,0.0967741935483871,0.5384615384615384,69890464,31,3
0,39,0.025,0.02586206896551724,80135097,40,1
2,9,0.7954545454545454,0.8888888888888888,82159210,44,35
1,10,0.47368421052631576,0.88,66899014,19,9
0,6,0.0,0.0,70634662,6,0
0,194,0.020202020202020204,0.193717277486911,70467936,198,4
0,89,0.07291666666666667,0.23076923076923078,70908215,96,7
0,6,0.0,0.0,82006487,6,0
0,5,0.0,0.0,82006519,5,0
1,28,0.125,0.5,70483525,32,4
1,85,0.1326530612244898,0.510548523206751,70908103,98,13
1,8,0.2,0.88,80089212,10,2
0,60,0.09090909090909091,0.392,63527282,66,6
1,25,0.10714285714285714,0.5,70918862,28,3
0,124,0.03125,0.11377245508982035,62840666,128,4
2,13,0.5517241379310345,0.7857142857142857,70781200,29,16
0,164,0.05202312138728324,0.3677536231884058,80150903,173,9
0,21,0.0,0.0,80162898,21,0
2,19,0.525,0.9347826086956522,64473500,40,21
1,12,0.14285714285714285,0.6521739130434783,70584374,14,2
2,3,0.5,0.625,73644165,6,3
0,53,0.03636363636363636,0.10909090909090909,82150099,55,2
0,272,0.16049382716049382,0.3310225303292894,60512704,324,52
1,158,0.11235955056179775,0.5581395348837209,70923776,178,20
0,59,0.06349206349206349,0.4819672131147541,82049111,63,4
1,24,0.3142857142857143,0.9047619047619048,67434696,35,11
0,127,0.17532467532467533,0.4482758620689655,69723990,154,27
1,103,0.2746478873239437,0.5116279069767442,80056662,142,39
0,1,0.0,0.0,64004906,1,0
0,74,0.075,0.3763440860215054,67051565,80,6
0,25,0.10714285714285714,0.42696629213483145,68193314,28,3
1,7,0.4166666666666667,0.7857142857142857,72816702,12,5
0,5,0.0,0.0,80086664,5,0
0,3,0.0,0.0,80086671,3,0
0,5,0.0,0.0,80150606,5,0
0,56,0.0967741935483871,0.31004366812227074,69204863,62,6
0,17,0.05555555555555555,0.24752475247524752,64399776,18,1
0,80,0.058823529411764705,0.32,70922754,85,5
1,45,0.11764705882352941,0.5337423312883436,80155856,51,6
0,95,0.030612244897959183,0.2069767441860465,66024945,98,3
0,73,0.0875,0.35361216730038025,68199215,80,7
1,5,0.2857142857142857,0.8,69912150,7,2
1,181,0.19911504424778761,0.55,70209734,226,45
0,14,0.06666666666666667,0.2608695652173913,70213311,15,1
0,40,0.06976744186046512,0.26704545454545453,82103800,43,3
0,7,0.125,0.15,70633325,8,1
1,17,0.10526315789473684,0.5070422535211268,64234765,19,2
0,108,0.01818181818181818,0.18689788053949905,80150884,110,2
0,77,0.16304347826086957,0.375,69216021,92,15
0,16,0.058823529411764705,0.22413793103448276,65922255,17,1
0,71,0.04054054054054054,0.09282700421940929,70908852,74,3
0,6,0.0,0.0,80163215,6,0
0,21,0.125,0.22058823529411764,70861840,24,3
0,397,0.12168141592920353,0.2898550724637681,63769594,452,55
1,154,0.11494252873563218,0.608540925266904,70923335,174,20
0,12,0.0,0.0,80150504,12,0
1,63,0.14864864864864866,0.5699481865284974,63782040,74,11
1,83,0.14432989690721648,0.5325670498084292,69481405,97,14
0,159,0.04790419161676647,0.2928452579034942,70918162,167,8
0,44,0.0,0.0,82205861,44,0
1,25,0.24242424242424243,0.68,73075184,33,8
1,5,0.2857142857142857,0.5454545454545454,67975166,7,2
0,79,0.10227272727272728,0.42567567567567566,64027936,88,9
0,25,0.07407407407407407,0.3300970873786408,67978092,27,2
1,19,0.13636363636363635,0.6511627906976745,67917626,22,3
0,31,0.1388888888888889,0.2992125984251969,80135055,36,5
2,43,0.5825242718446602,0.9358974358974359,69512506,103,60
1,42,0.19230769230769232,0.6481481481481481,80153535,52,10
1,211,0.2966666666666667,0.7036144578313253,80128630,300,89
0,68,0.02857142857142857,0.3292307692307692,80150001,70,2
0,50,0.0196078431372549,0.11971830985915492,68811596,51,1
0,11,0.0,0.0,80089184,11,0
0,127,0.015503875968992248,0.0447427293064877,82095490,129,2
0,33,0.05714285714285714,0.2608695652173913,70069846,35,2
0,31,0.1388888888888889,0.45161290322580644,70621474,36,5
0,59,0.06349206349206349,0.13656387665198239,81973006,63,4
0,48,0.1864406779661017,0.4206896551724138,82150125,59,11
1,37,0.17777777777777778,0.553030303030303,82150126,45,8
0,58,0.09375,0.25139664804469275,82150133,64,6
1,28,0.0967741935483871,0.5192307692307693,70923174,31,3
1,124,0.2832369942196532,0.6555183946488294,82143802,173,49
0,23,0.23333333333333334,0.25,69964496,30,7
1,31,0.32608695652173914,0.6444444444444445,69964643,46,15
1,3,0.25,0.7,73533292,4,1
1,16,0.23809523809523808,0.7323943661971831,64236312,21,5
0,96,0.102803738317757,0.22258064516129034,80118454,107,11
0,8,0.1111111111111111,0.42424242424242425,80162910,9,1
0,4,0.0,0.0,82006369,4,0
0,18,0.18181818181818182,0.43283582089552236,64472856,22,4
1,8,0.2727272727272727,0.7333333333333333,69736485,11,3
1,15,0.21052631578947367,0.75,65983134,19,4
0,20,0.0,0.0,80170975,20,0
1,14,0.3333333333333333,0.9142857142857143,70629426,21,7
1,29,0.17142857142857143,0.6538461538461539,67900476,35,6
0,21,0.125,0.39705882352941174,80155846,24,3
0,96,0.1504424778761062,0.33064516129032256,67877040,113,17
1,30,0.16666666666666666,0.708029197080292,70468146,36,6
0,12,0.07692307692307693,0.3181818181818182,69911814,13,1
1,7,0.2222222222222222,0.5789473684210527,71618645,9,2
0,170,0.022988505747126436,0.2173228346456693,80150904,174,4
1,105,0.25,0.5294117647058824,80165149,140,35
0,141,0.06622516556291391,0.3287037037037037,70482524,151,10
0,11,0.0,0.0,67051600,11,0
0,32,0.0,0.0,70467110,32,0
0,39,0.0,0.0,82049125,39,0
0,162,0.07428571428571429,0.4481707317073171,82134963,175,13
1,81,0.4413793103448276,0.9305555555555556,80124817,145,64
0,51,0.08928571428571429,0.20100502512562815,82103796,56,5
0,36,0.02702702702702703,0.11855670103092783,67896451,37,1
0,175,0.016853932584269662,0.14788732394366197,69857851,178,3
2,2,0.5,0.8571428571428571,64470322,4,2
1,3,0.4,0.875,69042645,5,2
1,36,0.18181818181818182,0.6356589147286822,70917084,44,8
1,22,0.45,0.9753086419753086,66923745,40,18
0,70,0.0,0.0,82173339,70,0
0,69,0.014285714285714285,0.16216216216216217,82173340,70,1
0,2,0.0,0.0,66238102,2,0
0,6,0.25,0.3,66238123,8,2
2,4,0.6666666666666666,0.7142857142857143,66257016,12,8
1,5,0.4444444444444444,0.5555555555555556,66257940,9,4
1,47,0.11320754716981132,0.5454545454545454,69033461,53,6
0,107,0.0,0.0,82152136,107,0
0,110,0.017857142857142856,0.12048192771084337,82152147,112,2
0,20,0.047619047619047616,0.14666666666666667,70681702,21,1
0,23,0.0,0.0,70693056,23,0
0,21,0.08695652173913043,0.47058823529411764,72773183,23,2
1,43,0.23214285714285715,0.5384615384615384,70345240,56,13
0,123,0.25,0.4765625,70892052,164,41
1,26,0.2571428571428571,0.6320754716981132,68241425,35,9
1,50,0.42528735632183906,0.8636363636363636,68401151,87,37
1,194,0.25384615384615383,0.6163265306122448,65318890,260,66
0,120,0.07692307692307693,0.04498269896193772,69177556,130,10
1,263,0.3708133971291866,0.8134615384615385,64331155,418,155
1,53,0.43010752688172044,0.89937106918239,82018969,93,40
1,33,0.4,0.8584905660377359,82018967,55,22
1,149,0.4542124542124542,0.8181818181818182,72700194,273,124
1,71,0.4274193548387097,0.7720588235294118,72700222,124,53
0,89,0.06315789473684211,0.1016949152542373,67285624,95,6
1,16,0.4666666666666667,0.918918918918919,80128693,30,14
1,23,0.3235294117647059,0.7592592592592593,80070046,34,11
1,14,0.44,0.9516129032258065,80067435,25,11
1,81,0.4527027027027027,0.8362573099415205,80163478,148,67
1,99,0.3310810810810811,0.7655677655677655,69176884,148,49
1,12,0.29411764705882354,0.5681818181818182,70861861,17,5
1,83,0.35658914728682173,0.6310679611650486,66826200,129,46
1,14,0.2631578947368421,0.627906976744186,70861833,19,5
1,92,0.35664335664335667,0.8536585365853658,69152426,143,51
0,51,0.13559322033898305,0.30612244897959184,69582821,59,8
2,7,0.631578947368421,0.9047619047619048,80161913,19,12
1,146,0.26262626262626265,0.53125,68655972,198,52
1,82,0.3387096774193548,0.6942675159235668,72417156,124,42
0,76,0.0379746835443038,0.10185185185185185,72417485,79,3
1,61,0.11594202898550725,0.5290697674418605,70238350,69,8
0,44,0.043478260869565216,0.054945054945054944,80124194,46,2
2,42,0.6283185840707964,0.7027027027027027,66925362,113,71
1,36,0.32075471698113206,0.8311688311688312,78863666,53,17
2,0,1.0,1.0,82019726,6,6
1,143,0.2513089005235602,0.5174418604651163,80133425,191,48
2,1,0.5,0.5,70770742,2,1
1,48,0.25,0.5576923076923077,724654,64,16
0,638,0.19444444444444445,0.4010989010989011,62222174,792,154
1,68,0.29896907216494845,0.6445783132530121,69737094,97,29
0,39,0.30357142857142855,0.43902439024390244,68401410,56,17
2,4,0.6363636363636364,0.8888888888888888,68401781,11,7
0,4,0.0,0.0,82202363,4,0
1,11,0.21428571428571427,0.5,74086663,14,3
1,69,0.34285714285714286,0.7663043478260869,69176541,105,36
2,29,0.6133333333333333,0.9375,69733531,75,46
1,54,0.3493975903614458,0.7916666666666666,69177794,83,29
1,62,0.32608695652173914,0.6767676767676768,81997884,92,30
0,48,0.1864406779661017,0.4634146341463415,68499970,59,11
1,39,0.4090909090909091,0.9230769230769231,82126753,66,27
0,44,0.16981132075471697,0.18309859154929578,68383553,53,9
1,27,0.425531914893617,0.8070175438596491,80062234,47,20
1,7,0.36363636363636365,0.6666666666666666,80135221,11,4
2,5,0.5454545454545454,0.8888888888888888,80135224,11,6
1,88,0.3888888888888889,0.8911917098445595,66856202,144,56
1,126,0.28,0.7194805194805195,80097220,175,49
2,11,0.7317073170731707,0.8888888888888888,77769580,41,30
2,5,0.6666666666666666,0.5,66796772,15,10
1,38,0.13636363636363635,0.5163934426229508,68318166,44,6
0,41,0.26785714285714285,0.41935483870967744,69003382,56,15
1,72,0.2727272727272727,0.6443514644351465,69183380,99,27
1,21,0.46153846153846156,0.9117647058823529,67411323,39,18
1,96,0.30434782608695654,0.6942148760330579,69724053,138,42
2,2,0.6666666666666666,0.75,80135015,6,4
0,99,0.2204724409448819,0.26627218934911245,80061065,127,28
0,89,0.21929824561403508,0.22377622377622378,80061072,114,25
0,71,0.23655913978494625,0.30612244897959184,80061086,93,22
1,40,0.3548387096774194,0.708029197080292,79989581,62,22
2,0,1.0,1.0,72470153,3,3
2,6,0.6666666666666666,0.8947368421052632,72411171,18,12
1,12,0.42857142857142855,0.76,80176609,21,9
1,30,0.2682926829268293,0.6436781609195402,70325010,41,11
2,16,0.5151515151515151,0.6666666666666666,69639871,33,17
1,11,0.47619047619047616,0.8636363636363636,68401774,21,10
0,18,0.1,0.044444444444444446,68400766,20,2
1,47,0.27692307692307694,0.6481481481481481,65606751,65,18
2,0,1.0,1.0,68457536,2,2
2,2,0.5,0.8333333333333334,73877286,4,2
0,22,0.12,0.11538461538461539,69622105,25,3
1,60,0.2682926829268293,0.7407407407407407,69383454,82,22
2,13,0.5,0.6,72774716,26,13
1,20,0.42857142857142855,0.8611111111111112,80104892,35,15
0,12,0.14285714285714285,0.28125,70677614,14,2
0,28,0.0967741935483871,0.17,70686280,31,3
1,18,0.3076923076923077,0.5277777777777778,71458814,26,8
1,102,0.32450331125827814,0.7926421404682275,82116881,151,49
1,108,0.2751677852348993,0.75,69564894,149,41
1,143,0.3286384976525822,0.7723076923076924,70350826,213,70
0,29,0.19444444444444445,0.36936936936936937,70912751,36,7
1,9,0.4,0.8809523809523809,70059283,15,6
0,301,0.21409921671018275,0.3563218390804598,74545814,383,82
0,14,0.2222222222222222,0.4838709677419355,74443152,18,4
0,512,0.1715210355987055,0.2681081081081081,69668844,618,106
1,113,0.23129251700680273,0.5888594164456233,80135243,147,34
1,197,0.2537878787878788,0.5412844036697247,70769874,264,67
0,162,0.17766497461928935,0.3075117370892019,68642322,197,35
0,375,0.16666666666666666,0.24397590361445784,66459155,450,75
1,17,0.2916666666666667,0.5555555555555556,66892756,24,7
1,26,0.23529411764705882,0.7916666666666666,62841765,34,8
0,151,0.16574585635359115,0.29850746268656714,80119188,181,30
0,113,0.096,0.33183856502242154,69006595,125,12
2,10,0.5652173913043478,0.9230769230769231,80071544,23,13
2,35,0.6902654867256637,0.9859154929577465,80126925,113,78
1,9,0.3076923076923077,0.7777777777777778,80067330,13,4
0,40,0.024390243902439025,0.031914893617021274,80122849,41,1
0,26,0.037037037037037035,0.05982905982905983,70685860,27,1
0,148,0.1590909090909091,0.2123076923076923,67154500,176,28
1,5,0.375,0.5714285714285714,70052003,8,3
0,19,0.09523809523809523,0.21052631578947367,70682843,21,2
2,0,1.0,1.0,68747686,2,2
0,29,0.17142857142857143,0.2948717948717949,70685132,35,6
1,50,0.46808510638297873,0.8758169934640523,69162520,94,44
0,50,0.09090909090909091,0.14912280701754385,66110786,55,5
1,23,0.34285714285714286,0.7166666666666667,64147713,35,12
1,8,0.3333333333333333,0.7413793103448276,67910374,12,4
0,22,0.15384615384615385,0.35443037974683544,67551603,26,4
0,266,0.036231884057971016,0.051587301587301584,80124249,276,10
2,15,0.6341463414634146,0.9875,80176875,41,26
0,344,0.10649350649350649,0.2286212914485166,80124244,385,41
0,113,0.14393939393939395,0.225,73588816,132,19
0,20,0.09090909090909091,0.375,70238854,22,2
1,18,0.25,0.5306122448979592,70661094,24,6
1,50,0.24242424242424243,0.6470588235294118,70754922,66,16
0,23,0.17857142857142858,0.1951219512195122,74709075,28,5
1,256,0.292817679558011,0.6759259259259259,69180685,362,106
1,20,0.375,0.8113207547169812,69482812,32,12
0,3,0.25,0.0,65008153,4,1
1,93,0.30597014925373134,0.7650602409638554,71236795,134,41
2,0,1.0,1.0,82152786,1,1
0,142,0.20670391061452514,0.343042071197411,70049301,179,37
1,21,0.3,0.8076923076923077,71081451,30,9
1,87,0.37410071942446044,0.9247311827956989,70200340,139,52
0,155,0.10919540229885058,0.2445141065830721,70629293,174,19
0,49,0.0392156862745098,0.17028985507246377,64982806,51,2
0,172,0.017142857142857144,0.03442340791738382,64248576,175,3
0,30,0.11764705882352941,0.30952380952380953,69508831,34,4
0,320,0.07514450867052024,0.36616702355460384,62834744,346,26
0,77,0.08333333333333333,0.2608695652173913,74924332,84,7
0,7,0.125,0.3793103448275862,67551246,8,1
1,122,0.18666666666666668,0.5876288659793815,80165686,150,28
0,160,0.2079207920792079,0.4685714285714286,68641972,202,42
0,168,0.0918918918918919,0.20489977728285078,80165684,185,17
1,25,0.3902439024390244,0.8941176470588236,82126710,41,16
0,52,0.2463768115942029,0.40625,67282474,69,17
2,92,0.5282051282051282,0.9805194805194806,65018702,195,103
1,164,0.18811881188118812,0.5066666666666667,66615920,202,38
1,12,0.25,0.7692307692307693,71081010,16,4
1,170,0.3117408906882591,0.751131221719457,70673645,247,77
2,5,0.5,0.9,64469314,10,5
1,4,0.3333333333333333,0.7142857142857143,80167329,6,2
2,3,0.7,0.8571428571428571,67510331,10,7
2,7,0.8727272727272727,0.9166666666666666,73949442,55,48
0,3,0.0,0.0,70705621,3,0
2,22,0.5769230769230769,0.9878048780487805,80127416,52,30
0,26,0.07142857142857142,0.06451612903225806,63050960,28,2
1,11,0.42105263157894735,0.8823529411764706,68400745,19,8
2,29,0.546875,0.8541666666666666,69055672,64,35
0,3,0.4,0.25,70036176,5,2
0,54,0.01818181818181818,0.049586776859504134,68743486,55,1
0,68,0.02857142857142857,0.09929078014184398,68743563,70,2
0,140,0.18128654970760233,0.44680851063829785,80172873,171,31
2,51,0.5853658536585366,0.9625,67173183,123,72
2,0,1.0,1.0,70925750,3,3
0,22,0.12,0.22580645161290322,70214305,25,3
0,14,0.0,0.0,70214312,14,0
0,61,0.06153846153846154,0.125,70633626,65,4
0,169,0.1507537688442211,0.18793503480278423,68533332,199,30
1,94,0.248,0.5276752767527675,70252406,125,31
1,71,0.35454545454545455,0.6972477064220184,80136903,110,39
0,59,0.04838709677419355,0.27049180327868855,78540756,62,3
0,243,0.18729096989966554,0.39242219215155616,62793220,299,56
0,284,0.05333333333333334,0.026200873362445413,73113614,300,16
2,0,1.0,1.0,65931194,11,11
2,32,0.5076923076923077,0.9659090909090909,80176648,65,33
0,2,0.0,0.0,70678881,2,0
1,61,0.2823529411764706,0.5903614457831325,68109440,85,24
2,2,0.8571428571428571,0.75,75265106,14,12
1,11,0.45,0.8333333333333334,82013557,20,9
0,10,0.2857142857142857,0.46,73801714,14,4
0,31,0.1388888888888889,0.2988505747126437,69280925,36,5
2,1,0.9,0.6666666666666666,82020378,10,9
1,11,0.45,0.6,68242461,20,9
0,84,0.23636363636363636,0.4524714828897338,80103296,110,26
1,20,0.47368421052631576,0.918918918918919,69180223,38,18
1,77,0.4076923076923077,0.8785942492012779,80037993,130,53
1,83,0.26548672566371684,0.7088122605363985,70543571,113,30
0,32,0.0,0.0,62837796,32,0
0,133,0.13636363636363635,0.21362229102167182,68628973,154,21
2,38,0.6545454545454545,0.7924528301886793,70713811,110,72
2,33,0.6857142857142857,0.975,69320783,105,72
2,0,1.0,1.0,80136560,18,18
2,20,0.5,0.9736842105263158,69946380,40,20
0,299,0.1940700808625337,0.3434452871072589,79520301,371,72
0,89,0.10101010101010101,0.15060240963855423,54204864,99,10
0,48,0.02040816326530612,0.022727272727272728,66885994,49,1
0,56,0.18840579710144928,0.41509433962264153,70489440,69,13
0,17,0.05555555555555555,0.0,69481811,18,1
0,31,0.18421052631578946,0.39622641509433965,68526416,38,7
0,79,0.16842105263157894,0.22142857142857142,66892616,95,16
1,25,0.2647058823529412,0.6271186440677966,70694330,34,9
0,4,0.0,0.0,70701561,4,0
0,8,0.0,0.0,70706601,8,0
0,3,0.0,0.0,70706923,3,0
0,5,0.16666666666666666,0.15789473684210525,72910285,6,1
2,1,0.8571428571428571,0.5,70073913,7,6
1,17,0.34615384615384615,0.7628865979381443,80113481,26,9
0,34,0.0,0.0,82018904,34,0
0,287,0.1355421686746988,0.3276699029126214,80096331,332,45
0,64,0.04477611940298507,0.09941520467836257,80124322,67,3
2,8,0.5555555555555556,0.42857142857142855,61843313,18,10
1,107,0.272108843537415,0.602510460251046,80103233,147,40
0,109,0.19852941176470587,0.42628205128205127,66723601,136,27
1,32,0.2727272727272727,0.6282051282051282,82126737,44,12
1,37,0.3392857142857143,0.8715596330275229,69603296,56,19
1,100,0.45652173913043476,0.9257142857142857,70917455,184,84
1,62,0.4959349593495935,0.9124423963133641,17885,123,61
1,27,0.1,0.5643564356435643,80149861,30,3
0,84,0.023255813953488372,0.1994750656167979,69005965,86,2
1,26,0.13333333333333333,0.5443037974683544,80149805,30,4
2,15,0.6341463414634146,0.96,80089352,41,26
1,16,0.38461538461538464,0.6216216216216216,67744264,26,10
1,15,0.3181818181818182,0.5161290322580645,73522554,22,7
0,109,0.035398230088495575,0.12653061224489795,62836606,113,4
0,19,0.24,0.40350877192982454,68380340,25,6
0,128,0.1232876712328767,0.3584905660377358,65395813,146,18
0,42,0.20754716981132076,0.49557522123893805,77676823,53,11
1,58,0.3626373626373626,0.744,68401711,91,33
1,131,0.39069767441860465,0.8110749185667753,70753326,215,84
1,127,0.27011494252873564,0.6358695652173914,69165376,174,47
1,32,0.38461538461538464,0.9230769230769231,79520105,52,20
1,31,0.2619047619047619,0.6054054054054054,70597142,42,11
1,24,0.4418604651162791,0.8545454545454545,80074302,43,19
1,37,0.24489795918367346,0.5084745762711864,73421516,49,12
0,5,0.0,0.0,64976303,5,0
1,42,0.38235294117647056,0.912621359223301,70121100,68,26
1,19,0.4722222222222222,0.7586206896551724,72632126,36,17
1,45,0.4578313253012048,0.9266666666666666,68256965,83,38
0,7,0.0,0.0,70686385,7,0
1,9,0.25,0.5625,70693063,12,3
0,18,0.14285714285714285,0.40789473684210525,70694162,21,3
1,11,0.45,0.9166666666666666,79796913,20,9
0,8,0.0,0.0,72910026,8,0
0,43,0.24561403508771928,0.3875,70645750,57,14
0,73,0.039473684210526314,0.1285140562248996,80128622,76,3
0,186,0.12264150943396226,0.32207207207207206,70617323,212,26
2,9,0.5263157894736842,0.9310344827586207,69974464,19,10
1,8,0.4666666666666667,0.8484848484848485,80163514,15,7
0,36,0.02702702702702703,0.06060606060606061,70568554,37,1
2,2,0.6666666666666666,0.6,82020077,6,4
0,4,0.0,0.0,69726314,4,0
0,12,0.07692307692307693,0.3333333333333333,69726440,13,1
0,13,0.0,0.0,69726510,13,0
0,9,0.0,0.0,70820113,9,0
1,228,0.34293948126801155,0.7213114754098361,68810791,347,119
0,54,0.12903225806451613,0.15789473684210525,70535150,62,8
2,2,0.5,0.75,63612563,4,2
1,209,0.2891156462585034,0.7110091743119266,69165663,294,85
0,63,0.125,0.2426470588235294,68499823,72,9
0,60,0.23076923076923078,0.3525641025641026,69184570,78,18
0,13,0.1875,0.40625,72962393,16,3
0,11,0.08333333333333333,0.05263157894736842,61500145,12,1
1,121,0.3202247191011236,0.762962962962963,69176625,178,57
1,134,0.3399014778325123,0.8648648648648649,80135830,203,69
0,36,0.16279069767441862,0.30952380952380953,80135054,43,7
1,46,0.2459016393442623,0.5785123966942148,80135063,61,15
1,59,0.2236842105263158,0.6012658227848101,68533556,76,17
1,45,0.3283582089552239,0.8053097345132744,68467840,67,22
0,127,0.1056338028169014,0.18632075471698112,80119315,142,15
0,80,0.10112359550561797,0.16083916083916083,80119343,89,9
1,68,0.40869565217391307,0.8943089430894309,62815284,115,47
1,78,0.3157894736842105,0.8131313131313131,66188395,114,36
0,102,0.11304347826086956,0.34121621621621623,80128165,115,13
0,85,0.09574468085106383,0.2925764192139738,80128308,94,9
1,25,0.21875,0.5232558139534884,80135002,32,7
0,81,0.047058823529411764,0.13524590163934427,64063216,85,4
0,36,0.05263157894736842,0.16049382716049382,64063706,38,2
1,43,0.31746031746031744,0.8865248226950354,65713683,63,20
0,101,0.18548387096774194,0.49099099099099097,69895861,124,23
1,60,0.2682926829268293,0.5891891891891892,70197456,82,22
1,16,0.36,0.7222222222222222,80168489,25,9
1,16,0.3333333333333333,0.75,81980711,24,8
2,0,1.0,1.0,65293186,1,1
1,47,0.4125,0.7946428571428571,80118363,80,33
1,74,0.37815126050420167,0.7023809523809523,69490393,119,45
0,53,0.07017543859649122,0.2875,70109725,57,4
0,110,0.14728682170542637,0.4860759493670886,70109753,129,19
2,27,0.5423728813559322,0.9315068493150684,73085495,59,32
1,62,0.30337078651685395,0.5375,82047558,89,27
1,78,0.4,0.8532110091743119,82007144,130,52
1,28,0.3,0.7096774193548387,64238790,40,12
0,95,0.1810344827586207,0.3006993006993007,73176565,116,21
0,124,0.19480519480519481,0.3685897435897436,67627336,154,30
2,1,0.6666666666666666,0.75,79849112,3,2
1,8,0.3333333333333333,0.7692307692307693,67215750,12,4
1,20,0.42857142857142855,0.8709677419354839,80181393,35,15
1,27,0.46,0.7307692307692307,71199905,50,23
2,3,0.5714285714285714,0.8333333333333334,69469155,7,4
1,23,0.11538461538461539,0.5609756097560976,69470800,26,3
0,28,0.0967741935483871,0.06896551724137931,80176706,31,3
2,9,0.6666666666666666,0.92,73848761,27,18
0,20,0.2,0.4444444444444444,70539826,25,5
0,150,0.18478260869565216,0.3380614657210402,70047754,184,34
0,198,0.11210762331838565,0.18850987432675045,69417033,223,25
0,22,0.0,0.0,60519991,22,0
0,261,0.12121212121212122,0.13644214162348878,80181291,297,36
2,79,0.5153374233128835,0.935361216730038,69044724,163,84
0,31,0.1388888888888889,0.2803030303030303,82036402,36,5
2,3,0.7692307692307693,0.9166666666666666,74443803,13,10
1,25,0.34210526315789475,0.6607142857142857,67438812,38,13
1,19,0.2962962962962963,0.6271186440677966,73643913,27,8
2,9,0.5263157894736842,0.9487179487179487,66832073,19,10
1,16,0.15789473684210525,0.6875,67589466,19,3
0,5,0.0,0.0,78735461,5,0
0,12,0.0,0.0,80150467,12,0
0,102,0.19047619047619047,0.3959537572254335,67160072,126,24
0,38,0.20833333333333334,0.2537313432835821,68805940,48,10
1,73,0.3113207547169811,0.691358024691358,66857231,106,33
0,4,0.0,0.0,69984985,4,0
1,269,0.24649859943977592,0.5894160583941606,65355843,357,88
0,103,0.2847222222222222,0.49333333333333335,69697901,144,41
1,79,0.22549019607843138,0.6115702479338843,82039202,102,23
2,1,0.75,0.5,70508536,4,3
1,82,0.1368421052631579,0.5524691358024691,62850382,95,13
1,51,0.32894736842105265,0.78125,70064176,76,25
0,112,0.06666666666666667,0.024390243902439025,66767680,120,8
0,91,0.125,0.4562334217506631,70669662,104,13
1,39,0.417910447761194,0.8333333333333334,69512464,67,28
1,27,0.2702702702702703,0.6282051282051282,64166361,37,10
1,4,0.2,0.5,63608902,5,1
1,18,0.18181818181818182,0.6122448979591837,64343650,22,4
0,5,0.0,0.0,80153642,5,0
0,2,0.0,0.0,64032416,2,0
0,121,0.2389937106918239,0.4923469387755102,68579196,159,38
0,26,0.0,0.0,80028984,26,0
1,40,0.1836734693877551,0.5052631578947369,82150076,49,9
0,52,0.13333333333333333,0.40703517587939697,69638156,60,8
0,15,0.0625,0.1694915254237288,69895182,16,1
0,20,0.0,0.0,69895595,20,0
2,9,0.5714285714285714,0.8888888888888888,73503346,21,12
0,23,0.041666666666666664,0.15151515151515152,67475492,24,1
1,18,0.25,0.6097560975609756,69072262,24,6
1,152,0.3944223107569721,0.7657142857142857,80124973,251,99
0,27,0.12903225806451613,0.3409090909090909,69390923,31,4
1,44,0.2542372881355932,0.5042016806722689,68740924,59,15
1,113,0.46190476190476193,0.6875,80178142,210,97
2,4,0.5555555555555556,0.5,82040689,9,5
2,10,0.7222222222222222,0.8571428571428571,68449962,36,26
0,41,0.16326530612244897,0.23863636363636365,69621923,49,8
0,67,0.056338028169014086,0.0707070707070707,70852614,71,4
2,10,0.8701298701298701,0.95,82018973,77,67
0,4,0.2,0.3333333333333333,80163668,5,1
0,7,0.2222222222222222,0.4444444444444444,80163687,9,2
2,0,1.0,1.0,82046189,1,1
0,129,0.03007518796992481,0.05305039787798409,69004432,133,4
2,111,0.5131578947368421,0.9653179190751445,67411316,228,117
0,58,0.06451612903225806,0.2345679012345679,65668260,62,4
0,10,0.09090909090909091,0.3673469387755102,82164883,11,1
1,113,0.3468208092485549,0.7044334975369458,82143570,173,60
0,297,0.2365038560411311,0.4309210526315789,11501322,389,92
0,96,0.21311475409836064,0.4811320754716981,69182260,122,26
0,44,0.13725490196078433,0.23076923076923078,68757360,51,7
0,20,0.13043478260869565,0.26229508196721313,63992761,23,3
0,50,0.15254237288135594,0.2403846153846154,73346966,59,9
0,605,0.13940256045519203,0.16516516516516516,80180389,703,98
1,124,0.3891625615763547,0.8733624454148472,80180472,203,79
0,63,0.11267605633802817,0.27522935779816515,80114685,71,8
0,8,0.0,0.0,66782100,8,0
1,37,0.3018867924528302,0.7870370370370371,78763503,53,16
0,51,0.10526315789473684,0.44680851063829785,61976180,57,6
0,33,0.05714285714285714,0.11578947368421053,61983460,35,2
0,31,0.03125,0.019801980198019802,61976215,32,1
0,15,0.0625,0.2777777777777778,61976523,16,1
0,83,0.12631578947368421,0.34519572953736655,74924122,95,12
2,47,0.5877192982456141,0.9731543624161074,69996675,114,67
0,32,0.08571428571428572,0.29577464788732394,69878823,35,3
1,124,0.26627218934911245,0.5192307692307693,70646135,169,45
0,25,0.21875,0.4657534246575342,69622266,32,7
1,20,0.3333333333333333,0.7,68688053,30,10
1,50,0.20634920634920634,0.7575757575757576,61100431,63,13
1,48,0.22580645161290322,0.6441717791411042,70659925,62,14
0,9,0.1,0.38235294117647056,60513845,10,1
0,165,0.19902912621359223,0.25,74545772,206,41
0,70,0.2222222222222222,0.47017543859649125,69058052,90,20
0,38,0.05,0.12962962962962962,80028886,40,2
0,61,0.1643835616438356,0.3191489361702128,68229616,73,12
1,7,0.3,0.9523809523809523,64345190,10,3
1,20,0.23076923076923078,0.6190476190476191,69638282,26,6
1,27,0.4807692307692308,0.9655172413793104,81960490,52,25
1,35,0.16666666666666666,0.5051546391752577,78763160,42,7
2,5,0.7916666666666666,0.8888888888888888,80083304,24,19
0,57,0.13636363636363635,0.3435897435897436,67721283,66,9
1,285,0.3014705882352941,0.7174280879864636,70641606,408,123
1,63,0.2125,0.5660377358490566,67923135,80,17
0,10,0.0,0.0,70820071,10,0
1,17,0.2608695652173913,0.5833333333333334,70820232,23,6
0,13,0.07142857142857142,0.09259259259259259,70674695,14,1
0,70,0.19540229885057472,0.3352941176470588,70566776,87,17
1,36,0.35714285714285715,0.8333333333333334,70081291,56,20
2,0,1.0,1.0,58855006,3,3
0,35,0.07894736842105263,0.1694915254237288,71761802,38,3
0,46,0.0,0.0,71761844,46,0
1,7,0.3,0.52,70063392,10,3
0,154,0.15384615384615385,0.2438423645320197,82016316,182,28
0,225,0.11764705882352941,0.14666666666666667,67291483,255,30
0,204,0.19367588932806323,0.4089068825910931,80097402,253,49
1,62,0.32608695652173914,0.6530612244897959,65820776,92,30
0,110,0.2198581560283688,0.40816326530612246,70234752,141,31
1,12,0.42857142857142855,0.9743589743589743,67513922,21,9
0,86,0.1134020618556701,0.1,67514006,97,11
2,3,0.7692307692307693,0.9,70062454,13,10
1,47,0.4125,0.85,68400535,80,33
1,51,0.43956043956043955,0.8321678321678322,71011850,91,40
1,65,0.4583333333333333,0.9222222222222223,80030573,120,55
1,162,0.25,0.5457063711911357,67506523,216,54
2,8,0.8620689655172413,0.95,62613376,58,50
0,21,0.16,0.47126436781609193,70746480,25,4
0,31,0.1388888888888889,0.2631578947368421,66222492,36,5
2,0,1.0,1.0,67786992,3,3
1,68,0.30612244897959184,0.6918238993710691,79166843,98,30
0,117,0.07874015748031496,0.10256410256410256,61481833,127,10
0,203,0.0514018691588785,0.023728813559322035,79822442,214,11
1,24,0.22580645161290322,0.5205479452054794,80154132,31,7
0,58,0.09375,0.23943661971830985,80135335,64,6
0,140,0.33014354066985646,0.32142857142857145,73228113,209,69
0,47,0.020833333333333332,0.03773584905660377,70568120,48,1
0,82,0.1276595744680851,0.2254335260115607,70568372,94,12
0,15,0.11764705882352941,0.25316455696202533,70568456,17,2
2,37,0.5375,0.9743589743589743,70925540,80,43
2,1,0.5,0.8461538461538461,72813622,2,1
0,233,0.068,0.2590529247910863,80124329,250,17
0,165,0.0782122905027933,0.18303571428571427,70081025,179,14
2,13,0.5357142857142857,0.9166666666666666,76204156,28,15
2,0,1.0,1.0,68432553,3,3
1,16,0.36,0.7272727272727273,62497190,25,9
0,3,0.0,0.0,67435102,3,0
0,17,0.10526315789473684,0.41935483870967744,69886824,19,2
0,13,0.07142857142857142,0.10526315789473684,70597772,14,1
1,59,0.3917525773195876,0.8148148148148148,54291160,97,38
1,50,0.4444444444444444,0.8536585365853658,62510224,90,40
0,134,0.04964539007092199,0.31759656652360513,68953213,141,7
0,14,0.06666666666666667,0.2702702702702703,70343623,15,1
2,19,0.5777777777777777,0.9772727272727273,80118890,45,26
0,1,0.0,0.0,70704424,1,0
2,1,0.75,0.5,80119018,4,3
1,29,0.30952380952380953,0.84,60522581,42,13
0,150,0.24242424242424243,0.43626062322946174,80110100,198,48
0,124,0.03875968992248062,0.17782026768642448,82049112,129,5
1,23,0.39473684210526316,0.8088235294117647,69666653,38,15
0,17,0.05555555555555555,0.1875,80149872,18,1
1,33,0.32653061224489793,0.7638888888888888,70253834,49,16
0,326,0.19506172839506172,0.41748942172073344,68544035,405,79
0,17,0.10526315789473684,0.1875,68497331,19,2
2,64,0.5328467153284672,0.8571428571428571,68750633,137,73
1,6,0.25,0.7083333333333334,66264926,8,2
0,26,0.21212121212121213,0.3380281690140845,80137564,33,7
2,23,0.54,0.95,80019975,50,27
1,6,0.3333333333333333,0.72,70649754,9,3
1,18,0.41935483870967744,0.7647058823529411,80176854,31,13
1,198,0.175,0.523696682464455,70190484,240,42
2,7,0.5,0.9473684210526315,68241432,14,7
2,0,1.0,1.0,68385835,1,1
0,69,0.24175824175824176,0.4,61365430,91,22
1,25,0.3055555555555556,0.7241379310344828,65915255,36,11
2,10,0.5833333333333334,0.8823529411764706,80125068,24,14
1,56,0.24324324324324326,0.5377358490566038,70748321,74,18
2,7,0.8205128205128205,0.8888888888888888,66763515,39,32
0,30,0.25,0.49333333333333335,69534066,40,10
1,23,0.25806451612903225,0.7241379310344828,73075191,31,8
0,27,0.22857142857142856,0.30666666666666664,70178794,35,8
0,20,0.25925925925925924,0.3939393939393939,82047584,27,7
1,50,0.2753623188405797,0.719626168224299,77676942,69,19
0,103,0.176,0.32085561497326204,70769846,125,22
0,21,0.125,0.38095238095238093,67862823,24,3
0,14,0.0,0.0,67862893,14,0
1,71,0.29,0.52,66272255,100,29
2,45,0.53125,0.9666666666666667,70625856,96,51
0,182,0.2222222222222222,0.40225563909774437,80145460,234,52
1,18,0.35714285714285715,0.7547169811320755,68600714,28,10
2,0,1.0,1.0,17444,22,22
0,46,0.23333333333333334,0.33663366336633666,80121105,60,14
0,29,0.14705882352941177,0.2625,68642203,34,5
2,56,0.5371900826446281,0.9791666666666666,79326142,121,65
0,9,0.0,0.0,70681296,9,0
2,1,0.75,0.5,82070186,4,3
0,3,0.25,0.2,75149550,4,1
0,3,0.0,0.0,82024327,3,0
1,8,0.38461538461538464,0.8333333333333334,82024366,13,5
1,11,0.35294117647058826,0.8275862068965517,70063623,17,6
1,49,0.3950617283950617,0.7866666666666666,80137388,81,32
1,41,0.3880597014925373,0.7777777777777778,80176698,67,26
1,31,0.4745762711864407,0.8783783783783784,80055353,59,28
2,4,0.8,0.5,70614180,20,16
1,47,0.45348837209302323,0.8969072164948454,65018933,86,39
1,75,0.25742574257425743,0.5697674418604651,70637966,101,26
1,136,0.24444444444444444,0.5964391691394659,72293781,180,44
1,14,0.46153846153846156,0.90625,69621951,26,12
1,6,0.4,0.9583333333333334,82129391,10,4
0,54,0.20588235294117646,0.3050847457627119,61566001,68,14
0,4,0.3333333333333333,0.25,68401564,6,2
1,47,0.3088235294117647,0.5673076923076923,69637043,68,21
0,167,0.11170212765957446,0.10619469026548672,69499192,188,21
1,11,0.26666666666666666,0.53125,65010400,15,4
0,297,0.21220159151193635,0.3626543209876543,80105711,377,80
0,7,0.125,0.17391304347826086,70175140,8,1
1,18,0.35714285714285715,0.7777777777777778,69589275,28,10
2,4,0.5555555555555556,0.4,82003957,9,5
0,117,0.24516129032258063,0.46946564885496184,80124674,155,38
1,29,0.3695652173913043,0.8507462686567164,69177703,46,17
0,164,0.1368421052631579,0.3037037037037037,64912862,190,26
1,62,0.3333333333333333,0.7948717948717948,69180671,93,31
0,98,0.25190839694656486,0.4074074074074074,73034283,131,33
1,30,0.25,0.5,69700162,40,10
2,0,1.0,1.0,75460021,6,6
2,43,0.5222222222222223,0.9642857142857143,82121286,90,47
2,12,0.625,0.75,67378451,32,20
1,36,0.4098360655737705,0.8715596330275229,73291603,61,25
0,14,0.125,0.22916666666666666,74789855,16,2
1,53,0.18461538461538463,0.5,80155194,65,12
1,57,0.3804347826086957,0.8424657534246576,80110800,92,35
0,134,0.2342857142857143,0.48255813953488375,80174684,175,41
1,80,0.2920353982300885,0.5487804878048781,80180185,113,33
1,51,0.32,0.7878787878787878,80119007,75,24
1,109,0.4834123222748815,0.9368029739776952,65251725,211,102
0,63,0.24096385542168675,0.4327485380116959,69630246,83,20
1,111,0.22377622377622378,0.6832844574780058,66737930,143,32
1,70,0.39655172413793105,0.8739495798319328,69607314,116,46
0,48,0.25,0.4639175257731959,80128505,64,16
2,36,0.6363636363636364,0.9836065573770492,69511995,99,63
1,125,0.32065217391304346,0.9155844155844156,68286323,184,59
2,13,0.6829268292682927,0.9736842105263158,69096146,41,28
1,30,0.4230769230769231,0.7346938775510204,82022871,52,22
0,145,0.07051282051282051,0.18974358974358974,72275182,156,11
0,99,0.1,0.17801047120418848,70181153,110,11
0,32,0.15789473684210525,0.37,72775241,38,6
0,33,0.08333333333333333,0.11864406779661017,72775535,36,3
1,56,0.4954954954954955,0.9516129032258065,80159568,111,55
0,20,0.047619047619047616,0.06349206349206349,82025260,21,1
0,44,0.18518518518518517,0.29545454545454547,70719796,54,10
0,231,0.20618556701030927,0.4004282655246253,80122392,291,60
0,201,0.06511627906976744,0.36946564885496186,66389281,215,14
0,63,0.1,0.24890829694323144,74923912,70,7
1,139,0.305,0.713963963963964,74555250,200,61
2,9,0.6896551724137931,0.9545454545454546,82023695,29,20
0,47,0.12962962962962962,0.2878787878787879,67376484,54,7
0,8,0.0,0.0,80164926,8,0
0,58,0.30120481927710846,0.3333333333333333,70583296,83,25
0,99,0.2265625,0.38650306748466257,71762705,128,29
1,92,0.2868217054263566,0.606694560669456,80086132,129,37
2,6,0.76,0.5714285714285714,67123770,25,19
1,126,0.3403141361256545,0.7865853658536586,68352340,191,65
1,142,0.26424870466321243,0.6369230769230769,69421191,193,51
1,72,0.25,0.6105769230769231,69664280,96,24
1,40,0.3548387096774194,0.8202247191011236,69183751,62,22
1,31,0.3541666666666667,0.788235294117647,69949096,48,17
2,21,0.5333333333333333,0.8888888888888888,80150442,45,24
1,81,0.4489795918367347,0.9041916167664671,80127350,147,66
0,90,0.09090909090909091,0.16981132075471697,69415934,99,9
0,4,0.2,0.36363636363636365,68040056,5,1
1,12,0.42857142857142855,0.8461538461538461,82038362,21,9
0,67,0.18292682926829268,0.2746478873239437,66361995,82,15
0,17,0.0,0.0,70680960,17,0
1,88,0.1111111111111111,0.5549295774647888,82049129,99,11
1,156,0.3333333333333333,0.6334519572953736,69985552,234,78
1,46,0.3333333333333333,0.6823529411764706,82126816,69,23
2,0,1.0,1.0,80175635,6,6
2,85,0.5952380952380952,0.9868421052631579,82065397,210,125
2,34,0.5277777777777778,0.96,82065398,72,38
2,0,1.0,1.0,82039349,8,8
0,85,0.23423423423423423,0.44660194174757284,80124671,111,26
2,28,0.582089552238806,0.9833333333333333,61772676,67,39
1,3,0.25,0.7727272727272727,70968135,4,1
1,126,0.4246575342465753,0.8740740740740741,80159043,219,93
1,85,0.49101796407185627,0.935064935064935,69603401,167,82
1,44,0.2786885245901639,0.5,69195441,61,17
0,27,0.2702702702702703,0.36538461538461536,69198276,37,10
0,35,0.3,0.4666666666666667,69198283,50,15
1,63,0.4056603773584906,0.8360655737704918,78118012,106,43
1,45,0.4943820224719101,0.9076923076923077,65888606,89,44
0,21,0.08695652173913043,0.288135593220339,62850032,23,2
1,143,0.46037735849056605,0.9360730593607306,67752685,265,122
0,25,0.1935483870967742,0.4897959183673469,67591671,31,6
0,212,0.20599250936329588,0.36637931034482757,68533304,267,55
2,36,0.5,0.8333333333333334,80180239,72,36
0,166,0.13989637305699482,0.4939467312348668,60514160,193,27
2,42,0.5172413793103449,0.9473684210526315,80118617,87,45
1,32,0.23809523809523808,0.6071428571428571,70854350,42,10
2,5,0.6428571428571429,0.875,68402173,14,9
0,131,0.07746478873239436,0.06103286384976526,66459596,142,11
0,7,0.125,0.4594594594594595,64225735,8,1
0,121,0.09022556390977443,0.11797752808988764,70626682,133,12
2,61,0.512,0.9316239316239316,68902750,125,64
0,6,0.14285714285714285,0.3684210526315789,70908320,7,1
1,68,0.3761467889908257,0.8582089552238806,69183793,109,41
1,137,0.21714285714285714,0.5990453460620525,62841100,175,38
1,11,0.3888888888888889,0.8620689655172413,80118946,18,7
0,23,0.17857142857142858,0.19230769230769232,68635721,28,5
1,124,0.38613861386138615,0.8975265017667845,65289952,202,78
0,7,0.0,0.0,80129197,7,0
1,32,0.3469387755102041,0.7627118644067796,70078155,49,17
1,6,0.3333333333333333,0.9016393442622951,79990113,9,3
2,0,1.0,1.0,68546632,1,1
2,1,0.5,0.5,70189826,2,1
0,1,0.0,0.0,82020018,1,0
1,26,0.13333333333333333,0.5121951219512195,80124206,30,4
2,22,0.8784530386740331,0.9655172413793104,70572530,181,159
2,0,1.0,1.0,80138912,5,5
2,42,0.7653631284916201,0.9666666666666667,74049255,179,137
1,12,0.3333333333333333,0.75,69681465,18,6
1,13,0.2777777777777778,0.6170212765957447,70587594,18,5
1,146,0.28078817733990147,0.685785536159601,70047740,203,57
0,19,0.05,0.0,70587566,20,1
2,2,0.5,0.75,69166034,4,2
0,5,0.2857142857142857,0.375,65279732,7,2
1,69,0.24175824175824176,0.5843621399176955,70761166,91,22
0,38,0.09523809523809523,0.0660377358490566,67963140,42,4
2,4,0.6666666666666666,0.9090909090909091,69522502,12,8
2,2,0.6666666666666666,0.6666666666666666,65280964,6,4
0,127,0.22560975609756098,0.46153846153846156,80133424,164,37
2,53,0.5859375,0.9418604651162791,66848705,128,75
2,39,0.5851063829787234,0.9693877551020408,79989756,94,55
2,3,0.5714285714285714,0.875,70209755,7,4
0,15,0.25,0.39473684210526316,62771142,20,5
1,10,0.375,0.7647058823529411,70854210,16,6
2,11,0.5769230769230769,0.9130434782608695,74091983,26,15
1,63,0.31521739130434784,0.6637931034482759,60137490,92,29
1,71,0.3106796116504854,0.7530864197530864,66742634,103,32
1,121,0.3888888888888889,0.8758620689655172,68133961,198,77
0,21,0.2222222222222222,0.3709677419354839,70854301,27,6
0,93,0.05102040816326531,0.2924281984334204,82049093,98,5
1,12,0.29411764705882354,0.6818181818181818,66802890,17,5
0,41,0.08888888888888889,0.3333333333333333,80124274,45,4
2,0,1.0,1.0,74129356,2,2
1,13,0.3157894736842105,0.8135593220338984,64238832,19,6
1,94,0.32857142857142857,0.7236842105263158,70063322,140,46
2,7,0.65,0.9565217391304348,77407792,20,13
1,9,0.25,0.6521739130434783,69718551,12,3
0,230,0.12213740458015267,0.16047548291233285,81979720,262,32
0,22,0.18518518518518517,0.2537313432835821,65282063,27,5
1,34,0.37037037037037035,0.7951807228915663,65288510,54,20
1,95,0.2857142857142857,0.6242038216560509,64917895,133,38
1,151,0.33771929824561403,0.5457875457875457,69733286,228,77
2,86,0.6906474820143885,0.9861111111111112,69634831,278,192
2,0,1.0,1.0,80178216,4,4
2,1,0.75,0.8888888888888888,70587832,4,3
1,260,0.29155313351498635,0.6224188790560472,73524794,367,107
2,0,1.0,1.0,82163424,1,1
1,18,0.25,0.6909090909090909,68497625,24,6
0,15,0.0625,0.06521739130434782,68499522,16,1
0,5,0.16666666666666666,0.42105263157894735,69478773,6,1
2,5,0.5454545454545454,0.9444444444444444,82017791,11,6
2,0,1.0,1.0,70230356,1,1
0,124,0.14482758620689656,0.36271186440677966,70908992,145,21
0,39,0.11363636363636363,0.2625,80117750,44,5
0,186,0.06532663316582915,0.04276315789473684,80121719,199,13
0,112,0.16417910447761194,0.23809523809523808,74708851,134,22
0,57,0.05,0.3333333333333333,62841436,60,3
2,51,0.6871165644171779,0.9915254237288136,69011684,163,112
0,127,0.045112781954887216,0.12303664921465969,70001582,133,6
0,163,0.13756613756613756,0.3418079096045198,70919562,189,26
0,51,0.1206896551724138,0.4523809523809524,70669676,58,7
0,120,0.24528301886792453,0.4207920792079208,62519765,159,39
1,45,0.3382352941176471,0.68,65524753,68,23
0,26,0.037037037037037035,0.13445378151260504,80124402,27,1
1,43,0.31746031746031744,0.7731958762886598,63051051,63,20
1,10,0.3333333333333333,0.875,63051065,15,5
1,57,0.27848101265822783,0.7052631578947368,68628910,79,22
1,12,0.3684210526315789,0.6551724137931034,68624080,19,7
1,77,0.3418803418803419,0.8090452261306532,69184703,117,40
0,151,0.05625,0.17275747508305647,80149850,160,9
1,30,0.3617021276595745,0.746268656716418,66566983,47,17
0,124,0.24848484848484848,0.4969512195121951,80118400,165,41
1,21,0.475,0.9322033898305084,70670341,40,19
0,164,0.14583333333333334,0.48847926267281105,69024165,192,28
0,74,0.14942528735632185,0.18857142857142858,80110541,87,13
1,30,0.4117647058823529,0.7976190476190477,68616870,51,21
0,230,0.12213740458015267,0.2703639514731369,70660282,262,32
1,8,0.42857142857142855,0.8387096774193549,70000672,14,6
2,15,0.5833333333333334,0.9545454545454546,77350182,36,21
1,4,0.42857142857142855,0.6923076923076923,68190241,7,3
1,57,0.3048780487804878,0.6785714285714286,67083912,82,25
2,40,0.68,0.9882352941176471,62807836,125,85
1,100,0.2537313432835821,0.6357827476038339,79788303,134,34
1,82,0.31092436974789917,0.7714285714285715,69215510,119,37
0,26,0.16129032258064516,0.1728395061728395,68392093,31,5
0,25,0.34210526315789475,0.47619047619047616,67880470,38,13
1,10,0.3333333333333333,0.5172413793103449,82013612,15,5
0,42,0.3225806451612903,0.4166666666666667,78980293,62,20
0,167,0.23394495412844038,0.40853658536585363,70645526,218,51
0,77,0.16304347826086957,0.21052631578947367,69498513,92,15
2,17,0.6304347826086957,0.9433962264150944,70599130,46,29
1,104,0.2777777777777778,0.6737804878048781,70604786,144,40
2,2,0.6,0.7142857142857143,66337740,5,3
2,12,0.5,0.825,70718445,24,12
0,20,0.09090909090909091,0.0759493670886076,82021577,22,2
2,49,0.7167630057803468,0.9891304347826086,70660044,173,124
0,31,0.225,0.2857142857142857,68383511,40,9
1,66,0.3333333333333333,0.7292817679558011,81967333,99,33
2,26,0.5873015873015873,0.9777777777777777,82251165,63,37
1,43,0.4819277108433735,0.9595959595959596,68286575,83,40
1,55,0.1791044776119403,0.5151515151515151,80125971,67,12
1,10,0.3333333333333333,0.7906976744186046,68578643,15,5
0,41,0.10869565217391304,0.3722627737226277,70417032,46,5
1,6,0.25,0.5,65279683,8,2
1,162,0.273542600896861,0.5525423728813559,69091736,223,61
1,34,0.3333333333333333,0.8470588235294118,69056575,51,17
2,19,0.6274509803921569,0.9795918367346939,82023699,51,32
1,95,0.3014705882352941,0.5692307692307692,68258176,136,41
0,156,0.14754098360655737,0.33264033264033266,69416571,183,27
0,143,0.15384615384615385,0.19825072886297376,70206920,169,26
1,9,0.35714285714285715,0.8,69039376,14,5
0,115,0.049586776859504134,0.16906474820143885,67620910,121,6
0,71,0.1125,0.36160714285714285,67620994,80,9
0,47,0.09615384615384616,0.4279661016949153,68547003,52,5
1,126,0.125,0.5036496350364964,70746200,144,18
1,45,0.3181818181818182,0.7752808988764045,80176331,66,21
0,55,0.08333333333333333,0.06060606060606061,80070963,60,5
2,17,0.6792452830188679,0.9824561403508771,72198140,53,36
0,66,0.175,0.3381294964028777,73072426,80,14
1,71,0.29,0.7304964539007093,61439910,100,29
1,4,0.3333333333333333,0.8125,70486556,6,2
0,28,0.125,0.3522727272727273,73489892,32,4
0,14,0.0,0.0,73490305,14,0
2,0,1.0,1.0,68007422,1,1
1,73,0.27722772277227725,0.7348837209302326,80071306,101,28
2,3,0.625,0.9,70037072,8,5
1,18,0.45454545454545453,0.875,70036575,33,15
0,75,0.11764705882352941,0.15432098765432098,68534032,85,10
0,2,0.0,0.0,69187853,2,0
1,47,0.25396825396825395,0.5327102803738317,69056624,63,16
1,59,0.45871559633027525,0.9538461538461539,66856356,109,50
0,154,0.18947368421052632,0.36989795918367346,67160233,190,36
1,68,0.44715447154471544,0.9197530864197531,70760725,123,55
2,1,0.75,0.5,82007221,4,3
2,82,0.5794871794871795,0.9159663865546218,80118347,195,113
1,42,0.391304347826087,0.7222222222222222,70174965,69,27
0,36,0.2,0.4909090909090909,80141481,45,9
1,118,0.2804878048780488,0.6656346749226006,82126688,164,46
1,20,0.2857142857142857,0.6379310344827587,69724130,28,8
1,249,0.3252032520325203,0.7439393939393939,82101727,369,120
2,13,0.796875,0.9696969696969697,70539301,64,51
2,0,1.0,1.0,80080056,4,4
2,2,0.5,0.5,70844200,4,2
2,5,0.5454545454545454,0.8571428571428571,72366000,11,6
1,26,0.49019607843137253,0.825,69058850,51,25
0,75,0.013157894736842105,0.03488372093023256,82152137,76,1
2,30,0.6703296703296703,0.9433962264150944,70322721,91,61
2,14,0.8,0.9655172413793104,66495814,70,56
2,2,0.7777777777777778,0.7777777777777778,82016263,9,7
2,4,0.7333333333333333,0.875,82061393,15,11
2,0,1.0,1.0,82090914,1,1
2,0,1.0,1.0,82102211,1,1
2,60,0.5041322314049587,0.8604651162790697,80178926,121,61
2,37,0.5194805194805194,0.9775280898876404,80180325,77,40
0,15,0.21052631578947367,0.3548387096774194,82096280,19,4
2,2,0.6666666666666666,0.25,82062239,6,4
2,30,0.5161290322580645,0.9411764705882353,64196034,62,32
2,3,0.8125,0.9090909090909091,82096253,16,13
2,6,0.8666666666666667,0.875,70567126,45,39
0,23,0.25806451612903225,0.32,70718711,31,8
1,10,0.4444444444444444,0.8888888888888888,80125045,18,8
2,6,0.6470588235294118,0.9230769230769231,72802975,17,11
2,49,0.5288461538461539,0.9354838709677419,70925624,104,55
1,47,0.43373493975903615,0.8311688311688312,70925820,83,36
2,4,0.5,0.8181818181818182,80052574,8,4
0,2,0.0,0.0,69185382,2,0
2,3,0.8333333333333334,0.8333333333333334,80150444,18,15
0,10,0.09090909090909091,0.058823529411764705,68546324,11,1
1,9,0.4,0.5384615384615384,67779754,15,6
1,26,0.3333333333333333,0.6086956521739131,80062423,39,13
1,224,0.3654390934844193,0.7109375,80178916,353,129
2,3,0.9,0.4,80080133,30,27
2,65,0.5390070921985816,0.9395604395604396,80176877,141,76
0,99,0.019801980198019802,0.037267080745341616,64240463,101,2
1,22,0.35294117647058826,0.82,67775351,34,12
1,20,0.3939393939393939,0.7777777777777778,81956349,33,13
0,219,0.060085836909871244,0.07575757575757576,80114573,233,14
2,4,0.5555555555555556,0.7777777777777778,80158248,9,5
2,7,0.6111111111111112,0.9565217391304348,82017803,18,11
0,3,0.0,0.0,82126256,3,0
0,3,0.0,0.0,82126267,3,0
2,4,0.5555555555555556,0.9230769230769231,82126269,9,5
1,4,0.2,0.6,82126270,5,1
0,66,0.21428571428571427,0.2826086956521739,72425654,84,18
1,38,0.4492753623188406,0.8,72426326,69,31
2,7,0.6666666666666666,0.9767441860465116,82023570,21,14
1,33,0.42105263157894735,0.782608695652174,69058605,57,24
2,14,0.5882352941176471,0.8125,70566454,34,20
0,88,0.2072072072072072,0.3870967741935484,66648295,111,23
1,15,0.4230769230769231,0.8235294117647058,69506822,26,11
2,0,1.0,1.0,70314454,7,7
0,12,0.0,0.0,70247996,12,0
1,11,0.15384615384615385,0.7777777777777778,70248003,13,2
0,29,0.0,0.0,70248045,29,0
1,10,0.09090909090909091,0.7142857142857143,70248080,11,1
0,22,0.0,0.0,70248094,22,0
2,2,0.9534883720930233,0.8,80159543,43,41
0,71,0.14457831325301204,0.28102189781021897,70769811,83,12
2,6,0.6470588235294118,0.8,80117734,17,11
2,13,0.9051094890510949,0.9333333333333333,81961522,137,124
2,0,1.0,1.0,82053073,26,26
0,189,0.09569377990430622,0.08588957055214724,80176721,209,20
0,129,0.19375,0.3237410071942446,80180227,160,31
2,25,0.5689655172413793,0.9444444444444444,69162905,58,33
1,5,0.375,0.5,80127005,8,3
1,91,0.4972375690607735,0.935,77769223,181,90
0,1,0.0,0.0,19445510,1,0
0,2,0.0,0.0,82024227,2,0
1,9,0.3076923076923077,0.5365853658536586,82024323,13,4
2,2,0.9,0.8,82020371,20,18
2,6,0.8604651162790697,0.3333333333333333,80126601,43,37
2,0,1.0,1.0,80162576,7,7
2,34,0.7166666666666667,0.8620689655172413,66744601,120,86
1,40,0.4117647058823529,0.7974683544303798,80123728,68,28
2,15,0.7540983606557377,0.9523809523809523,69731585,61,46
2,14,0.5483870967741935,0.7727272727272727,70576345,31,17
1,218,0.38935574229691877,0.7589928057553957,70631204,357,139
2,9,0.8333333333333334,0.9583333333333334,82096251,54,45
2,54,0.5909090909090909,0.9078947368421053,69512422,132,78
2,0,1.0,1.0,80159740,17,17
2,24,0.52,0.868421052631579,80158256,50,26
2,20,0.6363636363636364,0.9696969696969697,75120934,55,35
2,64,0.7288135593220338,0.967741935483871,70591283,236,172
0,21,0.045454545454545456,0.0,80156745,22,1
1,24,0.29411764705882354,0.6829268292682927,81896247,34,10
2,23,0.6229508196721312,0.9428571428571428,80176860,61,38
2,21,0.6440677966101694,0.9814814814814815,69733230,59,38
2,1,0.8,0.5,70037226,5,4
1,28,0.3170731707317073,0.7032967032967034,82096269,41,13
1,221,0.3480825958702065,0.7717206132879046,66903340,339,118
1,18,0.25,0.6,82153812,24,6
1,38,0.3770491803278688,0.7961165048543689,71276625,61,23
2,1,0.6666666666666666,0.5,69903435,3,2
0,6,0.25,0.1111111111111111,75545925,8,2
2,4,0.9310344827586207,0.8571428571428571,82039309,58,54
2,29,0.6741573033707865,0.9473684210526315,74043501,89,60
2,2,0.9,0.8333333333333334,64737190,20,18
1,82,0.3787878787878788,0.8392156862745098,72512650,132,50
2,132,0.6641221374045801,0.9854545454545455,80059035,393,261
1,21,0.4166666666666667,0.8727272727272727,80131234,36,15
2,0,1.0,1.0,82039344,4,4
2,0,1.0,1.0,82018676,3,3
2,2,0.8,0.8571428571428571,82045542,10,8
0,11,0.0,0.0,82001878,11,0
2,23,0.7195121951219512,0.875,82171879,82,59
2,0,1.0,1.0,80159228,13,13
1,53,0.24285714285714285,0.7863247863247863,70231021,70,17
1,62,0.31868131868131866,0.8053097345132744,74646376,91,29
2,0,1.0,1.0,82062248,13,13
2,69,0.6479591836734694,0.9470198675496688,80137966,196,127
2,1,0.96,0.5,80159747,25,24
1,3,0.4,0.75,62512100,5,2
0,139,0.1871345029239766,0.4362745098039216,70649635,171,32
0,5,0.0,0.0,70702254,5,0
0,1,0.0,0.0,70702555,1,0
0,17,0.0,0.0,72909641,17,0
2,20,0.7333333333333333,0.9487179487179487,70598731,75,55
2,3,0.5714285714285714,0.9,68400794,7,4
0,112,0.0743801652892562,0.06844106463878327,72135455,121,9
1,67,0.33,0.7953488372093023,65267090,100,33
1,129,0.287292817679558,0.6339622641509434,69896771,181,52
1,101,0.2733812949640288,0.55,69177633,139,38
1,67,0.3431372549019608,0.7654320987654321,69183520,102,35
0,38,0.19148936170212766,0.4827586206896552,70320166,47,9
0,23,0.11538461538461539,0.28125,70320180,26,3
2,21,0.8189655172413793,0.9836065573770492,67997251,116,95
1,60,0.29411764705882354,0.5,67994486,85,25
1,36,0.35714285714285715,0.7804878048780488,68962565,56,20
0,2,0.0,0.0,80128399,2,0
0,4,0.0,0.0,80154107,4,0
0,139,0.02112676056338028,0.031446540880503145,80128615,142,3
1,39,0.30357142857142855,0.5740740740740741,69949453,56,17
0,49,0.09259259259259259,0.24509803921568626,70687645,54,5
1,38,0.42424242424242425,0.7945205479452054,63767634,66,28
0,22,0.12,0.15217391304347827,69482105,25,3
1,19,0.2962962962962963,0.8214285714285714,80128710,27,8
1,12,0.3333333333333333,0.7037037037037037,76908545,18,6
2,32,0.5,0.972972972972973,67552436,64,32
2,29,0.6627906976744186,0.9367088607594937,73348884,86,57
2,4,0.8095238095238095,0.8,80155978,21,17
0,16,0.058823529411764705,0.3523809523809524,67620812,17,1
0,37,0.05128205128205128,0.2635135135135135,67620896,39,2
0,31,0.11428571428571428,0.4566929133858268,70238686,35,4
1,6,0.14285714285714285,0.5348837209302325,70238924,7,1
0,83,0.20192307692307693,0.46835443037974683,72773253,104,21
1,3,0.4,0.8,68400731,5,2
0,52,0.018867924528301886,0.02654867256637168,521780,53,1
0,62,0.20512820512820512,0.33587786259541985,68285840,78,16
1,14,0.4166666666666667,0.875,80163705,24,10
0,127,0.03787878787878788,0.1510791366906475,80049382,132,5
0,122,0.031746031746031744,0.1259259259259259,80049424,126,4
0,108,0.01818181818181818,0.03787878787878788,80049480,110,2
0,61,0.06153846153846154,0.2682926829268293,80049564,65,4
2,1,0.9166666666666666,0.6666666666666666,77620760,12,11
1,32,0.4666666666666667,0.8620689655172413,72632350,60,28
2,0,1.0,1.0,69167903,1,1
1,104,0.2517985611510791,0.5408163265306123,81980709,139,35
1,11,0.47619047619047616,0.875,80132324,21,10
1,57,0.41836734693877553,0.944,82126798,98,41
0,166,0.20952380952380953,0.4879032258064516,70687120,210,44
0,58,0.2054794520547945,0.35172413793103446,80131233,73,15
0,22,0.08333333333333333,0.2708333333333333,64069411,24,2
0,33,0.08333333333333333,0.05063291139240506,77676991,36,3
0,3,0.0,0.0,67899461,3,0
0,50,0.16666666666666666,0.319672131147541,70829703,60,10
0,137,0.17964071856287425,0.3333333333333333,68398106,167,30
0,33,0.15384615384615385,0.21518987341772153,68398190,39,6
0,87,0.25,0.47150259067357514,69863444,116,29
1,223,0.3788300835654596,0.8556338028169014,80118399,359,136
2,51,0.6136363636363636,0.8301886792452831,73442334,132,81
1,5,0.2857142857142857,0.5,73977953,7,2
1,8,0.38461538461538464,0.7692307692307693,68628980,13,5
1,135,0.2931937172774869,0.6877076411960132,68532072,191,56
1,92,0.31343283582089554,0.8407960199004975,80109862,134,42
0,22,0.18518518518518517,0.48,70476266,27,5
1,18,0.21739130434782608,0.6296296296296297,77676634,23,5
0,33,0.029411764705882353,0.09036144578313253,67468793,34,1
0,139,0.10897435897435898,0.36977491961414793,80149842,156,17
0,132,0.15384615384615385,0.41448692152917505,80128217,156,24
0,37,0.05128205128205128,0.20100502512562815,67467862,39,2
1,5,0.4444444444444444,0.9230769230769231,70917511,9,4
0,92,0.1559633027522936,0.48398576512455516,80149884,109,17
0,4,0.0,0.0,70909132,4,0
1,17,0.34615384615384615,0.7884615384615384,67327274,26,9
0,14,0.0,0.0,67466602,14,0
0,166,0.09782608695652174,0.37360178970917224,70908166,184,18
1,140,0.2964824120603015,0.6504854368932039,73200036,199,59
0,53,0.05357142857142857,0.24896265560165975,67467652,56,3
1,4,0.42857142857142855,0.8235294117647058,63767711,7,3
0,116,0.08661417322834646,0.30288461538461536,78763440,127,11
0,29,0.06451612903225806,0.33088235294117646,69526114,31,2
0,67,0.0945945945945946,0.34523809523809523,82008937,74,7
0,6,0.0,0.0,69525771,6,0
1,34,0.48484848484848486,0.8387096774193549,69733216,66,32
0,52,0.10344827586206896,0.2914285714285714,69134436,58,6
1,44,0.2542372881355932,0.6896551724137931,68642224,59,15
0,65,0.14473684210526316,0.4337899543378995,69463534,76,11
0,16,0.058823529411764705,0.05660377358490566,80128478,17,1
0,94,0.21008403361344538,0.3877551020408163,69165915,119,25
1,29,0.14705882352941177,0.5,80128816,34,5
2,3,0.6666666666666666,0.75,70493871,9,6
1,81,0.39552238805970147,0.7952755905511811,79849042,134,53
1,2,0.3333333333333333,0.6,70494053,3,1
1,12,0.4782608695652174,0.8076923076923077,82041726,23,11
1,33,0.42105263157894735,0.875,82137926,57,24
2,3,0.8235294117647058,0.5,54880721,17,14
1,38,0.3448275862068966,0.7413793103448276,69204632,58,20
1,5,0.2857142857142857,0.6538461538461539,70691271,7,2
2,0,1.0,1.0,70602980,5,5
2,1,0.875,0.5,66114083,8,7
0,143,0.1686046511627907,0.30662020905923343,70812854,172,29
0,51,0.03773584905660377,0.07453416149068323,70621446,53,2
0,48,0.12727272727272726,0.4791666666666667,70823060,55,7
0,47,0.0,0.0,70621390,47,0
1,75,0.27884615384615385,0.6451612903225806,64917881,104,29
0,16,0.0,0.0,67467715,16,0
0,45,0.0425531914893617,0.13333333333333333,67467981,47,2
0,124,0.06060606060606061,0.18352941176470589,69463541,132,8
0,63,0.05970149253731343,0.23243243243243245,80135357,67,4
0,205,0.10869565217391304,0.3713768115942029,64077055,230,25
0,18,0.18181818181818182,0.3389830508474576,69639080,22,4
1,133,0.3383084577114428,0.8463949843260188,68532310,201,68
0,144,0.19101123595505617,0.4025641025641026,63283430,178,34
0,26,0.0,0.0,69526051,26,0
1,66,0.415929203539823,0.9502762430939227,64375514,113,47
0,88,0.23478260869565218,0.4366812227074236,69177563,115,27
1,32,0.3191489361702128,0.7012987012987013,69183800,47,15
1,24,0.2727272727272727,0.550561797752809,69184710,33,9
0,76,0.23232323232323232,0.3431952662721893,68383532,99,23
1,88,0.41721854304635764,0.8379888268156425,71488431,151,63
0,23,0.11538461538461539,0.18666666666666668,67887463,26,3
0,32,0.058823529411764705,0.3106060606060606,70489216,34,2
0,32,0.0,0.0,70746004,32,0
0,39,0.04878048780487805,0.13513513513513514,70746144,41,2
0,10,0.0,0.0,82050074,10,0
2,31,0.5753424657534246,0.9774436090225563,80122933,73,42
1,95,0.35374149659863946,0.8311111111111111,69198465,147,52
1,22,0.26666666666666666,0.6956521739130435,75045453,30,8
0,178,0.10552763819095477,0.3247311827956989,69005825,199,21
1,35,0.10256410256410256,0.6190476190476191,80150015,39,4
0,19,0.09523809523809523,0.4017094017094017,69204884,21,2
2,6,0.5714285714285714,0.9655172413793104,80162808,14,8
1,29,0.275,0.8020833333333334,70629454,40,11
0,11,0.08333333333333333,0.17857142857142858,74086572,12,1
1,55,0.09836065573770492,0.5959595959595959,64183434,61,6
2,16,0.5897435897435898,0.9538461538461539,74043844,39,23
1,52,0.37349397590361444,0.8617021276595744,67600456,83,31
1,68,0.2765957446808511,0.6,69490743,94,26
2,19,0.5,0.9558823529411765,69706882,38,19
2,48,0.5102040816326531,0.8356164383561644,76571502,98,50
0,60,0.24050632911392406,0.15384615384615385,80180985,79,19
0,7,0.0,0.0,69638030,7,0
1,36,0.18181818181818182,0.5245901639344263,80149906,44,8
0,15,0.0,0.0,70468510,15,0
0,61,0.08955223880597014,0.2928870292887029,80153520,67,6
0,29,0.0,0.0,66025351,29,0
0,50,0.038461538461538464,0.2593856655290102,67896332,52,2
0,14,0.06666666666666667,0.16,61228685,15,1
0,7,0.0,0.0,64054753,7,0
0,18,0.1,0.2916666666666667,80150008,20,2
1,27,0.22857142857142856,0.5,80128635,35,8
1,48,0.4,0.8367346938775511,80180349,80,32
1,55,0.38202247191011235,0.7906976744186046,70046424,89,34
0,84,0.125,0.380327868852459,82143789,96,12
1,67,0.3163265306122449,0.6686746987951807,68883514,98,31
1,3,0.25,0.7142857142857143,70597814,4,1
0,103,0.02830188679245283,0.0783289817232376,62834121,106,3
1,51,0.34615384615384615,0.7764705882352941,80178112,78,27
0,6,0.0,0.0,66786622,6,0
0,1,0.0,0.0,66786832,1,0
1,5,0.16666666666666666,0.5,67754785,6,1
0,95,0.05,0.29213483146067415,62840582,100,5
0,104,0.12605042016806722,0.17177914110429449,82055993,119,15
0,11,0.08333333333333333,0.24489795918367346,65209102,12,1
1,4,0.3333333333333333,0.8235294117647058,66786440,6,2
1,75,0.358974358974359,0.8118811881188119,74576803,117,42
2,18,0.5,0.8717948717948718,70278481,36,18
2,1,0.6666666666666666,0.8333333333333334,80128521,3,2
2,6,0.5,0.8260869565217391,80135074,12,6
1,35,0.125,0.5649717514124294,69204814,40,5
2,18,0.6842105263157895,0.9,82055816,57,39
2,10,0.5652173913043478,0.9642857142857143,64472611,23,13
1,55,0.2361111111111111,0.6818181818181818,70621663,72,17
2,16,0.5428571428571428,0.6666666666666666,70637161,35,19
2,24,0.6923076923076923,0.8709677419354839,73447556,78,54
0,20,0.23076923076923078,0.2903225806451613,80172474,26,6
2,82,0.6611570247933884,0.9428571428571428,80137968,242,160
0,127,0.09929078014184398,0.21194029850746268,69417481,141,14
0,56,0.0967741935483871,0.1935483870967742,69505296,62,6
2,126,0.5384615384615384,0.8924731182795699,70182791,273,147
2,5,0.5833333333333334,0.9411764705882353,73871413,12,7
1,38,0.3090909090909091,0.6229508196721312,80176605,55,17
1,18,0.21739130434782608,0.5098039215686274,70202790,23,5
1,39,0.2909090909090909,0.6619718309859155,67793614,55,16
2,61,0.5704225352112676,0.9548022598870056,70802865,142,81
2,19,0.7164179104477612,0.972972972972973,69546680,67,48
0,25,0.13793103448275862,0.4375,82103798,29,4
1,6,0.45454545454545453,0.8421052631578947,61717544,11,5
1,18,0.3076923076923077,0.5932203389830508,73975076,26,8
1,231,0.3790322580645161,0.8077922077922078,80072090,372,141
2,4,0.6923076923076923,0.7857142857142857,80019394,13,9
1,14,0.4166666666666667,0.8666666666666667,62738781,24,10
1,34,0.2608695652173913,0.6339285714285714,80055696,46,12
1,18,0.41935483870967744,0.8536585365853658,80180476,31,13
1,29,0.3829787234042553,0.8507462686567164,69951161,47,18
0,120,0.22077922077922077,0.41007194244604317,80051573,154,34
0,52,0.10344827586206896,0.3235294117647059,63920682,58,6
1,20,0.4444444444444444,0.696969696969697,81956405,36,16
2,22,0.56,0.9655172413793104,73330971,50,28
1,3,0.4,0.7777777777777778,80145713,5,2
0,88,0.10204081632653061,0.23529411764705882,70679770,98,10
0,33,0.15384615384615385,0.4,73007116,39,6
0,25,0.07407407407407407,0.18181818181818182,80124177,27,2
0,35,0.16666666666666666,0.4074074074074074,70181160,42,7
1,10,0.23076923076923078,0.8333333333333334,80124356,13,3
1,89,0.31007751937984496,0.7829787234042553,69180090,129,40
0,64,0.14666666666666667,0.2688679245283019,80121143,75,11
1,128,0.4900398406374502,0.9484240687679083,79792251,251,123
0,1,0.0,0.0,70064113,1,0
0,122,0.20261437908496732,0.3519061583577713,67554046,153,31
1,38,0.3870967741935484,0.794392523364486,73975013,62,24
1,41,0.18,0.5537190082644629,68530140,50,9
0,92,0.12380952380952381,0.22826086956521738,69158250,105,13
0,62,0.21518987341772153,0.4785714285714286,69158341,79,17
0,36,0.16279069767441862,0.3577981651376147,69158481,43,7
1,56,0.25333333333333335,0.753968253968254,69160294,75,19
0,4,0.0,0.0,69479081,4,0
0,10,0.0,0.0,69479515,10,0
0,10,0.0,0.0,70229901,10,0
1,10,0.2857142857142857,0.803921568627451,70229922,14,4
1,25,0.1935483870967742,0.7051282051282052,81989787,31,6
0,16,0.1111111111111111,0.057692307692307696,67812283,18,2
1,149,0.3659574468085106,0.8609467455621301,70234836,235,86
2,4,0.7333333333333333,0.875,74047323,15,11
1,64,0.2808988764044944,0.6308411214953271,72817220,89,25
2,4,0.6666666666666666,0.9285714285714286,80161912,12,8
0,206,0.10434782608695652,0.2108843537414966,70181174,230,24
1,87,0.35555555555555557,0.7942583732057417,82124934,135,48
0,188,0.14545454545454545,0.15,67715991,220,32
0,79,0.12222222222222222,0.23728813559322035,63141960,90,11
0,64,0.14666666666666667,0.3155080213903743,69416956,75,11
0,94,0.2033898305084746,0.296875,81967326,118,24
0,116,0.14705882352941177,0.36049382716049383,67222540,136,20
0,13,0.0,0.0,66304840,13,0
0,18,0.21739130434782608,0.4791666666666667,66305085,23,5
1,77,0.2803738317757009,0.5961538461538461,81956340,107,30
1,208,0.2852233676975945,0.632258064516129,69703116,291,83
1,90,0.4,0.8491620111731844,66817114,150,60
1,34,0.38181818181818183,0.9468085106382979,80135841,55,21
1,114,0.3448275862068966,0.8369565217391305,68642273,174,60
2,23,0.5740740740740741,0.9850746268656716,72962400,54,31
0,4,0.0,0.0,73490081,4,0
0,26,0.10344827586206896,0.39603960396039606,80124294,29,3
0,6,0.0,0.0,80124399,6,0
2,4,0.6363636363636364,0.0,82120602,11,7
2,10,0.875,0.9166666666666666,70076342,80,70
0,41,0.0,0.0,64221801,41,0
1,31,0.225,0.5555555555555556,82041236,40,9
1,20,0.48717948717948717,0.8823529411764706,80135019,39,19
2,30,0.6590909090909091,0.9871794871794872,82008456,88,58
2,1,0.75,0.8571428571428571,80132801,4,3
2,17,0.711864406779661,0.8,65534686,59,42
1,5,0.375,0.5,80172024,8,3
1,21,0.4166666666666667,0.8947368421052632,80004141,36,15
1,44,0.3230769230769231,0.6190476190476191,69482084,65,21
1,60,0.3548387096774194,0.784,68427436,93,33
2,4,0.5,0.9166666666666666,68400843,8,4
1,20,0.2,0.5333333333333333,69994862,25,5
0,13,0.1875,0.2653061224489796,67515210,16,3
1,109,0.2781456953642384,0.6106870229007634,68642392,151,42
0,165,0.23963133640552994,0.3643410852713178,70868000,217,52
1,18,0.3333333333333333,0.6666666666666666,82251166,27,9
2,4,0.6363636363636364,0.0,69489056,11,7
2,0,1.0,1.0,66114825,7,7
1,45,0.2857142857142857,0.7479674796747967,69603625,63,18
0,31,0.29545454545454547,0.37037037037037035,68401025,44,13
1,34,0.43333333333333335,0.8762886597938144,79354590,60,26
1,27,0.425531914893617,0.9120879120879121,54460392,47,20
1,80,0.21568627450980393,0.5441176470588235,73637760,102,22
1,90,0.4797687861271676,0.9393939393939394,80095995,173,83
1,91,0.2777777777777778,0.5755813953488372,66857483,126,35
1,31,0.43636363636363634,0.963302752293578,80074330,55,24
0,101,0.15126050420168066,0.22580645161290322,68534025,119,18
2,16,0.5789473684210527,0.9318181818181818,82018897,38,22
1,109,0.3271604938271605,0.6692913385826772,80132317,162,53
1,32,0.4576271186440678,0.5675675675675675,68669020,59,27
2,26,0.543859649122807,0.8666666666666667,67326140,57,31
0,33,0.15384615384615385,0.12222222222222222,69737164,39,6
1,106,0.2689655172413793,0.672566371681416,66264366,145,39
0,163,0.08426966292134831,0.16139240506329114,69509034,178,15
1,12,0.4,0.8571428571428571,69039320,20,8
2,2,0.6,0.875,69064401,5,3
0,67,0.12987012987012986,0.15492957746478872,66964282,77,10
2,22,0.56,0.7837837837837838,80177536,50,28
0,63,0.1,0.1888111888111888,67285596,70,7
1,4,0.42857142857142855,0.7692307692307693,70120596,7,3
1,19,0.13636363636363635,0.5185185185185185,80116771,22,3
0,6,0.14285714285714285,0.23529411764705882,70683522,7,1
2,59,0.5874125874125874,0.7733333333333333,69972441,143,84
1,60,0.40594059405940597,0.9025974025974026,69031081,101,41
1,42,0.391304347826087,0.7804878048780488,67556041,69,27
0,351,0.2182628062360802,0.4724186704384724,72920372,449,98
1,63,0.31521739130434784,0.7615894039735099,70004921,92,29
0,92,0.18584070796460178,0.3834355828220859,63286804,113,21
1,46,0.4025974025974026,0.908256880733945,62016605,77,31
0,90,0.23728813559322035,0.4344262295081967,80127006,118,28
0,68,0.23595505617977527,0.28703703703703703,72445730,89,21
2,20,0.5833333333333334,0.95,74363961,48,28
0,97,0.11818181818181818,0.21708185053380782,72523374,110,13
0,56,0.125,0.30952380952380953,68312272,64,8
0,81,0.25688073394495414,0.4875,70741643,109,28
1,5,0.4444444444444444,0.8823529411764706,69983074,9,4
1,27,0.4489795918367347,0.9292929292929293,82151298,49,22
0,101,0.11403508771929824,0.2066115702479339,63141911,114,13
0,154,0.10465116279069768,0.12162162162162163,80071075,172,18
2,27,0.55,0.9402985074626866,82134993,60,33
1,60,0.29411764705882354,0.6906077348066298,82116854,85,25
1,29,0.2564102564102564,0.6086956521739131,69537013,39,10
2,23,0.5660377358490566,0.9423076923076923,75550363,53,30
1,5,0.4444444444444444,0.9090909090909091,68480321,9,4
0,75,0.25742574257425743,0.49693251533742333,74059083,101,26
2,51,0.7017543859649122,0.8311688311688312,80052434,171,120
2,13,0.5357142857142857,0.972972972972973,80074316,28,15
0,121,0.25766871165644173,0.47686832740213525,82124924,163,42
0,73,0.1797752808988764,0.36180904522613067,80133442,89,16
0,74,0.16853932584269662,0.3940677966101695,82011816,89,15
1,25,0.07407407407407407,0.5535714285714286,62836004,27,2
0,21,0.16,0.4507042253521127,82103870,25,4
0,85,0.07608695652173914,0.2631578947368421,64063041,92,7
0,65,0.07142857142857142,0.2548076923076923,63265552,70,5
1,74,0.27450980392156865,0.7065217391304348,66411961,102,28
0,11,0.15384615384615385,0.34285714285714286,69510350,13,2
1,10,0.2857142857142857,0.7111111111111111,82038326,14,4
0,11,0.0,0.0,66876950,11,0
1,26,0.13333333333333333,0.55,70468006,30,4
0,34,0.08108108108108109,0.376,70917175,37,3
0,102,0.1968503937007874,0.31671554252199413,82116858,127,25
1,88,0.42857142857142855,0.9010416666666666,70121212,154,66
2,6,0.7142857142857143,0.9166666666666666,72315061,21,15
1,19,0.24,0.6078431372549019,64002932,25,6
1,65,0.25287356321839083,0.695364238410596,67732546,87,22
0,87,0.03333333333333333,0.33604336043360433,80149961,90,3
1,108,0.19402985074626866,0.5921985815602837,61580890,134,26
0,50,0.07407407407407407,0.26519337016574585,70908124,54,4
1,36,0.21739130434782608,0.5867768595041323,64000524,46,10
1,21,0.19230769230769232,0.5476190476190477,69395424,26,5
1,28,0.2222222222222222,0.8295454545454546,70467943,36,8
0,54,0.05263157894736842,0.22413793103448276,78763132,57,3
0,142,0.08387096774193549,0.35092348284960423,63802473,155,13
0,44,0.2413793103448276,0.40559440559440557,82126691,58,14
1,24,0.4782608695652174,0.9622641509433962,80130697,46,22
0,49,0.14035087719298245,0.2653061224489796,69559231,57,8
1,19,0.3448275862068966,0.7166666666666667,82124913,29,10
2,20,0.5348837209302325,0.9259259259259259,80166901,43,23
1,62,0.2345679012345679,0.6348314606741573,69559693,81,19
2,18,0.6,0.875,80137980,45,27
1,5,0.4444444444444444,0.8,80130702,9,4
1,15,0.375,0.723404255319149,73871364,24,9
0,147,0.02,0.05177993527508091,62838734,150,3
2,4,0.7333333333333333,0.9166666666666666,67410896,15,11
0,53,0.24285714285714285,0.47333333333333333,67994570,70,17
0,66,0.10810810810810811,0.3355263157894737,70630000,74,8
0,18,0.18181818181818182,0.36363636363636365,70768110,22,4
1,40,0.375,0.7954545454545454,68547542,64,24
0,3,0.25,0.14285714285714285,82024211,4,1
1,86,0.23214285714285715,0.69,66536820,112,26
1,101,0.33986928104575165,0.748898678414097,64686342,153,52
1,9,0.35714285714285715,0.6129032258064516,67373061,14,5
0,31,0.06060606060606061,0.3269230769230769,64359764,33,2
0,1,0.0,0.0,67732644,1,0
2,4,0.7647058823529411,0.9411764705882353,78013733,17,13
1,33,0.2826086956521739,0.8611111111111112,65351342,46,13
0,78,0.22,0.45,80178626,100,22
1,88,0.2786885245901639,0.5410447761194029,74341414,122,34
0,74,0.075,0.22994652406417113,80149827,80,6
0,15,0.3181818181818182,0.4857142857142857,69410733,22,7
0,37,0.27450980392156865,0.4057971014492754,80022026,51,14
0,7,0.0,0.0,70081340,7,0
2,36,0.5135135135135135,0.9,70919275,74,38
0,32,0.1111111111111111,0.1388888888888889,80125055,36,4
0,33,0.08333333333333333,0.08823529411764706,82001877,36,3
0,18,0.21739130434782608,0.37681159420289856,70047782,23,5
0,139,0.23626373626373626,0.41637010676156583,69607832,182,43
1,44,0.2903225806451613,0.6024096385542169,61235055,62,18
1,32,0.4074074074074074,0.8955223880597015,80089821,54,22
1,34,0.20930232558139536,0.5425531914893617,68533206,43,9
2,9,0.5,0.9,72803423,18,9
0,17,0.15,0.3670886075949367,70675052,20,3
0,3,0.0,0.0,70682192,3,0
0,141,0.10191082802547771,0.11081794195250659,82011784,157,16
0,90,0.23728813559322035,0.4721311475409836,70658630,118,28
0,70,0.23076923076923078,0.43448275862068964,73524514,91,21
0,27,0.2894736842105263,0.4918032786885246,66892511,38,11
1,74,0.308411214953271,0.75,70064211,107,33
0,57,0.2191780821917808,0.3618421052631579,82126629,73,16
1,10,0.4117647058823529,0.9393939393939394,64866564,17,7
1,16,0.4838709677419355,0.9487179487179487,71689611,31,15
0,98,0.10091743119266056,0.2536231884057971,60514146,109,11
1,2,0.3333333333333333,0.6666666666666666,70751261,3,1
1,13,0.35,0.875,70751282,20,7
2,26,0.7678571428571429,0.9830508474576272,68446903,112,86
0,29,0.12121212121212122,0.2631578947368421,68756912,33,4
0,10,0.3333333333333333,0.4827586206896552,80052805,15,5
1,24,0.35135135135135137,0.7794117647058824,60563636,37,13
0,20,0.16666666666666666,0.2976190476190476,80181342,24,4
2,70,0.5569620253164557,0.959349593495935,65715356,158,88
1,7,0.36363636363636365,0.8392857142857143,79990001,11,4
1,60,0.3258426966292135,0.8342857142857143,66926111,89,29
1,10,0.4117647058823529,0.9393939393939394,69152363,17,7
1,2,0.3333333333333333,0.6666666666666666,70759801,3,1
0,63,0.136986301369863,0.16393442622950818,73650892,73,10
0,58,0.03333333333333333,0.02654867256637168,82022536,60,2
0,16,0.0,0.0,70703423,16,0
0,14,0.0,0.0,72910173,14,0
0,40,0.06976744186046512,0.09090909090909091,68199726,43,3
0,40,0.06976744186046512,0.037037037037037035,68199740,43,3
0,16,0.4074074074074074,0.2857142857142857,62148324,27,11
2,3,0.5,0.8260869565217391,82023123,6,3
1,22,0.4634146341463415,0.7894736842105263,73331013,41,19
1,61,0.33695652173913043,0.7873563218390804,63493332,92,31
1,22,0.3888888888888889,0.9333333333333333,67802455,36,14
0,39,0.23529411764705882,0.4507042253521127,61500243,51,12
1,94,0.16071428571428573,0.6270627062706271,62530384,112,18
2,9,0.5714285714285714,0.9444444444444444,70343483,21,12
0,5,0.16666666666666666,0.42857142857142855,54252023,6,1
0,9,0.0,0.0,69316681,9,0
0,38,0.22448979591836735,0.3384615384615385,63179235,49,11
0,92,0.0891089108910891,0.2671232876712329,70621726,101,9
0,1,0.0,0.0,67292001,1,0
0,48,0.07692307692307693,0.2742857142857143,65351356,52,4
0,310,0.10662824207492795,0.11764705882352941,67963371,347,37
1,14,0.17647058823529413,0.5409836065573771,68199320,17,3
0,88,0.08333333333333333,0.3159509202453988,80149833,96,8
0,22,0.21428571428571427,0.34210526315789475,69056722,28,6
0,23,0.08,0.12987012987012986,67551386,25,2
0,280,0.1566265060240964,0.23192019950124687,70045255,332,52
0,78,0.04878048780487805,0.28448275862068967,62839735,82,4
1,34,0.2765957446808511,0.5370370370370371,67394096,47,13
0,31,0.0,0.0,67887526,31,0
1,106,0.19696969696969696,0.5475285171102662,80149820,132,26
1,76,0.3770491803278688,0.9047619047619048,69184164,122,46
1,28,0.2631578947368421,0.6153846153846154,63850080,38,10
0,158,0.0,0.0,68811666,158,0
0,93,0.211864406779661,0.3722943722943723,67552366,118,25
1,73,0.2912621359223301,0.7960526315789473,82034384,103,30
0,65,0.16666666666666666,0.44751381215469616,63841540,78,13
1,27,0.41304347826086957,0.8555555555555555,70748370,46,19
1,13,0.1875,0.631578947368421,69867924,16,3
2,77,0.5126582278481012,0.9794871794871794,72776515,158,81
0,203,0.2397003745318352,0.4782608695652174,72413894,267,64
2,10,0.6,0.9444444444444444,82034383,25,15
1,15,0.4230769230769231,0.8983050847457628,80117930,26,11
0,77,0.06097560975609756,0.05314009661835749,72900170,82,5
2,8,0.873015873015873,0.9523809523809523,82020044,63,55
2,15,0.6428571428571429,0.896551724137931,80178958,42,27
1,18,0.21739130434782608,0.52,66496031,23,5
0,17,0.22727272727272727,0.06666666666666667,69483680,22,5
1,17,0.41379310344827586,0.5666666666666667,69483736,29,12
1,18,0.45454545454545453,0.717948717948718,69484744,33,15
0,109,0.07627118644067797,0.2958801498127341,72766190,118,9
1,74,0.3392857142857143,0.8333333333333334,80124420,112,38
2,13,0.5,0.90625,69385820,26,13
0,120,0.2682926829268293,0.4942084942084942,80107965,164,44
1,87,0.46296296296296297,0.9425287356321839,62431376,162,75
1,36,0.2653061224489796,0.6946564885496184,76717536,49,13
2,36,0.5555555555555556,0.9264705882352942,75613762,81,45
1,59,0.37894736842105264,0.8691099476439791,80145296,95,36
2,29,0.6133333333333333,0.9272727272727272,75264581,75,46
1,3,0.4,0.6923076923076923,66801770,5,2
0,8,0.1111111111111111,0.2631578947368421,80131194,9,1
1,63,0.27586206896551724,0.7717391304347826,70633682,87,24
0,10,0.0,0.0,69478535,10,0
0,7,0.0,0.0,70677250,7,0
0,5,0.0,0.0,65156952,5,0
0,5,0.0,0.0,65157092,5,0
0,7,0.0,0.0,65157120,7,0
0,10,0.0,0.0,65157190,10,0
0,10,0.0,0.0,65157281,10,0
1,7,0.125,0.6666666666666666,65157316,8,1
1,6,0.14285714285714285,0.7272727272727273,65157393,7,1
1,34,0.4426229508196721,0.83,70762853,61,27
1,25,0.4444444444444444,0.8823529411764706,80149455,45,20
1,120,0.4339622641509434,0.8883374689826302,80030566,212,92
1,4,0.42857142857142855,0.8461538461538461,65135091,7,3
0,8,0.2727272727272727,0.3333333333333333,62809215,11,3
2,2,0.5,0.8888888888888888,67427290,4,2
1,17,0.2916666666666667,0.7333333333333333,80141492,24,7
1,68,0.2608695652173913,0.6424242424242425,61184543,92,24
1,9,0.1,0.59375,63781564,10,1
0,17,0.05555555555555555,0.2857142857142857,67846373,18,1
0,48,0.1111111111111111,0.19680851063829788,70925435,54,6
1,41,0.26785714285714285,0.6495726495726496,67414473,56,15
1,147,0.11976047904191617,0.5106951871657754,63775726,167,20
2,11,0.6666666666666666,0.875,62581316,33,22
0,36,0.2,0.391304347826087,80176738,45,9
0,46,0.041666666666666664,0.07228915662650602,61587792,48,2
0,143,0.06535947712418301,0.2325,80081085,153,10
1,62,0.27058823529411763,0.6083333333333333,70759444,85,23
0,99,0.175,0.4858156028368794,80128493,120,21
0,19,0.2692307692307692,0.40625,82024048,26,7
0,49,0.09259259259259259,0.4205607476635514,80089681,54,5
1,53,0.35365853658536583,0.7210884353741497,79354583,82,29
1,30,0.4827586206896552,0.9342105263157895,74193336,58,28
1,88,0.2786885245901639,0.7020648967551623,80176484,122,34
2,1,0.9655172413793104,0.6666666666666666,66907064,29,28
1,31,0.40384615384615385,0.85,70078302,52,21
2,5,0.8571428571428571,0.3333333333333333,69666513,35,30
1,4,0.42857142857142855,0.9259259259259259,70238672,7,3
2,21,0.6440677966101694,0.9183673469387755,68294261,59,38
1,9,0.35714285714285715,0.7857142857142857,60242616,14,5
0,39,0.25,0.4369747899159664,66613904,52,13
2,9,0.5263157894736842,0.8846153846153846,80048031,19,10
1,39,0.4090909090909091,0.9036144578313253,68532632,66,27
0,53,0.07017543859649122,0.10309278350515463,82128636,57,4
0,43,0.25862068965517243,0.45348837209302323,69183373,58,15
0,55,0.25675675675675674,0.4634146341463415,70535122,74,19
2,11,0.7105263157894737,0.8518518518518519,66280984,38,27
0,142,0.07792207792207792,0.42201834862385323,62837635,154,12
0,96,0.11926605504587157,0.3202247191011236,69390944,109,13
2,2,0.5,0.8333333333333334,69027203,4,2
1,43,0.36764705882352944,0.6896551724137931,70718963,68,25
0,63,0.20253164556962025,0.4262295081967213,80140099,79,16
1,35,0.33962264150943394,0.6153846153846154,70925505,53,18
2,5,0.5833333333333334,0.9714285714285714,80125388,12,7
2,2,0.9259259259259259,0.6666666666666666,68755610,27,25
0,80,0.1111111111111111,0.13440860215053763,79650872,90,10
1,9,0.4375,0.5,72778454,16,7
1,27,0.34146341463414637,0.7142857142857143,70207424,41,14
1,98,0.3333333333333333,0.755868544600939,70207683,147,49
0,18,0.18181818181818182,0.42857142857142855,64007041,22,4
0,132,0.18012422360248448,0.4064748201438849,80153468,161,29
2,3,0.6666666666666666,0.9166666666666666,82021848,9,6
1,7,0.2222222222222222,0.5,69534206,9,2
0,1,0.0,0.0,69626326,1,0
0,5,0.0,0.0,69626375,5,0
2,98,0.5288461538461539,0.9788519637462235,81971167,208,110
1,43,0.36764705882352944,0.7548387096774194,69128031,68,25
2,8,0.6,0.7777777777777778,61172020,20,12
0,20,0.23076923076923078,0.4166666666666667,67287836,26,6
1,5,0.2857142857142857,0.5333333333333333,80163504,7,2
1,40,0.2727272727272727,0.7547169811320755,82036901,55,15
0,148,0.18232044198895028,0.3385579937304075,69417306,181,33
0,8,0.2,0.25,82116585,10,2
0,34,0.1282051282051282,0.16,73709223,39,5
0,76,0.23232323232323232,0.2872340425531915,68192432,99,23
1,250,0.2774566473988439,0.6202090592334495,80109316,346,96
0,39,0.2777777777777778,0.4536082474226804,70612290,54,15
1,35,0.453125,0.7931034482758621,80175645,64,29
1,32,0.38461538461538464,0.7692307692307693,68449934,52,20
2,78,0.5214723926380368,0.9627329192546584,72622522,163,85
2,8,0.7333333333333333,0.6363636363636364,70407162,30,22
2,6,0.7142857142857143,0.9473684210526315,8014832,21,15
1,13,0.4583333333333333,0.5714285714285714,66459232,24,11
1,14,0.46153846153846156,0.7272727272727273,66459281,26,12
2,1,0.9285714285714286,0.5,74484081,14,13
2,5,0.921875,0.8,82120646,64,59
2,13,0.5806451612903226,0.8679245283018868,80158231,31,18
1,25,0.32432432432432434,0.6333333333333333,70063651,37,12
1,15,0.375,0.8936170212765957,68401046,24,9
0,68,0.17073170731707318,0.4117647058823529,69112330,82,14
1,50,0.3333333333333333,0.7184466019417476,80145297,75,25
1,73,0.32407407407407407,0.7119565217391305,70207445,108,35
0,26,0.1875,0.13432835820895522,62497701,32,6
0,11,0.15384615384615385,0.10256410256410256,80163513,13,2
2,8,0.84,0.92,67596403,50,42
1,116,0.2564102564102564,0.5527426160337553,66892385,156,40
0,22,0.12,0.0958904109589041,81956143,25,3
1,56,0.3,0.7225806451612903,70564382,80,24
2,0,1.0,1.0,82052069,5,5
1,28,0.37777777777777777,0.8717948717948718,63198450,45,17
0,66,0.16455696202531644,0.3855421686746988,60763304,79,13
0,77,0.02531645569620253,0.06280193236714976,78763055,79,2
1,54,0.2702702702702703,0.5073529411764706,82066711,74,20
1,14,0.2222222222222222,0.509090909090909,69160385,18,4
1,111,0.1328125,0.5541871921182266,80128664,128,17
1,77,0.11494252873563218,0.5709090909090909,80149831,87,10
0,19,0.05,0.10588235294117647,70283402,20,1
1,32,0.21951219512195122,0.7947019867549668,82150075,41,9
2,13,0.8395061728395061,0.9615384615384616,8019662,81,68
2,60,0.589041095890411,0.8267716535433071,73443020,146,86
1,16,0.23809523809523808,0.6712328767123288,69886474,21,5
1,91,0.4484848484848485,0.8759124087591241,77600362,165,74
1,14,0.3333333333333333,0.8163265306122449,69886390,21,7
2,1,0.6666666666666666,0.5,82128789,3,2
1,70,0.2708333333333333,0.7090909090909091,80180168,96,26
1,101,0.28368794326241137,0.5875486381322957,74445616,141,40
0,27,0.4489795918367347,0.41025641025641024,67326175,49,22
0,77,0.18085106382978725,0.4647887323943662,68533381,94,17
1,47,0.36486486486486486,0.8676470588235294,67557175,74,27
1,7,0.46153846153846156,0.9642857142857143,69611381,13,6
0,137,0.12179487179487179,0.18373493975903615,82166805,156,19
2,38,0.6607142857142857,0.9879518072289156,68668866,112,74
1,112,0.3812154696132597,0.868421052631579,80140051,181,69
0,40,0.2727272727272727,0.3974358974358974,80028473,55,15
0,21,0.25,0.32142857142857145,68333993,28,7
0,23,0.20689655172413793,0.41007194244604317,81895989,29,6
1,128,0.375609756097561,0.8825622775800712,70207466,205,77
1,133,0.2925531914893617,0.5142857142857142,74029410,188,55
0,130,0.1390728476821192,0.26666666666666666,69112365,151,21
1,31,0.3541666666666667,0.8105263157894737,35824355,48,17
1,8,0.42857142857142855,0.8275862068965517,69489196,14,6
1,3,0.4,0.8571428571428571,80105102,5,2
2,4,0.6363636363636364,0.8333333333333334,62402165,11,7
2,161,0.5236686390532544,0.9380952380952381,66863272,338,177
1,86,0.2833333333333333,0.6710526315789473,67514125,120,34
1,60,0.3333333333333333,0.774390243902439,70234885,90,30
0,21,0.19230769230769232,0.32608695652173914,80165183,26,5
0,18,0.18181818181818182,0.2653061224489796,71783740,22,4
2,10,0.7727272727272727,0.9629629629629629,67744411,44,34
0,64,0.20987654320987653,0.3937007874015748,82096271,81,17
2,21,0.7469879518072289,0.9333333333333333,80126953,83,62
0,23,0.14814814814814814,0.16091954022988506,68143712,27,4
1,17,0.45161290322580644,0.8536585365853658,70803005,31,14
0,4,0.0,0.0,67384086,4,0
1,212,0.3855072463768116,0.85431654676259,81971154,345,133
1,33,0.1951219512195122,0.543859649122807,67591685,41,8
1,36,0.23404255319148937,0.7486338797814208,66338825,47,11
0,4,0.0,0.0,68405260,4,0
0,80,0.14893617021276595,0.27941176470588236,82006129,94,14
1,65,0.2696629213483146,0.6812227074235808,80156769,89,24
1,6,0.25,0.6451612903225806,66222366,8,2
0,53,0.19696969696969696,0.4842105263157895,66224571,66,13
0,21,0.045454545454545456,0.049019607843137254,66225544,22,1
0,13,0.07142857142857142,0.0684931506849315,66225565,14,1
0,17,0.15,0.4225352112676056,67620504,20,3
2,1,0.5,0.9166666666666666,82017792,2,1
1,19,0.3870967741935484,0.8148148148148148,82013624,31,12
0,152,0.2205128205128205,0.3941176470588235,68755421,195,43
2,18,0.5609756097560976,0.8490566037735849,453544,41,23
2,143,0.5217391304347826,0.942652329749104,74045811,299,156
0,22,0.12,0.23076923076923078,82001449,25,3
0,49,0.2222222222222222,0.39568345323741005,80176707,63,14
1,22,0.3125,0.8571428571428571,68604004,32,10
2,21,0.625,0.8888888888888888,77319263,56,35
2,7,0.5333333333333333,0.8,70710122,15,8
0,55,0.32098765432098764,0.4846153846153846,69704096,81,26
2,4,0.8333333333333334,0.875,60156474,24,20
0,14,0.2222222222222222,0.4807692307692308,78763636,18,4
1,59,0.3058823529411765,0.5935483870967742,71458674,85,26
0,164,0.07344632768361582,0.42449664429530204,62836830,177,13
0,106,0.1092436974789916,0.27547169811320754,82103789,119,13
2,1,0.6666666666666666,0.6666666666666666,69735694,3,2
0,52,0.018867924528301886,0.0380952380952381,82003732,53,1
2,1,0.95,0.5,82051902,20,19
2,2,0.9230769230769231,0.8,70718032,26,24
2,25,0.7933884297520661,0.9859154929577465,68530063,121,96
0,35,0.125,0.21428571428571427,68499683,40,5
2,15,0.5714285714285714,0.9787234042553191,67314114,35,20
0,214,0.05726872246696035,0.18439716312056736,64240400,227,13
1,19,0.2962962962962963,0.6777777777777778,82128659,27,8
1,77,0.3888888888888889,0.823943661971831,66228505,126,49
1,56,0.4666666666666667,0.974025974025974,82101726,105,49
1,35,0.2553191489361702,0.5142857142857142,69538644,47,12
1,12,0.42857142857142855,0.9302325581395349,73871336,21,9
1,119,0.3602150537634409,0.7873563218390804,80180110,186,67
2,10,0.6296296296296297,0.9375,70404474,27,17
0,26,0.037037037037037035,0.014084507042253521,69415864,27,1
1,81,0.325,0.7297297297297297,80128691,120,39
0,43,0.044444444444444446,0.16939890710382513,70746550,45,2
0,27,0.06896551724137931,0.3225806451612903,70746830,29,2
0,178,0.23931623931623933,0.4802158273381295,68763744,234,56
1,14,0.3333333333333333,0.7272727272727273,75149522,21,7
0,84,0.20754716981132076,0.36742424242424243,67557336,106,22
0,155,0.11931818181818182,0.15759312320916904,70567896,176,21
0,91,0.061855670103092786,0.04854368932038835,70567903,97,6
0,63,0.16,0.1864406779661017,70567931,75,12
1,30,0.2857142857142857,0.6346153846153846,82002275,42,12
1,47,0.3472222222222222,0.7449664429530202,70063231,72,25
1,14,0.3333333333333333,0.6818181818181818,82163469,21,7
0,13,0.0,0.0,70850836,13,0
0,8,0.0,0.0,70398734,8,0
0,34,0.1282051282051282,0.4065934065934066,70832195,39,5
0,115,0.13533834586466165,0.17192982456140352,80123755,133,18
1,12,0.42857142857142855,0.8461538461538461,79792230,21,9
0,25,0.4897959183673469,0.4782608695652174,66371851,49,24
1,82,0.31666666666666665,0.6666666666666666,70117173,120,38
2,16,0.5789473684210527,0.8846153846153846,70658721,38,22
1,8,0.42857142857142855,0.8125,80128096,14,6
0,99,0.1951219512195122,0.33793103448275863,66892623,123,24
0,8,0.2,0.4909090909090909,70068201,10,2
0,84,0.17647058823529413,0.23387096774193547,65616824,102,18
0,92,0.1320754716981132,0.18115942028985507,65616873,106,14
1,56,0.3170731707317073,0.7456647398843931,69603121,82,26
2,8,0.7419354838709677,0.9411764705882353,82041257,31,23
2,11,0.6333333333333333,0.967741935483871,77329532,30,19
1,28,0.2631578947368421,0.7884615384615384,70474852,38,10
1,45,0.21052631578947367,0.7413793103448276,64400273,57,12
2,6,0.5384615384615384,0.9523809523809523,65288692,13,7
1,10,0.3333333333333333,0.868421052631579,65280285,15,5
1,63,0.38235294117647056,0.8217054263565892,66228400,102,39
0,34,0.02857142857142857,0.03305785123966942,63527415,35,1
1,92,0.12380952380952381,0.5493421052631579,63527450,105,13
0,151,0.08484848484848485,0.356353591160221,65840096,165,14
2,14,0.6111111111111112,0.782608695652174,73588865,36,22
0,23,0.25806451612903225,0.4807692307692308,69180195,31,8
1,42,0.391304347826087,0.9,70252336,69,27
2,15,0.6938775510204082,0.8666666666666667,157591,49,34
0,26,0.21212121212121213,0.32608695652173914,82069226,33,7
1,72,0.4626865671641791,0.8571428571428571,80134719,134,62
1,52,0.2571428571428571,0.5584415584415584,80134747,70,18
1,163,0.40942028985507245,0.9072463768115943,82095531,276,113
1,269,0.13782051282051283,0.5164021164021164,62850284,312,43
1,15,0.4,0.7857142857142857,66914260,25,10
0,47,0.22950819672131148,0.4125874125874126,82126587,61,14
0,152,0.13142857142857142,0.2608695652173913,66155201,175,23
0,52,0.11864406779661017,0.24324324324324326,69501061,59,7
1,210,0.3617021276595745,0.5166666666666667,66830302,329,119
1,62,0.25301204819277107,0.5971223021582733,68905802,83,21
1,110,0.4416243654822335,0.875,70120806,197,87
2,30,0.6296296296296297,0.6666666666666666,69406736,81,51
2,0,1.0,1.0,80003532,9,9
2,19,0.8155339805825242,0.8148148148148148,80056620,103,84
0,8,0.0,0.0,82038342,8,0
0,6,0.0,0.0,82038344,6,0
0,4,0.0,0.0,82038347,4,0
0,40,0.1836734693877551,0.29133858267716534,68637884,49,9
1,59,0.3854166666666667,0.7676767676767676,68339432,96,37
0,2,0.0,0.0,69701450,2,0
0,53,0.171875,0.31543624161073824,80070795,64,11
0,47,0.21666666666666667,0.488,82166800,60,13
1,67,0.2872340425531915,0.8520710059171598,74291973,94,27
0,34,0.1282051282051282,0.15384615384615385,73346952,39,5
0,69,0.0547945205479452,0.12987012987012986,73245571,73,4
1,128,0.2808988764044944,0.5847457627118644,67042962,178,50
1,92,0.2868217054263566,0.692,69177332,129,37
1,76,0.32142857142857145,0.7469879518072289,67942364,112,36
0,57,0.13636363636363635,0.41216216216216217,61976754,66,9
1,35,0.39655172413793105,0.91,61986092,58,23
1,21,0.4,0.8461538461538461,70688163,35,14
1,49,0.24615384615384617,0.6538461538461539,80141458,65,16
1,13,0.4583333333333333,0.7777777777777778,70646233,24,11
0,62,0.1267605633802817,0.43575418994413406,62413834,71,9
0,26,0.07142857142857142,0.09090909090909091,63972272,28,2
1,56,0.3253012048192771,0.6555555555555556,68531624,83,27
1,19,0.4411764705882353,0.8032786885245902,78110872,34,15
0,14,0.06666666666666667,0.4205607476635514,63239771,15,1
1,28,0.28205128205128205,0.7938144329896907,69691160,39,11
1,24,0.3142857142857143,0.7236842105263158,74870544,35,11
1,57,0.4818181818181818,0.9423076923076923,70071393,110,53
0,4,0.0,0.0,70682262,4,0
2,0,1.0,1.0,80117755,9,9
0,79,0.05952380952380952,0.1897810218978102,62533450,84,5
0,45,0.18181818181818182,0.41379310344827586,69559336,55,10
0,18,0.14285714285714285,0.12727272727272726,69559371,21,3
2,1,0.5,0.8571428571428571,82102520,2,1
1,84,0.20754716981132076,0.5733333333333334,64109500,106,22
0,196,0.16595744680851063,0.2918287937743191,82036903,235,39
0,27,0.1,0.41739130434782606,69549746,30,3
0,17,0.15,0.1956521739130435,67657835,20,3
1,71,0.36607142857142855,0.8193548387096774,69739243,112,41
0,77,0.17204301075268819,0.45652173913043476,63685895,93,16
1,8,0.4666666666666667,0.5,70585711,15,7
1,227,0.20905923344947736,0.511504424778761,68553681,287,60
0,33,0.175,0.41739130434782606,69510336,40,7
0,73,0.23958333333333334,0.3735632183908046,80107706,96,23
1,47,0.27692307692307694,0.6711409395973155,68396356,65,18
1,23,0.39473684210526316,0.7666666666666667,64866256,38,15
0,30,0.3181818181818182,0.48,69464913,44,14
0,144,0.17714285714285713,0.3870056497175141,69239765,175,31
1,50,0.3150684931506849,0.7674418604651163,69607846,73,23
0,24,0.1724137931034483,0.38333333333333336,82129399,29,5
0,27,0.20588235294117646,0.2796610169491525,82138824,34,7
1,2,0.3333333333333333,0.5,69667724,3,1
0,39,0.04878048780487805,0.0975609756097561,70081011,41,2
0,80,0.024390243902439025,0.03225806451612903,70081200,82,2
0,1,0.0,0.0,82012807,1,0
0,9,0.0,0.0,82021859,9,0
1,12,0.4782608695652174,0.8,64357531,23,11
0,56,0.2,0.21656050955414013,69180405,70,14
0,188,0.06,0.022222222222222223,69033132,200,12
0,74,0.11904761904761904,0.20465116279069767,72522982,84,10
0,198,0.20481927710843373,0.3397548161120841,71358882,249,51
0,180,0.06735751295336788,0.06774193548387097,80129779,193,13
1,13,0.3157894736842105,0.7777777777777778,65280810,19,6
1,111,0.26490066225165565,0.5871886120996441,82116875,151,40
1,229,0.268370607028754,0.5577557755775577,72135266,313,84
1,35,0.39655172413793105,0.8831168831168831,68401011,58,23
0,78,0.20408163265306123,0.467680608365019,69551132,98,20
2,61,0.6369047619047619,0.9423076923076923,80137975,168,107
0,11,0.08333333333333333,0.1875,69554163,12,1
0,40,0.0,0.0,70605626,40,0
1,27,0.41304347826086957,0.8404255319148937,70669515,46,19
2,106,0.511520737327189,0.9631578947368421,79787463,217,111
1,117,0.35714285714285715,0.7478005865102639,69626095,182,65
1,5,0.2857142857142857,0.7948717948717948,70675766,7,2
0,3,0.0,0.0,70682003,3,0
2,15,0.6739130434782609,0.9583333333333334,82051893,46,31
2,186,0.5013404825737265,0.9385964912280702,68945905,373,187
2,0,1.0,1.0,80058734,3,3
0,10,0.09090909090909091,0.21875,70682283,11,1
0,18,0.21739130434782608,0.4166666666666667,70063210,23,5
1,34,0.43333333333333335,0.8,70246715,60,26
1,112,0.2328767123287671,0.6350710900473934,67620441,146,34
1,26,0.23529411764705882,0.5774647887323944,67812563,34,8
0,34,0.17073170731707318,0.29508196721311475,69579482,41,7
1,6,0.25,0.6923076923076923,70490336,8,2
0,129,0.17834394904458598,0.3949843260188088,69621384,157,28
0,69,0.12658227848101267,0.2553191489361702,68499774,79,10
2,11,0.56,0.9285714285714286,80019863,25,14
0,23,0.041666666666666664,0.05194805194805195,62962585,24,1
0,42,0.125,0.2361111111111111,69158026,48,6
0,129,0.051470588235294115,0.18037135278514588,63780395,136,7
1,32,0.2558139534883721,0.5512820512820513,81956142,43,11
2,1,0.8,0.5,69933843,5,4
0,53,0.208955223880597,0.48760330578512395,69421646,67,14
1,83,0.336,0.7589743589743589,73977904,125,42
2,28,0.7454545454545455,0.9726027397260274,80169815,110,82
1,41,0.4142857142857143,0.8857142857142857,62173720,70,29
1,3,0.4,0.7692307692307693,70861203,5,2
2,26,0.5,0.9253731343283582,82052047,52,26
0,21,0.045454545454545456,0.25882352941176473,80124308,22,1
0,152,0.22448979591836735,0.4485981308411215,69607461,196,44
1,77,0.3888888888888889,0.8050314465408805,68725706,126,49
1,44,0.42105263157894735,0.9065420560747663,68401655,76,32
0,8,0.2,0.25,80118872,10,2
0,68,0.11688311688311688,0.10526315789473684,82250925,77,9
0,2,0.0,0.0,80126524,2,0
0,39,0.04878048780487805,0.04819277108433735,69391105,41,2
0,28,0.0967741935483871,0.3786407766990291,69391042,31,3
0,46,0.2698412698412698,0.35064935064935066,69458641,63,17
1,133,0.23121387283236994,0.6217008797653959,80121246,173,40
1,8,0.1111111111111111,0.5208333333333334,62838650,9,1
0,38,0.02564102564102564,0.052083333333333336,68499872,39,1
1,58,0.2564102564102564,0.6370370370370371,68499942,78,20
1,270,0.32160804020100503,0.7869822485207101,68531435,398,128
2,15,0.6875,0.9666666666666667,80176866,48,33
1,14,0.2631578947368421,0.5769230769230769,69498506,19,5
2,39,0.524390243902439,0.9351851851851852,80156684,82,43
1,16,0.36,0.825,64231223,25,9
2,48,0.6595744680851063,0.9696969696969697,80152996,141,93
0,50,0.09090909090909091,0.19318181818181818,73982874,55,5
1,48,0.30434782608695654,0.6490066225165563,70759675,69,21
0,8,0.0,0.0,80122889,8,0
2,0,1.0,1.0,73551394,8,8
2,1,0.5,0.8571428571428571,82021471,2,1
1,5,0.4444444444444444,0.5,66228106,9,4
2,4,0.5555555555555556,0.6,66228421,9,5
1,77,0.2524271844660194,0.6513157894736842,64163456,103,26
1,33,0.13157894736842105,0.6993006993006993,66026044,38,5
1,145,0.11042944785276074,0.5191146881287726,62839042,163,18
1,157,0.2798165137614679,0.5701492537313433,81967313,218,61
0,66,0.05714285714285714,0.37572254335260113,62834534,70,4
0,8,0.0,0.0,70669634,8,0
1,34,0.22727272727272727,0.7133333333333334,62850375,44,10
2,20,0.801980198019802,0.967741935483871,67699471,101,81
0,48,0.14285714285714285,0.10144927536231885,67552093,56,8
2,37,0.5934065934065934,0.9384615384615385,82018808,91,54
1,8,0.42857142857142855,0.7916666666666666,82018968,14,6
1,189,0.42378048780487804,0.919047619047619,65029930,328,139
2,31,0.6125,0.8983050847457628,73829924,80,49
2,15,0.5454545454545454,0.8846153846153846,69594280,33,18
1,103,0.1557377049180328,0.5072463768115942,73398983,122,19
0,102,0.009708737864077669,0.009732360097323601,62839154,103,1
0,8,0.2727272727272727,0.4375,77329560,11,3
0,31,0.16216216216216217,0.4823529411764706,69007260,37,6
0,1,0.0,0.0,70707574,1,0
2,3,0.625,0.8181818181818182,79792580,8,5
1,106,0.3161290322580645,0.7326388888888888,81971148,155,49
2,2,0.8,0.6666666666666666,80091802,10,8
2,15,0.5,0.3333333333333333,80094924,30,15
2,0,1.0,1.0,74320771,18,18
2,24,0.6470588235294118,0.9166666666666666,68796644,68,44
2,32,0.5294117647058824,0.9761904761904762,70585991,68,36
2,39,0.7364864864864865,0.8490566037735849,66480393,148,109
2,11,0.6944444444444444,0.98,80176851,36,25
1,114,0.22972972972972974,0.5192307692307693,67511311,148,34
1,15,0.4230769230769231,0.8823529411764706,69666772,26,11
0,90,0.0425531914893617,0.18159203980099503,62839021,94,4
0,105,0.0625,0.3630434782608696,68798163,112,7
1,6,0.3333333333333333,0.7857142857142857,68461666,9,3
0,87,0.07446808510638298,0.14093959731543623,70608034,94,7
1,24,0.4,0.7916666666666666,80066413,40,16
2,7,0.631578947368421,0.96,80176849,19,12
2,7,0.65,0.9444444444444444,81895999,20,13
1,99,0.38125,0.6810344827586207,67764060,160,61
1,88,0.375886524822695,0.8629441624365483,69177493,141,53
2,6,0.5,0.9230769230769231,65279823,12,6
2,11,0.5925925925925926,0.967741935483871,73975062,27,16
2,14,0.5483870967741935,0.975,69152384,31,17
0,96,0.15789473684210525,0.3914590747330961,82012547,114,18
1,130,0.23076923076923078,0.5331325301204819,69234872,169,39
0,102,0.1282051282051282,0.19557195571955718,70686595,117,15
2,9,0.7272727272727273,0.8947368421052632,72426060,33,24
0,7,0.2222222222222222,0.4444444444444444,69390622,9,2
1,26,0.4090909090909091,0.7906976744186046,70591682,44,18
1,7,0.36363636363636365,0.625,76977334,11,4
1,10,0.23076923076923078,0.5555555555555556,65280271,13,3
1,12,0.4782608695652174,0.9090909090909091,65289056,23,11
2,13,0.5666666666666667,0.9,80135029,30,17
1,13,0.43478260869565216,0.96875,65293060,23,10
1,16,0.4666666666666667,0.9375,65288790,30,14
1,88,0.47928994082840237,0.8,69058836,169,81
1,36,0.2653061224489796,0.7107438016528925,70759864,49,13
0,133,0.08904109589041095,0.136,66087616,146,13
2,10,0.8245614035087719,0.9523809523809523,80118339,57,47
1,47,0.29850746268656714,0.8,66411975,67,20
2,5,0.5,0.8823529411764706,72801722,10,5
0,57,0.05,0.04838709677419355,82152763,60,3
0,28,0.24324324324324326,0.46,82152765,37,9
0,27,0.06896551724137931,0.075,82152766,29,2
0,49,0.0392156862745098,0.15625,80124240,51,2
2,1,0.9166666666666666,0.5,80118600,12,11
1,100,0.39759036144578314,0.8514056224899599,66052714,166,66
0,3,0.0,0.0,69421331,3,0
1,128,0.3435897435897436,0.7559322033898305,68741736,195,67
1,37,0.4032258064516129,0.8253968253968254,69215216,62,25
0,7,0.0,0.0,66111213,7,0
2,6,0.75,0.875,69622434,24,18
1,112,0.4074074074074074,0.9251700680272109,69056351,189,77
0,36,0.25,0.373134328358209,68401221,48,12
1,90,0.46107784431137727,0.912621359223301,69056281,167,77
1,8,0.38461538461538464,0.8571428571428571,68286043,13,5
0,104,0.08771929824561403,0.1705685618729097,69417425,114,10
2,17,0.5277777777777778,0.9322033898305084,70646380,36,19
0,30,0.21052631578947367,0.4602272727272727,82116843,38,8
2,31,0.5,0.7441860465116279,69972364,62,31
1,217,0.2517241379310345,0.6036585365853658,68533493,290,73
1,37,0.32727272727272727,0.6493506493506493,82018803,55,18
2,9,0.6666666666666666,0.975,80176858,27,18
0,13,0.07142857142857142,0.15217391304347827,72808764,14,1
0,189,0.08695652173913043,0.0467706013363029,77676494,207,18
0,121,0.15384615384615385,0.3053435114503817,80053554,143,22
0,17,0.22727272727272727,0.32653061224489793,66603985,22,5
0,6,0.14285714285714285,0.07142857142857142,82200544,7,1
2,32,0.5076923076923077,0.922077922077922,70720216,65,33
0,91,0.19469026548672566,0.3031674208144796,82126764,113,22
1,40,0.24528301886792453,0.5426356589147286,70395213,53,13
1,53,0.4175824175824176,0.810126582278481,82009539,91,38
0,11,0.3125,0.4444444444444444,80172319,16,5
0,6,0.0,0.0,67095070,6,0
0,54,0.06896551724137931,0.0859375,68299700,58,4
0,47,0.020833333333333332,0.16129032258064516,82090176,48,1
1,5,0.2857142857142857,0.9,68498815,7,2
0,38,0.05,0.29577464788732394,68499473,40,2
0,27,0.03571428571428571,0.3090909090909091,69479312,28,1
1,6,0.25,0.9130434782608695,70229656,8,2
0,75,0.013157894736842105,0.04597701149425287,82152148,76,1
1,70,0.3137254901960784,0.8078175895765473,69482861,102,32
1,5,0.16666666666666666,0.6530612244897959,81989789,6,1
2,10,0.8214285714285714,0.96,70189336,56,46
1,16,0.36,0.6857142857142857,80178882,25,9
1,61,0.3838383838383838,0.8620689655172413,67053063,99,38
0,52,0.07142857142857142,0.13138686131386862,62841975,56,4
0,61,0.06153846153846154,0.031914893617021274,63598696,65,4
1,13,0.3157894736842105,0.7837837837837838,67802721,19,6
0,11,0.0,0.0,67094125,11,0
1,126,0.31521739130434784,0.5911330049261084,80176749,184,58
1,36,0.47058823529411764,0.8875,72425633,68,32
0,33,0.05714285714285714,0.20454545454545456,60513614,35,2
0,83,0.07777777777777778,0.2962962962962963,60232536,90,7
2,7,0.6666666666666666,0.9444444444444444,80058776,21,14
0,33,0.25,0.49333333333333335,64938286,44,11
1,24,0.3142857142857143,0.8181818181818182,64938384,35,11
0,19,0.17391304347826086,0.21333333333333335,75121144,23,4
1,79,0.3828125,0.9082125603864735,82126628,128,49
0,85,0.17475728155339806,0.3595890410958904,80132464,103,18
1,28,0.3170731707317073,0.684931506849315,78863645,41,13
0,75,0.18478260869565216,0.37606837606837606,82000027,92,17
1,22,0.26666666666666666,0.7848101265822784,82103790,30,8
1,85,0.4585987261146497,0.8622754491017964,70505883,157,72
1,100,0.3197278911564626,0.702020202020202,66831912,147,47
1,9,0.4375,0.8666666666666667,68363442,16,7
1,47,0.3088235294117647,0.7906976744186046,82150078,68,21
1,102,0.1774193548387097,0.5152671755725191,65251886,124,22
0,21,0.25,0.4883720930232558,80108833,28,7
1,119,0.4079601990049751,0.8544600938967136,73650801,201,82
1,8,0.4666666666666667,0.8947368421052632,68401116,15,7
2,1,0.5,0.5,69833043,2,1
1,18,0.3333333333333333,0.7368421052631579,82007157,27,9
0,102,0.26618705035971224,0.4956521739130435,80107475,139,37
0,56,0.15151515151515152,0.34545454545454546,70831866,66,10
0,131,0.28415300546448086,0.4444444444444444,69489441,183,52
2,2,0.7142857142857143,0.75,79792321,7,5
0,54,0.23943661971830985,0.3806818181818182,66388455,71,17
1,143,0.3125,0.6910569105691057,80120473,208,65
1,14,0.3,0.6470588235294118,69611430,20,6
2,2,0.7142857142857143,0.6666666666666666,63177576,7,5
0,8,0.1111111111111111,0.4,80163667,9,1
0,2,0.0,0.0,80163689,2,0
0,11,0.08333333333333333,0.07142857142857142,80163691,12,1
2,14,0.5,0.8974358974358975,80145765,28,14
2,35,0.5,0.9583333333333334,73348856,70,35
0,159,0.024539877300613498,0.08522727272727272,80124226,163,4
2,1,0.9230769230769231,0.5,80126502,13,12
1,5,0.375,0.8666666666666667,80083374,8,3
2,1,0.8571428571428571,0.0,82052097,7,6
1,31,0.48333333333333334,0.9183673469387755,80122708,60,29
0,45,0.22413793103448276,0.3867924528301887,66062745,58,13
1,45,0.47058823529411764,0.9252336448598131,67252164,85,40
0,51,0.2153846153846154,0.390625,82126630,65,14
0,240,0.22330097087378642,0.34549878345498786,69458592,309,69
2,13,0.5,0.975609756097561,82139994,26,13
1,26,0.13333333333333333,0.532608695652174,68798443,30,4
0,125,0.17218543046357615,0.19753086419753085,68433981,151,26
1,42,0.34375,0.6823529411764706,66411982,64,22
1,19,0.2692307692307692,0.5918367346938775,82108572,26,7
0,2,0.0,0.0,63159726,2,0
1,49,0.3,0.7560975609756098,63702275,70,21
1,82,0.41007194244604317,0.6857142857142857,72700201,139,57
2,56,0.5130434782608696,0.8699186991869918,67753756,115,59
1,93,0.4745762711864407,0.9174311926605505,80165688,177,84
1,20,0.3939393939393939,0.875,69732824,33,13
1,29,0.275,0.5604395604395604,80104864,40,11
0,24,0.2,0.4032258064516129,69188063,30,6
0,48,0.02040816326530612,0.0,67889290,49,1
1,209,0.2939189189189189,0.6187624750499002,66857413,296,87
0,2,0.0,0.0,70678874,2,0
2,11,0.7105263157894737,0.926829268292683,80122546,38,27
0,66,0.2235294117647059,0.46551724137931033,67554053,85,19
1,67,0.2872340425531915,0.6326530612244898,54551812,94,27
0,30,0.23076923076923078,0.323943661971831,80172939,39,9
1,251,0.25297619047619047,0.629976580796253,80121089,336,85
1,137,0.2388888888888889,0.6134751773049646,73098991,180,43
1,36,0.23404255319148937,0.5815602836879432,70018753,47,11
2,13,0.6060606060606061,0.972972972972973,74047302,33,20
1,47,0.37333333333333335,0.9150326797385621,70072786,75,28
2,50,0.7340425531914894,0.954954954954955,70460250,188,138
0,2,0.0,0.0,70933772,2,0
1,28,0.3333333333333333,0.7065217391304348,82126808,42,14
1,39,0.43478260869565216,0.6829268292682927,57042496,69,30
0,92,0.17857142857142858,0.2978723404255319,61706190,112,20
1,107,0.28187919463087246,0.5853658536585366,82128660,149,42
1,23,0.34285714285714286,0.5869565217391305,70252371,35,12
1,41,0.29310344827586204,0.5785123966942148,72208661,58,17
2,5,0.782608695652174,0.967741935483871,77769930,23,18
1,4,0.3333333333333333,0.875,70677803,6,2
2,1,0.8333333333333334,0.5,80172928,6,5
0,15,0.0625,0.27419354838709675,70701974,16,1
0,27,0.06896551724137931,0.319672131147541,70705215,29,2
0,110,0.05982905982905983,0.07627118644067797,66885770,117,7
1,65,0.32989690721649484,0.7897727272727273,66856615,97,32
0,31,0.1388888888888889,0.1836734693877551,70045311,36,5
0,21,0.125,0.3037974683544304,69416963,24,3
0,100,0.2,0.47413793103448276,68138385,125,25
1,43,0.37681159420289856,0.7720588235294118,65934064,69,26
1,28,0.37777777777777777,0.703125,69617275,45,17
0,87,0.19444444444444445,0.305,69183660,108,21
2,1,0.8888888888888888,0.75,82095539,9,8
2,4,0.9,0.5,80118218,40,36
1,30,0.3333333333333333,0.7974683544303798,73977666,45,15
0,6,0.14285714285714285,0.0,68044550,7,1
0,8,0.1111111111111111,0.0,69514270,9,1
2,17,0.6222222222222222,0.9545454545454546,70231770,45,28
2,0,1.0,1.0,69884451,2,2
2,0,1.0,1.0,82012778,2,2
1,4,0.2,0.7169811320754716,68497765,5,1
0,104,0.07964601769911504,0.2692307692307692,70746410,113,9
0,1,0.0,0.0,80176177,1,0
0,48,0.2,0.42857142857142855,80140095,60,12
1,29,0.30952380952380953,0.8539325842696629,70045262,42,13
2,41,0.5494505494505495,0.9652173913043478,80125110,91,50
0,42,0.288135593220339,0.44761904761904764,66272101,59,17
0,58,0.21621621621621623,0.3698630136986301,71458695,74,16
2,19,0.6346153846153846,0.8421052631578947,71199520,52,33
1,33,0.25,0.6043956043956044,70675570,44,11
2,2,0.9130434782608695,0.9090909090909091,80149259,23,21
1,14,0.46153846153846156,0.8103448275862069,66903326,26,12
1,116,0.30952380952380953,0.7704402515723271,80071320,168,52
0,122,0.18666666666666668,0.49865951742627346,68311502,150,28
2,8,0.5294117647058824,0.8571428571428571,66257541,17,9
2,5,0.6666666666666666,0.8888888888888888,66258101,15,10
2,12,0.7391304347826086,0.8461538461538461,80117723,46,34
1,88,0.23478260869565218,0.5654205607476636,82054696,115,27
0,16,0.2,0.4444444444444444,82251169,20,4
0,22,0.0,0.0,69416053,22,0
1,17,0.22727272727272727,0.7692307692307693,63780570,22,5
1,37,0.2127659574468085,0.5060240963855421,65013326,47,10
1,28,0.40425531914893614,0.8163265306122449,67637752,47,19
0,128,0.04477611940298507,0.3038229376257545,80138867,134,6
1,10,0.2857142857142857,0.76,82008917,14,4
0,19,0.0,0.0,66472042,19,0
1,14,0.17647058823529413,0.6990291262135923,78166032,17,3
1,8,0.2,0.6923076923076923,72475186,10,2
0,3,0.0,0.0,80122910,3,0
1,3,0.25,0.75,80122920,4,1
1,47,0.45977011494252873,0.8478260869565217,80145769,87,40
2,5,0.5454545454545454,0.75,80118249,11,6
2,3,0.625,0.9,68240382,8,5
0,64,0.1111111111111111,0.27325581395348836,70633675,72,8
2,8,0.5,0.8888888888888888,72425556,16,8
1,35,0.4444444444444444,0.9315068493150684,80134790,63,28
0,11,0.15384615384615385,0.4,80135047,13,2
2,8,0.5789473684210527,0.9772727272727273,80097080,19,11
2,12,0.5,0.9310344827586207,80067344,24,12
0,9,0.0,0.0,54468456,9,0
0,95,0.23387096774193547,0.45528455284552843,68542565,124,29
0,14,0.0,0.0,68017803,14,0
1,47,0.27692307692307694,0.6688741721854304,70045276,65,18
2,1,0.5,0.8571428571428571,68150054,2,1
1,68,0.2916666666666667,0.6466165413533834,70770315,96,28
1,17,0.22727272727272727,0.5052631578947369,62646584,22,5
0,20,0.25925925925925924,0.41935483870967744,69049932,27,7
0,10,0.3333333333333333,0.375,69966386,15,5
2,7,0.75,0.9629629629629629,70769692,28,21
2,4,0.5555555555555556,0.16666666666666666,80128797,9,5
0,150,0.1712707182320442,0.4766355140186916,70222642,181,31
1,5,0.4444444444444444,0.9444444444444444,70669564,9,4
1,13,0.23529411764705882,0.581081081081081,82129396,17,4
2,29,0.532258064516129,0.9310344827586207,80138911,62,33
2,12,0.7272727272727273,0.9444444444444444,60600302,44,32
0,54,0.0,0.0,70600124,54,0
0,32,0.0,0.0,70600264,32,0
0,110,0.017857142857142856,0.11764705882352941,70600320,112,2
0,45,0.021739130434782608,0.11235955056179775,70600411,46,1
0,36,0.14285714285714285,0.14166666666666666,66723664,42,6
1,160,0.19597989949748743,0.5736434108527132,68241544,199,39
0,94,0.14545454545454545,0.29515418502202645,70350721,110,16
0,30,0.0625,0.125,72775052,32,2
0,13,0.1875,0.46153846153846156,72775591,16,3
0,124,0.1079136690647482,0.1970260223048327,66224690,139,15
0,9,0.18181818181818182,0.42857142857142855,67066580,11,2
0,7,0.0,0.0,70746704,7,0
0,29,0.09375,0.46923076923076923,68357254,32,3
1,57,0.4,0.92,80135751,95,38
0,40,0.047619047619047616,0.1297709923664122,80029061,42,2
0,71,0.06578947368421052,0.2550335570469799,80089646,76,5
2,2,0.6,0.8,66221260,5,3
1,58,0.3409090909090909,0.7916666666666666,80055080,88,30
1,111,0.26973684210526316,0.7665369649805448,68543524,152,41
0,63,0.24096385542168675,0.37662337662337664,69183422,83,20
1,4,0.42857142857142855,0.85,65282224,7,3
1,49,0.2222222222222222,0.7814207650273224,69597906,63,14
1,18,0.18181818181818182,0.5,64982631,22,4
1,129,0.42152466367713004,0.8685714285714285,80180353,223,94
0,194,0.08056872037914692,0.3088235294117647,70001246,211,17
0,132,0.07042253521126761,0.24,61394221,142,10
2,3,0.7,0.9333333333333333,68666374,10,7
0,31,0.18421052631578946,0.35398230088495575,69416585,38,7
0,42,0.16,0.34782608695652173,80141502,50,8
1,23,0.20689655172413793,0.5098039215686274,80127848,29,6
0,197,0.03902439024390244,0.07394366197183098,70080934,205,8
0,245,0.0959409594095941,0.2,70081165,271,26
1,7,0.3,0.8018018018018018,82137456,10,3
0,21,0.0,0.0,82137473,21,0
0,10,0.0,0.0,82137480,10,0
0,20,0.0,0.0,82137492,20,0
0,10,0.0,0.0,82137494,10,0
0,14,0.0,0.0,82137500,14,0
0,11,0.0,0.0,82137509,11,0
1,27,0.37209302325581395,0.9217391304347826,69003235,43,16
1,27,0.4489795918367347,0.8870967741935484,80132321,49,22
1,210,0.3768545994065282,0.81,70040383,337,127
0,25,0.10714285714285714,0.11494252873563218,80137552,28,3
2,1,0.5,0.8571428571428571,69057506,2,1
1,158,0.3039647577092511,0.7380952380952381,70486066,227,69
0,209,0.21722846441947566,0.43333333333333335,77563864,267,58
0,39,0.1702127659574468,0.11235955056179775,70463904,47,8
2,18,0.55,0.8,77349825,40,22
2,6,0.75,0.9230769230769231,77349832,24,18
0,20,0.3333333333333333,0.25925925925925924,69524763,30,10
2,20,0.5348837209302325,0.5806451612903226,80168332,43,23
0,1,0.0,0.0,70697893,1,0
2,7,0.7941176470588235,0.9090909090909091,74944254,34,27
0,7,0.125,0.2916666666666667,70697256,8,1
0,61,0.11594202898550725,0.18487394957983194,72808533,69,8
0,59,0.10606060606060606,0.25742574257425743,73007186,66,7
0,3,0.25,0.3333333333333333,80153636,4,1
1,21,0.36363636363636365,0.7307692307692307,69666891,33,12
1,33,0.46774193548387094,0.8857142857142857,65674973,62,29
0,27,0.25,0.45652173913043476,62988051,36,9
2,7,0.5,0.9333333333333333,62017060,14,7
1,52,0.30666666666666664,0.696078431372549,68761651,75,23
1,7,0.3,0.6666666666666666,68401732,10,3
1,85,0.3359375,0.7986111111111112,67558155,128,43
1,53,0.273972602739726,0.5813953488372093,69873643,73,20
0,22,0.18518518518518517,0.3333333333333333,72920953,27,5
2,7,0.5,0.8421052631578947,66337810,14,7
0,14,0.125,0.045454545454545456,82165053,16,2
2,45,0.6616541353383458,0.8695652173913043,70911351,133,88
2,21,0.7,0.76,80056606,70,49
0,42,0.08695652173913043,0.25161290322580643,69256320,46,4
2,16,0.6,0.9310344827586207,68402145,40,24
0,26,0.2972972972972973,0.4166666666666667,68401550,37,11
1,69,0.41025641025641024,0.8618421052631579,81971186,117,48
1,12,0.45454545454545453,0.7567567567567568,65713774,22,10
0,6,0.14285714285714285,0.16666666666666666,66110891,7,1
2,2,0.6666666666666666,0.75,82096239,6,4
1,31,0.38,0.7323943661971831,80163141,50,19
1,15,0.375,0.86,69579524,24,9
1,30,0.3023255813953488,0.7317073170731707,76600755,43,13
1,78,0.4264705882352941,0.9179487179487179,72417205,136,58
1,84,0.4166666666666667,0.8071065989847716,72417191,144,60
0,59,0.18055555555555555,0.39814814814814814,70638001,72,13
2,14,0.6744186046511628,0.6428571428571429,61843411,43,29
1,37,0.421875,0.868421052631579,78110865,64,27
2,6,0.5384615384615384,0.9,62912556,13,7
0,66,0.14285714285714285,0.4702702702702703,70230244,77,11
0,131,0.050724637681159424,0.20113314447592068,70001561,138,7
0,18,0.25,0.24242424242424243,68401662,24,6
1,19,0.4411764705882353,0.88,80161490,34,15
1,26,0.43478260869565216,0.8775510204081632,74545051,46,20
1,27,0.49056603773584906,0.9056603773584906,73623116,53,26
0,29,0.09375,0.19672131147540983,521871,32,3
2,4,0.5555555555555556,0.875,69484443,9,5
1,130,0.23976608187134502,0.5067114093959731,65667546,171,41
1,26,0.36585365853658536,0.8266666666666667,66855761,41,15
2,0,1.0,1.0,68760125,1,1
1,55,0.27631578947368424,0.504424778761062,70121730,76,21
1,80,0.3333333333333333,0.7559808612440191,69724074,120,40
2,19,0.525,0.90625,82039841,40,21
1,50,0.4186046511627907,0.8558558558558559,68401144,86,36
1,101,0.3129251700680272,0.7022222222222222,68949062,147,46
1,65,0.3157894736842105,0.7710280373831776,73200015,95,30
1,36,0.3076923076923077,0.7712765957446809,69577571,52,16
0,5,0.0,0.0,66110233,5,0
1,5,0.375,0.6666666666666666,70919261,8,3
0,20,0.0,0.0,70675080,20,0
0,3,0.0,0.0,70702184,3,0
0,8,0.0,0.0,72909935,8,0
0,3,0.0,0.0,80124796,3,0
1,17,0.19047619047619047,0.6909090909090909,80137578,21,4
1,7,0.3,0.7659574468085106,65279116,10,3
0,79,0.12222222222222222,0.39215686274509803,60313092,90,11
2,5,0.5454545454545454,0.9285714285714286,66152786,11,6
0,83,0.14432989690721648,0.24761904761904763,70713846,97,14
1,175,0.27983539094650206,0.7032258064516129,68533626,243,68
1,60,0.3617021276595745,0.8528138528138528,70758716,94,34
1,10,0.2857142857142857,0.8157894736842105,70058415,14,4
0,23,0.0,0.0,70239603,23,0
1,41,0.16326530612244897,0.6571428571428571,70416962,49,8
0,24,0.1111111111111111,0.4536082474226804,70746466,27,3
1,89,0.44375,0.8819875776397516,80096275,160,71
1,46,0.41025641025641024,0.8636363636363636,72417163,78,32
1,4,0.2,0.8235294117647058,70914235,5,1
0,24,0.2,0.34328358208955223,69705244,30,6
2,0,1.0,1.0,967645,15,15
0,26,0.1875,0.24,69737234,32,6
2,14,0.5,0.9433962264150944,80128504,28,14
1,37,0.22916666666666666,0.5576923076923077,80162849,48,11
0,74,0.0,0.0,80150005,74,0
0,63,0.05970149253731343,0.22580645161290322,63169736,67,4
0,66,0.13157894736842105,0.37158469945355194,63627844,76,10
0,19,0.09523809523809523,0.1111111111111111,71619310,21,2
0,2,0.0,0.0,71619352,2,0
1,35,0.3,0.8333333333333334,71620052,50,15
0,16,0.2,0.4788732394366197,80154105,20,4
0,90,0.1,0.255,69005734,100,10
1,31,0.18421052631578946,0.5543478260869565,80155845,38,7
0,3,0.0,0.0,69170024,3,0
0,27,0.1,0.08045977011494253,67049563,30,3
0,80,0.1111111111111111,0.20689655172413793,70618016,90,10
1,15,0.21052631578947367,0.5614035087719298,80128242,19,4
2,31,0.5441176470588235,0.9102564102564102,80089905,68,37
0,26,0.13333333333333333,0.24545454545454545,69660325,30,4
1,11,0.3888888888888889,0.8918918918918919,73421481,18,7
0,9,0.0,0.0,80149984,9,0
1,5,0.4444444444444444,0.9375,64469531,9,4
1,150,0.20212765957446807,0.6104294478527608,65400944,188,38
0,11,0.0,0.0,70324632,11,0
1,15,0.34782608695652173,0.8604651162790697,65201983,23,8
1,5,0.16666666666666666,0.5454545454545454,82102652,6,1
1,39,0.22,0.5267857142857143,80128175,50,11
0,8,0.1111111111111111,0.0,73870300,9,1
0,26,0.07142857142857142,0.1794871794871795,82036404,28,2
0,102,0.07272727272727272,0.2398843930635838,80128146,110,8
2,2,0.5,0.7777777777777778,80128352,4,2
1,61,0.2823529411764706,0.7721518987341772,63264824,85,24
1,51,0.41379310344827586,0.7375,70544166,87,36
2,97,0.5174129353233831,0.7373737373737373,69980120,201,104
1,102,0.32450331125827814,0.7686567164179104,72270765,151,49
1,93,0.3357142857142857,0.7476635514018691,70005894,140,47
1,53,0.3614457831325301,0.7142857142857143,64225175,83,30
1,131,0.4353448275862069,0.9003021148036254,54888911,232,101
0,66,0.1951219512195122,0.21875,65005962,82,16
1,56,0.44554455445544555,0.9363636363636364,80166906,101,45
1,60,0.3333333333333333,0.6836734693877551,80051601,90,30
1,26,0.3953488372093023,0.828125,65545053,43,17
0,32,0.1111111111111111,0.1732283464566929,82039211,36,4
1,37,0.2127659574468085,0.5079365079365079,72157085,47,10
1,87,0.3409090909090909,0.8495934959349594,67819290,132,45
0,11,0.3125,0.4583333333333333,82014486,16,5
1,10,0.47368421052631576,0.8181818181818182,82014487,19,9
2,26,0.7111111111111111,0.978494623655914,70411082,90,64
1,8,0.38461538461538464,0.8333333333333334,65675015,13,5
2,22,0.5217391304347826,0.9206349206349206,70687792,46,24
0,75,0.20212765957446807,0.3987730061349693,80070844,94,19
1,130,0.2571428571428571,0.6078431372549019,69603786,175,45
0,95,0.08653846153846154,0.125,82000075,104,9
0,10,0.3333333333333333,0.4375,80056263,15,5
2,7,0.8108108108108109,0.9230769230769231,82039298,37,30
0,9,0.18181818181818182,0.3181818181818182,80141487,11,2
0,3,0.0,0.0,80155201,3,0
1,3,0.4,0.5,70703766,5,2
1,65,0.2073170731707317,0.5454545454545454,80140118,82,17
2,19,0.525,0.9375,74656372,40,21
2,17,0.7166666666666667,0.9142857142857143,80117740,60,43
1,13,0.2777777777777778,0.5263157894736842,69151390,18,5
2,12,0.7209302325581395,0.9411764705882353,64660022,43,31
1,16,0.2727272727272727,0.5333333333333333,81971428,22,6
0,25,0.24242424242424243,0.47058823529411764,66804241,33,8
1,46,0.3698630136986301,0.8319327731092437,67086173,73,27
1,8,0.42857142857142855,0.8636363636363636,68144412,14,6
0,10,0.09090909090909091,0.15625,73801504,11,1
1,9,0.3076923076923077,0.6129032258064516,73801511,13,4
2,1,0.5,0.5,65295356,2,1
2,24,0.7241379310344828,0.9285714285714286,77312473,87,63
1,33,0.35294117647058826,0.8494623655913979,64975736,51,18
2,34,0.5853658536585366,0.956140350877193,80136357,82,48
1,46,0.4945054945054945,0.8666666666666667,65865961,91,45
1,5,0.375,0.631578947368421,69116992,8,3
0,9,0.1,0.13043478260869565,80126818,10,1
0,5,0.0,0.0,82013601,5,0
1,80,0.38461538461538464,0.85,67995781,130,50
0,25,0.038461538461538464,0.09482758620689655,66442026,26,1
0,143,0.06535947712418301,0.30718954248366015,69007232,153,10
2,2,0.875,0.75,80176255,16,14
2,20,0.5121951219512195,0.975,68241824,41,21
2,67,0.5503355704697986,0.8583333333333333,80134709,149,82
2,25,0.5098039215686274,0.875,80123546,51,26
1,160,0.41818181818181815,0.8883495145631068,80152720,275,115
2,23,0.6805555555555556,0.8048780487804879,66379740,72,49
2,12,0.7647058823529411,0.9629629629629629,65974174,51,39
0,17,0.19047619047619047,0.3333333333333333,82124914,21,4
0,95,0.12037037037037036,0.1527777777777778,82061331,108,13
0,37,0.05128205128205128,0.03571428571428571,82061332,39,2
2,10,0.7142857142857143,0.9473684210526315,73609641,35,25
1,20,0.4444444444444444,0.8888888888888888,70192521,36,16
0,306,0.211340206185567,0.3723577235772358,80127932,388,82
0,106,0.061946902654867256,0.11072664359861592,74924213,113,7
1,45,0.3181818181818182,0.6515151515151515,63579705,66,21
2,8,0.84,0.9629629629629629,67142495,50,42
0,83,0.08791208791208792,0.060810810810810814,80123613,91,8
1,21,0.46153846153846156,0.8222222222222222,80125556,39,18
0,102,0.14285714285714285,0.17372881355932204,70047831,119,17
2,1,0.6666666666666666,0.75,81953878,3,2
0,220,0.140625,0.1697674418604651,70753312,256,36
2,0,1.0,1.0,80117722,5,5
2,5,0.8913043478260869,0.9285714285714286,80117712,46,41
0,114,0.14925373134328357,0.26136363636363635,74158721,134,20
0,281,0.04421768707482993,0.1746987951807229,62834856,294,13
2,31,0.69,0.9591836734693877,80155213,100,69
2,6,0.6,0.9285714285714286,68191060,15,9
2,3,0.9302325581395349,0.8,67457621,43,40
1,12,0.4782608695652174,0.94,82010270,23,11
1,37,0.24489795918367346,0.6699029126213593,74923814,49,12
1,11,0.3125,0.8709677419354839,82096334,16,5
2,1,0.6666666666666666,0.6666666666666666,64244544,3,2
1,28,0.3,0.7222222222222222,70798931,40,12
0,90,0.09090909090909091,0.06334841628959276,68391960,99,9
1,45,0.2857142857142857,0.6833333333333333,69638800,63,18
0,114,0.10236220472440945,0.066006600660066,79651033,127,13
0,140,0.1907514450867052,0.3415841584158416,70618366,173,33
0,48,0.2,0.2857142857142857,69334615,60,12
1,24,0.3684210526315789,0.8666666666666667,70587755,38,14
1,69,0.24175824175824176,0.6387434554973822,69160021,91,22
1,34,0.19047619047619047,0.7532467532467533,67976104,42,8
0,78,0.0,0.0,80149929,78,0
0,73,0.0759493670886076,0.3840304182509506,82206210,79,6
1,18,0.25,0.7837837837837838,63168931,24,6
1,99,0.09174311926605505,0.627906976744186,66026093,109,10
1,11,0.15384615384615385,0.7472527472527473,80167326,13,2
0,2,0.0,0.0,80176294,2,0
0,1,0.0,0.0,82006873,1,0
0,11,0.0,0.0,80150701,11,0
0,10,0.0,0.0,80150711,10,0
0,13,0.0,0.0,80150731,13,0
0,41,0.06818181818181818,0.47863247863247865,67896556,44,3
0,28,0.125,0.4148936170212766,69528074,32,4
0,50,0.038461538461538464,0.27896995708154504,69858271,52,2
1,6,0.14285714285714285,0.86,69867994,7,1
0,14,0.0,0.0,82049140,14,0
0,26,0.0,0.0,80155862,26,0
1,13,0.13333333333333333,0.5254237288135594,80165769,15,2
0,27,0.18181818181818182,0.2,80137715,33,6
0,19,0.17391304347826086,0.0,80137717,23,4
1,95,0.24,0.8,67509155,125,30
0,28,0.3333333333333333,0.2,75852343,42,14
1,24,0.4146341463414634,0.8913043478260869,66389673,41,17
2,12,0.5555555555555556,0.9354838709677419,66815574,27,15
0,42,0.023255813953488372,0.07344632768361582,67509554,43,1
0,9,0.0,0.0,66035865,9,0
0,1,0.0,0.0,70917315,1,0
0,42,0.16,0.4959349593495935,82150131,50,8
0,4,0.2,0.3333333333333333,80165754,5,1
0,36,0.0,0.0,82134972,36,0
0,42,0.023255813953488372,0.34220532319391633,80149909,43,1
0,16,0.0,0.0,70923643,16,0
1,51,0.23880597014925373,0.8562091503267973,69879222,67,16
1,6,0.25,0.75,80131215,8,2
1,11,0.08333333333333333,0.6031746031746031,70923566,12,1
0,14,0.06666666666666667,0.3269230769230769,70483084,15,1
0,139,0.041379310344827586,0.20610687022900764,70922376,145,6
0,26,0.10344827586206896,0.32592592592592595,82103795,29,3
0,81,0.03571428571428571,0.2508250825082508,82134955,84,3
0,112,0.042735042735042736,0.3948412698412698,69857802,117,5
0,26,0.10344827586206896,0.3375,70661360,29,3
1,2,0.3333333333333333,0.9090909090909091,69527976,3,1
0,41,0.046511627906976744,0.07526881720430108,69887272,43,2
0,47,0.0784313725490196,0.345,69250545,51,4
0,14,0.125,0.25,80128476,16,2
2,37,0.5978260869565217,0.9666666666666667,69512513,92,55
0,51,0.03773584905660377,0.11659192825112108,69250524,53,2
0,21,0.08695652173913043,0.4931506849315068,80135360,23,2
1,17,0.15,0.6886792452830188,62838671,20,3
0,41,0.023809523809523808,0.07368421052631578,68356582,42,1
0,6,0.0,0.0,80172660,6,0
0,5,0.0,0.0,68953220,5,0
0,116,0.08661417322834646,0.17391304347826086,70633521,127,11
0,38,0.11627906976744186,0.4140127388535032,82103895,43,5
0,25,0.0,0.0,80150879,25,0
1,117,0.12686567164179105,0.5543478260869565,65295405,134,17
0,17,0.0,0.0,80150502,17,0
0,7,0.0,0.0,80150700,7,0
0,13,0.0,0.0,80150716,13,0
0,1,0.0,0.0,70483343,1,0
0,4,0.0,0.0,80162870,4,0
0,125,0.015748031496062992,0.09836065573770492,82134988,127,2
0,43,0.18867924528301888,0.48255813953488375,67793565,53,10
1,81,0.2358490566037736,0.615,62148303,106,25
0,83,0.023529411764705882,0.23192019950124687,82206110,85,2
0,100,0.13793103448275862,0.3837638376383764,69887230,116,16
0,1,0.0,0.0,69464080,1,0
0,2,0.0,0.0,80167281,2,0
0,3,0.0,0.0,80167284,3,0
0,264,0.053763440860215055,0.2795321637426901,82134961,279,15
1,12,0.2,0.5714285714285714,65551360,15,3
0,39,0.025,0.09765625,62837201,40,1
1,11,0.3125,0.5625,80118170,16,5
0,100,0.2248062015503876,0.4725274725274725,80181321,129,29
1,40,0.3333333333333333,0.9030303030303031,69704684,60,20
2,8,0.6190476190476191,0.92,66469284,21,13
0,23,0.0,0.0,80149834,23,0
0,51,0.05555555555555555,0.1951219512195122,67974942,54,3
0,68,0.04225352112676056,0.152,69911646,71,3
0,69,0.028169014084507043,0.09504132231404959,66126753,71,2
0,14,0.125,0.11627906976744186,67204102,16,2
0,42,0.16,0.3924731182795699,67721136,50,8
1,109,0.20437956204379562,0.5984251968503937,67455136,137,28
0,52,0.07142857142857142,0.2545454545454545,80155865,56,4
0,31,0.08823529411764706,0.4657534246575342,66804066,34,3
1,103,0.08035714285714286,0.5626598465473146,70467425,112,9
0,60,0.047619047619047616,0.3137254901960784,82134968,63,3
1,10,0.16666666666666666,0.6444444444444445,68007912,12,2
1,31,0.24390243902439024,0.5625,69058283,41,10
1,5,0.375,0.8333333333333334,70821611,8,3
0,11,0.08333333333333333,0.38,70536445,12,1
0,27,0.1,0.48598130841121495,67585742,30,3
0,74,0.0975609756097561,0.4495798319327731,67839051,82,8
1,12,0.07692307692307693,0.7368421052631579,66025603,13,1
0,50,0.05660377358490566,0.25,69250531,53,3
0,184,0.041666666666666664,0.3248502994011976,67004525,192,8
0,92,0.16363636363636364,0.4897360703812317,68286281,110,18
1,52,0.22388059701492538,0.8426395939086294,64130290,67,15
0,121,0.016260162601626018,0.08742004264392324,67468254,123,2
0,53,0.018518518518518517,0.09777777777777778,67434500,54,1
0,8,0.0,0.0,70343686,8,0
0,34,0.0,0.0,70343700,34,0
0,57,0.17391304347826086,0.49230769230769234,80135044,69,12
1,2,0.3333333333333333,0.6666666666666666,82006649,3,1
2,15,0.5454545454545454,0.8,82051884,33,18
0,47,0.12962962962962962,0.49404761904761907,70922516,54,7
0,59,0.03278688524590164,0.27099236641221375,66026100,61,2
0,36,0.12195121951219512,0.21897810218978103,67516232,41,5
0,111,0.11904761904761904,0.17467248908296942,80176736,126,15
1,29,0.35555555555555557,0.7894736842105263,80135064,45,16
1,12,0.45454545454545453,0.9090909090909091,69058185,22,10
1,16,0.2727272727272727,0.6578947368421053,80046106,22,6
0,5,0.0,0.0,80131200,5,0
0,59,0.20270270270270271,0.4472361809045226,69562906,74,15
1,27,0.37209302325581395,0.813953488372093,69141233,43,16
0,61,0.18666666666666668,0.4430379746835443,69948711,75,14
0,7,0.125,0.2,70634865,8,1
2,4,0.6363636363636364,0.8571428571428571,68398372,11,7
0,45,0.1,0.23563218390804597,80153526,50,5
0,49,0.07547169811320754,0.2102803738317757,82103879,53,4
0,29,0.06451612903225806,0.12781954887218044,82103882,31,2
0,25,0.07407407407407407,0.056338028169014086,74924031,27,2
2,4,0.6,0.8947368421052632,65176272,10,6
0,22,0.08333333333333333,0.40476190476190477,69391385,24,2
0,37,0.0975609756097561,0.4225352112676056,69497694,41,4
1,62,0.1506849315068493,0.5748987854251012,70069874,73,11
1,2,0.3333333333333333,0.6,70758744,3,1
0,7,0.0,0.0,80150514,7,0
0,17,0.10526315789473684,0.2807017543859649,70635271,19,2
1,27,0.4375,0.8928571428571429,62358366,48,21
1,54,0.43157894736842106,0.9748743718592965,66395700,95,41
1,21,0.08695652173913043,0.5714285714285714,70343693,23,2
0,4,0.0,0.0,80163179,4,0
1,51,0.1774193548387097,0.6451612903225806,64002253,62,11
0,57,0.08064516129032258,0.3253588516746411,67888212,62,5
0,102,0.09734513274336283,0.3388704318936877,78762831,113,11
1,36,0.18181818181818182,0.6573426573426573,82150130,44,8
1,44,0.18518518518518517,0.6820809248554913,67585721,54,10
1,32,0.2,0.7943262411347518,70467600,40,8
1,89,0.13592233009708737,0.5432525951557093,70922404,103,14
0,30,0.03225806451612903,0.21081081081081082,70917630,31,1
0,11,0.08333333333333333,0.4691358024691358,70918645,12,1
0,59,0.0,0.0,67051572,59,0
0,24,0.07692307692307693,0.2962962962962963,70908880,26,2
0,105,0.045454545454545456,0.2816593886462882,64182405,110,5
0,21,0.0,0.0,82109294,21,0
1,48,0.09433962264150944,0.5277777777777778,67467421,53,5
0,56,0.0,0.0,67004742,56,0
0,32,0.0,0.0,70918715,32,0
1,72,0.2,0.7482758620689656,70463701,90,18
0,3,0.25,0.375,78802675,4,1
0,10,0.16666666666666666,0.4745762711864407,64068774,12,2
1,35,0.36363636363636365,0.6351351351351351,69979644,55,20
0,7,0.0,0.0,82158885,7,0
0,7,0.0,0.0,82158886,7,0
1,63,0.16,0.5377358490566038,68607035,75,12
1,7,0.125,0.5,67792865,8,1
0,71,0.0273972602739726,0.008298755186721992,74020345,73,2
1,59,0.3218390804597701,0.7579617834394905,65964780,87,28
1,108,0.2987012987012987,0.7419354838709677,74045412,154,46
2,1,0.6666666666666666,0.5,78449035,3,2
1,4,0.3333333333333333,0.6666666666666666,70861826,6,2
0,78,0.20408163265306123,0.36036036036036034,80130003,98,20
1,75,0.3181818181818182,0.5822784810126582,78110851,110,35
1,10,0.375,0.9047619047619048,68401830,16,6
2,26,0.5737704918032787,0.96,82106950,61,35
2,6,0.6,0.9166666666666666,62512114,15,9
1,19,0.36666666666666664,0.7777777777777778,70480564,30,11
2,45,0.55,0.9272727272727272,72270940,100,55
0,16,0.1111111111111111,0.24675324675324675,69693386,18,2
0,4,0.0,0.0,69693491,4,0
0,1,0.0,0.0,69693680,1,0
0,52,0.22388059701492538,0.4925373134328358,69693736,67,15
0,1,0.0,0.0,69693883,1,0
2,12,0.84,0.9666666666666667,70594146,75,63
0,20,0.047619047619047616,0.26262626262626265,67620665,21,1
2,0,1.0,1.0,69195203,12,12
0,13,0.07142857142857142,0.15217391304347827,63772044,14,1
1,82,0.37404580152671757,0.8333333333333334,68401620,131,49
1,52,0.36585365853658536,0.9548872180451128,67553976,82,30
0,42,0.023255813953488372,0.019230769230769232,68357121,43,1
1,70,0.3577981651376147,0.8404907975460123,69177115,109,39
0,108,0.06896551724137931,0.3572938689217759,62834674,116,8
2,12,0.8636363636363636,0.967741935483871,80181545,88,76
2,18,0.8125,0.9117647058823529,68640992,96,78
0,123,0.12142857142857143,0.10666666666666667,65944452,140,17
1,32,0.2,0.5735294117647058,69160266,40,8
1,3,0.4,0.9615384615384616,69478871,5,2
0,126,0.18181818181818182,0.388,73700536,154,28
2,7,0.5625,0.6666666666666666,75851503,16,9
0,1,0.0,0.0,70672385,1,0
0,1,0.0,0.0,78858563,1,0
2,1,0.5,0.8571428571428571,68791702,2,1
0,5,0.16666666666666666,0.2727272727272727,65286711,6,1
1,3,0.25,0.5714285714285714,65286760,4,1
1,68,0.32673267326732675,0.7571428571428571,66857350,101,33
1,34,0.48484848484848486,0.7551020408163265,80019471,66,32
2,5,0.6153846153846154,0.9375,80137557,13,8
0,211,0.08658008658008658,0.14824797843665768,63757505,231,20
1,141,0.33490566037735847,0.8107344632768362,69176842,212,71
1,50,0.3670886075949367,0.7988165680473372,80086195,79,29
2,9,0.5263157894736842,0.9166666666666666,67636821,19,10
2,0,1.0,1.0,70174524,9,9
1,43,0.45569620253164556,0.7956989247311828,80062171,79,36
0,4,0.2,0.2619047619047619,69173202,5,1
2,2,0.9285714285714286,0.8,80145586,28,26
0,23,0.14814814814814814,0.2361111111111111,69160672,27,4
1,82,0.42657342657342656,0.9411764705882353,69184780,143,61
2,1,0.5,0.0,67866533,2,1
0,124,0.24390243902439024,0.4744186046511628,82055995,164,40
0,118,0.08527131782945736,0.16379310344827586,69960282,129,11
0,91,0.042105263157894736,0.053763440860215055,80122843,95,4
0,39,0.025,0.0,66203410,40,1
0,22,0.26666666666666666,0.47540983606557374,62497526,30,8
1,33,0.2978723404255319,0.631578947368421,68434331,47,14
0,403,0.17755102040816326,0.2945823927765237,82128641,490,87
0,16,0.2727272727272727,0.45652173913043476,65286914,22,6
0,48,0.1111111111111111,0.09090909090909091,19990033,54,6
1,22,0.2413793103448276,0.7407407407407407,68498031,29,7
1,5,0.16666666666666666,0.7666666666666667,68498045,6,1
1,25,0.16666666666666666,0.5431034482758621,68498150,30,5
0,52,0.11864406779661017,0.42011834319526625,68498192,59,7
0,28,0.034482758620689655,0.2748091603053435,68498276,29,1
0,33,0.05714285714285714,0.33093525179856115,68498311,35,2
0,23,0.11538461538461539,0.4533333333333333,68498395,26,3
1,45,0.1509433962264151,0.6071428571428571,69007015,53,8
0,4,0.0,0.0,70229131,4,0
0,4,0.0,0.0,70229292,4,0
0,16,0.0,0.0,70229390,16,0
0,8,0.0,0.0,70230230,8,0
0,24,0.04,0.3375,70230510,25,1
1,11,0.15384615384615385,0.7710843373493976,80145561,13,2
0,139,0.19186046511627908,0.2948717948717949,70575134,172,33
2,4,0.8095238095238095,0.6,82025179,21,17
1,39,0.15217391304347827,0.5,69417355,46,7
2,29,0.5245901639344263,0.9384615384615385,74442711,61,32
1,6,0.4,0.8,69548325,10,4
2,1,0.5,0.9545454545454546,71878695,2,1
1,38,0.3770491803278688,0.8877551020408163,69184031,61,23
0,210,0.16334661354581673,0.304635761589404,73245725,251,41
1,26,0.38095238095238093,0.8450704225352113,68401802,42,16
1,50,0.34210526315789475,0.8653846153846154,69642993,76,26
1,68,0.3644859813084112,0.8305084745762712,69613705,107,39
1,55,0.3373493975903614,0.808641975308642,69184500,83,28
1,99,0.23846153846153847,0.5396825396825397,66110380,130,31
0,19,0.24,0.4772727272727273,63213185,25,6
1,28,0.37777777777777777,0.75,69666562,45,17
2,50,0.5327102803738317,0.9576271186440678,69205276,107,57
0,36,0.1,0.13253012048192772,69737353,40,4
2,4,0.6923076923076923,0.875,68731663,13,9
0,46,0.09803921568627451,0.144,69188000,51,5
1,194,0.38801261829652994,0.8742857142857143,69153756,317,123
0,81,0.047058823529411764,0.0,80140074,85,4
2,2,0.7142857142857143,0.6666666666666666,69864144,7,5
1,15,0.4642857142857143,0.8928571428571429,80125511,28,13
1,106,0.4479166666666667,0.9434782608695652,66911880,192,86
2,3,0.8695652173913043,0.6666666666666666,66592295,23,20
1,50,0.3670886075949367,0.6953125,79838780,79,29
0,49,0.18333333333333332,0.45394736842105265,82103786,60,11
0,67,0.0,0.0,74924283,67,0
0,18,0.21739130434782608,0.21621621621621623,15090670,23,5
1,88,0.2727272727272727,0.819047619047619,70121156,121,33
0,31,0.11428571428571428,0.11538461538461539,69559553,35,4
1,16,0.2727272727272727,0.6538461538461539,69481853,22,6
1,131,0.31413612565445026,0.7685714285714286,71389262,191,60
1,49,0.27941176470588236,0.5287356321839081,68532751,68,19
2,20,0.5238095238095238,0.8979591836734694,65176230,42,22
1,11,0.26666666666666666,0.5483870967741935,66616046,15,4
1,25,0.3902439024390244,0.9411764705882353,81972416,41,16
1,4,0.3333333333333333,0.7,70635495,6,2
1,2,0.3333333333333333,0.5,68008206,3,1
0,48,0.1864406779661017,0.47668393782383417,68655965,59,11
1,6,0.45454545454545453,0.7777777777777778,69195476,11,5
1,22,0.35294117647058826,0.7678571428571429,73635093,34,12
2,0,1.0,1.0,82039381,2,2
2,0,1.0,1.0,82054015,9,9
2,30,0.6428571428571429,0.9814814814814815,54291216,84,54
2,28,0.7565217391304347,0.9795918367346939,69589100,115,87
0,23,0.17857142857142858,0.39215686274509803,63607481,28,5
0,59,0.11940298507462686,0.23931623931623933,69391056,67,8
1,11,0.3125,0.525,80125501,16,5
0,31,0.06060606060606061,0.14084507042253522,69841044,33,2
1,48,0.4,0.7387387387387387,80180205,80,32
1,80,0.3220338983050847,0.6542056074766355,69964622,118,38
2,19,0.5869565217391305,0.9423076923076923,70059115,46,27
2,5,0.5833333333333334,0.9615384615384616,66354260,12,7
0,53,0.15873015873015872,0.16842105263157894,65930935,63,10
1,15,0.4444444444444444,0.8888888888888888,80137888,27,12
2,49,0.6111111111111112,0.9753086419753086,74043830,126,77
2,1,0.875,0.8333333333333334,60242805,8,7
2,13,0.6388888888888888,0.5625,60242826,36,23
2,13,0.5666666666666667,0.6,67237793,30,17
0,50,0.0,0.0,72766246,50,0
2,1,0.75,0.5,82019754,4,3
0,23,0.23333333333333334,0.4745762711864407,80137547,30,7
1,57,0.27848101265822783,0.6305732484076433,68641881,79,22
0,29,0.2564102564102564,0.4266666666666667,70927101,39,10
2,4,0.6666666666666666,0.8571428571428571,80168488,12,8
1,50,0.35064935064935066,0.8794326241134752,69092674,77,27
2,2,0.5,0.3333333333333333,69691251,4,2
1,38,0.2830188679245283,0.686046511627907,67485901,53,15
0,94,0.24193548387096775,0.4230769230769231,69056414,124,30
2,39,0.6953125,0.9873417721518988,80019625,128,89
2,15,0.5,0.9508196721311475,72802674,30,15
0,44,0.043478260869565216,0.13432835820895522,80124393,46,2
1,51,0.33766233766233766,0.6551724137931034,69693015,77,26
1,16,0.4482758620689655,0.95,70669592,29,13
1,2,0.3333333333333333,0.75,70855813,3,1
0,11,0.15384615384615385,0.2,72809086,13,2
1,6,0.25,0.6296296296296297,76941816,8,2
1,61,0.24691358024691357,0.5411764705882353,69739320,81,20
1,54,0.25,0.5046728971962616,82120528,72,18
0,118,0.024793388429752067,0.052752293577981654,62834604,121,3
1,90,0.29133858267716534,0.6290322580645161,69183604,127,37
2,10,0.5,0.8421052631578947,903602,20,10
1,23,0.4523809523809524,0.88,73652110,42,19
2,0,1.0,1.0,82024364,1,1
1,183,0.29343629343629346,0.6374695863746959,66440983,259,76
1,22,0.40540540540540543,0.6060606060606061,60240166,37,15
2,8,0.5789473684210527,0.9230769230769231,82009372,19,11
2,27,0.6538461538461539,0.9743589743589743,70799281,78,51
0,18,0.05263157894736842,0.09523809523809523,70683585,19,1
0,25,0.13793103448275862,0.21428571428571427,80096366,29,4
1,30,0.4230769230769231,0.9072847682119205,82002278,52,22
2,16,0.7746478873239436,0.9859154929577465,67650240,71,55
1,38,0.3333333333333333,0.6756756756756757,73977470,57,19
1,6,0.45454545454545453,0.9,69837915,11,5
1,102,0.3503184713375796,0.69375,70063371,157,55
2,65,0.577922077922078,0.9948717948717949,82213709,154,89
1,70,0.4927536231884058,0.9183673469387755,67788924,138,68
1,11,0.3125,0.6,67553703,16,5
1,34,0.2608695652173913,0.55,68044760,46,12
0,35,0.14634146341463414,0.32989690721649484,80149859,41,6
1,5,0.2857142857142857,0.92,80150033,7,2
0,12,0.14285714285714285,0.3333333333333333,76081292,14,2
2,4,0.7647058823529411,0.875,80117736,17,13
1,322,0.2907488986784141,0.7406989853438557,70562156,454,132
0,134,0.10067114093959731,0.10996563573883161,69899081,149,15
0,8,0.2,0.3125,69596380,10,2
0,101,0.1440677966101695,0.3191489361702128,68526311,118,17
0,18,0.18181818181818182,0.3787878787878788,82050494,22,4
0,256,0.22424242424242424,0.4168618266978923,69157851,330,74
0,29,0.03333333333333333,0.21428571428571427,69693995,30,1
0,7,0.0,0.0,69700036,7,0
1,3,0.25,0.5142857142857142,69700064,4,1
0,2,0.0,0.0,69700386,2,0
1,9,0.4,0.7142857142857143,79976470,15,6
2,1,0.6666666666666666,0.75,79457413,3,2
2,0,1.0,1.0,82033543,6,6
2,26,0.5272727272727272,0.8955223880597015,80152796,55,29
2,0,1.0,1.0,69129844,1,1
1,4,0.3333333333333333,0.6470588235294118,72697884,6,2
2,7,0.5,0.8846153846153846,80163680,14,7
0,8,0.1111111111111111,0.47058823529411764,70694141,9,1
1,93,0.30597014925373134,0.5974842767295597,65562504,134,41
2,14,0.5333333333333333,0.7804878048780488,80158285,30,16
1,39,0.4,0.7411764705882353,69399372,65,26
0,25,0.2647058823529412,0.4714285714285714,70670271,34,9
2,22,0.5217391304347826,0.9111111111111111,74289600,46,24
2,2,0.6,0.75,79792433,5,3
0,7,0.0,0.0,68497793,7,0
2,7,0.5882352941176471,0.9285714285714286,80118130,17,10
2,29,0.5396825396825397,0.9491525423728814,70670586,63,34
1,27,0.46,0.9487179487179487,66198013,50,23
1,162,0.36964980544747084,0.8028169014084507,82009523,257,95
1,36,0.16279069767441862,0.5390625,82150113,43,7
0,14,0.17647058823529413,0.42857142857142855,82205938,17,3
1,43,0.1568627450980392,0.5466666666666666,70908411,51,8
1,88,0.35294117647058826,0.9390862944162437,73739113,136,48
1,42,0.25,0.6666666666666666,82103787,56,14
1,63,0.29213483146067415,0.7526881720430108,66926314,89,26
1,7,0.2222222222222222,0.5454545454545454,70121142,9,2
0,14,0.2631578947368421,0.3076923076923077,80176683,19,5
0,62,0.07462686567164178,0.11038961038961038,66224564,67,5
1,8,0.3333333333333333,0.8163265306122449,68546926,12,4
0,5,0.0,0.0,69634334,5,0
1,90,0.27419354838709675,0.6091370558375635,68153764,124,34
2,15,0.8611111111111112,0.9428571428571428,69692350,108,93
0,80,0.1111111111111111,0.15730337078651685,68383595,90,10
0,112,0.11811023622047244,0.44886363636363635,80150439,127,15
1,40,0.14893617021276595,0.5245901639344263,80150441,47,7
2,1,0.5,0.6666666666666666,70843066,2,1
2,0,1.0,1.0,79785825,1,1
2,26,0.6338028169014085,0.7894736842105263,82132593,71,45
1,61,0.22784810126582278,0.6583850931677019,63306194,79,18
2,7,0.7083333333333334,0.9,80149512,24,17
1,5,0.375,0.6,67786691,8,3
0,3,0.25,0.2,67786894,4,1
0,121,0.2484472049689441,0.4847161572052402,80176785,161,40
2,8,0.7894736842105263,0.9090909090909091,80054653,38,30
0,80,0.13978494623655913,0.45925925925925926,18370562,93,13
0,46,0.041666666666666664,0.020202020202020204,69100836,48,2
1,45,0.4578313253012048,0.9245283018867925,68785241,83,38
1,162,0.2669683257918552,0.6247464503042597,82126653,221,59
2,2,0.6,0.9,70861056,5,3
2,16,0.5428571428571428,0.9534883720930233,61760412,35,19
1,53,0.4536082474226804,0.8902439024390244,70700903,97,44
1,41,0.3387096774193548,0.7850467289719626,79879086,62,21
2,1,0.5,0.0,66229443,2,1
2,10,0.6153846153846154,0.8928571428571429,80145831,26,16
2,0,1.0,1.0,82096331,6,6
0,23,0.041666666666666664,0.2808988764044944,67315024,24,1
0,63,0.11267605633802817,0.38764044943820225,67315052,71,8
1,3,0.4,0.8888888888888888,70238154,5,2
0,28,0.034482758620689655,0.14423076923076922,70238175,29,1
1,19,0.32142857142857145,0.9035087719298246,79990120,28,9
1,32,0.1111111111111111,0.5785714285714286,62841240,36,4
0,25,0.24242424242424243,0.17142857142857143,62497183,33,8
2,61,0.5234375,0.8666666666666667,80028431,128,67
0,29,0.06451612903225806,0.29357798165137616,328300,31,2
1,15,0.25,0.68,64019123,20,5
1,30,0.3023255813953488,0.6836734693877551,67801062,43,13
1,40,0.24528301886792453,0.5066666666666667,69160525,53,13
1,88,0.2072072072072072,0.5598086124401914,69637694,111,23
0,5,0.0,0.0,66782282,5,0
0,48,0.14285714285714285,0.4367816091954023,69021925,56,8
0,56,0.08196721311475409,0.028901734104046242,62766942,61,5
0,27,0.1,0.29906542056074764,69637925,30,3
1,105,0.3181818181818182,0.6888888888888889,61172041,154,49
0,88,0.14563106796116504,0.33980582524271846,62809243,103,15
1,20,0.3333333333333333,0.8352941176470589,63992754,30,10
2,7,0.5625,0.6,70487326,16,9
2,39,0.5063291139240507,0.9069767441860465,68199621,79,40
0,64,0.14666666666666667,0.4627659574468085,80124439,75,11
2,0,1.0,1.0,80132934,1,1
2,11,0.6206896551724138,0.9772727272727273,72802954,29,18
0,19,0.20833333333333334,0.49230769230769234,70681191,24,5
0,21,0.125,0.390625,69638233,24,3
1,18,0.41935483870967744,0.9347826086956522,66264121,31,13
0,43,0.022727272727272728,0.06779661016949153,63993062,44,1
0,2,0.0,0.0,66782093,2,0
0,4,0.0,0.0,66782555,4,0
0,9,0.0,0.0,66783066,9,0
0,6,0.0,0.0,66785166,6,0
0,3,0.0,0.0,66787035,3,0
0,6,0.0,0.0,67896003,6,0
1,8,0.3333333333333333,0.8928571428571429,80070032,12,4
1,28,0.24324324324324326,0.6161616161616161,66503052,37,9
0,8,0.0,0.0,80052623,8,0
1,14,0.48148148148148145,0.9302325581395349,80052644,27,13
1,12,0.4,0.8333333333333334,69414996,20,8
0,68,0.10526315789473684,0.4061302681992337,80029152,76,8
0,154,0.21025641025641026,0.39035087719298245,80137609,195,41
0,38,0.09523809523809523,0.4224137931034483,80028830,42,4
1,26,0.21212121212121213,0.7232142857142857,80029145,33,7
1,30,0.3023255813953488,0.7761194029850746,65380882,43,13
1,5,0.2857142857142857,0.6363636363636364,80054590,7,2
0,33,0.15384615384615385,0.4424778761061947,63993706,39,6
0,11,0.0,0.0,65668400,11,0
1,25,0.21875,0.7582417582417582,66933202,32,7
0,39,0.04878048780487805,0.1346153846153846,69895203,41,2
0,71,0.08974358974358974,0.4365781710914454,66470173,78,7
1,27,0.4489795918367347,0.868421052631579,80176669,49,22
0,49,0.19672131147540983,0.3826086956521739,70072275,61,12
0,87,0.13,0.35944700460829493,70629965,100,13
1,21,0.16,0.5172413793103449,74924381,25,4
2,3,0.5714285714285714,0.9230769230769231,68060643,7,4
2,2,0.6,0.8333333333333334,80046155,5,3
1,72,0.3684210526315789,0.873015873015873,68282963,114,42
0,47,0.06,0.1981981981981982,82019417,50,3
0,7,0.2222222222222222,0.2857142857142857,71878492,9,2
0,9,0.18181818181818182,0.4358974358974359,80067260,11,2
0,43,0.06521739130434782,0.13333333333333333,71761774,46,3
1,11,0.3888888888888889,0.8235294117647058,73634701,18,7
1,146,0.2980769230769231,0.7021276595744681,69522341,208,62
0,119,0.21710526315789475,0.32571428571428573,80105795,152,33
0,88,0.21428571428571427,0.3080168776371308,68010880,112,24
2,17,0.5277777777777778,0.8275862068965517,82036306,36,19
0,79,0.12222222222222222,0.48024316109422494,62850403,90,11
1,127,0.2485207100591716,0.5338983050847458,68172503,169,42
1,46,0.38666666666666666,0.7676767676767676,66272010,75,29
1,50,0.4444444444444444,0.927710843373494,69873391,90,40
1,78,0.3389830508474576,0.6890243902439024,80180904,118,40
1,92,0.39473684210526316,0.9230769230769231,80133811,152,60
0,47,0.14545454545454545,0.32085561497326204,73914463,55,8
2,2,0.5,0.75,69893754,4,2
1,21,0.19230769230769232,0.5641025641025641,70037086,26,5
0,42,0.16,0.4298245614035088,67049136,50,8
2,6,0.7142857142857143,0.9411764705882353,70073766,21,15
0,26,0.037037037037037035,0.14814814814814814,80124311,27,1
0,69,0.041666666666666664,0.0903954802259887,80124421,72,3
2,0,1.0,1.0,82127526,1,1
2,5,0.5454545454545454,0.9767441860465116,71090425,11,6
0,72,0.25,0.44516129032258067,61565056,96,24
1,67,0.4017857142857143,0.8119266055045872,70748335,112,45
1,44,0.3230769230769231,0.9289940828402367,73842573,65,21
1,31,0.18421052631578946,0.6,80135070,38,7
0,20,0.13043478260869565,0.3709677419354839,80135098,23,3
1,9,0.25,0.5625,80137563,12,3
0,4,0.2,0.0,67131736,5,1
1,53,0.29333333333333333,0.5277777777777778,71502193,75,22
2,6,0.7142857142857143,0.8666666666666667,80172020,21,15
1,25,0.4318181818181818,0.9387755102040817,69604535,44,19
0,47,0.21666666666666667,0.24210526315789474,69180125,60,13
0,153,0.19047619047619047,0.33762057877813506,68740630,189,36
0,18,0.0,0.0,68356463,18,0
0,41,0.24074074074074073,0.3559322033898305,68546016,54,13
0,79,0.08139534883720931,0.025806451612903226,79650921,86,7
2,18,0.71875,0.9444444444444444,80137965,64,46
0,19,0.20833333333333334,0.22641509433962265,65579955,24,5
1,75,0.3697478991596639,0.8823529411764706,70638911,119,44
0,34,0.15,0.25,69198591,40,6
1,48,0.4782608695652174,0.9481865284974094,72512664,92,44
1,18,0.25,0.5102040816326531,80180222,24,6
1,79,0.29464285714285715,0.7191011235955056,63765730,112,33
0,112,0.08943089430894309,0.10628019323671498,79650956,123,11
2,28,0.6455696202531646,0.9508196721311475,67753721,79,51
0,49,0.2898550724637681,0.4842105263157895,65007341,69,20
1,6,0.4,0.8888888888888888,69597430,10,4
1,34,0.24444444444444444,0.6440677966101694,70633213,45,11
2,138,0.5257731958762887,0.9227467811158798,69166202,291,153
2,5,0.6428571428571429,0.8666666666666667,67656862,14,9
0,6,0.14285714285714285,0.2857142857142857,67656876,7,1
2,7,0.5882352941176471,0.9473684210526315,69666506,17,10
1,39,0.47297297297297297,0.9152542372881356,72417240,74,35
1,6,0.45454545454545453,0.782608695652174,69506864,11,5
0,36,0.14285714285714285,0.40540540540540543,69478563,42,6
1,30,0.1891891891891892,0.7083333333333334,69634586,37,7
0,1,0.0,0.0,82037278,1,0
0,1,0.0,0.0,82037280,1,0
2,2,0.7142857142857143,0.3333333333333333,66757453,7,5
1,9,0.4,0.9166666666666666,66194576,15,6
0,29,0.03333333333333333,0.07142857142857142,70669655,30,1
2,0,1.0,1.0,70474845,1,1
0,1,0.0,0.0,78443113,1,0
1,93,0.41509433962264153,0.8654970760233918,80180333,159,66
0,43,0.10416666666666667,0.39285714285714285,521843,48,5
0,36,0.23404255319148937,0.49137931034482757,66931613,47,11
0,124,0.18421052631578946,0.35036496350364965,69481874,152,28
1,24,0.4146341463414634,0.7142857142857143,80013444,41,17
1,56,0.4166666666666667,0.944954128440367,67970273,96,40
0,46,0.17857142857142858,0.22018348623853212,67170670,56,10
1,14,0.36363636363636365,0.84,72539971,22,8
0,7,0.2222222222222222,0.2,72540272,9,2
2,0,1.0,1.0,77112483,1,1
2,2,0.8461538461538461,0.6666666666666666,17460660,13,11
2,6,0.88,0.7777777777777778,69666660,50,44
1,17,0.41379310344827586,0.926829268292683,69399925,29,12
2,11,0.5217391304347826,0.8333333333333334,70575190,23,12
1,52,0.2,0.5,63159425,65,13
1,109,0.23776223776223776,0.5470588235294118,69084652,143,34
1,38,0.3770491803278688,0.8378378378378378,66086993,61,23
1,22,0.2903225806451613,0.6610169491525424,65083431,31,9
0,169,0.2175925925925926,0.4744525547445255,68497345,216,47
1,59,0.3218390804597701,0.8571428571428571,80098501,87,28
2,28,0.5,0.9642857142857143,79947651,56,28
0,16,0.1111111111111111,0.10416666666666667,70919471,18,2
1,47,0.29850746268656714,0.6363636363636364,69180314,67,20
2,4,0.5,0.8260869565217391,80141346,8,4
2,17,0.5142857142857142,0.9090909090909091,68610066,35,18
0,14,0.06666666666666667,0.2909090909090909,70862470,15,1
2,4,0.6,0.875,80054912,10,6
1,21,0.4,0.8955223880597015,61889373,35,14
0,20,0.2,0.49230769230769234,67035500,25,5
0,233,0.09689922480620156,0.0962800875273523,80112795,258,25
0,1,0.0,0.0,72964535,1,0
0,18,0.25,0.49295774647887325,67554340,24,6
1,11,0.3888888888888889,0.8666666666666667,80152634,18,7
1,75,0.32432432432432434,0.7871287128712872,66857000,111,36
0,32,0.1111111111111111,0.15873015873015872,70320152,36,4
1,16,0.36,0.6842105263157895,73588844,25,9
2,6,0.5,0.9523809523809523,69008492,12,6
0,15,0.0625,0.05555555555555555,82046928,16,1
1,33,0.4,0.8615384615384616,82049173,55,22
1,12,0.3684210526315789,0.7450980392156863,82049174,19,7
0,120,0.08396946564885496,0.06296296296296296,69621356,131,11
1,71,0.330188679245283,0.8118279569892473,69183730,106,35
2,6,0.6,0.9310344827586207,80158340,15,9
2,19,0.6041666666666666,0.9433962264150944,80139936,48,29
0,17,0.39285714285714285,0.3333333333333333,80172969,28,11
0,6,0.0,0.0,70697403,6,0
0,3,0.0,0.0,70698495,3,0
2,8,0.7647058823529411,0.8947368421052632,69267793,34,26
0,38,0.24,0.4774193548387097,70494522,50,12
0,8,0.1111111111111111,0.3076923076923077,69204891,9,1
0,49,0.14035087719298245,0.2484472049689441,80121144,57,8
0,83,0.11702127659574468,0.28063241106719367,69417215,94,11
2,14,0.7083333333333334,0.96875,68191781,48,34
1,32,0.3469387755102041,0.8611111111111112,73637795,49,17
2,4,0.5,0.8888888888888888,82039858,8,4
1,29,0.23684210526315788,0.5752212389380531,79254840,38,9
0,14,0.2222222222222222,0.41975308641975306,67929701,18,4
0,29,0.23684210526315788,0.379746835443038,68434240,38,9
0,13,0.13333333333333333,0.14634146341463414,67775232,15,2
2,17,0.6730769230769231,0.9795918367346939,80130152,52,35
0,13,0.0,0.0,66111073,13,0
0,20,0.0,0.0,82018905,20,0
0,84,0.0967741935483871,0.25925925925925924,82019418,93,9
0,28,0.2,0.2830188679245283,69180573,35,7
0,53,0.2638888888888889,0.3563218390804598,66826130,72,19
1,109,0.32298136645962733,0.7799043062200957,67291833,161,52
1,21,0.4,0.8846153846153846,69183170,35,14
0,28,0.0,0.0,70684971,28,0
1,30,0.21052631578947367,0.6690647482014388,66168116,38,8
1,69,0.18823529411764706,0.5637583892617449,70417200,85,16
1,150,0.25742574257425743,0.6065573770491803,68533885,202,52
1,21,0.27586206896551724,0.640625,66225012,29,8
0,49,0.125,0.2536231884057971,66225271,56,7
1,7,0.2222222222222222,0.5454545454545454,66225334,9,2
0,2,0.0,0.0,68283012,2,0
1,26,0.38095238095238093,0.7954545454545454,69404790,42,16
1,82,0.3050847457627119,0.685,80152812,118,36
2,24,0.5636363636363636,0.9444444444444444,67618985,55,31
1,31,0.41509433962264153,0.9186046511627907,80118404,53,22
1,44,0.3333333333333333,0.7375,66802750,66,22
0,3,0.25,0.47058823529411764,67330382,4,1
1,96,0.43529411764705883,0.9006211180124224,66802673,170,74
1,5,0.2857142857142857,0.7096774193548387,77319116,7,2
1,15,0.4444444444444444,0.9166666666666666,70854000,27,12
1,60,0.34782608695652173,0.7108433734939759,80149457,92,32
0,163,0.1683673469387755,0.36363636363636365,70660331,196,33
0,7,0.0,0.0,74607365,7,0
1,32,0.3333333333333333,0.7422680412371134,69640473,48,16
1,53,0.36904761904761907,0.8627450980392157,69180055,84,31
0,50,0.15254237288135594,0.25,67552163,59,9
1,16,0.2,0.5606060606060606,70687190,20,4
0,12,0.0,0.0,70675934,12,0
0,3,0.0,0.0,70681205,3,0
2,4,0.7142857142857143,0.5555555555555556,68167750,14,10
1,45,0.25,0.7006369426751592,78763412,60,15
1,38,0.4794520547945205,0.9444444444444444,60513943,73,35
2,2,0.5,0.8333333333333334,69164606,4,2
1,37,0.28846153846153844,0.7352941176470589,70587636,52,15
1,19,0.17391304347826086,0.5692307692307692,70219660,23,4
1,25,0.375,0.7906976744186046,80180212,40,15
1,10,0.47368421052631576,0.8378378378378378,68645941,19,9
1,35,0.33962264150943394,0.7291666666666666,66028942,53,18
1,8,0.2727272727272727,0.7297297297297297,66379530,11,3
0,75,0.11764705882352941,0.1125,65272445,85,10
0,15,0.0625,0.18181818181818182,69693274,16,1
0,14,0.0,0.0,69693302,14,0
1,32,0.4482758620689655,0.9304347826086956,72802555,58,26
2,2,0.6666666666666666,0.8333333333333334,82013670,6,4
1,6,0.4,0.9285714285714286,66969651,10,4
1,121,0.3125,0.6508474576271186,68393941,176,55
0,114,0.13636363636363635,0.34782608695652173,78763391,132,18
1,73,0.46715328467153283,0.9013157894736842,61139645,137,64
1,27,0.2894736842105263,0.7272727272727273,66802862,38,11
2,13,0.717391304347826,0.95,74048730,46,33
1,36,0.3076923076923077,0.7027027027027027,66930234,52,16
2,0,1.0,1.0,80126323,10,10
1,9,0.4375,0.9333333333333333,65280355,16,7
0,90,0.16666666666666666,0.3392857142857143,69417236,108,18
0,10,0.16666666666666666,0.23333333333333334,65286151,12,2
1,206,0.1953125,0.6466431095406361,66830442,256,50
0,218,0.22695035460992907,0.4697754749568221,68236161,282,64
2,12,0.625,0.9285714285714286,73609004,32,20
1,55,0.46601941747572817,0.8983957219251337,79408735,103,48
1,21,0.125,0.5211267605633803,70109732,24,3
2,8,0.5,0.8333333333333334,69170612,16,8
0,9,0.3076923076923077,0.45454545454545453,69404034,13,4
2,2,0.5,0.8181818181818182,70867895,4,2
1,52,0.2676056338028169,0.5714285714285714,65853102,71,19
1,17,0.43333333333333335,0.9,72802793,30,13
0,7,0.0,0.0,72808876,7,0
0,44,0.08333333333333333,0.20454545454545456,70078351,48,4
0,138,0.17365269461077845,0.2971014492753623,69621594,167,29
1,11,0.35294117647058826,0.7419354838709677,82140364,17,6
0,61,0.17567567567567569,0.4057971014492754,67793516,74,13
0,31,0.0,0.0,62841310,31,0
1,62,0.19480519480519481,0.5277777777777778,67963294,77,15
0,23,0.041666666666666664,0.34375,69033454,24,1
1,116,0.34831460674157305,0.8325991189427313,69154211,178,62
0,29,0.0,0.0,68499102,29,0
2,2,0.6,0.8,80130725,5,3
0,10,0.16666666666666666,0.3157894736842105,69723983,12,2
1,20,0.3333333333333333,0.8961038961038961,64001035,30,10
1,46,0.425,0.8571428571428571,80125420,80,34
1,20,0.3333333333333333,0.7678571428571429,67887932,30,10
0,66,0.16455696202531644,0.3657142857142857,73783213,79,13
1,30,0.25,0.5802469135802469,82116610,40,10
1,22,0.21428571428571427,0.5614035087719298,80122917,28,6
0,37,0.17777777777777778,0.20430107526881722,74921805,45,8
1,59,0.3058823529411765,0.6132075471698113,69066403,85,26
1,56,0.18840579710144928,0.6067415730337079,69417404,69,13
2,33,0.5285714285714286,0.9367088607594937,70713356,70,37
2,3,0.5,0.7272727272727273,70752955,6,3
0,5,0.16666666666666666,0.3076923076923077,80128572,6,1
2,2,0.8947368421052632,0.75,18066671,19,17
0,5,0.0,0.0,72910005,5,0
0,3,0.0,0.0,73295803,3,0
0,84,0.25663716814159293,0.42702702702702705,80136824,113,29
1,38,0.19148936170212766,0.5066666666666667,73637816,47,9
1,64,0.2967032967032967,0.6134969325153374,70508746,91,27
2,13,0.6976744186046512,0.8,69973372,43,30
1,71,0.30392156862745096,0.7064220183486238,65077334,102,31
0,100,0.2248062015503876,0.41139240506329117,82126682,129,29
0,3,0.0,0.0,64948863,3,0
0,48,0.15789473684210525,0.24752475247524752,54205263,57,9
1,60,0.34782608695652173,0.8445945945945946,69184724,92,32
1,32,0.39622641509433965,0.8452380952380952,80125951,53,21
1,5,0.2857142857142857,0.7142857142857143,82059485,7,2
1,10,0.4117647058823529,0.6875,80149972,17,7
1,27,0.41304347826086957,0.8375,72953685,46,19
0,67,0.14102564102564102,0.3588235294117647,70081074,78,11
0,43,0.0851063829787234,0.24107142857142858,70081263,47,4
0,36,0.16279069767441862,0.2926829268292683,72199470,43,7
1,12,0.42857142857142855,0.8333333333333334,82023510,21,9
2,22,0.5849056603773585,0.9428571428571428,65140593,53,31
1,2,0.3333333333333333,0.75,72866892,3,1
1,67,0.33,0.7906976744186046,68532541,100,33
1,2,0.3333333333333333,0.7142857142857143,68659052,3,1
1,38,0.4153846153846154,0.88,69548794,65,27
0,18,0.05263157894736842,0.1958762886597938,72910145,19,1
2,6,0.5714285714285714,0.9166666666666666,72801421,14,8
0,78,0.10344827586206896,0.1277533039647577,80122389,87,9
0,31,0.06060606060606061,0.39156626506024095,78540693,33,2
1,24,0.38461538461538464,0.5405405405405406,74362064,39,15
0,68,0.25274725274725274,0.4939759036144578,82126663,91,23
0,31,0.20512820512820512,0.3142857142857143,80137560,39,8
1,26,0.4222222222222222,0.9318181818181818,68905844,45,19
0,80,0.16666666666666666,0.31666666666666665,80149268,96,16
2,21,0.5882352941176471,0.9302325581395349,69732810,51,30
1,15,0.25,0.6,80181591,20,5
2,9,0.6896551724137931,0.9705882352941176,80139937,29,20
2,7,0.7666666666666667,0.8333333333333334,80118212,30,23
2,1,0.8,0.0,70411243,5,4
2,10,0.6153846153846154,0.8846153846153846,69625850,26,16
0,117,0.040983606557377046,0.1145374449339207,80128620,122,5
2,20,0.7849462365591398,0.9782608695652174,69039404,93,73
2,2,0.8666666666666667,0.75,80178963,15,13
2,1,0.8333333333333334,0.8571428571428571,69173965,6,5
2,2,0.875,0.75,80172962,16,14
2,0,1.0,1.0,80165270,6,6
1,61,0.3711340206185567,0.7156862745098039,80158084,97,36
0,35,0.14634146341463414,0.3157894736842105,70198072,41,6
0,34,0.05555555555555555,0.0,70198100,36,2
2,4,0.8095238095238095,0.0,80126600,21,17
2,23,0.7325581395348837,0.8947368421052632,73407236,86,63
0,1,0.0,0.0,67311244,1,0
0,1,0.0,0.0,67311251,1,0
0,1,0.0,0.0,67311272,1,0
1,4,0.42857142857142855,0.6666666666666666,65066344,7,3
2,10,0.6774193548387096,0.9473684210526315,80066343,31,21
2,17,0.6136363636363636,0.9142857142857143,82037214,44,27
2,9,0.85,0.9473684210526315,82009401,60,51
2,17,0.7424242424242424,0.975609756097561,80127014,66,49
2,0,1.0,1.0,80165211,2,2
1,25,0.2857142857142857,0.7142857142857143,69728330,35,10
2,20,0.6,0.9047619047619048,71199513,50,30
2,0,1.0,1.0,82037560,1,1
2,3,0.5714285714285714,0.5,80158316,7,4
2,0,1.0,1.0,67258723,1,1
2,2,0.9,0.6666666666666666,80118198,20,18
0,90,0.1588785046728972,0.26744186046511625,68625725,107,17
2,0,1.0,1.0,80127029,12,12
2,1,0.8333333333333334,0.5,67787664,6,5
2,24,0.5384615384615384,0.9736842105263158,80180117,52,28
2,4,0.6363636363636364,0.75,80158288,11,7
1,17,0.37037037037037035,0.5483870967741935,77981253,27,10
0,153,0.1,0.14189189189189189,80140077,170,17
1,27,0.22857142857142856,0.625,73637711,35,8
2,0,1.0,1.0,67181730,14,14
0,19,0.09523809523809523,0.06060606060606061,80172911,21,2
2,1,0.875,0.6666666666666666,79884210,8,7
2,4,0.9047619047619048,0.9285714285714286,69173916,42,38
2,0,1.0,1.0,80162117,18,18
2,0,1.0,1.0,66256806,2,2
2,1,0.875,0.6666666666666666,67066741,8,7
2,0,1.0,1.0,82023217,1,1
2,2,0.9512195121951219,0.0,77603113,41,39
2,0,1.0,1.0,80054660,20,20
2,1,0.75,0.5,80126964,4,3
2,11,0.7317073170731707,0.8823529411764706,69973463,41,30
2,2,0.9354838709677419,0.6666666666666666,74484074,31,29
0,4,0.0,0.0,80018701,4,0
2,2,0.6666666666666666,0.75,80018750,6,4
2,0,1.0,1.0,82054730,1,1
1,138,0.28125,0.6273885350318471,82143798,192,54
1,44,0.3888888888888889,0.8070175438596491,65121924,72,28
2,0,1.0,1.0,80176427,8,8
2,0,1.0,1.0,80175978,18,18
2,4,0.5555555555555556,0.8125,80172970,9,5
2,7,0.8,0.9375,74029445,35,28
0,3,0.25,0.0,80018225,4,1
2,3,0.5,0.16666666666666666,80018232,6,3
2,1,0.6666666666666666,0.6666666666666666,66460695,3,2
0,3,0.0,0.0,80158243,3,0
0,2,0.0,0.0,80158281,2,0
2,7,0.5625,0.7647058823529411,80117733,16,9
2,3,0.5,0.75,67359894,6,3
0,9,0.1,0.3076923076923077,67379725,10,1
2,12,0.625,0.9838709677419355,70343266,32,20
2,1,0.9230769230769231,0.75,82018784,13,12
2,1,0.9666666666666667,0.5,80118219,30,29
2,6,0.5714285714285714,0.8888888888888888,70800751,14,8
2,77,0.5333333333333333,0.9711538461538461,70612584,165,88
1,15,0.4230769230769231,0.875,69389901,26,11
2,2,0.8333333333333334,0.8,80149487,12,10
2,7,0.7586206896551724,0.8888888888888888,72425752,29,22
1,76,0.4108527131782946,0.6964285714285714,80019604,129,53
2,4,0.8095238095238095,0.75,70591276,21,17
0,5,0.16666666666666666,0.1875,80158326,6,1
0,6,0.14285714285714285,0.2702702702702703,82013535,7,1
1,7,0.36363636363636365,0.6857142857142857,82013566,11,4
2,23,0.7228915662650602,0.9459459459459459,66848481,83,60
2,38,0.5581395348837209,0.9782608695652174,70637910,86,48
1,22,0.45,0.9166666666666666,82053998,40,18
1,115,0.294478527607362,0.6329113924050633,80136826,163,48
0,36,0.12195121951219512,0.40625,68497814,41,5
2,2,0.6666666666666666,0.75,590856,6,4
1,174,0.3203125,0.7382920110192838,65813034,256,82
0,21,0.08695652173913043,0.0410958904109589,65279515,23,2
0,71,0.1744186046511628,0.20567375886524822,70711256,86,15
0,39,0.025,0.0,70720321,40,1
0,110,0.02654867256637168,0.05707762557077625,62835836,113,3
1,55,0.36046511627906974,0.6902654867256637,80165902,86,31
0,6,0.25,0.2,82008046,8,2
1,37,0.32727272727272727,0.7652173913043478,69160651,55,18
1,7,0.46153846153846156,0.9230769230769231,82007154,13,6
1,56,0.36363636363636365,0.8269230769230769,70688261,88,32
2,1,0.9,0.5,82039179,10,9
1,3,0.4,0.8421052631578947,70679441,5,2
2,1,0.9444444444444444,0.5,80054765,18,17
1,4,0.42857142857142855,0.5,67257855,7,3
0,119,0.1736111111111111,0.2689655172413793,81979022,144,25
1,42,0.373134328358209,0.8192771084337349,62590073,67,25
1,77,0.36363636363636365,0.7857142857142857,68400955,121,44
0,16,0.1111111111111111,0.0,82061333,18,2
0,14,0.2222222222222222,0.2962962962962963,65316755,18,4
0,38,0.17391304347826086,0.358974358974359,54205256,46,8
0,7,0.125,0.4411764705882353,66221820,8,1
2,0,1.0,1.0,69950706,1,1
1,26,0.4090909090909091,0.8125,79251886,44,18
0,88,0.053763440860215055,0.06040268456375839,71762614,93,5
0,107,0.17692307692307693,0.2875,71762712,130,23
1,43,0.4266666666666667,0.9574468085106383,60755513,75,32
2,4,0.5555555555555556,0.875,74058621,9,5
1,46,0.30303030303030304,0.6132075471698113,67929680,66,20
2,2,0.5,0.8333333333333334,68373634,4,2
2,14,0.5757575757575758,0.9130434782608695,80128847,33,19
2,6,0.5384615384615384,0.7142857142857143,80128848,13,7
2,8,0.6923076923076923,0.9166666666666666,12079606,26,18
1,8,0.1111111111111111,0.7692307692307693,69526065,9,1
0,32,0.058823529411764705,0.25,69526240,34,2
0,124,0.06060606060606061,0.14728682170542637,70852600,132,8
0,144,0.0136986301369863,0.0,70852621,146,2
0,36,0.05263157894736842,0.39285714285714285,62840610,38,2
2,7,0.6956521739130435,0.7857142857142857,73411681,23,16
1,25,0.375,0.828125,68532744,40,15
0,164,0.16326530612244897,0.28291316526610644,67630703,196,32
1,24,0.35135135135135137,0.7115384615384616,82017784,37,13
1,8,0.2727272727272727,0.8421052631578947,67900175,11,3
1,60,0.23076923076923078,0.5357142857142857,63279342,78,18
0,27,0.03571428571428571,0.04,80149860,28,1
0,39,0.13333333333333333,0.12380952380952381,73200106,45,6
1,89,0.2764227642276423,0.5956521739130435,82126758,123,34
1,4,0.42857142857142855,0.9117647058823529,71619394,7,3
1,5,0.2857142857142857,0.5416666666666666,70633346,7,2
0,24,0.07692307692307693,0.3333333333333333,67467995,26,2
1,21,0.3225806451612903,0.75,78863596,31,10
1,17,0.45161290322580644,0.9148936170212766,75103175,31,14
0,31,0.08823529411764706,0.375,67781595,34,3
0,37,0.05128205128205128,0.17880794701986755,67782393,39,2
1,33,0.1951219512195122,0.5073529411764706,67781686,41,8
0,53,0.018518518518518517,0.049019607843137254,62836403,54,1
1,39,0.43478260869565216,0.9130434782608695,69165670,69,30
0,49,0.0392156862745098,0.17796610169491525,80124221,51,2
0,59,0.14492753623188406,0.14,80141463,69,10
1,47,0.3472222222222222,0.6111111111111112,69550250,72,25
2,38,0.6082474226804123,0.9529411764705882,65199274,97,59
1,7,0.46153846153846156,0.5833333333333334,75121116,13,6
1,8,0.3333333333333333,0.7,72697891,12,4
0,3,0.25,0.3333333333333333,70684880,4,1
0,21,0.125,0.22058823529411764,80131231,24,3
1,51,0.2608695652173913,0.576271186440678,64158325,69,18
1,120,0.3939393939393939,0.8686868686868687,69637036,198,78
0,81,0.14736842105263157,0.11290322580645161,80176708,95,14
2,18,0.6666666666666666,0.9846153846153847,80090304,54,36
2,21,0.5227272727272727,0.7142857142857143,60240145,44,23
2,7,0.5625,0.967741935483871,80167010,16,9
2,26,0.723404255319149,0.96,69039334,94,68
0,11,0.08333333333333333,0.0,70515410,12,1
0,12,0.14285714285714285,0.1836734693877551,70843955,14,2
1,30,0.25,0.52,82002247,40,10
2,3,0.5,0.6666666666666666,68904976,6,3
2,5,0.8076923076923077,0.3333333333333333,75576473,26,21
1,28,0.17647058823529413,0.7714285714285715,67896262,34,6
0,57,0.109375,0.3870967741935484,64359351,64,7
1,30,0.4915254237288136,0.9642857142857143,66141194,59,29
1,6,0.4,0.9090909090909091,67551540,10,4
1,9,0.3076923076923077,0.75,70919590,13,4
2,1,0.6666666666666666,0.8571428571428571,66783675,3,2
1,18,0.14285714285714285,0.6271186440677966,67435291,21,3
1,38,0.24,0.5842696629213483,80135059,50,12
0,40,0.1836734693877551,0.4796747967479675,80155836,49,9
0,15,0.16666666666666666,0.46875,73366041,18,3
1,90,0.22413793103448276,0.5877551020408164,70760312,116,26
0,5,0.0,0.0,66785873,5,0
1,28,0.391304347826087,0.8837209302325582,63633752,46,18
0,46,0.09803921568627451,0.3737864077669903,70467033,51,5
1,3,0.25,0.8,66783451,4,1
1,84,0.24324324324324326,0.6257309941520468,69005993,111,27
1,24,0.4782608695652174,0.9014084507042254,65715111,46,22
1,70,0.2553191489361702,0.5483870967741935,66993521,94,24
1,28,0.3333333333333333,0.7419354838709677,70037611,42,14
0,145,0.17142857142857143,0.34124629080118696,80181296,175,30
1,9,0.3076923076923077,0.6666666666666666,70825804,13,4
0,16,0.0,0.0,65882565,16,0
1,40,0.1836734693877551,0.5983606557377049,78762796,49,9
1,6,0.25,0.8055555555555556,66786986,8,2
0,33,0.05714285714285714,0.46859903381642515,67896283,35,2
0,46,0.061224489795918366,0.24647887323943662,69638485,49,3
0,7,0.0,0.0,64046115,7,0
1,63,0.43243243243243246,0.8670520231213873,70712173,111,48
0,10,0.16666666666666666,0.27586206896551724,65716196,12,2
1,8,0.4666666666666667,0.9047619047619048,63948836,15,7
1,30,0.23076923076923078,0.6105263157894737,64041712,39,9
1,16,0.2727272727272727,0.7959183673469388,64041733,22,6
0,14,0.06666666666666667,0.421875,66781974,15,1
0,2,0.0,0.0,66784494,2,0
0,8,0.0,0.0,66784655,8,0
0,7,0.0,0.0,66784725,7,0
0,4,0.0,0.0,66784830,4,0
1,6,0.25,0.8333333333333334,66785103,8,2
0,4,0.0,0.0,66785404,4,0
0,4,0.0,0.0,66785460,4,0
0,4,0.0,0.0,66785481,4,0
0,7,0.0,0.0,66786580,7,0
0,4,0.0,0.0,66786965,4,0
1,3,0.4,0.8571428571428571,68603864,5,2
0,19,0.09523809523809523,0.4782608695652174,70468265,21,2
1,41,0.3050847457627119,0.8144329896907216,70468496,59,18
1,18,0.25,0.5942028985507246,78478631,24,6
1,10,0.47368421052631576,0.967741935483871,66899105,19,9
2,3,0.8846153846153846,0.875,67988025,26,23
0,8,0.1111111111111111,0.4,65209095,9,1
0,11,0.0,0.0,66783731,11,0
0,25,0.13793103448275862,0.4666666666666667,69204716,29,4
0,34,0.08108108108108109,0.35766423357664234,69204723,37,3
0,14,0.06666666666666667,0.125,73366055,15,1
1,21,0.46153846153846156,0.963855421686747,69042911,39,18
1,15,0.4230769230769231,0.9285714285714286,79816996,26,11
2,1,0.75,0.8571428571428571,80118164,4,3
1,64,0.2558139534883721,0.5163398692810458,62184486,86,22
2,21,0.875,0.9285714285714286,82062243,168,147
2,7,0.8,0.9655172413793104,73415930,35,28
0,10,0.0,0.0,80128544,10,0
0,80,0.16666666666666666,0.44129554655870445,69415843,96,16
1,3,0.25,0.8,80149461,4,1
2,3,0.5714285714285714,0.75,68747014,7,4
0,9,0.0,0.0,67985932,9,0
1,54,0.2987012987012987,0.8071428571428572,63389193,77,23
0,66,0.13157894736842105,0.3051643192488263,69886376,76,10
1,11,0.45,0.8695652173913043,80135186,20,9
0,81,0.05813953488372093,0.23857868020304568,60541726,86,5
0,80,0.3333333333333333,0.47619047619047616,75060496,120,40
0,72,0.25,0.32857142857142857,80181325,96,24
1,12,0.29411764705882354,0.5,80181328,17,5
0,183,0.06153846153846154,0.13535911602209943,70568365,195,12
0,18,0.05263157894736842,0.1111111111111111,80122919,19,1
2,8,0.6521739130434783,0.9583333333333334,80163451,23,15
0,118,0.008403361344537815,0.014652014652014652,66087385,119,1
1,18,0.3333333333333333,0.6666666666666666,63142303,27,9
0,18,0.05263157894736842,0.03076923076923077,70744940,19,1
0,28,0.0967741935483871,0.1111111111111111,70744975,31,3
0,166,0.08287292817679558,0.2446043165467626,80124160,181,15
1,6,0.4,0.8918918918918919,80145711,10,4
2,0,1.0,1.0,80083682,3,3
0,55,0.15384615384615385,0.23255813953488372,80140094,65,10
1,9,0.35714285714285715,0.6666666666666666,80141482,14,5
1,49,0.25757575757575757,0.6929824561403509,73635163,66,17
2,29,0.5084745762711864,0.9111111111111111,70610512,59,30
2,14,0.631578947368421,0.9767441860465116,80061023,38,24
0,5,0.4444444444444444,0.3333333333333333,19487293,9,4
1,9,0.47058823529411764,0.8333333333333334,68656266,17,8
0,45,0.21052631578947367,0.46534653465346537,82129393,57,12
2,1,0.8333333333333334,0.5,70591703,6,5
1,85,0.3511450381679389,0.7974137931034483,66054275,131,46
1,33,0.37735849056603776,0.9102564102564102,79324196,53,20
0,33,0.029411764705882353,0.2111111111111111,77577262,34,1
1,58,0.32558139534883723,0.7889908256880734,68785262,86,28
2,8,0.6,0.967741935483871,66364445,20,12
0,24,0.07692307692307693,0.16666666666666666,72038022,26,2
1,7,0.46153846153846156,0.5555555555555556,66238046,13,6
2,5,0.5,0.5,66238116,10,5
0,45,0.0,0.0,66250590,45,0
1,8,0.2727272727272727,0.5263157894736842,82052044,11,3
1,60,0.3258426966292135,0.7111111111111111,69607244,89,29
1,18,0.25,0.6617647058823529,82126623,24,6
0,94,0.1826086956521739,0.3811074918566775,70242613,115,21
0,67,0.11842105263157894,0.4681818181818182,68318054,76,9
1,5,0.375,0.8095238095238095,70760270,8,3
2,8,0.6363636363636364,0.9375,82052029,22,14
1,18,0.3076923076923077,0.6486486486486487,80125958,26,8
1,21,0.3225806451612903,0.717391304347826,73634911,31,10
1,191,0.32269503546099293,0.6842105263157895,70110264,282,91
1,48,0.4838709677419355,0.8706896551724138,70925834,93,45
1,21,0.475,0.9814814814814815,67218613,40,19
1,9,0.4375,0.9,69735925,16,7
2,3,0.5714285714285714,0.9333333333333333,70710164,7,4
1,15,0.4642857142857143,0.825,67971050,28,13
0,26,0.07142857142857142,0.05405405405405406,80135333,28,2
0,11,0.0,0.0,70703710,11,0
0,13,0.07142857142857142,0.2,70704396,14,1
0,11,0.08333333333333333,0.3673469387755102,70705103,12,1
1,62,0.4745762711864407,0.9347826086956522,72776501,118,56
2,32,0.5733333333333334,0.9122807017543859,80019520,75,43
2,3,0.625,0.8,75265092,8,5
0,4,0.2,0.08333333333333333,70582582,5,1
0,4,0.2,0.0,69163171,5,1
1,79,0.3828125,0.8779342723004695,67994444,128,49
0,67,0.10666666666666667,0.2919254658385093,72392831,75,8
2,10,0.6,0.7857142857142857,80137889,25,15
1,54,0.3076923076923077,0.6870748299319728,80133421,78,24
1,10,0.4444444444444444,0.90625,80128502,18,8
1,4,0.3333333333333333,0.9166666666666666,70536466,6,2
1,12,0.42857142857142855,0.78125,80132326,21,9
2,44,0.5555555555555556,0.9716312056737588,73098725,99,55
0,126,0.16556291390728478,0.20430107526881722,67553220,151,25
0,62,0.16216216216216217,0.17307692307692307,72393335,74,12
0,66,0.043478260869565216,0.14814814814814814,80124162,69,3
0,34,0.02857142857142857,0.16071428571428573,80124337,35,1
0,123,0.11510791366906475,0.363905325443787,80116904,139,16
1,4,0.3333333333333333,0.8857142857142857,70417046,6,2
0,119,0.0703125,0.14766839378238342,70681730,128,9
0,29,0.12121212121212122,0.029411764705882353,80141484,33,4
1,8,0.3333333333333333,0.7272727272727273,72909704,12,4
0,16,0.058823529411764705,0.15789473684210525,70078204,17,1
0,97,0.12612612612612611,0.22356495468277945,69416501,111,14
1,7,0.3,0.5454545454545454,69596303,10,3
1,24,0.35135135135135137,0.7543859649122807,69179754,37,13
0,7,0.2222222222222222,0.25,82102384,9,2
1,65,0.47580645161290325,0.7261904761904762,80180984,124,59
0,119,0.048,0.029498525073746312,69415990,125,6
0,22,0.18518518518518517,0.4024390243902439,69416795,27,5
0,118,0.078125,0.048582995951417005,69177752,128,10
0,86,0.054945054945054944,0.01,69177780,91,5
0,3,0.0,0.0,69598053,3,0
0,122,0.1223021582733813,0.29435483870967744,80124175,139,17
1,50,0.35064935064935066,0.7155963302752294,69704173,77,27
2,0,1.0,1.0,80118308,2,2
1,117,0.34269662921348315,0.8107255520504731,68536020,178,61
1,39,0.25,0.5108695652173914,82116848,52,13
1,45,0.40789473684210525,0.897196261682243,66857595,76,31
1,23,0.3611111111111111,0.8695652173913043,82062034,36,13
1,4,0.42857142857142855,0.8181818181818182,80113502,7,3
1,24,0.22580645161290322,0.5344827586206896,72390934,31,7
1,18,0.4857142857142857,0.9642857142857143,80124457,35,17
2,3,0.7,0.9,72803430,10,7
2,27,0.6493506493506493,0.9791666666666666,70660051,77,50
0,8,0.2,0.47368421052631576,74361063,10,2
0,55,0.12698412698412698,0.20382165605095542,67344263,63,8
1,69,0.28865979381443296,0.6463414634146342,80176676,97,28
1,66,0.30526315789473685,0.6917808219178082,60137504,95,29
0,141,0.17058823529411765,0.33186813186813185,74850055,170,29
1,29,0.4528301886792453,0.968503937007874,70341656,53,24
0,25,0.13793103448275862,0.20238095238095238,73977722,29,4
1,19,0.3448275862068966,0.84375,69160504,29,10
2,7,0.75,0.9230769230769231,69585642,28,21
0,16,0.36,0.3225806451612903,70614173,25,9
1,27,0.20588235294117646,0.5111111111111111,80125968,34,7
1,153,0.29493087557603687,0.6033519553072626,82008936,217,64
2,10,0.7142857142857143,0.9473684210526315,79792496,35,25
1,28,0.3170731707317073,0.6071428571428571,70751093,41,13
0,37,0.2127659574468085,0.3629032258064516,82126690,47,10
1,18,0.3076923076923077,0.8235294117647058,70467061,26,8
0,17,0.10526315789473684,0.42424242424242425,82206066,19,2
1,33,0.15384615384615385,0.5042735042735043,69160924,39,6
0,11,0.0,0.0,70677586,11,0
1,26,0.1875,0.6744186046511628,70468076,32,6
1,83,0.14432989690721648,0.5350877192982456,70468356,97,14
0,53,0.11666666666666667,0.1388888888888889,73818143,60,7
1,35,0.2391304347826087,0.625,67049192,46,11
1,29,0.3695652173913043,0.9545454545454546,82120536,46,17
2,5,0.8076923076923077,0.9230769230769231,78013691,26,21
2,7,0.631578947368421,0.9285714285714286,63158452,19,12
1,16,0.42857142857142855,0.8723404255319149,72802583,28,12
0,77,0.04938271604938271,0.14798206278026907,78762894,81,4
0,3,0.0,0.0,82206077,3,0
1,33,0.42105263157894735,0.8924731182795699,67547711,57,24
1,37,0.3508771929824561,0.7701149425287356,70865676,57,20
0,20,0.047619047619047616,0.10869565217391304,70467775,21,1
0,67,0.056338028169014086,0.2235294117647059,78763111,71,4
1,4,0.2,0.7692307692307693,82206068,5,1
0,15,0.0625,0.2261904761904762,64068711,16,1
1,31,0.45614035087719296,0.9285714285714286,82038327,57,26
1,34,0.39285714285714285,0.9381443298969072,69603170,56,22
2,11,0.5217391304347826,0.8333333333333334,70864640,23,12
0,28,0.24324324324324326,0.4647887323943662,69056435,37,9
2,10,0.5,0.9090909090909091,65282763,20,10
0,12,0.07692307692307693,0.04,54468421,13,1
0,9,0.0,0.0,69033524,9,0
0,13,0.07142857142857142,0.34146341463414637,70600250,14,1
2,4,0.6923076923076923,0.8571428571428571,82062192,13,9
0,56,0.2328767123287671,0.3870967741935484,69607475,73,17
0,30,0.09090909090909091,0.13333333333333333,69724410,33,3
1,42,0.3225806451612903,0.8661971830985915,67905796,62,20
0,17,0.19047619047619047,0.038461538461538464,80130738,21,4
0,55,0.2361111111111111,0.3829787234042553,80018960,72,17
1,12,0.4782608695652174,0.9508196721311475,69974471,23,11
0,61,0.06153846153846154,0.27672955974842767,67314982,65,4
0,44,0.043478260869565216,0.19727891156462585,67314996,46,2
1,15,0.11764705882352941,0.56,67315003,17,2
0,14,0.0,0.0,67315045,14,0
0,9,0.0,0.0,70238581,9,0
1,6,0.14285714285714285,0.6571428571428571,70238616,7,1
0,9,0.0,0.0,70238896,9,0
1,9,0.1,0.5,70239561,10,1
1,17,0.10526315789473684,0.5060240963855421,75147653,19,2
1,2,0.3333333333333333,0.8888888888888888,79994355,3,1
1,36,0.18181818181818182,0.5471698113207547,73637781,44,8
2,1,0.8,0.6666666666666666,70182672,5,4
1,58,0.3176470588235294,0.7333333333333333,68657862,85,27
0,13,0.0,0.0,70681982,13,0
0,26,0.13333333333333333,0.38181818181818183,73007172,30,4
2,12,0.5,0.9859154929577465,81971198,24,12
1,47,0.41975308641975306,0.7903225806451613,80180179,81,34
1,80,0.4557823129251701,0.8808290155440415,73590146,147,67
1,135,0.3112244897959184,0.749034749034749,68533843,196,61
0,30,0.1891891891891892,0.43617021276595747,69421464,37,7
1,15,0.3181818181818182,0.8333333333333334,65286501,22,7
0,125,0.04580152671755725,0.009433962264150943,68512052,131,6
0,30,0.1891891891891892,0.2727272727272727,63466655,37,7
1,73,0.4065040650406504,0.9230769230769231,80135831,123,50
2,20,0.6774193548387096,0.9375,73829931,62,42
1,64,0.2558139534883721,0.5876288659793815,70761026,86,22
0,4,0.0,0.0,70679910,4,0
0,25,0.21875,0.38596491228070173,65798754,32,7
2,10,0.6153846153846154,0.9411764705882353,80130749,26,16
0,18,0.21739130434782608,0.4153846153846154,82126785,23,5
1,38,0.45714285714285713,0.8656716417910447,80128576,70,32
1,60,0.375,0.828125,68745600,96,36
0,15,0.11764705882352941,0.10526315789473684,69149374,17,2
2,106,0.5267857142857143,0.8461538461538461,80155216,224,118
2,17,0.6046511627906976,0.9142857142857143,70398062,43,26
2,5,0.6153846153846154,0.9,71277612,13,8
2,10,0.5652173913043478,0.987012987012987,80176324,23,13
2,17,0.7763157894736842,0.96875,65619162,76,59
1,4,0.2,0.7222222222222222,70694694,5,1
0,77,0.27358490566037735,0.4948453608247423,73412605,106,29
0,120,0.21568627450980393,0.46179401993355484,68241460,153,33
0,61,0.12857142857142856,0.2524271844660194,70645372,70,9
0,60,0.01639344262295082,0.01282051282051282,82126665,61,1
0,72,0.06493506493506493,0.049689440993788817,82126666,77,5
0,12,0.07692307692307693,0.10638297872340426,69554191,13,1
0,39,0.025,0.0125,69554240,40,1
0,7,0.125,0.3333333333333333,70605710,8,1
1,5,0.2857142857142857,0.7894736842105263,82158910,7,2
2,1,0.95,0.875,69069252,20,19
2,2,0.75,0.9375,67210976,8,6
1,100,0.3333333333333333,0.8101694915254237,66723636,150,50
1,30,0.11764705882352941,0.5056179775280899,61983642,34,4
1,22,0.21428571428571427,0.5384615384615384,69611283,28,6
1,39,0.38095238095238093,0.8620689655172413,80111451,63,24
0,20,0.2857142857142857,0.36666666666666664,82005349,28,8
2,1,0.6666666666666666,0.9285714285714286,82143623,3,2
1,40,0.42028985507246375,0.9459459459459459,65018723,69,29
1,29,0.23684210526315788,0.5188679245283019,80108770,38,9
1,15,0.21052631578947367,0.5652173913043478,67034765,19,4
0,19,0.09523809523809523,0.2840909090909091,69562633,21,2
0,171,0.03389830508474576,0.18604651162790697,69320552,177,6
0,11,0.0,0.0,80128118,11,0
0,17,0.05555555555555555,0.32432432432432434,69551944,18,1
2,52,0.5357142857142857,0.96875,72198161,112,60
1,106,0.2980132450331126,0.7046413502109705,63050911,151,45
0,33,0.13157894736842105,0.12857142857142856,66264324,38,5
1,131,0.2640449438202247,0.575,62803083,178,47
0,11,0.15384615384615385,0.18421052631578946,71081080,13,2
1,7,0.4166666666666667,0.8181818181818182,67910451,12,5
0,6,0.25,0.45454545454545453,67910444,8,2
2,10,0.7142857142857143,0.9230769230769231,68013323,35,25
0,9,0.0,0.0,82103923,9,0
1,44,0.46987951807228917,0.863013698630137,70071134,83,39
0,40,0.024390243902439025,0.06626506024096386,70682794,41,1
2,11,0.8,0.92,70625891,55,44
1,77,0.3125,0.5686274509803921,80124813,112,35
1,50,0.2753623188405797,0.8873873873873874,69664154,69,19
1,93,0.2734375,0.7906976744186046,44800,128,35
1,25,0.375,0.7931034482758621,82011257,40,15
0,168,0.16,0.200836820083682,60439645,200,32
1,32,0.38461538461538464,0.797752808988764,70242683,52,20
0,21,0.08695652173913043,0.15625,70242795,23,2
1,4,0.42857142857142855,0.7692307692307693,72692053,7,3
2,0,1.0,1.0,80165289,2,2
2,14,0.8833333333333333,0.9803921568627451,82020039,120,106
2,14,0.6216216216216216,0.4,68449563,37,23
1,42,0.23636363636363636,0.5947712418300654,70760361,55,13
0,88,0.053763440860215055,0.1678082191780822,69701646,93,5
2,15,0.5833333333333334,0.9696969696969697,70673876,36,21
0,40,0.09090909090909091,0.057692307692307696,80129947,44,4
0,100,0.18032786885245902,0.2767857142857143,80176725,122,22
0,148,0.13953488372093023,0.4772727272727273,63028672,172,24
2,8,0.5294117647058824,0.9523809523809523,77676865,17,9
1,3,0.4,0.7692307692307693,82154382,5,2
0,146,0.09876543209876543,0.20465116279069767,69106884,162,16
0,110,0.19117647058823528,0.27459016393442626,70207095,136,26
0,23,0.11538461538461539,0.14084507042253522,72038001,26,3
1,28,0.28205128205128205,0.5753424657534246,70718886,39,11
2,0,1.0,1.0,80128017,2,2
2,8,0.68,0.7333333333333333,80178957,25,17
1,21,0.27586206896551724,0.6888888888888889,68257000,29,8
2,4,0.7142857142857143,0.5,60242784,14,10
0,169,0.028735632183908046,0.0027247956403269754,66086916,174,5
0,19,0.2692307692307692,0.47058823529411764,80162643,26,7
0,82,0.21904761904761905,0.3431372549019608,67627301,105,23
1,68,0.2765957446808511,0.6653992395437263,70761096,94,26
0,91,0.21551724137931033,0.4064516129032258,80118670,116,25
1,80,0.24528301886792453,0.625,67568662,106,26
1,79,0.3779527559055118,0.8609625668449198,67558211,127,48
0,6,0.3333333333333333,0.16666666666666666,80163143,9,3
1,30,0.23076923076923078,0.5454545454545454,68639662,39,9
0,99,0.04807692307692308,0.286697247706422,62840946,104,5
1,27,0.2702702702702703,0.5510204081632653,82023066,37,10
1,16,0.36,0.6363636363636364,82023705,25,9
2,0,1.0,1.0,79990092,14,14
2,4,0.8095238095238095,0.9230769230769231,70022036,21,17
1,23,0.30303030303030304,0.75,69499465,33,10
0,4,0.3333333333333333,0.42857142857142855,82250615,6,2
0,42,0.08695652173913043,0.36075949367088606,80029054,46,4
0,44,0.16981132075471697,0.2283464566929134,66188206,53,9
1,17,0.15,0.6756756756756757,80028963,20,3
0,25,0.0,0.0,80028991,25,0
0,14,0.0,0.0,70674940,14,0
0,15,0.0,0.0,70682780,15,0
0,1,0.0,0.0,77283710,1,0
2,5,0.5454545454545454,0.9090909090909091,66086972,11,6
0,26,0.16129032258064516,0.24285714285714285,69204345,31,5
2,2,0.5,0.5,67906573,4,2
2,56,0.5371900826446281,0.9368421052631579,71665223,121,65
1,89,0.2644628099173554,0.5399239543726235,80103303,121,32
0,30,0.03225806451612903,0.1111111111111111,80028865,31,1
1,39,0.30357142857142855,0.6976744186046512,69634061,56,17
0,34,0.05555555555555555,0.05042016806722689,69640711,36,2
2,11,0.5217391304347826,0.8571428571428571,80174693,23,12
0,48,0.2727272727272727,0.4666666666666667,80019030,66,18
0,19,0.13636363636363635,0.1111111111111111,65092636,22,3
2,16,0.6595744680851063,0.9642857142857143,72802520,47,31
0,2,0.0,0.0,80145726,2,0
0,4,0.0,0.0,80145892,4,0
1,32,0.42857142857142855,0.9137931034482759,73599610,56,24
2,2,0.6,0.6666666666666666,70334824,5,3
1,53,0.2638888888888889,0.5291005291005291,70063805,72,19
2,12,0.7333333333333333,0.9285714285714286,68257931,45,33
1,39,0.390625,0.9285714285714286,66404394,64,25
0,66,0.16455696202531644,0.15602836879432624,65851660,79,13
0,22,0.15384615384615385,0.09090909090909091,82126773,26,4
2,4,0.6363636363636364,0.7142857142857143,79816436,11,7
2,2,0.6666666666666666,0.75,82151152,6,4
0,73,0.27,0.463855421686747,82116884,100,27
0,58,0.12121212121212122,0.18,80072174,66,8
0,23,0.08,0.0,67553094,25,2
0,44,0.2,0.2689075630252101,66973011,55,11
1,37,0.3148148148148148,0.7904761904761904,80135081,54,17
1,44,0.2903225806451613,0.6323529411764706,73652124,62,18
0,10,0.0,0.0,69134324,10,0
1,55,0.48598130841121495,0.7652173913043478,63766192,107,52
0,78,0.10344827586206896,0.42857142857142855,68242321,87,9
0,3,0.0,0.0,78762684,3,0
2,32,0.5616438356164384,0.90625,57176812,73,41
1,5,0.4444444444444444,0.9310344827586207,69944175,9,4
1,46,0.43209876543209874,0.9430379746835443,70637896,81,35
1,11,0.26666666666666666,0.5,70937650,15,4
0,83,0.14432989690721648,0.34558823529411764,69106926,97,14
2,3,0.75,0.9166666666666666,70795151,12,9
2,0,1.0,1.0,75120955,2,2
0,4,0.0,0.0,70684922,4,0
0,10,0.0,0.0,80126786,10,0
0,17,0.2608695652173913,0.47368421052631576,82002257,23,6
0,138,0.02127659574468085,0.03302752293577982,62834975,141,3
0,58,0.1076923076923077,0.174496644295302,54204906,65,7
0,285,0.0981012658227848,0.17676143386897405,66058755,316,31
1,84,0.27586206896551724,0.7434782608695653,80121267,116,32
1,16,0.36,0.875,70760060,25,9
2,52,0.5185185185185185,0.9758064516129032,79838766,108,56
2,54,0.5045871559633027,0.9555555555555556,79838773,109,55
0,2,0.0,0.0,67779285,2,0
0,2,0.0,0.0,67779292,2,0
2,6,0.6666666666666666,0.8823529411764706,67779775,18,12
1,67,0.49624060150375937,0.9096385542168675,80163476,133,66
2,6,0.6666666666666666,0.8571428571428571,66495800,18,12
2,0,1.0,1.0,72803451,3,3
2,0,1.0,1.0,79691402,8,8
2,4,0.7142857142857143,0.875,62143592,14,10
0,57,0.17391304347826086,0.39473684210526316,73346854,69,12
2,11,0.6333333333333333,0.9583333333333334,63462700,30,19
2,9,0.5263157894736842,0.9473684210526315,68151293,19,10
1,2,0.3333333333333333,0.5555555555555556,69979630,3,1
2,7,0.6818181818181818,0.7857142857142857,80047086,22,15
2,28,0.5625,0.9830508474576272,80181497,64,36
0,56,0.06666666666666667,0.14545454545454545,82019479,60,4
1,23,0.20689655172413793,0.5,82022532,29,6
2,1,0.9166666666666666,0.6666666666666666,82110458,12,11
0,49,0.0392156862745098,0.07017543859649122,70685125,51,2
0,16,0.2,0.4789915966386555,70694722,20,4
1,11,0.26666666666666666,0.5862068965517241,82002272,15,4
2,4,0.8260869565217391,0.9375,70925533,23,19
0,57,0.32142857142857145,0.4,78150282,84,27
1,10,0.23076923076923078,0.7297297297297297,69033503,13,3
2,7,0.5882352941176471,0.7692307692307693,71230145,17,10
1,21,0.27586206896551724,0.5,76045473,29,8
1,90,0.34782608695652173,0.8131868131868132,66856496,138,48
0,202,0.04265402843601896,0.034759358288770054,70491624,211,9
2,1,0.5,0.5,70803096,2,1
1,115,0.31547619047619047,0.6858407079646017,69215181,168,53
1,24,0.2727272727272727,0.8345864661654135,72868173,33,9
0,56,0.13846153846153847,0.10476190476190476,73977771,65,9
0,2,0.3333333333333333,0.375,69412644,3,1
1,56,0.3170731707317073,0.7874015748031497,70234864,82,26
0,57,0.14925373134328357,0.2804878048780488,65249751,67,10
1,55,0.38202247191011235,0.813953488372093,63425222,89,34
1,10,0.375,0.7647058823529411,67591335,16,6
0,7,0.125,0.17647058823529413,67591314,8,1
0,71,0.05333333333333334,0.21033210332103322,64999634,75,4
2,29,0.5606060606060606,0.8939393939393939,79816464,66,37
2,12,0.6842105263157895,0.9259259259259259,82041827,38,26
1,48,0.3424657534246575,0.7160493827160493,80129948,73,25
2,24,0.52,0.972972972972973,67127732,50,26
0,56,0.08196721311475409,0.12962962962962962,69903582,61,5
0,20,0.2857142857142857,0.37037037037037035,82065186,28,8
2,4,0.5,0.8571428571428571,70829052,8,4
1,80,0.25925925925925924,0.520618556701031,62510854,108,28
1,23,0.3611111111111111,0.8805970149253731,68286316,36,13
1,21,0.4,0.7872340425531915,67411274,35,14
0,6,0.14285714285714285,0.1111111111111111,69093626,7,1
1,17,0.32,0.7647058823529411,69093640,25,8
2,7,0.6111111111111112,0.9090909090909091,81900756,18,11
1,32,0.2727272727272727,0.64,63050974,44,12
2,2,0.5,0.75,82145105,4,2
2,1,0.6666666666666666,0.8,67654832,3,2
0,11,0.26666666666666666,0.4666666666666667,69499136,15,4
1,55,0.3956043956043956,0.795774647887324,79796920,91,36
2,65,0.6408839779005525,0.9038461538461539,82041828,181,116
1,14,0.2631578947368421,0.7777777777777778,70862484,19,5
1,21,0.27586206896551724,0.6,69183471,29,8
1,13,0.43478260869565216,0.9230769230769231,80132305,23,10
1,28,0.44,0.7671232876712328,80180256,50,22
1,53,0.4111111111111111,0.8837209302325582,82010669,90,37
1,34,0.32,0.625,67612510,50,16
1,10,0.3333333333333333,0.8333333333333334,82018820,15,5
0,3,0.0,0.0,67620742,3,0
0,50,0.0196078431372549,0.12087912087912088,67620973,51,1
1,12,0.25,0.75,69946975,16,4
0,5,0.0,0.0,70417025,5,0
0,21,0.045454545454545456,0.21,73489493,22,1
0,35,0.2391304347826087,0.41379310344827586,68352543,46,11
2,3,0.7692307692307693,0.5,74088490,13,10
1,105,0.36363636363636365,0.7938144329896907,80134787,165,60
1,8,0.42857142857142855,0.6153846153846154,57050231,14,6
0,6,0.14285714285714285,0.18181818181818182,69498982,7,1
0,15,0.0,0.0,68499144,15,0
0,25,0.07407407407407407,0.4095238095238095,68500145,27,2
0,2,0.0,0.0,68500320,2,0
1,2,0.3333333333333333,0.896551724137931,68500355,3,1
0,4,0.0,0.0,71212316,4,0
0,98,0.0297029702970297,0.20444444444444446,69006455,101,3
2,18,0.875,0.975609756097561,70596512,144,126
1,49,0.3717948717948718,0.7741935483870968,67220482,78,29
0,21,0.27586206896551724,0.3620689655172414,71214990,29,8
1,8,0.4666666666666667,0.8333333333333334,71215004,15,7
0,12,0.07692307692307693,0.05,80128312,13,1
1,36,0.4782608695652174,0.9655172413793104,80180324,69,33
1,38,0.45714285714285713,0.8783783783783784,80126946,70,32
1,48,0.38461538461538464,0.7565217391304347,66272325,78,30
1,30,0.375,0.7570093457943925,82023512,48,18
2,58,0.6685714285714286,0.9746835443037974,80126567,175,117
0,88,0.12,0.3141592920353982,69478836,100,12
2,24,0.625,0.918918918918919,73443013,64,40
2,10,0.7297297297297297,0.8275862068965517,66763606,37,27
1,55,0.3373493975903614,0.8446601941747572,67429096,83,28
1,59,0.4485981308411215,0.6904761904761905,80180013,107,48
2,11,0.56,0.9615384615384616,65288636,25,14
2,20,0.5652173913043478,0.9024390243902439,71020495,46,26
0,61,0.22784810126582278,0.3087248322147651,69179635,79,18
0,12,0.25,0.3559322033898305,65281363,16,4
1,28,0.28205128205128205,0.5833333333333334,63633304,39,11
1,60,0.42857142857142855,0.9366197183098591,69184542,105,45
0,6,0.0,0.0,69954213,6,0
1,3,0.4,0.625,70415471,5,2
2,4,0.6363636363636364,0.9444444444444444,69098323,11,7
1,80,0.375,0.6696428571428571,80176070,128,48
1,16,0.4666666666666667,0.9166666666666666,66459253,30,14
0,11,0.21428571428571427,0.3333333333333333,67665500,14,3
2,15,0.53125,0.9512195121951219,82096240,32,17
1,78,0.21212121212121213,0.8209606986899564,74020121,99,21
0,49,0.0392156862745098,0.012422360248447204,65850960,51,2
2,2,0.75,0.5,70761621,8,6
0,2,0.0,0.0,70761824,2,0
0,14,0.0,0.0,70681352,14,0
2,2,0.5,0.8888888888888888,80126823,4,2
0,182,0.07142857142857142,0.16049382716049382,73331342,196,14
1,26,0.4222222222222222,0.9342105263157895,69183744,45,19
2,5,0.5,0.9166666666666666,69625745,10,5
0,116,0.04132231404958678,0.04129793510324484,62929083,121,5
1,86,0.36764705882352944,0.8110599078341014,65278556,136,50
0,108,0.0847457627118644,0.075,72135441,118,10
1,6,0.3333333333333333,0.7894736842105263,68658786,9,3
0,80,0.17525773195876287,0.49019607843137253,70608496,97,17
0,21,0.08695652173913043,0.2773722627737226,70608503,23,2
1,56,0.2222222222222222,0.536723163841808,80133439,72,16
1,18,0.4,0.9387755102040817,67053616,30,12
1,17,0.45161290322580644,0.9069767441860465,73415006,31,14
1,129,0.44635193133047213,0.9558823529411765,67558106,233,104
2,1,0.8,0.5,67979583,5,4
1,79,0.3130434782608696,0.6611111111111111,80136825,115,36
1,105,0.4198895027624309,0.8089430894308943,79765560,181,76
0,47,0.04081632653061224,0.18218623481781376,62840022,49,2
1,52,0.21212121212121213,0.5738636363636364,70190463,66,14
0,19,0.09523809523809523,0.46534653465346537,70917364,21,2
2,19,0.6545454545454545,0.9512195121951219,80137962,55,36
0,28,0.15151515151515152,0.27906976744186046,69582744,33,5
0,75,0.12790697674418605,0.4083333333333333,64076866,86,11
0,22,0.15384615384615385,0.1346153846153846,65281342,26,4
2,1,0.9,0.5,67551316,10,9
0,38,0.15555555555555556,0.3660130718954248,69691993,45,7
0,27,0.15625,0.28888888888888886,63999103,32,5
1,84,0.44,0.9508196721311475,69165425,150,66
1,24,0.3333333333333333,0.7796610169491526,82124927,36,12
0,125,0.22839506172839505,0.44089456869009586,68531183,162,37
1,12,0.3684210526315789,0.9285714285714286,80108245,19,7
1,64,0.28888888888888886,0.6008403361344538,70871500,90,26
1,93,0.24390243902439024,0.625,80158076,123,30
1,29,0.275,0.6623376623376623,66305064,40,11
1,7,0.46153846153846156,0.7916666666666666,82024247,13,6
1,16,0.4074074074074074,0.921875,54295654,27,11
1,18,0.4857142857142857,0.9428571428571428,68543566,35,17
1,74,0.308411214953271,0.5774647887323944,80108455,107,33
0,104,0.2,0.45408163265306123,67159736,130,26
0,121,0.16551724137931034,0.3515625,67159750,145,24
0,50,0.15254237288135594,0.2357142857142857,80097521,59,9
0,63,0.08695652173913043,0.10059171597633136,80097535,69,6
1,42,0.20754716981132076,0.5027624309392266,80097542,53,11
1,48,0.3424657534246575,0.8125,80117932,73,25
0,66,0.18518518518518517,0.28378378378378377,80123754,81,15
1,46,0.2698412698412698,0.6136363636363636,67748996,63,17
2,0,1.0,1.0,72803031,2,2
0,13,0.13333333333333333,0.1,80156744,15,2
0,19,0.2692307692307692,0.40350877192982454,71036924,26,7
2,1,0.5,0.0,69560540,2,1
1,67,0.27956989247311825,0.7163461538461539,68036192,93,26
1,99,0.32653061224489793,0.79182156133829,68434310,147,48
0,81,0.03571428571428571,0.06741573033707865,69508866,84,3
1,63,0.36363636363636365,0.7448559670781894,75115355,99,36
2,2,0.6,0.9333333333333333,80145813,5,3
1,9,0.3076923076923077,0.5652173913043478,80158323,13,4
1,11,0.45,0.925,72417905,20,9
0,66,0.0958904109589041,0.33544303797468356,80124211,73,7
1,19,0.36666666666666664,0.7666666666666667,63883225,30,11
2,0,1.0,1.0,80128523,1,1
2,38,0.5,0.8469387755102041,80180182,76,38
1,261,0.30952380952380953,0.6614509246088194,65686033,378,117
0,56,0.18840579710144928,0.2727272727272727,80127701,69,13
0,58,0.15942028985507245,0.45789473684210524,69084540,69,11
2,25,0.6268656716417911,0.984375,80181496,67,42
0,93,0.12264150943396226,0.1488095238095238,69138650,106,13
1,12,0.45454545454545453,0.8636363636363636,66263533,22,10
2,8,0.7333333333333333,0.9583333333333334,71526063,30,22
0,38,0.0,0.0,68498430,38,0
0,37,0.075,0.3275862068965517,68498472,40,3
0,47,0.09615384615384616,0.3710691823899371,68498556,52,5
1,8,0.2,0.6041666666666666,69478654,10,2
0,10,0.0,0.0,69478864,10,0
0,19,0.09523809523809523,0.49122807017543857,69478976,21,2
0,3,0.0,0.0,69479004,3,0
0,4,0.2,0.0625,79453206,5,1
2,5,0.7619047619047619,0.875,69575856,21,16
2,1,0.8333333333333334,0.5,68025580,6,5
0,22,0.2413793103448276,0.3469387755102041,82126632,29,7
2,29,0.6704545454545454,0.9791666666666666,80013472,88,59
0,259,0.01893939393939394,0.04214123006833713,62836221,264,5
2,1,0.5,0.5,80133899,2,1
2,10,0.7560975609756098,0.9090909090909091,80118933,41,31
0,26,0.21212121212121213,0.43137254901960786,68561626,33,7
1,6,0.45454545454545453,0.7777777777777778,82018893,11,5
1,58,0.21621621621621623,0.5252525252525253,68533570,74,16
1,8,0.42857142857142855,0.8181818181818182,66914834,14,6
1,59,0.46846846846846846,0.8823529411764706,69733405,111,52
0,1,0.0,0.0,68632774,1,0
0,3,0.0,0.0,82108139,3,0
2,0,1.0,1.0,70591710,2,2
1,7,0.2222222222222222,0.6,73705611,9,2
1,53,0.2535211267605634,0.5068493150684932,67555740,71,18
2,9,0.625,0.9285714285714286,68402082,24,15
2,7,0.7307692307692307,0.9375,65821441,26,19
2,7,0.5333333333333333,0.9705882352941176,79690093,15,8
0,99,0.175,0.3273809523809524,82041339,120,21
2,27,0.7768595041322314,0.9827586206896551,80114461,121,94
1,70,0.39655172413793105,0.8153846153846154,67043025,116,46
2,31,0.5507246376811594,0.9534883720930233,69713245,69,38
1,40,0.4444444444444444,0.8125,63897036,72,32
1,61,0.49586776859504134,0.8888888888888888,67971036,121,60
1,39,0.48,0.9568965517241379,69208251,75,36
2,39,0.5617977528089888,0.9830508474576272,80150445,89,50
0,9,0.0,0.0,70509040,9,0
1,26,0.4090909090909091,0.9418604651162791,69499234,44,18
0,124,0.18421052631578946,0.3811188811188811,69073613,152,28
0,35,0.2222222222222222,0.4830508474576271,70018704,45,10
1,6,0.3333333333333333,0.7916666666666666,69712223,9,3
1,84,0.391304347826087,0.9004739336492891,82128646,138,54
2,12,0.625,0.9285714285714286,80176879,32,20
0,80,0.09090909090909091,0.2066115702479339,71762313,88,8
1,28,0.36363636363636365,0.6222222222222222,82251167,44,16
1,17,0.45161290322580644,0.8260869565217391,69985524,31,14
1,26,0.3333333333333333,0.7121212121212122,65288783,39,13
1,56,0.28205128205128205,0.6461538461538462,70741825,78,22
2,1,0.5,0.5,69582723,2,1
0,6,0.14285714285714285,0.2631578947368421,69582772,7,1
1,5,0.375,0.6111111111111112,69582800,8,3
2,4,0.5,0.6666666666666666,69582842,8,4
0,17,0.15,0.4157303370786517,70674436,20,3
0,7,0.125,0.38235294117647056,70675990,8,1
0,24,0.07692307692307693,0.18309859154929578,70680253,26,2
0,6,0.0,0.0,80126778,6,0
0,13,0.0,0.0,70692174,13,0
1,27,0.25,0.5929203539823009,65288664,36,9
1,22,0.3125,0.6666666666666666,65281244,32,10
0,24,0.2,0.25925925925925924,65281300,30,6
1,17,0.34615384615384615,0.9,65282973,26,9
1,15,0.4444444444444444,0.921875,70591815,27,12
1,13,0.2777777777777778,0.5789473684210527,65280243,18,5
0,47,0.04081632653061224,0.23529411764705882,82090174,49,2
0,36,0.02702702702702703,0.2,82090175,37,1
0,43,0.0,0.0,82090177,43,0
0,47,0.0,0.0,82090178,47,0
0,48,0.04,0.25925925925925924,82090179,50,2
0,49,0.02,0.15384615384615385,82090180,50,1
2,17,0.8191489361702128,0.9655172413793104,66829714,94,77
2,0,1.0,1.0,80156047,2,2
0,71,0.15476190476190477,0.21794871794871795,70610036,84,13
0,213,0.10504201680672269,0.1318181818181818,70072044,238,25
0,14,0.2222222222222222,0.41025641025641024,69622224,18,4
0,5,0.0,0.0,70677971,5,0
1,50,0.2857142857142857,0.7063492063492064,69421506,70,20
0,7,0.3,0.4,69622140,10,3
1,16,0.36,0.7391304347826086,69622315,25,9
1,108,0.2116788321167883,0.5243553008595988,70040845,137,29
0,81,0.19801980198019803,0.2949640287769784,69183912,101,20
0,14,0.2222222222222222,0.43478260869565216,73709314,18,4
2,3,0.8,0.9090909090909091,80155958,15,12
2,13,0.5666666666666667,0.896551724137931,67780930,30,17
1,35,0.2857142857142857,0.723404255319149,70014091,49,14
0,8,0.3333333333333333,0.2,366576,12,4
0,193,0.12669683257918551,0.22186495176848875,68754693,221,28
0,18,0.05263157894736842,0.22580645161290322,70568232,19,1
0,81,0.16494845360824742,0.3218390804597701,79025765,97,16
1,39,0.4,0.8452380952380952,65914884,65,26
1,61,0.3068181818181818,0.6510416666666666,80124125,88,27
2,6,0.7931034482758621,0.8461538461538461,67064893,29,23
2,7,0.5882352941176471,0.7272727272727273,70120582,17,10
0,62,0.015873015873015872,0.005434782608695652,69416816,63,1
2,6,0.5384615384615384,0.9230769230769231,69408080,13,7
2,4,0.8333333333333334,0.8571428571428571,72324154,24,20
1,34,0.38181818181818183,0.5,69954066,55,21
2,2,0.8181818181818182,0.8333333333333334,74320722,11,9
2,2,0.8181818181818182,0.625,66651823,11,9
0,12,0.0,0.0,69548353,12,0
0,19,0.0,0.0,69548374,19,0
1,11,0.42105263157894735,0.9333333333333333,69507382,19,8
0,202,0.03349282296650718,0.0536480686695279,64241261,209,7
0,62,0.11428571428571428,0.13821138211382114,69534080,70,8
1,10,0.2857142857142857,0.8333333333333334,75479915,14,4
0,128,0.20987654320987653,0.4792243767313019,80155975,162,34
0,56,0.18840579710144928,0.336734693877551,82042894,69,13
1,20,0.3103448275862069,0.6938775510204082,68946941,29,9
1,41,0.16326530612244897,0.6111111111111112,811503,49,8
2,22,0.5319148936170213,0.9454545454545454,82047560,47,25
1,6,0.25,0.7727272727272727,80029271,8,2
1,20,0.25925925925925924,0.6164383561643836,66404296,27,7
0,108,0.23404255319148937,0.3105022831050228,80136842,141,33
1,2,0.3333333333333333,0.75,80130699,3,1
0,17,0.15,0.2903225806451613,82128673,20,3
1,71,0.4083333333333333,0.8740157480314961,273882,120,49
0,52,0.16129032258064516,0.45989304812834225,67924535,62,10
1,78,0.2777777777777778,0.6926406926406926,80121106,108,30
0,44,0.10204081632653061,0.18048780487804877,82039206,49,5
1,69,0.38392857142857145,0.888,80110940,112,43
0,4,0.2,0.0,70809151,5,1
0,3,0.25,0.42857142857142855,80130701,4,1
0,114,0.17985611510791366,0.38869257950530034,80176732,139,25
0,13,0.13333333333333333,0.46153846153846156,70199605,15,2
0,10,0.0,0.0,70199633,10,0
1,79,0.44755244755244755,0.9469026548672567,70417445,143,64
1,31,0.2619047619047619,0.5875,75892852,42,11
2,4,0.5,0.8888888888888888,61500320,8,4
1,6,0.3333333333333333,0.5882352941176471,63725921,9,3
2,16,0.5789473684210527,0.9855072463768116,64357524,38,22
1,90,0.21739130434782608,0.6134020618556701,64912883,115,25
2,2,0.6,0.75,72803220,5,3
0,59,0.04838709677419355,0.020689655172413793,79650900,62,3
2,8,0.873015873015873,0.95,65819565,63,55
2,1,0.75,0.0,67830686,4,3
1,6,0.45454545454545453,0.8478260869565217,80162644,11,5
0,58,0.23684210526315788,0.39864864864864863,82126711,76,18
1,16,0.3333333333333333,0.6,71458723,24,8
0,77,0.2222222222222222,0.328042328042328,69139280,99,22
0,33,0.1951219512195122,0.3333333333333333,69092464,41,8
1,32,0.3191489361702128,0.6956521739130435,67970301,47,15
1,8,0.2727272727272727,0.7142857142857143,70060452,11,3
0,2,0.0,0.0,70320383,2,0
1,2,0.3333333333333333,0.6666666666666666,70637623,3,1
1,19,0.2962962962962963,0.825,69031193,27,8
1,35,0.33962264150943394,0.8064516129032258,69621622,53,18
0,5,0.0,0.0,69082531,5,0
0,26,0.16129032258064516,0.36904761904761907,70536431,31,5
1,36,0.2,0.6071428571428571,69638660,45,9
2,9,0.625,0.972972972972973,82139995,24,15
1,75,0.29245283018867924,0.6141732283464567,70009646,106,31
2,3,0.7,0.75,67744320,10,7
0,9,0.3076923076923077,0.35,68401641,13,4
1,55,0.3037974683544304,0.6225165562913907,82126735,79,24
2,10,0.5833333333333334,0.9166666666666666,70036974,24,14
2,2,0.7142857142857143,0.8,72801995,7,5
2,2,0.8333333333333334,0.9444444444444444,72801862,12,10
0,6,0.25,0.36363636363636365,72426466,8,2
1,28,0.36363636363636365,0.8041237113402062,80135615,44,16
1,42,0.36363636363636365,0.7764705882352941,69184591,66,24
2,3,0.7,0.8,68044662,10,7
2,28,0.5625,0.9016393442622951,69530811,64,36
0,5,0.2857142857142857,0.375,70718655,7,2
1,42,0.3,0.6333333333333333,66793811,60,18
0,95,0.30656934306569344,0.4883720930232558,69962494,137,42
2,14,0.5,0.9629629629629629,80163137,28,14
0,47,0.020833333333333332,0.1891891891891892,73006976,48,1
0,27,0.12903225806451613,0.4485981308411215,73007151,31,4
1,49,0.26865671641791045,0.6890756302521008,69575744,67,18
1,27,0.2894736842105263,0.6235294117647059,68400871,38,11
0,28,0.17647058823529413,0.3541666666666667,73977792,34,6
1,35,0.2708333333333333,0.55,80061121,48,13
2,1,0.8888888888888888,0.6666666666666666,82041266,9,8
0,13,0.1875,0.34545454545454546,70759773,16,3
0,24,0.22580645161290322,0.45614035087719296,70711291,31,7
0,77,0.21428571428571427,0.4722222222222222,80140107,98,21
2,0,1.0,1.0,68545736,2,2
2,2,0.6,0.6666666666666666,70280112,5,3
2,1,0.5,0.0,70921123,2,1
2,7,0.72,0.7857142857142857,82018978,25,18
2,0,1.0,1.0,70494340,2,2
2,6,0.5,0.9393939393939394,82145522,12,6
1,31,0.3541666666666667,0.7865168539325843,80129992,48,17
1,24,0.38461538461538464,0.8648648648648649,66855803,39,15
1,83,0.4028776978417266,0.8987341772151899,69464976,139,56
0,12,0.07692307692307693,0.16666666666666666,82119386,13,1
0,8,0.0,0.0,82119387,8,0
0,85,0.19047619047619047,0.4385245901639344,70627375,105,20
2,13,0.6666666666666666,0.9411764705882353,73829896,39,26
2,26,0.7319587628865979,0.9565217391304348,80172972,97,71
0,11,0.21428571428571427,0.45,70844060,14,3
1,21,0.36363636363636365,0.821917808219178,72801750,33,12
0,56,0.15151515151515152,0.42452830188679247,70568106,66,10
2,3,0.625,0.9166666666666666,82013615,8,5
2,17,0.6046511627906976,0.6875,80128780,43,26
1,4,0.3333333333333333,0.7142857142857143,82126591,6,2
1,25,0.46808510638297873,0.9479166666666666,64124984,47,22
0,160,0.096045197740113,0.10752688172043011,80071054,177,17
1,46,0.2923076923076923,0.5753424657534246,80178114,65,19
1,6,0.3333333333333333,0.8125,64183182,9,3
1,31,0.41509433962264153,0.8484848484848485,68688060,53,22
0,16,0.1111111111111111,0.09523809523809523,69724242,18,2
2,1,0.8,0.5,66238403,5,4
1,11,0.42105263157894735,0.8888888888888888,70223762,19,8
1,32,0.28888888888888886,0.5633802816901409,69180104,45,13
2,33,0.7053571428571429,0.8524590163934426,67584146,112,79
1,107,0.3742690058479532,0.6872246696035242,80180195,171,64
0,130,0.1095890410958904,0.1786743515850144,82014184,146,16
1,38,0.22448979591836735,0.6693548387096774,67291910,49,11
1,25,0.32432432432432434,0.8148148148148148,69183905,37,12
0,45,0.21052631578947367,0.42990654205607476,67428375,57,12
1,47,0.27692307692307694,0.6153846153846154,68393885,65,18
1,34,0.34615384615384615,0.6574074074074074,80136900,52,18
0,147,0.1301775147928994,0.23858921161825727,67793502,169,22
2,8,0.7142857142857143,0.75,82020067,28,20
2,0,1.0,1.0,80134726,1,1
2,4,0.8333333333333334,0.8888888888888888,69404202,24,20
2,1,0.8,0.5,80163138,5,4
1,46,0.38666666666666666,0.856,70748384,75,29
2,24,0.6363636363636364,0.9574468085106383,67971022,66,42
1,34,0.30612244897959184,0.7916666666666666,72530423,49,15
0,20,0.16666666666666666,0.2545454545454545,66892350,24,4
2,5,0.5,0.8,69733244,10,5
2,25,0.5283018867924528,0.9560439560439561,70925610,53,28
0,51,0.1206896551724138,0.21893491124260356,65463573,58,7
1,18,0.3076923076923077,0.6612903225806451,68052824,26,8
2,15,0.7169811320754716,0.9642857142857143,82054006,53,38
1,9,0.3076923076923077,0.8717948717948718,69141030,13,4
1,31,0.32608695652173914,0.6,70608874,46,15
1,6,0.3333333333333333,0.5625,74389511,9,3
0,66,0.21428571428571427,0.3393939393939394,67995214,84,18
1,90,0.3023255813953488,0.6989795918367347,62815452,129,39
1,46,0.43902439024390244,0.746268656716418,61706162,82,36
1,90,0.22413793103448276,0.5057142857142857,80168507,116,26
2,33,0.5714285714285714,0.9166666666666666,72700236,77,44
1,30,0.4230769230769231,0.8225806451612904,80180176,52,22
2,6,0.6,0.7,79457392,15,9
2,7,0.5333333333333333,0.25,67610564,15,8
2,3,0.5,0.2,70857381,6,3
1,45,0.47058823529411764,0.9316239316239316,80141323,85,40
0,12,0.14285714285714285,0.14814814814814814,80117830,14,2
0,48,0.2,0.3282828282828283,82116870,60,12
2,46,0.5208333333333334,0.937984496124031,73869880,96,50
2,5,0.5,0.9,13733615,10,5
1,124,0.28735632183908044,0.7348484848484849,68533752,174,50
0,8,0.38461538461538464,0.25,82165052,13,5
2,25,0.5833333333333334,0.8333333333333334,80168324,60,35
1,13,0.23529411764705882,0.59375,69416935,17,4
1,26,0.43478260869565216,0.9375,80118456,46,20
1,13,0.48,0.8108108108108109,80051664,25,12
0,7,0.0,0.0,67822615,7,0
0,35,0.05405405405405406,0.36666666666666664,69698335,37,2
2,5,0.6153846153846154,0.875,80134724,13,8
1,14,0.44,0.8636363636363636,72844114,25,11
1,38,0.2692307692307692,0.7311827956989247,73444854,52,14
0,1,0.0,0.0,69082762,1,0
1,27,0.2894736842105263,0.7352941176470589,73634603,38,11
1,93,0.45614035087719296,0.5434782608695652,68187084,171,78
2,5,0.5454545454545454,0.9375,73623095,11,6
1,54,0.3493975903614458,0.7798165137614679,69608154,83,29
1,13,0.23529411764705882,0.5,69603723,17,4
2,1,0.5,0.8333333333333334,65249422,2,1
1,45,0.4230769230769231,0.8024691358024691,71011864,78,33
1,20,0.2857142857142857,0.8611111111111112,68352291,28,8
1,8,0.38461538461538464,0.8333333333333334,69007330,13,5
1,51,0.3108108108108108,0.6774193548387096,69534262,74,23
1,17,0.32,0.6730769230769231,80163515,25,8
1,16,0.4074074074074074,0.7021276595744681,68028905,27,11
2,19,0.6122448979591837,0.88,74749843,49,30
1,84,0.4125874125874126,0.7635135135135135,72534301,143,59
1,32,0.23809523809523808,0.7410714285714286,80124694,42,10
1,58,0.30120481927710846,0.6036585365853658,80086251,83,25
2,19,0.8303571428571429,0.975,70891373,112,93
1,67,0.40707964601769914,0.8798586572438163,68546912,113,46
1,17,0.41379310344827586,0.875,69727756,29,12
1,26,0.3333333333333333,0.8428571428571429,69724123,39,13
0,36,0.14285714285714285,0.07142857142857142,62498100,42,6
2,6,0.5714285714285714,0.9523809523809523,68401081,14,8
0,12,0.14285714285714285,0.36363636363636365,65033913,14,2
0,17,0.15,0.3409090909090909,69724221,20,3
0,36,0.14285714285714285,0.16666666666666666,73445435,42,6
1,18,0.4,0.7551020408163265,71689562,30,12
2,16,0.6862745098039216,0.967741935483871,69732796,51,35
2,0,1.0,1.0,69733902,3,3
0,2,0.3333333333333333,0.25,66234063,3,1
2,2,0.6,0.5,66234196,5,3
2,1,0.5,0.3333333333333333,66234203,2,1
0,4,0.0,0.0,70705145,4,0
2,3,0.5,0.8947368421052632,82010322,6,3
1,6,0.3333333333333333,0.8214285714285714,70693896,9,3
1,83,0.3464566929133858,0.7246376811594203,71762684,127,44
1,8,0.38461538461538464,0.8636363636363636,72803115,13,5
0,166,0.2169811320754717,0.3855421686746988,82124903,212,46
0,24,0.1724137931034483,0.36065573770491804,67190053,29,5
0,177,0.2062780269058296,0.4774193548387097,82036706,223,46
1,86,0.3333333333333333,0.7161290322580646,80096261,129,43
0,14,0.0,0.0,74019904,14,0
1,17,0.10526315789473684,0.5287356321839081,74019911,19,2
0,88,0.08333333333333333,0.29213483146067415,69106870,96,8
1,10,0.4117647058823529,0.92,60976825,17,7
0,39,0.1702127659574468,0.3724137931034483,69395466,47,8
1,14,0.4166666666666667,0.9,69058451,24,10
1,15,0.21052631578947367,0.6714285714285714,80149987,19,4
0,14,0.2631578947368421,0.41935483870967744,80181644,19,5
1,73,0.2912621359223301,0.7981220657276995,69704600,103,30
0,34,0.02857142857142857,0.024193548387096774,68297831,35,1
2,6,0.7272727272727273,0.9285714285714286,82041296,22,16
2,13,0.6060606060606061,0.9574468085106383,79816555,33,20
2,6,0.5714285714285714,0.8823529411764706,72802751,14,8
0,28,0.034482758620689655,0.06722689075630252,72808785,29,1
2,8,0.68,0.9444444444444444,67833332,25,17
0,25,0.3055555555555556,0.49019607843137253,70614194,36,11
1,23,0.425,0.9452054794520548,80136720,40,17
2,12,0.6756756756756757,0.9411764705882353,82008295,37,25
0,31,0.20512820512820512,0.3611111111111111,69055483,39,8
0,29,0.2564102564102564,0.4444444444444444,80061135,39,10
0,32,0.2558139534883721,0.4027777777777778,80061142,43,11
0,107,0.21897810218978103,0.2773109243697479,70543410,137,30
1,60,0.3333333333333333,0.7409638554216867,69177584,90,30
2,1,0.9666666666666667,0.5,70593915,30,29
2,0,1.0,1.0,82202303,1,1
0,3,0.0,0.0,72474661,3,0
1,6,0.3333333333333333,0.8,72475151,9,3
0,38,0.15555555555555556,0.3055555555555556,67995620,45,7
1,24,0.1111111111111111,0.6050955414012739,62839511,27,3
0,34,0.0,0.0,62840134,34,0
0,92,0.031578947368421054,0.1388888888888889,67868633,95,3
1,20,0.16666666666666666,0.569620253164557,82103869,24,4
0,30,0.09090909090909091,0.27205882352941174,82103871,33,3
1,25,0.24242424242424243,0.6161616161616161,70633143,33,8
0,27,0.22857142857142856,0.1346153846153846,62497001,35,8
0,30,0.14285714285714285,0.10909090909090909,62497281,35,5
0,90,0.1743119266055046,0.352059925093633,70063644,109,19
2,10,0.6774193548387096,0.7857142857142857,66054492,31,21
2,6,0.6,0.75,82145163,15,9
0,12,0.2,0.1282051282051282,70509243,15,3
1,56,0.4666666666666667,0.8909090909090909,80163706,105,49
2,8,0.68,0.7222222222222222,69547632,25,17
2,22,0.7582417582417582,0.8918918918918919,66763522,91,69
1,33,0.37735849056603776,0.7333333333333333,80137601,53,20
1,17,0.34615384615384615,0.7755102040816326,68401270,26,9
1,6,0.3333333333333333,0.7272727272727273,70059822,9,3
1,103,0.3795180722891566,0.8434782608695652,82126702,166,63
0,14,0.0,0.0,82003706,14,0
0,2,0.0,0.0,82003752,2,0
2,29,0.5797101449275363,0.8275862068965517,69311326,69,40
2,10,0.5,0.9047619047619048,75121053,20,10
0,5,0.0,0.0,70702835,5,0
1,19,0.24,0.524390243902439,70704144,25,6
1,43,0.29508196721311475,0.7521367521367521,64166396,61,18
0,8,0.1111111111111111,0.21428571428571427,77691411,9,1
0,6,0.25,0.35,67040456,8,2
1,7,0.36363636363636365,0.6956521739130435,80055913,11,4
0,48,0.14285714285714285,0.31547619047619047,74923856,56,8
0,163,0.1043956043956044,0.20180722891566266,67285645,182,19
0,70,0.20454545454545456,0.40939597315436244,79788464,88,18
2,10,0.5652173913043478,0.9166666666666666,80172866,23,13
2,3,0.5714285714285714,0.75,70713202,7,4
2,0,1.0,1.0,73390051,10,10
0,48,0.09433962264150944,0.24324324324324326,70238931,53,5
1,5,0.2857142857142857,0.8888888888888888,71277584,7,2
0,14,0.0,0.0,79468466,14,0
1,17,0.39285714285714285,0.7872340425531915,82041899,28,11
0,1,0.0,0.0,70508445,1,0
1,3,0.25,0.5,69092345,4,1
1,104,0.2777777777777778,0.7388059701492538,70768964,144,40
1,15,0.3181818181818182,0.6585365853658537,69092436,22,7
2,4,0.875,0.9375,80172929,32,28
0,4,0.0,0.0,70682871,4,0
0,10,0.0,0.0,80126827,10,0
1,6,0.4,0.5555555555555556,82023758,10,4
2,2,0.8461538461538461,0.75,80127023,13,11
1,35,0.20454545454545456,0.5151515151515151,74923926,44,9
1,27,0.25,0.6470588235294118,68229483,36,9
0,28,0.125,0.16666666666666666,80135288,32,4
1,2,0.3333333333333333,0.875,70573174,3,1
1,13,0.23529411764705882,0.5094339622641509,82096332,17,4
0,143,0.04666666666666667,0.2535211267605634,62834576,150,7
2,1,0.5,0.75,67053665,2,1
1,104,0.35802469135802467,0.6785714285714286,80135749,162,58
0,189,0.02577319587628866,0.07401032702237521,66876516,194,5
1,75,0.27884615384615385,0.6984126984126984,70828534,104,29
0,23,0.0,0.0,74924374,23,0
0,32,0.08571428571428572,0.37755102040816324,70209804,35,3
0,34,0.05555555555555555,0.17475728155339806,70209825,36,2
1,6,0.4,0.7142857142857143,74924052,10,4
1,15,0.16666666666666666,0.6029411764705882,74924073,18,3
0,38,0.11627906976744186,0.06557377049180328,73524535,43,5
0,16,0.0,0.0,80163173,16,0
2,3,0.5,0.9444444444444444,82118261,6,3
0,6,0.14285714285714285,0.05263157894736842,82053032,7,1
0,9,0.18181818181818182,0.3333333333333333,82053046,11,2
0,7,0.125,0.2,70634592,8,1
0,180,0.08163265306122448,0.3910806174957118,63975541,196,16
2,0,1.0,1.0,70761530,1,1
1,21,0.16,0.7078651685393258,70463512,25,4
0,33,0.08333333333333333,0.2925170068027211,80167325,36,3
0,19,0.0,0.0,80176298,19,0
0,54,0.16923076923076924,0.3502824858757062,69058101,65,11
0,2,0.0,0.0,67917773,2,0
0,11,0.08333333333333333,0.1891891891891892,63188223,12,1
0,39,0.04878048780487805,0.26424870466321243,70468034,41,2
0,126,0.08029197080291971,0.3872255489021956,64069502,137,11
0,42,0.045454545454545456,0.29767441860465116,65228121,44,2
1,32,0.1111111111111111,0.5583333333333333,70923741,36,4
1,11,0.21428571428571427,0.6571428571428571,69887055,14,3
1,9,0.25,0.7674418604651163,74924311,12,3
0,23,0.041666666666666664,0.10569105691056911,70923251,24,1
0,25,0.0,0.0,80150845,25,0
0,53,0.05357142857142857,0.18867924528301888,68198956,56,3
0,122,0.03937007874015748,0.14957264957264957,66876474,127,5
0,4,0.0,0.0,80150618,4,0
0,26,0.0,0.0,82205948,26,0
2,7,0.6956521739130435,0.96,73179610,23,16
1,4,0.2,0.5,64467655,5,1
0,112,0.0743801652892562,0.49193548387096775,68356855,121,9
1,62,0.17333333333333334,0.622568093385214,80128662,75,13
0,10,0.0,0.0,80163376,10,0
2,0,1.0,1.0,68039825,1,1
0,14,0.06666666666666667,0.4727272727272727,67888534,15,1
1,10,0.47368421052631576,0.9024390243902439,67517401,19,9
1,43,0.31746031746031744,0.7672413793103449,69621601,63,20
0,88,0.2072072072072072,0.4258373205741627,80176729,111,23
2,2,0.5,0.6666666666666666,69058206,4,2
0,31,0.0,0.0,69160931,31,0
1,25,0.4444444444444444,0.926829268292683,79146011,45,20
0,13,0.0,0.0,80150516,13,0
0,6,0.0,0.0,80150583,6,0
0,16,0.058823529411764705,0.29850746268656714,67978351,17,1
0,1,0.0,0.0,66395756,1,0
0,7,0.125,0.36585365853658536,64234674,8,1
0,6,0.0,0.0,67434920,6,0
0,13,0.0,0.0,80150685,13,0
1,17,0.10526315789473684,0.5754716981132075,80150877,19,2
0,12,0.25,0.4909090909090909,77321944,16,4
1,19,0.09523809523809523,0.6903225806451613,82049107,21,2
0,17,0.05555555555555555,0.40441176470588236,82049108,18,1
0,100,0.10714285714285714,0.3828125,65350901,112,12
0,20,0.13043478260869565,0.3253012048192771,80153552,23,3
1,23,0.30303030303030304,0.8194444444444444,67812640,33,10
0,10,0.09090909090909091,0.21951219512195122,67511234,11,1
2,5,0.5,0.9444444444444444,80118162,10,5
1,9,0.18181818181818182,0.7611940298507462,82034201,11,2
0,38,0.13636363636363635,0.4892086330935252,64099931,44,6
1,89,0.17592592592592593,0.6134453781512605,67510163,108,19
1,47,0.265625,0.5321100917431193,82143801,64,17
0,44,0.10204081632653061,0.26506024096385544,72917341,49,5
1,11,0.42105263157894735,0.8333333333333334,80173411,19,8
0,72,0.07692307692307693,0.44510385756676557,70918106,78,6
0,39,0.09302325581395349,0.4393305439330544,66801434,43,4
0,6,0.0,0.0,69188623,6,0
1,23,0.43902439024390244,0.8793103448275862,64472926,41,18
0,65,0.07142857142857142,0.23039215686274508,80153531,70,5
1,32,0.1111111111111111,0.5086206896551724,64234723,36,4
0,6,0.0,0.0,80089261,6,0
2,7,0.5882352941176471,0.9565217391304348,67970861,17,10
1,17,0.48484848484848486,0.9024390243902439,67865875,33,16
1,14,0.2222222222222222,0.7627118644067796,70629972,18,4
1,11,0.21428571428571427,0.6666666666666666,64463000,14,3
2,11,0.5217391304347826,0.9032258064516129,80171750,23,12
0,19,0.05,0.38666666666666666,68384505,20,1
0,36,0.07692307692307693,0.14074074074074075,82050497,39,3
1,2,0.3333333333333333,0.8181818181818182,80162857,3,1
1,20,0.3103448275862069,0.7578947368421053,80173410,29,9
0,5,0.0,0.0,82006640,5,0
0,32,0.030303030303030304,0.014492753623188406,70798875,33,1
2,0,1.0,1.0,68041491,2,2
0,26,0.037037037037037035,0.15517241379310345,68356722,27,1
1,14,0.125,0.5068493150684932,82118242,16,2
0,12,0.0,0.0,69886264,12,0
0,1,0.0,0.0,70634641,1,0
0,2,0.0,0.0,80162818,2,0
0,23,0.14814814814814814,0.21818181818181817,70798896,27,4
2,7,0.5882352941176471,0.8125,69042750,17,10
0,4,0.0,0.0,80169896,4,0
1,9,0.18181818181818182,0.7027027027027027,80173423,11,2
1,33,0.26666666666666666,0.7920792079207921,73700585,45,12
0,47,0.11320754716981132,0.2111111111111111,82001866,53,6
1,82,0.2545454545454545,0.6017316017316018,80135438,110,28
0,23,0.08,0.32941176470588235,68384533,25,2
0,14,0.06666666666666667,0.2,64462972,15,1
0,9,0.1,0.1509433962264151,80172564,10,1
0,62,0.11428571428571428,0.3137254901960784,64649725,70,8
0,149,0.050955414012738856,0.224105461393597,67122370,157,8
0,12,0.0,0.0,67434906,12,0
0,85,0.07608695652173914,0.3280757097791798,67839114,92,7
1,41,0.2545454545454545,0.5975609756097561,79976652,55,14
0,32,0.030303030303030304,0.3482587064676617,80149990,33,1
0,3,0.0,0.0,66096870,3,0
0,28,0.06666666666666667,0.336283185840708,78166305,30,2
0,16,0.1111111111111111,0.4864864864864865,70213402,18,2
0,31,0.11428571428571428,0.3194444444444444,67721276,35,4
0,5,0.0,0.0,78762726,5,0
1,59,0.313953488372093,0.8590909090909091,70542976,86,27
0,122,0.008130081300813009,0.07768924302788845,80150869,123,1
0,18,0.0,0.0,67900245,18,0
0,11,0.08333333333333333,0.38,70918834,12,1
0,57,0.06557377049180328,0.1917808219178082,65716581,61,4
1,56,0.2,0.632183908045977,80028802,70,14
0,1,0.0,0.0,80171051,1,0
0,1,0.0,0.0,66827810,1,0
0,25,0.07407407407407407,0.4409937888198758,66472021,27,2
1,52,0.05454545454545454,0.5159235668789809,80149922,55,3
0,49,0.0,0.0,80150865,49,0
0,1,0.0,0.0,82152435,1,0
1,32,0.23809523809523808,0.7456140350877193,78763321,42,10
0,48,0.04,0.1347517730496454,65716511,50,2
0,1,0.0,0.0,82205869,1,0
0,36,0.0,0.0,82206143,36,0
0,18,0.05263157894736842,0.25675675675675674,80089282,19,1
1,17,0.15,0.7083333333333334,80089303,20,3
0,20,0.09090909090909091,0.38333333333333336,80149812,22,2
0,45,0.1346153846153846,0.46745562130177515,67454856,52,7
0,30,0.11764705882352941,0.42045454545454547,67888786,34,4
0,17,0.05555555555555555,0.11458333333333333,80126522,18,1
1,28,0.3,0.8135593220338984,79976666,40,12
0,84,0.125,0.4831932773109244,67888625,96,12
0,20,0.0,0.0,70629993,20,0
1,25,0.24242424242424243,0.6212121212121212,74923821,33,8
2,0,1.0,1.0,80159731,7,7
2,0,1.0,1.0,65960692,1,1
1,4,0.3333333333333333,0.8214285714285714,70754894,6,2
0,18,0.14285714285714285,0.35,82129380,21,3
1,116,0.30952380952380953,0.6774193548387096,68532513,168,52
0,62,0.06060606060606061,0.0297029702970297,65005990,66,4
2,5,0.6428571428571429,0.8571428571428571,69864123,14,9
0,9,0.4375,0.2857142857142857,80159641,16,7
1,20,0.4444444444444444,0.8717948717948718,69472522,36,16
0,3,0.0,0.0,65006746,3,0
2,0,1.0,1.0,69172614,2,2
2,0,1.0,1.0,61493852,1,1
2,2,0.6666666666666666,0.5,67823014,6,4
0,16,0.1111111111111111,0.15384615384615385,67823581,18,2
0,48,0.07692307692307693,0.2894736842105263,69007155,52,4
1,2,0.3333333333333333,0.8571428571428571,69478346,3,1
0,14,0.06666666666666667,0.034482758620689655,60877691,15,1
0,4,0.2,0.3,66046722,5,1
0,34,0.22727272727272727,0.35,69666751,44,10
2,5,0.5454545454545454,0.5,68163053,11,6
2,3,0.5714285714285714,0.9166666666666666,68163060,7,4
0,33,0.23255813953488372,0.29545454545454547,69959085,43,10
2,41,0.5980392156862745,0.935064935064935,69575870,102,61
0,19,0.13636363636363635,0.43209876543209874,62529530,22,3
2,4,0.75,0.9230769230769231,69733391,16,12
0,1,0.0,0.0,70629223,1,0
0,20,0.047619047619047616,0.1566265060240964,80028844,21,1
1,27,0.18181818181818182,0.7058823529411765,80029124,33,6
0,71,0.07792207792207792,0.3523809523809524,74020324,77,6
0,59,0.2716049382716049,0.49624060150375937,70781914,81,22
0,36,0.12195121951219512,0.13043478260869565,60439400,41,5
0,179,0.2217391304347826,0.4186046511627907,70654731,230,51
0,13,0.0,0.0,80124338,13,0
0,14,0.0,0.0,80124429,14,0
0,18,0.18181818181818182,0.4943820224719101,66442012,22,4
1,9,0.25,0.6842105263157895,70489286,12,3
0,3,0.0,0.0,70747950,3,0
0,163,0.07386363636363637,0.1574468085106383,70606893,176,13
1,10,0.4117647058823529,0.8928571428571429,66892721,17,7
0,1,0.0,0.0,68047581,1,0
2,3,0.6666666666666666,0.75,68163011,9,6
2,26,0.5806451612903226,0.9818181818181818,81989156,62,36
1,6,0.45454545454545453,0.7857142857142857,68273471,11,5
1,30,0.3617021276595745,0.7582417582417582,82002259,47,17
2,2,0.8461538461538461,0.6666666666666666,80145467,13,11
1,16,0.42857142857142855,0.8709677419354839,69093710,28,12
2,3,0.9142857142857143,0.9473684210526315,69538805,35,32
0,15,0.21052631578947367,0.43137254901960786,73551786,19,4
0,73,0.12048192771084337,0.08045977011494253,65006004,83,10
2,16,0.5151515151515151,0.9661016949152542,65281594,33,17
0,69,0.2159090909090909,0.4460431654676259,79788415,88,19
1,86,0.4027777777777778,0.8952380952380953,64686643,144,58
2,0,1.0,1.0,69212052,1,1
0,7,0.125,0.21739130434782608,73295670,8,1
1,3,0.25,0.5454545454545454,73295705,4,1
0,41,0.1276595744680851,0.2929936305732484,69416326,47,6
0,58,0.19444444444444445,0.48295454545454547,69416151,72,14
1,21,0.4473684210526316,0.8837209302325582,68401172,38,17
2,3,0.7,0.9090909090909091,70812973,10,7
0,2,0.0,0.0,64571626,2,0
0,78,0.21212121212121213,0.4067796610169492,68143705,99,21
0,12,0.14285714285714285,0.12121212121212122,64052555,14,2
0,18,0.18181818181818182,0.24074074074074073,69730115,22,4
1,61,0.37755102040816324,0.8333333333333334,81992708,98,37
1,5,0.375,0.8518518518518519,69021820,8,3
2,15,0.5454545454545454,0.7575757575757576,71292921,33,18
1,6,0.4,0.5,70567805,10,4
2,0,1.0,1.0,82102166,5,5
1,49,0.30985915492957744,0.5980392156862745,82004783,71,22
2,6,0.6,0.9565217391304348,69539995,15,9
0,45,0.22413793103448276,0.45689655172413796,69621545,58,13
1,44,0.35294117647058826,0.8145161290322581,70252651,68,24
0,11,0.21428571428571427,0.4444444444444444,73443881,14,3
2,28,0.6266666666666667,0.6511627906976745,69898150,75,47
0,68,0.0684931506849315,0.2857142857142857,80124414,73,5
2,2,0.7777777777777778,0.8,80018771,9,7
0,6,0.14285714285714285,0.14285714285714285,69597255,7,1
0,34,0.24444444444444444,0.4015748031496063,68434086,45,11
1,64,0.3904761904761905,0.847457627118644,79788506,105,41
0,17,0.0,0.0,72808610,17,0
1,61,0.19736842105263158,0.7062146892655368,70908936,76,15
0,31,0.06060606060606061,0.1796875,70908810,33,2
0,34,0.08108108108108109,0.2037037037037037,67758824,37,3
1,24,0.25,0.6923076923076923,80172664,32,8
0,154,0.05521472392638037,0.13529411764705881,78762754,163,9
1,16,0.2727272727272727,0.7804878048780488,65200156,22,6
0,3,0.0,0.0,72808974,3,0
2,4,0.7142857142857143,0.9230769230769231,80176873,14,10
2,3,0.8333333333333334,0.8333333333333334,74027856,18,15
0,10,0.16666666666666666,0.23809523809523808,65286802,12,2
1,63,0.26744186046511625,0.640625,68784450,86,23
2,2,0.8571428571428571,0.875,70277340,14,12
2,2,0.9166666666666666,0.75,82060082,24,22
1,11,0.3888888888888889,0.7333333333333333,70493913,18,7
0,52,0.1746031746031746,0.44061302681992337,82041095,63,11
0,135,0.14012738853503184,0.1935483870967742,68741162,157,22
1,17,0.43333333333333335,0.9069767441860465,70926975,30,13
0,25,0.16666666666666666,0.4367816091954023,68499900,30,5
0,32,0.21951219512195122,0.3,68401193,41,9
0,121,0.07633587786259542,0.0971563981042654,73914456,131,10
1,19,0.4411764705882353,0.8333333333333334,69691223,34,15
2,24,0.5,0.8518518518518519,73829910,48,24
2,2,0.8333333333333334,0.0,82037161,12,10
1,21,0.27586206896551724,0.6511627906976745,80053512,29,8
0,93,0.021052631578947368,0.07936507936507936,80124260,95,2
1,91,0.3053435114503817,0.6488095238095238,82126739,131,40
2,6,0.5714285714285714,0.9655172413793104,82009365,14,8
0,7,0.4166666666666667,0.45454545454545453,70867286,12,5
0,31,0.18421052631578946,0.27472527472527475,70587720,38,7
2,4,0.6,0.8333333333333334,65598820,10,6
1,12,0.3684210526315789,0.9411764705882353,70350833,19,7
1,20,0.3333333333333333,0.8043478260869565,72749152,30,10
0,12,0.29411764705882354,0.4444444444444444,66970106,17,5
0,19,0.0,0.0,72906743,19,0
2,3,0.5,0.8571428571428571,70493080,6,3
0,25,0.3055555555555556,0.4807692307692308,80176616,36,11
0,11,0.15384615384615385,0.4827586206896552,69469330,13,2
0,3,0.0,0.0,69469792,3,0
0,9,0.0,0.0,69469806,9,0
0,12,0.07692307692307693,0.23809523809523808,69469862,13,1
0,10,0.0,0.0,70694792,10,0
2,30,0.6629213483146067,0.983739837398374,80081036,89,59
0,1,0.0,0.0,82113202,1,0
1,27,0.2894736842105263,0.6428571428571429,68687605,38,11
0,39,0.11363636363636363,0.06422018348623854,67553143,44,5
1,5,0.2857142857142857,0.5454545454545454,70926261,7,2
0,13,0.13333333333333333,0.22727272727272727,82050495,15,2
0,65,0.015151515151515152,0.0847457627118644,80124379,66,1
2,1,0.875,0.8,82037213,8,7
2,61,0.5080645161290323,0.951048951048951,80070186,124,63
1,4,0.2,0.7741935483870968,68499046,5,1
1,5,0.16666666666666666,0.7727272727272727,68499200,6,1
0,11,0.0,0.0,68499263,11,0
0,11,0.0,0.0,68499291,11,0
0,7,0.0,0.0,68499326,7,0
0,9,0.0,0.0,69007253,9,0
0,2,0.0,0.0,82143735,2,0
0,19,0.13636363636363635,0.41739130434782606,75264875,22,3
0,124,0.06060606060606061,0.18421052631578946,82007800,132,8
0,58,0.03333333333333333,0.13432835820895522,82007802,60,2
0,119,0.032520325203252036,0.10067114093959731,82007804,123,4
0,46,0.08,0.2773109243697479,82007806,50,4
0,74,0.05128205128205128,0.13768115942028986,82007808,78,4
0,6,0.0,0.0,70703325,6,0
1,8,0.2,0.5,70705586,10,2
0,7,0.0,0.0,72910250,7,0
1,48,0.323943661971831,0.6309523809523809,79788541,71,23
0,94,0.08737864077669903,0.38571428571428573,69006385,103,9
0,16,0.0,0.0,70230405,16,0
1,2,0.3333333333333333,0.6666666666666666,80128825,3,1
0,9,0.1,0.0,73634540,10,1
1,33,0.3125,0.6578947368421053,66112445,48,15
1,29,0.3409090909090909,0.7796610169491526,67513054,44,15
1,4,0.3333333333333333,0.5,70926303,6,2
0,10,0.16666666666666666,0.10526315789473684,82101246,12,2
1,9,0.4375,0.9411764705882353,70751254,16,7
0,2,0.0,0.0,80156299,2,0
1,48,0.2835820895522388,0.75,80135842,67,19
0,15,0.0625,0.30357142857142855,80128141,16,1
1,8,0.2,0.7037037037037037,80128271,10,2
0,10,0.0,0.0,80128274,10,0
0,38,0.13636363636363635,0.4563106796116505,70474943,44,6
0,10,0.09090909090909091,0.05263157894736842,68546660,11,1
0,4,0.2,0.45454545454545453,70037135,5,1
0,15,0.0625,0.2,80154098,16,1
0,155,0.08284023668639054,0.18435754189944134,62413813,169,14
0,59,0.14492753623188406,0.23333333333333334,61989501,69,10
0,52,0.07142857142857142,0.037037037037037035,61989522,56,4
1,11,0.15384615384615385,0.5555555555555556,69701240,13,2
1,7,0.3,0.5625,67052965,10,3
2,1,0.5,0.5,65292640,2,1
2,1,0.8333333333333334,0.8571428571428571,80136950,6,5
0,9,0.1,0.24285714285714285,70692783,10,1
1,8,0.2727272727272727,0.5384615384615384,81989173,11,3
0,93,0.14678899082568808,0.35815602836879434,69416704,109,16
1,36,0.4626865671641791,0.8861788617886179,80145873,67,31
1,7,0.46153846153846156,0.8333333333333334,79815974,13,6
2,1,0.5,0.0,67817855,2,1
2,12,0.8421052631578947,0.967741935483871,68620916,76,64
1,75,0.375,0.8705882352941177,69179551,120,45
2,21,0.6181818181818182,0.9761904761904762,70071302,55,34
0,90,0.03225806451612903,0.01090909090909091,62766921,93,3
0,17,0.10526315789473684,0.10714285714285714,66423392,19,2
2,2,0.9333333333333333,0.0,70418250,30,28
2,2,0.7777777777777778,0.75,80172931,9,7
1,61,0.22784810126582278,0.5792079207920792,72773281,79,18
0,11,0.08333333333333333,0.26,70697816,12,1
2,18,0.6086956521739131,0.7307692307692307,77329546,46,28
1,7,0.2222222222222222,0.6666666666666666,66225425,9,2
1,40,0.43661971830985913,0.9387755102040817,80152822,71,31
2,15,0.5161290322580645,0.9777777777777777,69180741,31,16
1,94,0.2932330827067669,0.6216216216216216,82128661,133,39
1,27,0.2702702702702703,0.6818181818181818,69733580,37,10
0,7,0.2222222222222222,0.38461538461538464,74086684,9,2
0,124,0.21019108280254778,0.3969465648854962,80135833,157,33
1,148,0.3116279069767442,0.6613756613756614,82047586,215,67
0,30,0.0,0.0,67475821,30,0
0,32,0.15789473684210525,0.3114754098360656,82001867,38,6
2,3,0.625,0.9090909090909091,67160142,8,5
1,27,0.18181818181818182,0.6027397260273972,69895161,33,6
0,81,0.03571428571428571,0.07386363636363637,67837854,84,3
0,8,0.1111111111111111,0.4,60513565,9,1
1,20,0.2857142857142857,0.6702127659574468,72555630,28,8
1,45,0.36619718309859156,0.8888888888888888,64261995,71,26
2,10,0.5,0.8947368421052632,73459694,20,10
0,11,0.08333333333333333,0.10714285714285714,60919250,12,1
0,36,0.12195121951219512,0.08695652173913043,82032899,41,5
2,13,0.5185185185185185,0.967741935483871,80124825,27,14
2,9,0.5,0.9811320754716981,80167230,18,9
2,4,0.6363636363636364,0.8888888888888888,75293155,11,7
2,17,0.6851851851851852,0.9428571428571428,80126949,54,37
1,46,0.25806451612903225,0.7904191616766467,80135171,62,16
0,27,0.1,0.35,65668372,30,3
2,47,0.5392156862745098,0.9380530973451328,73993031,102,55
1,12,0.29411764705882354,0.6428571428571429,82051771,17,5
0,134,0.056338028169014086,0.3603082851637765,64183413,142,8
0,75,0.05063291139240506,0.24338624338624337,64248765,79,4
1,8,0.2727272727272727,0.6857142857142857,74086852,11,3
0,8,0.1111111111111111,0.2702702702702703,67464124,9,1
0,16,0.058823529411764705,0.06666666666666667,69637750,17,1
2,55,0.6283783783783784,0.9565217391304348,82009749,148,93
0,118,0.07086614173228346,0.25,328853,127,9
1,7,0.3,0.8181818181818182,80128895,10,3
0,46,0.08,0.26582278481012656,63993216,50,4
1,6,0.25,0.8043478260869565,63993251,8,2
0,47,0.22950819672131148,0.3769230769230769,80180216,61,14
0,6,0.0,0.0,75327224,6,0
0,24,0.1724137931034483,0.25396825396825395,75327252,29,5
2,1,0.8571428571428571,0.6666666666666666,80131223,7,6
1,10,0.23076923076923078,0.5,80137605,13,3
1,26,0.2571428571428571,0.8717948717948718,63992964,35,9
0,38,0.09523809523809523,0.30392156862745096,69895392,42,4
0,6,0.0,0.0,66785285,6,0
0,14,0.06666666666666667,0.10526315789473684,65368856,15,1
0,111,0.13953488372093023,0.4903581267217631,18370625,129,18
0,128,0.14666666666666667,0.19123505976095617,80176731,150,22
0,143,0.10062893081761007,0.23622047244094488,81979727,159,16
0,6,0.14285714285714285,0.10526315789473684,68340811,7,1
1,9,0.35714285714285715,0.6451612903225806,70525784,14,5
2,6,0.7931034482758621,0.9375,70525826,29,23
0,59,0.2236842105263158,0.46794871794871795,68497044,76,17
1,15,0.4,0.7636363636363637,69735085,25,10
0,10,0.0,0.0,80124202,10,0
1,3,0.25,0.6,69160490,4,1
1,5,0.16666666666666666,0.5333333333333333,67253270,6,1
1,45,0.48863636363636365,0.86,80018540,88,43
0,30,0.1891891891891892,0.3273809523809524,82124910,37,7
1,37,0.3148148148148148,0.527027027027027,68400941,54,17
2,1,0.8333333333333334,0.5,61486523,6,5
2,5,0.875,0.75,75576515,40,35
2,21,0.5625,0.9761904761904762,69472123,48,27
2,3,0.5,0.8571428571428571,67625656,6,3
1,24,0.22580645161290322,0.5,65250892,31,7
1,3,0.4,0.6666666666666666,65290974,5,2
1,12,0.42857142857142855,0.9074074074074074,68563782,21,9
1,6,0.4,0.6956521739130435,63189532,10,4
0,37,0.1590909090909091,0.3625,74059104,44,7
1,18,0.4375,0.9215686274509803,68563474,32,14
0,4,0.2,0.3333333333333333,70037191,5,1
1,126,0.20754716981132076,0.6295180722891566,64000951,159,33
1,11,0.42105263157894735,0.6111111111111112,70866726,19,8
1,9,0.35714285714285715,0.9090909090909091,73459960,14,5
0,49,0.057692307692307696,0.10909090909090909,72417492,52,3
2,8,0.5,0.9393939393939394,70238861,16,8
2,3,0.625,0.5,67779810,8,5
2,1,0.75,0.6666666666666666,67779824,4,3
1,2,0.3333333333333333,0.7142857142857143,67136874,3,1
1,8,0.3333333333333333,0.631578947368421,69707176,12,4
0,55,0.15384615384615385,0.3583815028901734,60512676,65,10
0,94,0.06930693069306931,0.14,64400266,101,7
0,50,0.15254237288135594,0.3592233009708738,82003735,59,9
0,28,0.2222222222222222,0.24358974358974358,72135511,36,8
1,41,0.29310344827586204,0.8472222222222222,82008948,58,17
1,15,0.11764705882352941,0.6071428571428571,67434766,17,2
1,175,0.2971887550200803,0.6336088154269972,69388571,249,74
0,17,0.19047619047619047,0.4878048780487805,69058745,21,4
2,28,0.5,0.8367346938775511,69058822,56,28
1,3,0.25,0.5714285714285714,69097854,4,1
2,20,0.6078431372549019,0.9920634920634921,70051310,51,31
1,36,0.32075471698113206,0.65,82004785,53,17
2,4,0.7777777777777778,0.9230769230769231,79792706,18,14
2,0,1.0,1.0,80178629,6,6
0,6,0.0,0.0,63527401,6,0
1,65,0.1095890410958904,0.521551724137931,63527436,73,8
1,67,0.27956989247311825,0.7682926829268293,68784464,93,26
0,51,0.23880597014925373,0.4732824427480916,80124812,67,16
1,97,0.39375,0.9047619047619048,70207536,160,63
1,38,0.3870967741935484,0.8737864077669902,69179761,62,24
0,46,0.23333333333333334,0.48,63282884,60,14
0,5,0.0,0.0,67160156,5,0
1,6,0.25,0.6129032258064516,67160163,8,2
0,20,0.047619047619047616,0.1958762886597938,70669613,21,1
1,40,0.2857142857142857,0.7798165137614679,70059675,56,16
2,36,0.5135135135135135,0.9178082191780822,62590052,74,38
1,104,0.2517985611510791,0.6007067137809188,67160415,139,35
2,0,1.0,1.0,61745586,2,2
0,30,0.03225806451612903,0.0,68757171,31,1
0,23,0.11538461538461539,0.125,68757220,26,3
0,33,0.21428571428571427,0.4117647058823529,68497240,42,9
0,33,0.13157894736842105,0.21839080459770116,68499690,38,5
1,47,0.41975308641975306,0.9295774647887324,67281655,81,34
1,12,0.4,0.8292682926829268,69024620,20,8
1,6,0.4,0.8695652173913043,67282026,10,4
0,115,0.017094017094017096,0.08571428571428572,70600341,117,2
1,14,0.2222222222222222,0.7358490566037735,71761725,18,4
1,2,0.3333333333333333,0.625,80150269,3,1
2,0,1.0,1.0,69547884,1,1
0,15,0.0,0.0,80124317,15,0
0,5,0.0,0.0,80124344,5,0
0,16,0.0,0.0,80124380,16,0
2,9,0.5263157894736842,0.9473684210526315,80104843,19,10
1,15,0.4642857142857143,0.9148936170212766,72803815,28,13
0,12,0.07692307692307693,0.18181818181818182,72808505,13,1
2,65,0.5323741007194245,0.9408284023668639,70059206,139,74
2,2,0.8888888888888888,0.75,70769545,18,16
0,105,0.08695652173913043,0.045112781954887216,68740763,115,10
0,12,0.14285714285714285,0.25,82119383,14,2
1,72,0.3076923076923077,0.6739130434782609,70960015,104,32
0,43,0.1568627450980392,0.2702702702702703,69621860,51,8
0,6,0.0,0.0,70463750,6,0
0,3,0.0,0.0,70463855,3,0
0,117,0.10687022900763359,0.08960573476702509,68784821,131,14
1,61,0.35106382978723405,0.808641975308642,82126815,94,33
1,89,0.34558823529411764,0.8448979591836735,69176835,136,47
0,14,0.125,0.20689655172413793,77676963,16,2
1,71,0.3425925925925926,0.6590909090909091,68284272,108,37
2,30,0.6341463414634146,0.9814814814814815,80161910,82,52
0,7,0.0,0.0,70568344,7,0
0,35,0.20454545454545456,0.4945054945054945,80122899,44,9
0,35,0.2222222222222222,0.15789473684210525,68382594,45,10
0,5,0.0,0.0,79689050,5,0
2,2,0.6,0.4,80091942,5,3
2,27,0.5909090909090909,0.8292682926829268,70867195,66,39
2,8,0.7777777777777778,0.96,82152433,36,28
1,200,0.30313588850174217,0.6414686825053996,81967265,287,87
0,14,0.17647058823529413,0.19047619047619047,54550902,17,3
2,0,1.0,1.0,66049060,1,1
0,51,0.0,0.0,70679000,51,0
0,44,0.0,0.0,72808526,44,0
2,22,0.5,0.9333333333333333,73071684,44,22
2,10,0.5,0.85,70184030,20,10
2,0,1.0,1.0,69547730,3,3
0,6,0.0,0.0,70604996,6,0
0,22,0.2903225806451613,0.47058823529411764,80161491,31,9
2,37,0.5697674418604651,0.9444444444444444,67359880,86,49
2,1,0.5,0.9166666666666666,70062615,2,1
1,20,0.2857142857142857,0.5961538461538461,80128727,28,8
1,50,0.4186046511627907,0.8823529411764706,72417100,86,36
1,86,0.29508196721311475,0.645320197044335,14064064,122,36
0,102,0.06422018348623854,0.08241758241758242,69100815,109,7
2,4,0.6923076923076923,0.8666666666666667,70485562,13,9
0,54,0.2894736842105263,0.4166666666666667,69704131,76,22
1,41,0.3387096774193548,0.6588235294117647,80161486,62,21
0,171,0.08064516129032258,0.05956112852664577,82095674,186,15
1,15,0.25,0.6538461538461539,76043450,20,5
2,19,0.525,0.975609756097561,60305175,40,21
2,9,0.5,0.8787878787878788,80051734,18,9
1,2,0.3333333333333333,0.5,70687071,3,1
2,2,0.5,0.5,69526996,4,2
0,6,0.14285714285714285,0.41379310344827586,80145439,7,1
1,4,0.3333333333333333,0.7777777777777778,82010246,6,2
0,136,0.15527950310559005,0.22955974842767296,71762306,161,25
2,9,0.5263157894736842,0.8153846153846154,73623340,19,10
0,101,0.12931034482758622,0.36065573770491804,70489111,116,15
0,46,0.11538461538461539,0.25766871165644173,66222681,52,6
2,6,0.5,0.7142857142857143,73459995,12,6
2,5,0.5454545454545454,0.9666666666666667,80163453,11,6
1,68,0.33980582524271846,0.7162162162162162,70463792,103,35
2,31,0.5079365079365079,0.8493150684931506,69317521,63,32
2,12,0.52,0.8857142857142857,80175643,25,13
1,22,0.35294117647058826,0.8555555555555555,70515431,34,12
1,10,0.3333333333333333,0.6938775510204082,69951280,15,5
2,54,0.5970149253731343,0.923728813559322,66494974,134,80
2,3,0.7272727272727273,0.9090909090909091,80018470,11,8
1,5,0.4444444444444444,0.9285714285714286,66802736,9,4
2,10,0.6296296296296297,0.9375,70854231,27,17
1,7,0.4166666666666667,0.8571428571428571,65282553,12,5
1,29,0.32558139534883723,0.7058823529411765,69538735,43,14
2,3,0.7,0.8571428571428571,70718494,10,7
1,68,0.18072289156626506,0.5869565217391305,79650886,83,15
1,20,0.42857142857142855,0.8,66802883,35,15
1,50,0.2753623188405797,0.5857142857142857,70063301,69,19
2,0,1.0,1.0,82037169,1,1
2,4,0.8518518518518519,0.9285714285714286,62589765,27,23
1,80,0.40298507462686567,0.7241379310344828,72433585,134,54
2,3,0.7692307692307693,0.8571428571428571,73415923,13,10
0,13,0.0,0.0,69681416,13,0
1,11,0.26666666666666666,0.625,67690630,15,4
1,13,0.38095238095238093,0.6571428571428571,70591661,21,8
1,33,0.32653061224489793,0.7752808988764045,70758555,49,16
2,14,0.5,0.9655172413793104,73634715,28,14
0,24,0.1111111111111111,0.3492063492063492,67315066,27,3
1,18,0.28,0.75,66452876,25,7
0,28,0.2631578947368421,0.46551724137931033,70854056,38,10
0,18,0.21739130434782608,0.475,70908733,23,5
0,14,0.2631578947368421,0.4594594594594595,65291023,19,5
0,7,0.125,0.0,62771135,8,1
0,18,0.25,0.4411764705882353,70854406,24,6
0,2,0.3333333333333333,0.42857142857142855,66802715,3,1
1,10,0.3333333333333333,0.7037037037037037,66802792,15,5
1,51,0.3625,0.7387387387387387,66132255,80,29
0,60,0.1891891891891892,0.3939393939393939,66930262,74,14
0,112,0.13178294573643412,0.20108695652173914,82055991,129,17
0,21,0.16,0.2222222222222222,65289700,25,4
1,6,0.4,0.8571428571428571,65286830,10,4
1,8,0.3333333333333333,0.7619047619047619,65279172,12,4
1,18,0.4,0.8292682926829268,69498345,30,12
0,8,0.1111111111111111,0.2857142857142857,82101248,9,1
2,0,1.0,1.0,80083472,1,1
2,21,0.7162162162162162,0.92,68173763,74,53
1,77,0.45390070921985815,0.9484536082474226,72198154,141,64
1,20,0.48717948717948717,0.9692307692307692,73226496,39,19
1,48,0.35135135135135137,0.8058252427184466,69499444,74,26
0,12,0.14285714285714285,0.45,69886663,14,2
1,25,0.32432432432432434,0.8604651162790697,69887111,37,12
2,1,0.6666666666666666,0.3333333333333333,68904906,3,2
0,37,0.24489795918367346,0.4430379746835443,69692014,49,12
0,2,0.0,0.0,70567875,2,0
0,5,0.16666666666666666,0.45454545454545453,70567910,6,1
0,5,0.0,0.0,70567924,5,0
0,1,0.0,0.0,70575491,1,0
2,14,0.7910447761194029,0.9487179487179487,69547653,67,53
1,30,0.2857142857142857,0.6710526315789473,70633164,42,12
1,7,0.36363636363636365,0.9354838709677419,70825755,11,4
2,2,0.6,0.9333333333333333,69483960,5,3
0,8,0.1111111111111111,0.3125,80150480,9,1
1,136,0.24022346368715083,0.5911458333333334,79520196,179,43
2,92,0.5598086124401914,0.920863309352518,80018652,209,117
1,6,0.4,0.9285714285714286,68158342,10,4
1,19,0.3448275862068966,0.78125,67760994,29,10
2,18,0.6896551724137931,0.8571428571428571,80164911,58,40
0,20,0.09090909090909091,0.37662337662337664,74439932,22,2
2,5,0.7368421052631579,0.9090909090909091,69394353,19,14
1,16,0.4838709677419355,0.7111111111111111,67242266,31,15
2,2,0.6,0.6666666666666666,68058333,5,3
0,93,0.19827586206896552,0.38976377952755903,69183961,116,23
0,1,0.0,0.0,65976743,1,0
1,5,0.2857142857142857,0.6666666666666666,70175651,7,2
0,58,0.23684210526315788,0.40594059405940597,70660422,76,18
1,51,0.43956043956043955,0.8066298342541437,81882136,91,40
2,2,0.5,0.9,71458513,4,2
1,10,0.375,0.7692307692307693,71458835,16,6
0,100,0.05660377358490566,0.02564102564102564,80070984,106,6
1,29,0.2564102564102564,0.625,82042897,39,10
0,63,0.1,0.17692307692307693,69100773,70,7
2,20,0.5238095238095238,0.9292929292929293,69475483,42,22
2,2,0.5,0.6,70080171,4,2
2,20,0.7468354430379747,0.9838709677419355,80137361,79,59
2,4,0.8095238095238095,0.9375,70277375,21,17
1,62,0.28735632183908044,0.7464788732394366,80172868,87,25
1,26,0.48,0.9259259259259259,82018902,50,24
2,17,0.6382978723404256,0.7619047619047619,70811573,47,30
1,42,0.46835443037974683,0.8916666666666667,69045725,79,37
1,69,0.49635036496350365,0.9513888888888888,67429061,137,68
2,4,0.8181818181818182,0.9090909090909091,65888774,22,18
2,1,0.6666666666666666,0.5,80172953,3,2
2,1,0.75,0.6666666666666666,68163095,4,3
0,2,0.3333333333333333,0.3333333333333333,69974485,3,1
1,31,0.3541666666666667,0.7088607594936709,74289621,48,17
2,16,0.5294117647058824,0.925,69973246,34,18
2,4,0.6363636363636364,0.8571428571428571,70525763,11,7
2,1,0.9642857142857143,0.5,80159746,28,27
2,5,0.5454545454545454,0.9,82009369,11,6
2,0,1.0,1.0,80051356,4,4
2,4,0.84,0.9,80178951,25,21
2,0,1.0,1.0,82033558,10,10
2,1,0.8333333333333334,0.5,80083290,6,5
1,20,0.48717948717948717,0.8983050847457628,80151031,39,19
2,0,1.0,1.0,80152991,1,1
2,8,0.7714285714285715,0.0,80125808,35,27
1,36,0.28,0.546875,80125043,50,14
1,27,0.35714285714285715,0.8518518518518519,69964531,42,15
2,19,0.7654320987654321,0.875,74886994,81,62
0,7,0.3,0.4444444444444444,67347343,10,3
2,0,1.0,1.0,80159670,3,3
2,0,1.0,1.0,82047554,2,2
1,28,0.3,0.7340425531914894,75283481,40,12
1,37,0.24489795918367346,0.6041666666666666,70645953,49,12
1,50,0.13793103448275862,0.5481927710843374,80029250,58,8
1,35,0.39655172413793105,0.8016528925619835,79954014,58,23
1,33,0.49230769230769234,0.8938053097345132,80158234,65,32
2,7,0.7083333333333334,0.8571428571428571,82041298,24,17
2,20,0.5833333333333334,0.9166666666666666,81989290,48,28
2,4,0.8666666666666667,0.625,82051901,30,26
1,31,0.4745762711864407,0.825,69058010,59,28
2,9,0.8524590163934426,0.9444444444444444,72433543,61,52
2,2,0.9310344827586207,0.8571428571428571,80126547,29,27
1,5,0.4444444444444444,0.8571428571428571,69484534,9,4
2,2,0.9,0.5,65430561,20,18
2,1,0.96,0.5,80126588,25,24
2,8,0.7142857142857143,0.9230769230769231,69587840,28,20
2,4,0.5555555555555556,0.9166666666666666,75140240,9,5
1,69,0.49264705882352944,0.8690476190476191,80178140,136,67
2,1,0.6666666666666666,0.0,82046070,3,2
2,3,0.8421052631578947,0.875,68167932,19,16
1,95,0.16666666666666666,0.6997518610421837,82009589,114,19
2,10,0.8507462686567164,0.9583333333333334,70279916,67,57
2,0,1.0,1.0,70598332,18,18
1,14,0.391304347826087,0.9272727272727272,82140395,23,9
2,0,1.0,1.0,80159254,8,8
0,26,0.07142857142857142,0.05660377358490566,73700753,28,2
2,8,0.6190476190476191,0.8666666666666667,80155232,21,13
1,28,0.37777777777777777,0.782051282051282,80176711,45,17
0,29,0.12121212121212122,0.0,66848425,33,4
0,31,0.225,0.06666666666666667,66848432,40,9
2,13,0.5185185185185185,0.9423076923076923,80158235,27,14
2,0,1.0,1.0,82053816,3,3
1,54,0.34146341463414637,0.6627906976744186,73650843,82,28
2,12,0.5862068965517241,0.8461538461538461,73654294,29,17
1,58,0.43137254901960786,0.8930817610062893,82095538,102,44
2,0,1.0,1.0,68405393,12,12
1,8,0.4666666666666667,0.9,69664742,15,7
1,104,0.4090909090909091,0.6324786324786325,70231805,176,72
1,33,0.34,0.5522388059701493,68401263,50,17
1,9,0.4,0.8536585365853658,72803283,15,6
0,6,0.25,0.0,72808680,8,2
0,9,0.1,0.0,67834515,10,1
0,115,0.22297297297297297,0.4550898203592814,70049434,148,33
1,55,0.3037974683544304,0.7407407407407407,68283075,79,24
1,25,0.4444444444444444,0.9836065573770492,80133805,45,20
0,68,0.20930232558139536,0.32298136645962733,82062469,86,18
0,48,0.058823529411764705,0.07534246575342465,68155703,51,3
2,57,0.5615384615384615,0.9867549668874173,66169971,130,73
2,14,0.5333333333333333,0.9142857142857143,70494690,30,16
2,0,1.0,1.0,82144695,2,2
0,24,0.07692307692307693,0.2077922077922078,73739701,26,2
2,36,0.5,0.9620253164556962,68467931,72,36
0,6,0.14285714285714285,0.36,70683662,7,1
2,0,1.0,1.0,80132796,24,24
2,0,1.0,1.0,80176859,2,2
1,3,0.4,0.8235294117647058,66222660,5,2
0,57,0.109375,0.16167664670658682,66657206,64,7
0,19,0.20833333333333334,0.3877551020408163,61178656,24,5
2,27,0.5909090909090909,0.9722222222222222,62407912,66,39
1,73,0.23958333333333334,0.714765100671141,65947343,96,23
0,8,0.2727272727272727,0.36363636363636365,70711305,11,3
1,21,0.36363636363636365,0.7608695652173914,62746313,33,12
1,24,0.4418604651162791,0.7619047619047619,69728302,43,19
0,8,0.0,0.0,82003739,8,0
1,22,0.26666666666666666,0.7349397590361446,70059703,30,8
1,57,0.49107142857142855,0.948936170212766,68121375,112,55
0,8,0.1111111111111111,0.3448275862068966,67899552,9,1
1,46,0.19298245614035087,0.7407407407407407,66344810,57,11
0,60,0.03225806451612903,0.09968847352024922,67468086,62,2
0,16,0.0,0.0,80150815,16,0
0,26,0.1875,0.3142857142857143,80176709,32,6
0,92,0.2,0.2513089005235602,80108434,115,23
0,111,0.1590909090909091,0.1864406779661017,70225470,132,21
2,9,0.64,0.38461538461538464,69550222,25,16
0,26,0.07142857142857142,0.39622641509433965,80150793,28,2
0,22,0.0,0.0,80150810,22,0
0,27,0.15625,0.109375,65360596,32,5
0,27,0.03571428571428571,0.14285714285714285,80150804,28,1
0,19,0.05,0.2987012987012987,80150809,20,1
0,45,0.1346153846153846,0.44385026737967914,67455024,52,7
0,10,0.0,0.0,66933356,10,0
0,49,0.02,0.08695652173913043,67468016,50,1
0,38,0.05,0.27932960893854747,67468744,40,2
0,26,0.037037037037037035,0.17829457364341086,80150807,27,1
0,77,0.01282051282051282,0.045454545454545456,69464255,78,1
0,29,0.0,0.0,80150788,29,0
0,19,0.05,0.2261904761904762,80150796,20,1
1,22,0.2413793103448276,0.803030303030303,67900063,29,7
1,17,0.2916666666666667,0.7126436781609196,62646486,24,7
1,8,0.42857142857142855,0.8695652173913043,64127294,14,6
2,1,0.5,0.8823529411764706,64881565,2,1
0,18,0.05263157894736842,0.06666666666666667,66221554,19,1
0,21,0.19230769230769232,0.4225352112676056,66221596,26,5
0,78,0.15217391304347827,0.3045977011494253,66224550,92,14
1,6,0.4,0.75,66224886,10,4
0,13,0.07142857142857142,0.08928571428571429,66226006,14,1
2,17,0.6851851851851852,0.8571428571428571,66114055,54,37
1,30,0.4642857142857143,0.9,69172586,56,26
0,5,0.2857142857142857,0.0,65257080,7,2
1,3,0.25,0.6,72910264,4,1
1,13,0.43478260869565216,0.9285714285714286,70051331,23,10
1,5,0.375,0.8285714285714286,70525791,8,3
1,15,0.11764705882352941,0.5131578947368421,80124442,17,2
1,8,0.2727272727272727,0.8103448275862069,79990155,11,3
1,29,0.23684210526315788,0.5675675675675675,70760424,38,9
0,27,0.0,0.0,68356645,27,0
1,7,0.3,0.9344262295081968,74094972,10,3
1,12,0.3333333333333333,0.5172413793103449,73443923,18,6
1,12,0.25,0.5333333333333333,76695542,16,4
1,38,0.09523809523809523,0.553763440860215,64183273,42,4
0,47,0.22950819672131148,0.37168141592920356,80176702,61,14
0,30,0.11764705882352941,0.09259259259259259,70829794,34,4
0,31,0.03125,0.11055276381909548,67467946,32,1
2,9,0.625,0.9655172413793104,65634023,24,15
0,39,0.04878048780487805,0.25,69024305,41,2
1,23,0.20689655172413793,0.5319148936170213,80018820,29,6
0,18,0.1,0.30434782608695654,80018862,20,2
0,9,0.18181818181818182,0.38095238095238093,80018890,11,2
0,67,0.028985507246376812,0.1858974358974359,67467505,69,2
2,0,1.0,1.0,80159739,5,5
2,0,1.0,1.0,70411250,7,7
2,0,1.0,1.0,68804932,1,1
1,8,0.3333333333333333,0.5833333333333334,69728435,12,4
0,13,0.07142857142857142,0.41935483870967744,66783003,14,1
0,2,0.0,0.0,66786356,2,0
2,12,0.5862068965517241,0.6,70247002,29,17
0,11,0.15384615384615385,0.37037037037037035,80172594,13,2
0,22,0.18518518518518517,0.4411764705882353,80135208,27,5
1,54,0.46534653465346537,0.9134615384615384,63166761,101,47
1,9,0.18181818181818182,0.6470588235294118,69005790,11,2
2,8,0.5294117647058824,0.9166666666666666,80162796,17,9
0,60,0.24050632911392406,0.41353383458646614,80180193,79,19
1,7,0.125,0.5454545454545454,64054844,8,1
0,4,0.42857142857142855,0.3333333333333333,80028326,7,3
1,12,0.3333333333333333,0.8048780487804879,65606793,18,6
1,19,0.2962962962962963,0.6235294117647059,80131309,27,8
1,31,0.32608695652173914,0.75,73955231,46,15
0,10,0.09090909090909091,0.49122807017543857,80163387,11,1
1,16,0.4838709677419355,0.9206349206349206,70660303,31,15
1,6,0.25,0.6923076923076923,61228811,8,2
1,21,0.38235294117647056,0.813953488372093,80153574,34,13
0,22,0.0,0.0,64359386,22,0
0,24,0.04,0.25471698113207547,64501661,25,1
0,146,0.09876543209876543,0.08816120906801007,69021421,162,16
2,0,1.0,1.0,70926310,1,1
2,20,0.7530864197530864,0.84375,70670831,81,61
2,4,0.75,0.8888888888888888,70327453,16,12
0,31,0.08823529411764706,0.012658227848101266,82116868,34,3
2,9,0.7631578947368421,0.7894736842105263,70174496,38,29
0,53,0.345679012345679,0.45714285714285713,80178929,81,28
2,16,0.68,0.9375,82047505,50,34
2,16,0.6,0.9545454545454546,64226043,40,24
0,110,0.2028985507246377,0.4336734693877551,69978370,138,28
2,1,0.5,0.6666666666666666,67371451,2,1
1,8,0.1111111111111111,0.6923076923076923,69550516,9,1
0,13,0.07142857142857142,0.08108108108108109,65392782,14,1
0,4,0.0,0.0,70621754,4,0
1,34,0.2765957446808511,0.7372881355932204,80121198,47,13
0,57,0.0,0.0,82158899,57,0
0,57,0.0,0.0,82158900,57,0
2,9,0.5263157894736842,0.9512195121951219,70081235,19,10
1,19,0.24,0.5862068965517241,76932282,25,6
1,95,0.3448275862068966,0.7773109243697479,80108000,145,50
2,114,0.5648854961832062,0.9789473684210527,82088773,262,148
2,2,0.8,0.6666666666666666,60585602,10,8
2,3,0.8695652173913043,0.8,70960232,23,20
2,23,0.5818181818181818,0.7954545454545454,70718452,55,32
0,1,0.0,0.0,69993735,1,0
1,20,0.3939393939393939,0.7435897435897436,73323922,33,13
0,12,0.2,0.4375,68784093,15,3
1,29,0.275,0.53125,65280040,40,11
1,9,0.25,0.5384615384615384,60877712,12,3
1,9,0.3076923076923077,0.6666666666666666,69416025,13,4
2,0,1.0,1.0,68457830,1,1
2,9,0.75,0.96,68203065,36,27
2,4,0.5555555555555556,0.875,68273583,9,5
0,107,0.1640625,0.23694779116465864,67428340,128,21
0,115,0.18439716312056736,0.3323615160349854,70234696,141,26
0,144,0.16279069767441862,0.1891891891891892,804972,172,28
2,5,0.5833333333333334,0.7333333333333333,70851032,12,7
0,33,0.15384615384615385,0.09375,66613890,39,6
0,36,0.02702702702702703,0.25,82003709,37,1
0,72,0.21739130434782608,0.4117647058823529,67160282,92,20
0,22,0.08333333333333333,0.08433734939759036,82118070,24,2
1,127,0.2573099415204678,0.5928338762214984,70626885,171,44
1,62,0.4095238095238095,0.7281553398058253,80135013,105,43
1,16,0.30434782608695654,0.6222222222222222,68434296,23,7
1,44,0.4942528735632184,0.9459459459459459,73982860,87,43
1,85,0.3089430894308943,0.6602870813397129,66856993,123,38
0,21,0.08695652173913043,0.08928571428571429,65291016,23,2
1,3,0.25,0.65625,66304924,4,1
2,14,0.5333333333333333,0.8888888888888888,75662706,30,16
2,42,0.5483870967741935,0.9487179487179487,67154332,93,51
2,1,0.9375,0.8571428571428571,80118200,16,15
2,6,0.8,0.7142857142857143,70408345,30,24
2,1,0.8571428571428571,0.0,63447503,7,6
0,39,0.09302325581395349,0.35664335664335667,80116834,43,4
2,8,0.7647058823529411,0.9615384615384616,70614166,34,26
2,0,1.0,1.0,63594545,15,15
1,19,0.4411764705882353,0.8513513513513513,70063546,34,15
0,64,0.07246376811594203,0.3333333333333333,80116813,69,5
0,261,0.10309278350515463,0.15436241610738255,70608041,291,30
1,50,0.4117647058823529,0.8172043010752689,69185725,85,35
2,18,0.5609756097560976,0.9574468085106383,70540393,41,23
0,5,0.4444444444444444,0.3333333333333333,70687750,9,4
0,18,0.3076923076923077,0.34285714285714286,70183050,26,8
0,77,0.09411764705882353,0.14007782101167315,70660275,85,8
0,2,0.3333333333333333,0.3333333333333333,80165425,3,1
0,99,0.05714285714285714,0.06748466257668712,70081312,105,6
0,46,0.20689655172413793,0.2971014492753623,69183996,58,12
0,133,0.2222222222222222,0.496,80156773,171,38
1,49,0.36363636363636365,0.6029411764705882,80180174,77,28
0,21,0.27586206896551724,0.15384615384615385,72445653,29,8
1,40,0.43661971830985913,0.75,72445660,71,31
1,42,0.38235294117647056,0.8842975206611571,80130155,68,26
2,7,0.7741935483870968,0.9285714285714286,73939684,31,24
2,15,0.6052631578947368,0.9473684210526315,68191802,38,23
1,41,0.359375,0.6031746031746031,82102378,64,23
0,11,0.0,0.0,70245553,11,0
2,5,0.8333333333333334,0.9090909090909091,82008297,30,25
0,75,0.2268041237113402,0.45569620253164556,73524752,97,22
0,107,0.08547008547008547,0.3924914675767918,60286905,117,10
2,58,0.5,0.9666666666666667,60664450,116,58
1,2,0.3333333333333333,0.8571428571428571,69640494,3,1
1,2,0.3333333333333333,0.5,67810183,3,1
1,6,0.45454545454545453,0.9375,79792692,11,5
0,7,0.0,0.0,69031200,7,0
0,111,0.11904761904761904,0.21902017291066284,63141456,126,15
0,82,0.20388349514563106,0.2608695652173913,70631351,103,21
2,4,0.9310344827586207,0.9375,82132590,58,54
2,34,0.5211267605633803,0.9130434782608695,80152709,71,37
0,22,0.043478260869565216,0.05405405405405406,82103887,23,1
0,20,0.047619047619047616,0.125,65713123,21,1
0,43,0.022727272727272728,0.06349206349206349,78763076,44,1
1,18,0.25,0.8,82109298,24,6
1,19,0.24,0.6461538461538462,67551484,25,6
0,61,0.14084507042253522,0.39593908629441626,80155852,71,10
1,71,0.432,0.9375,60755562,125,54
1,10,0.2857142857142857,0.8648648648648649,82206055,14,4
1,54,0.12903225806451613,0.5182926829268293,70468041,62,8
0,7,0.2222222222222222,0.4375,82124912,9,2
0,72,0.1,0.2572614107883817,82150123,80,8
0,91,0.13333333333333333,0.47601476014760147,80149946,105,14
1,46,0.16363636363636364,0.5526315789473685,70630070,55,9
2,11,0.5217391304347826,0.8181818181818182,80125204,23,12
0,8,0.1111111111111111,0.05263157894736842,68151202,9,1
0,4,0.2,0.4,72175243,5,1
1,83,0.4028776978417266,0.9322916666666666,82129384,139,56
1,17,0.22727272727272727,0.8846153846153846,70917350,22,5
1,14,0.3333333333333333,0.8235294117647058,68338592,21,7
1,37,0.0975609756097561,0.6032388663967612,82049117,41,4
0,21,0.08695652173913043,0.22857142857142856,82019423,23,2
0,24,0.07692307692307693,0.3023255813953488,70467530,26,2
1,61,0.47863247863247865,0.9539473684210527,80127580,117,56
1,26,0.2571428571428571,0.5098039215686274,82251381,35,9
2,8,0.5,0.8918918918918919,68645920,16,8
1,2,0.3333333333333333,0.5555555555555556,72813734,3,1
2,39,0.5568181818181818,0.9722222222222222,67905782,88,49
0,14,0.0,0.0,70683326,14,0
2,0,1.0,1.0,60261761,3,3
1,3,0.4,0.75,80145707,5,2
0,11,0.15384615384615385,0.3953488372093023,69479662,13,2
1,30,0.4230769230769231,0.835820895522388,70860363,52,22
0,29,0.275,0.3076923076923077,62744591,40,11
0,18,0.3076923076923077,0.43243243243243246,80056284,26,8
2,35,0.5070422535211268,0.927536231884058,80137333,71,36
1,7,0.46153846153846156,0.8461538461538461,80162645,13,6
0,12,0.2,0.3870967741935484,80162649,15,3
1,39,0.4868421052631579,0.8513513513513513,73610243,76,37
1,8,0.42857142857142855,0.8421052631578947,79146004,14,6
2,23,0.5892857142857143,0.85,62626011,56,33
0,34,0.1282051282051282,0.32,82003745,39,5
1,29,0.275,0.5853658536585366,82126810,40,11
1,30,0.23076923076923078,0.5487804878048781,65716910,39,9
0,19,0.20833333333333334,0.2727272727272727,70843080,24,5
2,2,0.5,0.3333333333333333,69484681,4,2
2,0,1.0,1.0,82020021,1,1
2,0,1.0,1.0,82039429,2,2
0,60,0.0,0.0,73245466,60,0
0,51,0.05555555555555555,0.11538461538461539,80124183,54,3
2,5,0.8076923076923077,0.9411764705882353,67996460,26,21
2,0,1.0,1.0,68107480,2,2
1,33,0.34,0.803921568627451,62497624,50,17
0,38,0.17391304347826086,0.36585365853658536,68533185,46,8
0,68,0.10526315789473684,0.3602150537634409,70174573,76,8
0,67,0.028985507246376812,0.06818181818181818,67034646,69,2
0,58,0.18309859154929578,0.21768707482993196,77065163,71,13
1,26,0.4222222222222222,0.9692307692307692,77065135,45,19
0,32,0.21951219512195122,0.4430379746835443,64159074,41,9
0,46,0.14814814814814814,0.422360248447205,73650416,54,8
0,1,0.0,0.0,82102672,1,0
1,3,0.25,0.8181818181818182,82102916,4,1
0,32,0.030303030303030304,0.05172413793103448,72809226,33,1
2,0,1.0,1.0,65430715,2,2
0,17,0.19047619047619047,0.37254901960784315,70005222,21,4
1,57,0.24,0.5944444444444444,67324313,75,18
1,52,0.40229885057471265,0.8737864077669902,82018807,87,35
0,189,0.03571428571428571,0.0472972972972973,69509174,196,7
0,8,0.2727272727272727,0.2631578947368421,81989148,11,3
1,14,0.36363636363636365,0.7096774193548387,60332370,22,8
1,51,0.08928571428571429,0.5235602094240838,68811645,56,5
0,75,0.1935483870967742,0.3776824034334764,70046613,93,18
2,12,0.5714285714285714,0.9545454545454546,79884196,28,16
1,20,0.47368421052631576,0.9122807017543859,66407845,38,18
1,46,0.30303030303030304,0.5643564356435643,65007362,66,20
1,48,0.22580645161290322,0.6411764705882353,70687162,62,14
2,0,1.0,1.0,80178222,2,2
1,7,0.125,0.7894736842105263,67703594,8,1
1,8,0.1111111111111111,0.8,67703622,9,1
0,9,0.0,0.0,67703650,9,0
0,3,0.0,0.0,67703755,3,0
0,4,0.0,0.0,67703790,4,0
2,9,0.6666666666666666,0.9696969696969697,72801330,27,18
0,55,0.09836065573770492,0.20625,69416340,61,6
2,1,0.75,0.3333333333333333,71292711,4,3
1,33,0.08333333333333333,0.5852272727272727,62839420,36,3
1,31,0.39215686274509803,0.9183673469387755,75148444,51,20
1,45,0.2857142857142857,0.5700934579439252,68535950,63,18
1,9,0.25,0.7419354838709677,82050492,12,3
2,4,0.6363636363636364,0.8,70460173,11,7
0,40,0.09090909090909091,0.25,70686322,44,4
2,18,0.6727272727272727,0.9333333333333333,67823462,55,37
1,24,0.4782608695652174,0.9222222222222223,80067246,46,22
2,0,1.0,1.0,70745150,2,2
1,35,0.2553191489361702,0.6610169491525424,65971724,47,12
1,30,0.2682926829268293,0.5,67244135,41,11
0,22,0.043478260869565216,0.0,67287801,23,1
2,9,0.7567567567567568,0.8333333333333334,65974790,37,28
1,82,0.1368421052631579,0.5287356321839081,80089604,95,13
1,34,0.22727272727272727,0.8217054263565892,80089583,44,10
1,15,0.25,0.7872340425531915,64929375,20,5
0,31,0.0,0.0,62839483,31,0
1,6,0.4,0.8275862068965517,80127354,10,4
0,53,0.13114754098360656,0.2916666666666667,67513992,61,8
0,127,0.11805555555555555,0.4634920634920635,61976684,144,17
0,28,0.0,0.0,60542706,28,0
2,1,0.5,0.5,69726566,2,1
1,12,0.3684210526315789,0.8,79817031,19,7
2,7,0.631578947368421,0.8888888888888888,80126932,19,12
1,7,0.2222222222222222,0.8461538461538461,80116820,9,2
1,15,0.25,0.925,80124371,20,5
2,11,0.7380952380952381,0.5714285714285714,69168274,42,31
2,0,1.0,1.0,943621,1,1
0,10,0.23076923076923078,0.3333333333333333,82018858,13,3
0,56,0.17647058823529413,0.4791666666666667,69417313,68,12
1,46,0.352112676056338,0.7666666666666667,71903986,71,25
1,27,0.2702702702702703,0.6901408450704225,73635100,37,10
2,7,0.8409090909090909,0.9565217391304348,75376805,44,37
1,7,0.2222222222222222,0.5,80004050,9,2
1,42,0.35384615384615387,0.8375,80111346,65,23
0,37,0.13953488372093023,0.17123287671232876,80124530,43,6
2,0,1.0,1.0,80131363,24,24
2,7,0.86,0.9375,80118210,50,43
0,2,0.0,0.0,69479452,2,0
0,11,0.0,0.0,70230475,11,0
0,4,0.0,0.0,75147625,4,0
1,20,0.13043478260869565,0.6219512195121951,79994320,23,3
1,2,0.3333333333333333,0.8333333333333334,70702464,3,1
2,23,0.8614457831325302,0.8846153846153846,66991260,166,143
0,46,0.16363636363636364,0.24806201550387597,67626951,55,9
0,43,0.18867924528301888,0.22666666666666666,70494725,53,10
2,5,0.7058823529411765,0.8333333333333334,76571775,17,12
1,11,0.35294117647058826,0.8,69611416,17,6
2,0,1.0,1.0,80132800,4,4
2,3,0.6666666666666666,0.8,66166940,9,6
2,4,0.7647058823529411,0.8333333333333334,80128764,17,13
0,57,0.14925373134328357,0.32456140350877194,70683060,67,10
1,30,0.3181818181818182,0.6779661016949152,70781760,44,14
2,0,1.0,1.0,80139946,4,4
1,62,0.44144144144144143,0.8807339449541285,80130722,111,49
0,57,0.09523809523809523,0.17647058823529413,70633661,63,6
2,7,0.5625,0.9166666666666666,82009370,16,9
1,7,0.3,0.6111111111111112,74850272,10,3
0,12,0.14285714285714285,0.27586206896551724,66423665,14,2
2,0,1.0,1.0,69735673,1,1
0,3,0.25,0.4,71458576,4,1
0,49,0.15517241379310345,0.3333333333333333,69621265,58,9
2,2,0.7777777777777778,0.8888888888888888,82010276,9,7
0,73,0.0641025641025641,0.04716981132075472,82014182,78,5
2,1,0.75,0.5,67589473,4,3
1,39,0.3389830508474576,0.8607594936708861,82116842,59,20
0,38,0.0,0.0,79650865,38,0
1,14,0.2631578947368421,0.6578947368421053,78763216,19,5
1,19,0.17391304347826086,0.6578947368421053,18370345,23,4
1,22,0.40540540540540543,0.851063829787234,70917462,37,15
0,18,0.14285714285714285,0.38095238095238093,69886243,21,3
1,14,0.3333333333333333,0.6976744186046512,70864444,21,7
2,15,0.7058823529411765,0.8125,61434674,51,36
0,19,0.20833333333333334,0.38461538461538464,19277804,24,5
1,15,0.3181818181818182,0.5833333333333334,74047316,22,7
1,16,0.3333333333333333,0.5853658536585366,68025216,24,8
0,18,0.25,0.4827586206896552,81976041,24,6
1,21,0.4166666666666667,0.6615384615384615,67410875,36,15
0,37,0.22916666666666666,0.47863247863247865,70018774,48,11
2,0,1.0,1.0,82247825,1,1
0,12,0.14285714285714285,0.17647058823529413,70463806,14,2
2,23,0.5576923076923077,0.967741935483871,54860652,52,29
2,45,0.5108695652173914,0.9496402877697842,64975645,92,47
0,13,0.13333333333333333,0.4642857142857143,67285673,15,2
0,30,0.09090909090909091,0.2484076433121019,65713536,33,3
1,13,0.4583333333333333,0.8,80176699,24,11
2,4,0.5555555555555556,0.8333333333333334,69573686,9,5
2,1,0.9166666666666666,0.5,19542432,12,11
2,1,0.875,0.5,80124804,8,7
1,41,0.3050847457627119,0.7575757575757576,80159752,59,18
0,26,0.037037037037037035,0.0379746835443038,80135914,27,1
1,45,0.3181818181818182,0.6785714285714286,82126801,66,21
1,2,0.3333333333333333,0.9230769230769231,62711684,3,1
1,17,0.48484848484848486,0.9459459459459459,77329686,33,16
1,24,0.4,0.6666666666666666,70071323,40,16
2,15,0.7115384615384616,0.9761904761904762,82018851,52,37
0,28,0.06666666666666667,0.18181818181818182,80135086,30,2
2,0,1.0,1.0,69541010,1,1
1,35,0.3,0.7522123893805309,70045206,50,15
0,19,0.05,0.0,73134866,20,1
2,1,0.5,0.5,80118178,2,1
0,40,0.024390243902439025,0.12244897959183673,80124375,41,1
2,0,1.0,1.0,70743092,2,2
2,4,0.5555555555555556,0.75,82110457,9,5
1,96,0.35570469798657717,0.8823529411764706,67276272,149,53
0,109,0.24305555555555555,0.2553191489361702,72445646,144,35
2,33,0.5769230769230769,0.9666666666666667,77770210,78,45
2,1,0.9285714285714286,0.5,82059900,14,13
1,76,0.44525547445255476,0.8295454545454546,80127978,137,61
1,19,0.2692307692307692,0.5636363636363636,80118372,26,7
2,17,0.5142857142857142,0.8260869565217391,80066315,35,18
0,13,0.07142857142857142,0.024390243902439025,82108576,14,1
0,233,0.11742424242424243,0.3916554508748318,68811435,264,31
0,62,0.19480519480519481,0.35802469135802467,80051636,77,15
1,5,0.2857142857142857,0.5405405405405406,72946391,7,2
0,77,0.17204301075268819,0.3508771929824561,69204303,93,16
0,30,0.09090909090909091,0.23684210526315788,70081004,33,3
0,34,0.08108108108108109,0.15942028985507245,70081326,37,3
0,73,0.17045454545454544,0.2722222222222222,67553892,88,15
2,21,0.5882352941176471,0.9166666666666666,72774695,51,30
0,37,0.11904761904761904,0.14285714285714285,80119195,42,5
1,32,0.4074074074074074,0.5555555555555556,68031733,54,22
0,47,0.06,0.022988505747126436,81956347,50,3
1,19,0.32142857142857145,0.9148936170212766,80135177,28,9
1,33,0.34,0.5581395348837209,71458821,50,17
0,11,0.08333333333333333,0.043478260869565216,69660710,12,1
2,10,0.7368421052631579,0.9523809523809523,82096249,38,28
1,8,0.3333333333333333,0.6,82096289,12,4
1,4,0.3333333333333333,0.896551724137931,80159832,6,2
2,17,0.734375,0.972972972972973,69069042,64,47
0,21,0.19230769230769232,0.19696969696969696,69180426,26,5
0,20,0.047619047619047616,0.08695652173913043,82001448,21,1
0,19,0.09523809523809523,0.15555555555555556,82001453,21,2
1,12,0.2,0.6052631578947368,82001454,15,3
2,3,0.625,0.7142857142857143,82145164,8,5
0,55,0.16666666666666666,0.464,68500096,66,11
0,5,0.0,0.0,67665423,5,0
0,8,0.1111111111111111,0.22727272727272727,69534052,9,1
1,49,0.3875,0.8333333333333334,69944511,80,31
1,11,0.3125,0.7142857142857143,70474950,16,5
1,14,0.2631578947368421,0.7228915662650602,70230293,19,5
2,0,1.0,1.0,12162591,4,4
2,23,0.5490196078431373,0.9178082191780822,71752954,51,28
2,4,0.5555555555555556,0.9230769230769231,75149690,9,5
0,2,0.0,0.0,70678545,2,0
2,5,0.7619047619047619,0.8571428571428571,73411352,21,16
1,17,0.2916666666666667,0.8571428571428571,80132276,24,7
0,103,0.22556390977443608,0.37261146496815284,69179733,133,30
1,6,0.45454545454545453,0.9166666666666666,70184044,11,5
1,63,0.24096385542168675,0.569620253164557,67833836,83,20
0,11,0.08333333333333333,0.43902439024390244,62840540,12,1
1,38,0.2692307692307692,0.7875,80128214,52,14
1,20,0.3939393939393939,0.8048780487804879,69666520,33,13
1,72,0.25773195876288657,0.5761589403973509,65299780,97,25
0,60,0.2682926829268293,0.37333333333333335,66839843,82,22
2,2,0.8181818181818182,0.3333333333333333,69870731,11,9
1,74,0.39344262295081966,0.8273809523809523,66838702,122,48
1,76,0.17391304347826086,0.5044510385756676,69204751,92,16
2,20,0.6296296296296297,0.9761904761904762,66641491,54,34
0,46,0.02127659574468085,0.0,80098662,47,1
0,30,0.1891891891891892,0.4791666666666667,82011815,37,7
1,37,0.32727272727272727,0.7264957264957265,70207382,55,18
1,72,0.34545454545454546,0.7189542483660131,74512046,110,38
0,32,0.08571428571428572,0.26865671641791045,82019475,35,3
0,13,0.23529411764705882,0.47619047619047616,69940353,17,4
1,18,0.4,0.7872340425531915,66970071,30,12
0,56,0.125,0.45454545454545453,70661444,64,8
1,107,0.2671232876712329,0.5596330275229358,80176784,146,39
1,49,0.25757575757575757,0.6216216216216216,69043534,66,17
1,19,0.36666666666666664,0.7391304347826086,80152632,30,11
2,2,0.5,0.75,69997480,4,2
0,22,0.18518518518518517,0.20634920634920634,65281160,27,5
0,14,0.17647058823529413,0.38095238095238093,68688991,17,3
0,117,0.16428571428571428,0.21428571428571427,67552275,140,23
0,6,0.14285714285714285,0.25,82206214,7,1
0,11,0.08333333333333333,0.2608695652173913,66885966,12,1
1,15,0.25,0.5333333333333333,73302390,20,5
1,28,0.37777777777777777,0.7017543859649122,79838801,45,17
2,2,0.5,0.875,80163681,4,2
2,0,1.0,1.0,72803962,2,2
0,56,0.125,0.10743801652892562,80108602,64,8
1,98,0.40963855421686746,0.9085173501577287,79749992,166,68
0,154,0.02531645569620253,0.043478260869565216,80124282,158,4
1,35,0.2857142857142857,0.514018691588785,62498114,49,14
1,14,0.4166666666666667,0.6111111111111112,68191970,24,10
2,13,0.6285714285714286,0.9534883720930233,79960132,35,22
1,6,0.3333333333333333,0.7619047619047619,69057912,9,3
0,139,0.027972027972027972,0.030555555555555555,80081071,143,4
0,85,0.011627906976744186,0.05067567567567568,73064215,86,1
0,37,0.11904761904761904,0.4864864864864865,69204842,42,5
1,29,0.32558139534883723,0.7727272727272727,65083424,43,14
0,2,0.0,0.0,71878450,2,0
2,4,0.5,0.8,71879584,8,4
1,31,0.3673469387755102,0.881578947368421,80059336,49,18
1,16,0.38461538461538464,0.90625,80172879,26,10
2,12,0.5384615384615384,0.7777777777777778,69713280,26,14
0,35,0.14634146341463414,0.48484848484848486,69139140,41,6
0,23,0.14814814814814814,0.17582417582417584,70490994,27,4
0,33,0.3125,0.4888888888888889,69989010,48,15
2,2,0.5,0.7,72775276,4,2
2,2,0.5,0.75,67053602,4,2
1,11,0.3125,0.7931034482758621,69498422,16,5
0,35,0.2391304347826087,0.4125,80103310,46,11
1,45,0.4155844155844156,0.8035714285714286,69704222,77,32
0,85,0.2608695652173913,0.4769874476987448,81980710,115,30
1,42,0.46835443037974683,0.8695652173913043,80158081,79,37
1,4,0.3333333333333333,0.8333333333333334,69390895,6,2
0,7,0.125,0.4,70699356,8,1
0,12,0.2,0.26666666666666666,70643244,15,3
0,69,0.19767441860465115,0.30434782608695654,70719726,86,17
2,12,0.7735849056603774,0.9642857142857143,65877945,53,41
0,144,0.09433962264150944,0.11682242990654206,70061866,159,15
1,10,0.3333333333333333,0.8,61356400,15,5
1,11,0.45,0.9230769230769231,66859982,20,9
1,85,0.3971631205673759,0.8380566801619433,80037944,141,56
2,3,0.9473684210526315,0.8333333333333334,70990493,57,54
1,38,0.4153846153846154,0.8439716312056738,69162541,65,27
0,10,0.16666666666666666,0.25,17806040,12,2
1,19,0.36666666666666664,0.7924528301886793,61439882,30,11
0,22,0.15384615384615385,0.3176470588235294,70660226,26,4
2,14,0.5882352941176471,0.9333333333333333,68400500,34,20
0,32,0.08571428571428572,0.04395604395604396,73459736,35,3
1,226,0.3046153846153846,0.762402088772846,70641613,325,99
2,0,1.0,1.0,80081190,10,10
1,41,0.359375,0.7288135593220338,72426361,64,23
1,23,0.3611111111111111,0.7796610169491526,80180477,36,13
1,72,0.22580645161290322,0.6731707317073171,80133440,93,21
2,8,0.6190476190476191,0.9375,80137887,21,13
0,3,0.0,0.0,81968397,3,0
0,5,0.0,0.0,81968412,5,0
2,3,0.8333333333333334,0.8333333333333334,80083325,18,15
2,0,1.0,1.0,82022946,4,4
2,12,0.7209302325581395,0.8461538461538461,69401143,43,31
2,13,0.6829268292682927,0.8846153846153846,72745022,41,28
2,7,0.6111111111111112,0.8666666666666667,73870384,18,11
0,1,0.0,0.0,65327192,1,0
1,16,0.30434782608695654,0.6363636363636364,65290176,23,7
2,0,1.0,1.0,70407953,5,5
2,4,0.5555555555555556,0.6666666666666666,82060536,9,5
1,7,0.46153846153846156,0.75,82061200,13,6
1,3,0.25,0.7142857142857143,70509306,4,1
2,3,0.625,0.5,66211992,8,5
1,17,0.15,0.5454545454545454,66467156,20,3
2,6,0.85,0.9333333333333333,80145462,40,34
0,20,0.16666666666666666,0.42105263157894735,82128671,24,4
1,43,0.410958904109589,0.8387096774193549,69992545,73,30
0,8,0.2727272727272727,0.46875,69468252,11,3
1,7,0.46153846153846156,0.7647058823529411,70056945,13,6
1,47,0.45348837209302323,0.9340659340659341,69056603,86,39
0,71,0.19318181818181818,0.390625,80121164,88,17
1,61,0.2375,0.5,804804,80,19
0,49,0.20967741935483872,0.49230769230769234,69534143,62,13
2,5,0.7222222222222222,0.9375,70115290,18,13
1,7,0.36363636363636365,0.7727272727272727,70257005,11,4
1,76,0.2692307692307692,0.6586826347305389,67384814,104,28
0,61,0.26506024096385544,0.3402061855670103,80136821,83,22
2,11,0.5416666666666666,0.8333333333333334,70617491,24,13
1,16,0.4838709677419355,0.9523809523809523,66855866,31,15
1,32,0.23809523809523808,0.5565217391304348,66192133,42,10
0,7,0.125,0.10526315789473684,68500075,8,1
1,52,0.21212121212121213,0.5104166666666666,69634530,66,14
0,103,0.02830188679245283,0.13192612137203166,70848330,106,3
0,61,0.0,0.0,76805540,61,0
1,73,0.32407407407407407,0.6262626262626263,71502186,108,35
0,55,0.19117647058823528,0.267515923566879,62142052,68,13
2,2,0.6666666666666666,0.5,70189224,6,4
0,9,0.18181818181818182,0.23333333333333334,68288962,11,2
0,15,0.11764705882352941,0.13513513513513514,69151341,17,2
1,37,0.24489795918367346,0.7727272727272727,61983684,49,12
1,34,0.2916666666666667,0.8105263157894737,62842024,48,14
0,27,0.06896551724137931,0.2692307692307692,82019431,29,2
0,5,0.0,0.0,82019447,5,0
2,14,0.8157894736842105,0.9,70591416,76,62
0,1,0.0,0.0,63662151,1,0
1,30,0.2857142857142857,0.5,68883346,42,12
2,6,0.7272727272727273,0.8571428571428571,74320764,22,16
0,15,0.25,0.28,66603964,20,5
0,60,0.11764705882352941,0.264,67513985,68,8
1,13,0.3157894736842105,0.8378378378378378,80178135,19,6
1,8,0.2727272727272727,0.5384615384615384,72844016,11,3
0,18,0.14285714285714285,0.33707865168539325,82052448,21,3
0,12,0.07692307692307693,0.171875,82062269,13,1
0,83,0.16161616161616163,0.22167487684729065,66087126,99,16
0,73,0.0641025641025641,0.03164556962025317,79650823,78,5
1,82,0.359375,0.7321428571428571,64357503,128,46
1,37,0.26,0.5974025974025974,70646345,50,13
1,12,0.29411764705882354,0.6944444444444444,69726531,17,5
0,9,0.0,0.0,69726545,9,0
1,21,0.4,0.9043478260869565,73672865,35,14
0,77,0.14444444444444443,0.2564102564102564,64158220,90,13
1,38,0.4794520547945205,0.8846153846153846,64357615,73,35
1,23,0.23333333333333334,0.6285714285714286,67721122,30,7
1,57,0.3132530120481928,0.7028985507246377,69183926,83,26
2,10,0.5454545454545454,0.9459459459459459,67995816,22,12
1,31,0.2619047619047619,0.6,67748933,42,11
0,10,0.0,0.0,69726363,10,0
1,17,0.2608695652173913,0.6590909090909091,69726433,23,6
0,7,0.0,0.0,69726482,7,0
1,16,0.36,0.8518518518518519,74362106,25,9
1,177,0.2062780269058296,0.5059952038369304,77676802,223,46
0,47,0.04081632653061224,0.12953367875647667,79145934,49,2
0,32,0.1794871794871795,0.45714285714285713,80135067,39,7
0,14,0.391304347826087,0.36,80176834,23,9
2,2,0.8571428571428571,0.6666666666666666,67744390,14,12
1,26,0.3333333333333333,0.7407407407407407,71682205,39,13
0,10,0.23076923076923078,0.36666666666666664,69061776,13,3
1,20,0.375,0.6428571428571429,71288665,32,12
1,9,0.18181818181818182,0.5454545454545454,67455185,11,2
1,18,0.18181818181818182,0.5263157894736842,67745972,22,4
0,8,0.0,0.0,67836874,8,0
0,21,0.19230769230769232,0.41025641025641024,69117251,26,5
1,48,0.30434782608695654,0.5294117647058824,80125046,69,21
1,33,0.2978723404255319,0.7368421052631579,69608294,47,14
1,17,0.32,0.7681159420289855,64166340,25,8
1,3,0.4,0.8571428571428571,67672675,5,2
1,64,0.3469387755102041,0.753968253968254,80124683,98,34
0,2,0.3333333333333333,0.0,64192366,3,1
2,3,0.5714285714285714,0.8888888888888888,69160560,7,4
1,31,0.2619047619047619,0.527027027027027,68283103,42,11
1,12,0.2,0.6,68617983,15,3
1,5,0.375,0.5,70463813,8,3
2,48,0.5051546391752577,0.7888888888888889,80118326,97,49
2,31,0.6770833333333334,0.9333333333333333,80125805,96,65
2,0,1.0,1.0,69692021,18,18
2,1,0.8,0.5,82023690,5,4
1,62,0.16216216216216217,0.5571428571428572,68257014,74,12
0,2,0.0,0.0,65686054,2,0
0,43,0.23214285714285715,0.46938775510204084,70508830,56,13
1,32,0.30434782608695654,0.6055045871559633,71458541,46,14
2,10,0.6875,0.9411764705882353,77319011,32,22
1,37,0.3392857142857143,0.7619047619047619,66192154,56,19
0,31,0.27906976744186046,0.375,68400570,43,12
0,36,0.05263157894736842,0.2,60546990,38,2
0,35,0.14634146341463414,0.4117647058823529,60547004,41,6
2,2,0.6,0.9047619047619048,68311460,5,3
0,24,0.04,0.019230769230769232,64571920,25,1
0,32,0.1111111111111111,0.34710743801652894,80135046,36,4
1,43,0.47560975609756095,0.9528795811518325,68028842,82,39
2,11,0.8658536585365854,0.9583333333333334,70594153,82,71
1,13,0.3157894736842105,0.6666666666666666,72198350,19,6
2,5,0.6666666666666666,0.9545454545454546,65286662,15,10
2,48,0.5247524752475248,0.9466666666666667,63385084,101,53
0,14,0.2222222222222222,0.3333333333333333,61501405,18,4
2,0,1.0,1.0,72309776,2,2
1,4,0.2,0.7407407407407407,68905613,5,1
0,45,0.16666666666666666,0.1796875,69180615,54,9
0,66,0.16455696202531644,0.2864321608040201,82126616,79,13
0,1,0.0,0.0,66770690,1,0
1,36,0.4,0.9204545454545454,61565721,60,24
1,22,0.3125,0.54,71215011,32,10
1,13,0.3157894736842105,0.6666666666666666,74440331,19,6
1,116,0.2564102564102564,0.6625386996904025,80154008,156,40
2,0,1.0,1.0,82185024,1,1
2,2,0.6666666666666666,0.8888888888888888,76939324,6,4
1,11,0.35294117647058826,0.7666666666666667,80174907,17,6
1,38,0.20833333333333334,0.6341463414634146,54609751,48,10
1,36,0.49295774647887325,0.8793103448275862,69666611,71,35
0,13,0.23529411764705882,0.41379310344827586,70245616,17,4
0,97,0.18487394957983194,0.2706422018348624,65360512,119,22
0,4,0.2,0.0,70960036,5,1
0,1,0.0,0.0,70679623,1,0
1,21,0.38235294117647056,0.9047619047619048,71277556,34,13
0,3,0.0,0.0,70680190,3,0
0,3,0.0,0.0,70698404,3,0
2,1,0.5,0.8333333333333334,70743876,2,1
0,1,0.0,0.0,70744184,1,0
0,5,0.0,0.0,80126789,5,0
2,6,0.5,0.7692307692307693,70843374,12,6
2,0,1.0,1.0,82018074,1,1
1,84,0.34375,0.772020725388601,72802534,128,44
0,5,0.16666666666666666,0.23809523809523808,70005873,6,1
0,3,0.0,0.0,80069962,3,0
2,18,0.5135135135135135,0.96,70612591,37,19
1,50,0.32432432432432434,0.6233766233766234,80072251,74,24
1,34,0.40350877192982454,0.8382352941176471,70940506,57,23
1,29,0.3958333333333333,0.7397260273972602,62404104,48,19
0,72,0.1,0.14224137931034483,81979812,80,8
1,23,0.3783783783783784,0.8548387096774194,70937622,37,14
0,61,0.21794871794871795,0.4336283185840708,66471251,78,17
0,32,0.21951219512195122,0.43283582089552236,70173586,41,9
2,1,0.5,0.5,68333391,2,1
0,20,0.047619047619047616,0.17105263157894737,82041237,21,1
1,10,0.375,0.8048780487804879,69964545,16,6
0,11,0.21428571428571427,0.48,65405291,14,3
1,16,0.30434782608695654,0.6046511627906976,62017011,23,7
2,9,0.6785714285714286,0.7777777777777778,80178956,28,19
1,28,0.37777777777777777,0.6,80180262,45,17
1,14,0.36363636363636365,0.6296296296296297,80056543,22,8
1,45,0.19642857142857142,0.5932203389830508,67985372,56,11
1,12,0.45454545454545453,0.8,72847243,22,10
1,27,0.3076923076923077,0.6111111111111112,70241192,39,12
1,23,0.20689655172413793,0.5,73634750,29,6
2,81,0.5030674846625767,0.9367816091954023,79816961,163,82
2,11,0.5,0.7142857142857143,76571810,22,11
1,21,0.34375,0.803030303030303,73870286,32,11
0,15,0.21052631578947367,0.3953488372093023,69554254,19,4
0,23,0.0,0.0,69554296,23,0
0,3,0.0,0.0,66892861,3,0
0,4,0.0,0.0,62532694,4,0
0,8,0.0,0.0,70183176,8,0
1,21,0.3,0.9176470588235294,70233464,30,9
0,48,0.1864406779661017,0.30701754385964913,70120001,59,11
1,36,0.29411764705882354,0.7372262773722628,70052143,51,15
1,4,0.2,0.6666666666666666,70693504,5,1
0,11,0.0,0.0,70693910,11,0
0,44,0.043478260869565216,0.19727891156462585,73007123,46,2
0,90,0.19642857142857142,0.33098591549295775,80127577,112,22
0,1,0.0,0.0,82105398,1,0
1,126,0.2631578947368421,0.5925925925925926,69900586,171,45
2,1,0.8888888888888888,0.5,82041910,9,8
1,34,0.48484848484848486,0.8941176470588236,80061016,66,32
1,40,0.2727272727272727,0.5942028985507246,62497722,55,15
0,79,0.27522935779816515,0.4946236559139785,64999830,109,30
0,67,0.014705882352941176,0.05333333333333334,70600201,68,1
2,2,0.7142857142857143,0.7777777777777778,66258052,7,5
0,27,0.03571428571428571,0.21686746987951808,82003720,28,1
0,42,0.125,0.3157894736842105,70693175,48,6
2,14,0.5333333333333333,0.9459459459459459,68030480,30,16
2,15,0.6153846153846154,0.8461538461538461,80155231,39,24
0,63,0.2840909090909091,0.07692307692307693,69954094,88,25
1,7,0.3,0.7037037037037037,68158356,10,3
0,38,0.07317073170731707,0.3898305084745763,80029131,41,3
1,39,0.43478260869565216,0.883495145631068,80149897,69,30
0,36,0.02702702702702703,0.11267605633802817,521696,37,1
0,79,0.05952380952380952,0.14367816091954022,68743472,84,5
1,73,0.2980769230769231,0.6622516556291391,67038601,104,31
2,5,0.6666666666666666,0.9583333333333334,80165893,15,10
0,156,0.07142857142857142,0.20152091254752852,80124252,168,12
0,17,0.0,0.0,70674310,17,0
0,5,0.0,0.0,70679182,5,0
2,4,0.9420289855072463,0.8,72410695,69,65
1,14,0.391304347826087,0.7678571428571429,72574810,23,9
1,4,0.42857142857142855,0.5714285714285714,80129155,7,3
0,112,0.08196721311475409,0.08465608465608465,64147811,122,10
2,3,0.5,0.75,80130719,6,3
2,30,0.5,0.9701492537313433,70014084,60,30
0,84,0.08695652173913043,0.43014705882352944,67846464,92,8
1,29,0.48214285714285715,0.8863636363636364,72522156,56,27
0,5,0.16666666666666666,0.05555555555555555,71288756,6,1
2,9,0.64,0.9130434782608695,73451266,25,16
2,3,0.5,0.7142857142857143,70221893,6,3
0,2,0.3333333333333333,0.25,69603016,3,1
0,2,0.0,0.0,69604052,2,0
1,30,0.3023255813953488,0.6944444444444444,65816996,43,13
1,29,0.3695652173913043,0.8913043478260869,79807630,46,17
2,0,1.0,1.0,64342054,1,1
1,100,0.40476190476190477,0.9365079365079365,80159044,168,68
1,39,0.20408163265306123,0.5740740740740741,71081003,49,10
0,3,0.0,0.0,82102609,3,0
1,116,0.27044025157232704,0.6470588235294118,73134873,159,43
2,23,0.5576923076923077,0.9696969696969697,70618562,52,29
0,16,0.0,0.0,80128166,16,0
1,35,0.3137254901960784,0.8380952380952381,68060433,51,16
1,3,0.25,0.5714285714285714,82102589,4,1
0,16,0.058823529411764705,0.39285714285714285,82102923,17,1
1,29,0.19444444444444445,0.5862068965517241,69395550,36,7
1,4,0.42857142857142855,0.9375,67422635,7,3
1,49,0.18333333333333332,0.5591397849462365,67049542,60,11
1,28,0.3,0.5797101449275363,73870111,40,12
2,0,1.0,1.0,67184124,2,2
2,5,0.7368421052631579,0.9375,80125057,19,14
1,14,0.2631578947368421,0.65,79005360,19,5
1,22,0.4358974358974359,0.935064935064935,64380176,39,17
1,45,0.40789473684210525,0.7586206896551724,79838794,76,31
2,18,0.5609756097560976,0.95,74816693,41,23
0,11,0.15384615384615385,0.2857142857142857,74086586,13,2
2,2,0.75,0.75,69589233,8,6
2,18,0.6326530612244898,0.8666666666666667,70718291,49,31
2,41,0.5119047619047619,0.8837209302325582,82009598,84,43
0,5,0.16666666666666666,0.15384615384615385,72157064,6,1
2,6,0.8,0.6666666666666666,75576466,30,24
0,75,0.13793103448275862,0.22900763358778625,82023776,87,12
0,5,0.16666666666666666,0.23255813953488372,75121165,6,1
0,42,0.023255813953488372,0.029411764705882353,82061334,43,1
1,42,0.2631578947368421,0.6448598130841121,70914242,57,15
1,25,0.375,0.9290780141843972,79990225,40,15
2,12,0.6363636363636364,0.9814814814814815,72801736,33,21
0,10,0.0,0.0,80122869,10,0
0,51,0.019230769230769232,0.056910569105691054,70568442,52,1
0,38,0.2549019607843137,0.41346153846153844,68434100,51,13
0,51,0.1206896551724138,0.2535211267605634,72135462,58,7
1,52,0.44680851063829785,0.8954248366013072,70760984,94,42
2,24,0.6521739130434783,0.9821428571428571,82014484,69,45
2,2,0.5,0.4,82143668,4,2
1,8,0.38461538461538464,0.8571428571428571,67929750,13,5
0,31,0.1388888888888889,0.3018867924528302,80125967,36,5
1,6,0.14285714285714285,0.625,70239386,7,1
1,11,0.15384615384615385,0.7547169811320755,79994334,13,2
0,5,0.16666666666666666,0.0,80051944,6,1
1,3,0.4,0.6666666666666666,70415520,5,2
1,11,0.3888888888888889,0.7906976744186046,63094612,18,7
0,66,0.15384615384615385,0.22929936305732485,80119095,78,12
1,14,0.44,0.6666666666666666,80176057,25,11
1,8,0.2727272727272727,0.6756756756756757,66110345,11,3
0,11,0.0,0.0,73064320,11,0
1,5,0.4444444444444444,0.9047619047619048,61189583,9,4
1,12,0.42857142857142855,0.8571428571428571,68026364,21,9
1,20,0.3333333333333333,0.74,63966994,30,10
2,5,0.5,0.8571428571428571,70649173,10,5
0,34,0.17073170731707318,0.43478260869565216,69691195,41,7
1,12,0.3333333333333333,0.5833333333333334,80055906,18,6
0,16,0.23809523809523808,0.08695652173913043,80061100,21,5
1,72,0.36283185840707965,0.8068965517241379,70673792,113,41
1,21,0.3225806451612903,0.5972222222222222,70257012,31,10
1,64,0.30434782608695654,0.8578680203045685,80128496,92,28
2,20,0.5454545454545454,0.918918918918919,80024245,44,24
1,37,0.4032258064516129,0.8699186991869918,69073536,62,25
1,70,0.4852941176470588,0.918918918918919,82110417,136,66
0,44,0.10204081632653061,0.336734693877551,72909606,49,5
0,26,0.037037037037037035,0.16,73007235,27,1
0,40,0.23076923076923078,0.40860215053763443,69596464,52,12
1,11,0.35294117647058826,0.84,69601084,17,6
1,10,0.3333333333333333,0.7333333333333333,72801442,15,5
0,2,0.0,0.0,70705453,2,0
0,64,0.13513513513513514,0.1657754010695187,69554142,74,10
0,60,0.0,0.0,70605633,60,0
0,46,0.16363636363636364,0.2523364485981308,70605675,55,9
0,13,0.1875,0.23809523809523808,67511332,16,3
2,5,0.5454545454545454,0.9230769230769231,68401844,11,6
0,32,0.21951219512195122,0.367816091954023,70910952,41,9
0,6,0.14285714285714285,0.44,66885903,7,1
0,11,0.08333333333333333,0.20454545454545456,72909634,12,1
2,8,0.6190476190476191,0.926829268292683,80158342,21,13
1,12,0.29411764705882354,0.6888888888888889,80135262,17,5
0,20,0.09090909090909091,0.09859154929577464,80135266,22,2
1,15,0.4,0.7333333333333333,65286361,25,10
1,18,0.4857142857142857,0.8125,80180177,35,17
0,4,0.0,0.0,79783914,4,0
0,1,0.0,0.0,65286242,1,0
1,3,0.4,0.6666666666666666,69997921,5,2
1,5,0.16666666666666666,0.782608695652174,70251055,6,1
1,26,0.35,0.8,69534122,40,14
0,60,0.0625,0.2868525896414343,78166011,64,4
0,40,0.06976744186046512,0.4,82206057,43,3
2,1,0.5,0.875,80128341,2,1
0,48,0.04,0.19433198380566802,82134973,50,2
0,34,0.20930232558139536,0.47368421052631576,67393914,43,9
0,5,0.0,0.0,80150531,5,0
0,15,0.0625,0.22,65364040,16,1
0,78,0.11363636363636363,0.47058823529411764,67900350,88,10
0,19,0.17391304347826086,0.4883720930232558,78166046,23,4
0,24,0.04,0.291970802919708,82006607,25,1
0,11,0.0,0.0,82006611,11,0
1,5,0.16666666666666666,0.5416666666666666,82006692,6,1
0,40,0.14893617021276595,0.410958904109589,80118448,47,7
0,49,0.0392156862745098,0.1951219512195122,67122132,51,2
0,14,0.0,0.0,70923160,14,0
0,85,0.011627906976744186,0.12628865979381443,80150867,86,1
1,30,0.1891891891891892,0.6260869565217392,70917371,37,7
0,8,0.0,0.0,80169886,8,0
0,34,0.02857142857142857,0.0703125,70621600,35,1
0,33,0.029411764705882353,0.3706896551724138,80150887,34,1
0,38,0.02564102564102564,0.325,80150888,39,1
0,49,0.09259259259259259,0.37967914438502676,67900581,54,5
1,52,0.2876712328767123,0.8210116731517509,76695766,73,21
1,17,0.48484848484848486,0.9464285714285714,66993514,33,16
0,73,0.0875,0.2089041095890411,80153597,80,7
2,1,0.5,0.875,70660492,2,1
0,2,0.0,0.0,70760445,2,0
0,19,0.13636363636363635,0.4935064935064935,80153537,22,3
2,3,0.5,0.8461538461538461,72816681,6,3
0,12,0.0,0.0,67971526,12,0
0,19,0.05,0.16071428571428573,80019121,20,1
1,10,0.2857142857142857,0.7317073170731707,70633276,14,4
1,5,0.16666666666666666,0.5217391304347826,67309074,6,1
0,45,0.18181818181818182,0.28703703703703703,69558426,55,10
1,29,0.17142857142857143,0.6938775510204082,69528116,35,6
0,65,0.057971014492753624,0.37209302325581395,62841744,69,4
0,23,0.0,0.0,80150494,23,0
0,14,0.0,0.0,80150500,14,0
0,9,0.1,0.1388888888888889,63991641,10,1
0,90,0.1,0.3920863309352518,65563141,100,10
2,19,0.5128205128205128,0.9666666666666667,65674980,39,20
1,12,0.25,0.8390804597701149,80135184,16,4
0,45,0.021739130434782608,0.1,70213325,46,1
1,10,0.16666666666666666,0.5333333333333333,80163394,12,2
1,13,0.23529411764705882,0.7419354838709677,73508813,17,4
1,30,0.4642857142857143,0.9390243902439024,68018594,56,26
2,9,0.5909090909090909,0.967741935483871,68488343,22,13
0,6,0.14285714285714285,0.47058823529411764,70635425,7,1
0,4,0.0,0.0,70635621,4,0
0,18,0.14285714285714285,0.26666666666666666,71081241,21,3
1,3,0.25,0.6666666666666666,80172546,4,1
1,11,0.21428571428571427,0.6052631578947368,67917836,14,3
0,110,0.07563025210084033,0.3805309734513274,69481321,119,9
0,8,0.0,0.0,82102611,8,0
1,8,0.2,0.5263157894736842,74926901,10,2
1,70,0.23076923076923078,0.6309523809523809,72906393,91,21
1,6,0.4,0.84,82103924,10,4
0,45,0.0425531914893617,0.37815126050420167,67469906,47,2
1,19,0.42424242424242425,0.92,70741524,33,14
1,19,0.09523809523809523,0.7404580152671756,70848344,21,2
0,2,0.0,0.0,80162803,2,0
1,20,0.2,0.7164179104477612,67122286,25,5
1,15,0.25,0.5757575757575758,66468003,20,5
0,9,0.1,0.3958333333333333,80150726,10,1
0,15,0.0,0.0,82102606,15,0
0,5,0.0,0.0,80162820,5,0
1,7,0.2222222222222222,0.7692307692307693,68227166,9,2
0,44,0.16981132075471697,0.4298245614035088,73650395,53,9
0,23,0.11538461538461539,0.2523364485981308,73650402,26,3
0,26,0.037037037037037035,0.22857142857142856,67896423,27,1
0,4,0.0,0.0,70821632,4,0
0,31,0.0,0.0,82206139,31,0
0,105,0.045454545454545456,0.21393034825870647,67434493,110,5
0,2,0.0,0.0,70634613,2,0
0,9,0.0,0.0,70635040,9,0
0,36,0.1,0.26666666666666666,78166333,40,4
0,42,0.08695652173913043,0.25210084033613445,67122265,46,4
0,2,0.3333333333333333,0.4,70585592,3,1
0,18,0.1,0.4111111111111111,64043903,20,2
0,109,0.09166666666666666,0.3220779220779221,82150087,120,11
0,26,0.0,0.0,70482244,26,0
0,17,0.05555555555555555,0.35294117647058826,69910393,18,1
1,5,0.2857142857142857,0.7142857142857143,82118239,7,2
0,65,0.029850746268656716,0.06060606060606061,62836515,67,2
1,45,0.1,0.5433070866141733,70482174,50,5
1,70,0.06666666666666667,0.5992366412213741,70468454,75,5
0,38,0.09523809523809523,0.42483660130718953,67454996,42,4
1,10,0.3333333333333333,0.8367346938775511,71618771,15,5
2,31,0.5694444444444444,0.863013698630137,68904913,72,41
0,54,0.03571428571428571,0.0718232044198895,80135157,56,2
0,40,0.024390243902439025,0.09316770186335403,70467215,41,1
0,14,0.0,0.0,80163189,14,0
0,8,0.1111111111111111,0.2647058823529412,80172597,9,1
0,32,0.15789473684210525,0.3816793893129771,80135209,38,6
2,2,0.7142857142857143,0.5,82018965,7,5
0,81,0.05813953488372093,0.35678391959798994,80150878,86,5
1,17,0.15,0.6565656565656566,70343546,20,3
0,12,0.0,0.0,80150495,12,0
0,95,0.18803418803418803,0.3915343915343915,68289081,117,22
0,9,0.0,0.0,80162793,9,0
0,7,0.125,0.43548387096774194,80172549,8,1
0,4,0.2,0.2857142857142857,80165751,5,1
0,9,0.1,0.1724137931034483,69887335,10,1
0,29,0.0,0.0,70919576,29,0
2,12,0.5,0.9534883720930233,82108573,24,12
0,6,0.25,0.18181818181818182,69887202,8,2
1,15,0.25,0.726027397260274,69887356,20,5
0,56,0.125,0.42035398230088494,67887652,64,8
1,28,0.2,0.5185185185185185,80067281,35,7
0,32,0.0,0.0,72775073,32,0
2,2,0.8,0.6666666666666666,82024349,10,8
0,64,0.1794871794871795,0.3956043956043956,73347036,78,14
2,18,0.5263157894736842,0.9565217391304348,75662734,38,20
1,20,0.13043478260869565,0.576271186440678,80029033,23,3
0,10,0.2857142857142857,0.23529411764705882,69550243,14,4
1,74,0.3392857142857143,0.8307692307692308,82126777,112,38
0,2,0.3333333333333333,0.3333333333333333,82010299,3,1
2,1,0.5,0.875,69573203,2,1
1,23,0.17857142857142858,0.5483870967741935,73103121,28,5
0,65,0.04411764705882353,0.14383561643835616,80118320,68,3
2,1,0.875,0.0,80178913,8,7
2,0,1.0,1.0,82145126,4,4
1,22,0.3333333333333333,0.7049180327868853,65914730,33,11
2,11,0.6333333333333333,0.9411764705882353,70591780,30,19
1,17,0.37037037037037035,0.803030303030303,69998082,27,10
1,9,0.25,0.5161290322580645,72717694,12,3
2,7,0.8292682926829268,0.8888888888888888,82020071,41,34
2,0,1.0,1.0,82020628,3,3
1,28,0.391304347826087,0.696969696969697,70202573,46,18
1,7,0.4166666666666667,0.5714285714285714,66159632,12,5
1,6,0.25,0.5,66164196,8,2
0,1,0.0,0.0,66164245,1,0
0,2,0.0,0.0,66185035,2,0
2,28,0.6818181818181818,0.9444444444444444,80124823,88,60
0,30,0.14285714285714285,0.4411764705882353,82009729,35,5
1,18,0.3333333333333333,0.6,76695031,27,9
2,2,0.5,0.9565217391304348,72802030,4,2
2,1,0.5,0.5,68402096,2,1
2,5,0.75,0.875,70860335,20,15
1,12,0.42857142857142855,0.9344262295081968,73346973,21,9
0,34,0.20930232558139536,0.23595505617977527,67690686,43,9
0,22,0.2413793103448276,0.44,62497043,29,7
0,3,0.0,0.0,82068729,3,0
2,4,0.6363636363636364,0.5,67311223,11,7
2,1,0.5,0.6,69597451,2,1
1,21,0.46153846153846156,0.9666666666666667,66541454,39,18
1,25,0.32432432432432434,0.7209302325581395,65281125,37,12
0,5,0.0,0.0,69997445,5,0
1,69,0.30303030303030304,0.7018348623853211,69417432,99,30
2,2,0.5,0.6666666666666666,681653,4,2
1,10,0.3333333333333333,0.6451612903225806,68401690,15,5
1,49,0.30985915492957744,0.6296296296296297,77078393,71,22
1,63,0.42201834862385323,0.8990825688073395,67556174,109,46
1,27,0.47058823529411764,0.8857142857142857,64925714,51,24
1,110,0.35294117647058826,0.825503355704698,68745593,170,60
1,10,0.3333333333333333,0.5666666666666667,64925721,15,5
1,7,0.3,0.875,64052576,10,3
1,9,0.35714285714285715,0.7368421052631579,64002386,14,5
0,11,0.0,0.0,69416606,11,0
2,0,1.0,1.0,82020769,2,2
0,1,0.0,0.0,66310076,1,0
0,33,0.175,0.352,82041233,40,7
0,28,0.2222222222222222,0.43037974683544306,80137545,36,8
1,19,0.2692307692307692,0.7166666666666667,80137546,26,7
0,24,0.1111111111111111,0.07407407407407407,80137550,27,3
0,17,0.15,0.12,80137558,20,3
0,11,0.15384615384615385,0.38333333333333336,71081486,13,2
0,33,0.175,0.2077922077922078,73701124,40,7
0,52,0.08771929824561403,0.27741935483870966,82103881,57,5
2,29,0.5,0.9154929577464789,67131015,58,29
1,6,0.25,0.5806451612903226,70842975,8,2
0,37,0.1956521739130435,0.28735632183908044,66892714,46,9
0,9,0.18181818181818182,0.375,67766720,11,2
0,4,0.2,0.4166666666666667,70679763,5,1
0,231,0.06854838709677419,0.04804804804804805,80071145,248,17
2,30,0.5081967213114754,0.9298245614035088,69395473,61,31
1,20,0.3103448275862069,0.7884615384615384,67656260,29,9
0,23,0.14814814814814814,0.28169014084507044,69559560,27,4
1,18,0.3333333333333333,0.6545454545454545,69643245,27,9
0,12,0.2,0.2903225806451613,69180433,15,3
1,49,0.4235294117647059,0.8805970149253731,66412185,85,36
1,10,0.3333333333333333,0.6470588235294118,74688824,15,5
0,7,0.125,0.0,74688831,8,1
0,6,0.14285714285714285,0.0,62449422,7,1
1,33,0.4,0.7922077922077922,82002277,55,22
0,46,0.20689655172413793,0.35384615384615387,82213157,58,12
0,77,0.25961538461538464,0.4117647058823529,80136832,104,27
1,58,0.22666666666666666,0.524822695035461,75892733,75,17
1,7,0.3,0.8043478260869565,68498010,10,3
1,27,0.2894736842105263,0.841726618705036,80010805,38,11
1,6,0.4,0.7619047619047619,69005482,10,4
0,13,0.07142857142857142,0.13559322033898305,515480,14,1
0,2,0.0,0.0,66885931,2,0
2,10,0.5454545454545454,0.8,66233132,22,12
1,14,0.46153846153846156,0.8181818181818182,68649294,26,12
0,5,0.0,0.0,70679833,5,0
1,3,0.25,0.631578947368421,70691712,4,1
1,8,0.3333333333333333,0.7021276595744681,70691866,12,4
0,4,0.0,0.0,70695093,4,0
0,3,0.0,0.0,70742994,3,0
1,2,0.3333333333333333,0.8333333333333334,70743295,3,1
0,4,0.0,0.0,70743771,4,0
2,4,0.5555555555555556,0.9375,82010241,9,5
2,2,0.7142857142857143,0.6,70414393,7,5
2,0,1.0,1.0,64196993,4,4
1,23,0.3235294117647059,0.8163265306122449,82126617,34,11
2,15,0.6428571428571429,0.9743589743589743,66836203,42,27
1,102,0.32894736842105265,0.770949720670391,66856412,152,50
0,39,0.025,0.043478260869565216,82019467,40,1
0,53,0.0,0.0,54204836,53,0
2,20,0.5652173913043478,0.9534883720930233,70493801,46,26
0,20,0.2857142857142857,0.40540540540540543,70494123,28,8
2,4,0.6363636363636364,0.9285714285714286,69466586,11,7
2,35,0.6634615384615384,0.9863013698630136,70819392,104,69
1,10,0.4444444444444444,0.8888888888888888,70057771,18,8
1,19,0.36666666666666664,0.7441860465116279,80004022,30,11
1,35,0.33962264150943394,0.7575757575757576,68530126,53,18
1,20,0.2,0.5510204081632653,66110534,25,5
2,13,0.5,0.9259259259259259,80118355,26,13
2,0,1.0,1.0,82070175,2,2
1,24,0.3142857142857143,0.6559139784946236,70063791,35,11
2,1,0.5,0.3333333333333333,67786243,2,1
2,1,0.5,0.3333333333333333,67786306,2,1
0,2,0.0,0.0,67786313,2,0
0,81,0.15625,0.3224489795918367,80180483,96,15
0,1,0.0,0.0,70747495,1,0
0,9,0.1,0.09090909090909091,69611276,10,1
1,54,0.25,0.6111111111111112,69634152,72,18
0,21,0.08695652173913043,0.140625,68500131,23,2
0,4,0.0,0.0,82102614,4,0
1,15,0.3181818181818182,0.6744186046511628,80176680,22,7
0,25,0.07407407407407407,0.34814814814814815,65882544,27,2
0,94,0.13761467889908258,0.3393665158371041,74924220,109,15
1,46,0.17857142857142858,0.6125,64359680,56,10
1,120,0.28994082840236685,0.5209580838323353,72776235,169,49
0,14,0.17647058823529413,0.1935483870967742,65282413,17,3
0,7,0.125,0.19444444444444445,70568085,8,1
0,16,0.2,0.2,67672843,20,4
2,20,0.5833333333333334,0.875,68294212,48,28
1,54,0.3076923076923077,0.7128205128205128,70669473,78,24
1,42,0.43243243243243246,0.952755905511811,80127351,74,32
1,52,0.2777777777777778,0.5,70357126,72,20
2,3,0.7,0.8333333333333334,72640953,10,7
1,8,0.4666666666666667,0.9523809523809523,79989595,15,7
2,4,0.6363636363636364,0.4,67824162,11,7
2,1,0.6666666666666666,0.5,66235442,3,2
2,10,0.5833333333333334,0.9090909090909091,80128557,24,14
2,1,0.5,0.5,69701653,2,1
0,1,0.0,0.0,72768402,1,0
0,15,0.375,0.3333333333333333,70414120,24,9
1,23,0.28125,0.7763157894736842,63993853,32,9
2,8,0.8181818181818182,0.9655172413793104,65714712,44,36
0,16,0.0,0.0,63992894,16,0
1,5,0.2857142857142857,0.88,69004404,7,2
1,10,0.3333333333333333,0.7368421052631579,69622532,15,5
0,29,0.06451612903225806,0.0967741935483871,82145536,31,2
2,4,0.7333333333333333,0.9,80090192,15,11
1,27,0.3076923076923077,0.5227272727272727,82009526,39,12
2,18,0.5813953488372093,0.9523809523809523,68725741,43,25
1,3,0.4,0.5555555555555556,19191970,5,2
2,0,1.0,1.0,69145524,12,12
0,3,0.25,0.0,66861060,4,1
2,0,1.0,1.0,67545534,1,1
0,9,0.18181818181818182,0.4482758620689655,65380903,11,2
1,103,0.29931972789115646,0.6595744680851063,82008935,147,44
1,26,0.21212121212121213,0.547945205479452,73650661,33,7
0,51,0.1206896551724138,0.44021739130434784,68289795,58,7
1,26,0.21212121212121213,0.6133333333333333,69637841,33,7
0,169,0.05056179775280899,0.02099236641221374,69416592,178,9
1,19,0.2962962962962963,0.7301587301587301,64017212,27,8
0,9,0.0,0.0,80028893,9,0
0,2,0.0,0.0,64287860,2,0
1,45,0.25,0.6588235294117647,70646646,60,15
1,34,0.24444444444444444,0.8024691358024691,70630140,45,11
1,18,0.4,0.8717948717948718,70751226,30,12
2,12,0.6756756756756757,0.9230769230769231,80149486,37,25
1,93,0.2846153846153846,0.7375,63686126,130,37
2,1,0.5,0.75,67551176,2,1
0,15,0.0625,0.15555555555555556,80150942,16,1
2,5,0.7619047619047619,0.8823529411764706,80181394,21,16
1,3,0.25,0.8148148148148148,62842486,4,1
1,7,0.46153846153846156,0.8636363636363636,80161485,13,6
1,11,0.15384615384615385,0.6071428571428571,70115136,13,2
0,2,0.0,0.0,71588055,2,0
2,3,0.5714285714285714,0.625,80028410,7,4
1,20,0.375,0.7840909090909091,67775001,32,12
0,12,0.0,0.0,82022543,12,0
2,9,0.71875,0.9090909090909091,79816646,32,23
1,14,0.48148148148148145,0.9880952380952381,68028856,27,13
1,15,0.34782608695652173,0.788235294117647,69206725,23,8
2,4,0.6923076923076923,0.975609756097561,69634943,13,9
1,30,0.25,0.5737704918032787,73635114,40,10
0,36,0.07692307692307693,0.056451612903225805,64221423,39,3
1,20,0.375,0.8571428571428571,69395774,32,12
2,14,0.6216216216216216,0.9838709677419355,65904552,37,23
0,40,0.1836734693877551,0.4782608695652174,80122880,49,9
0,6,0.0,0.0,82019426,6,0
0,7,0.0,0.0,82019474,7,0
1,22,0.21428571428571427,0.6696428571428571,69469190,28,6
1,32,0.2558139534883721,0.648,69724235,43,11
0,7,0.0,0.0,70680323,7,0
0,72,0.02702702702702703,0.10043668122270742,82003750,74,2
2,12,0.5555555555555556,0.9454545454545454,72803255,27,15
0,19,0.42424242424242425,0.4,75577194,33,14
1,45,0.4,0.8375,68286582,75,30
0,89,0.11,0.34551495016611294,70597982,100,11
1,8,0.38461538461538464,0.84,69466341,13,5
1,43,0.31746031746031744,0.7,82126750,63,20
2,0,1.0,1.0,70586516,23,23
1,29,0.32558139534883723,0.8732394366197183,70633360,43,14
0,126,0.03076923076923077,0.10972568578553615,69320713,130,4
0,52,0.10344827586206896,0.13445378151260504,76204485,58,6
0,21,0.125,0.35514018691588783,69737304,24,3
1,40,0.3333333333333333,0.8333333333333334,66856125,60,20
1,15,0.375,0.9375,66304882,24,9
0,23,0.08,0.06140350877192982,63141540,25,2
0,6,0.0,0.0,63647976,6,0
2,18,0.6170212765957447,0.9824561403508771,82043023,47,29
0,42,0.08695652173913043,0.015748031496062992,70761012,46,4
1,38,0.36666666666666664,0.8165137614678899,72417135,60,22
0,33,0.21428571428571427,0.44565217391304346,70633171,42,9
1,7,0.3,0.75,515676,10,3
0,15,0.21052631578947367,0.29411764705882354,69183695,19,4
0,22,0.15384615384615385,0.4155844155844156,69737031,26,4
2,6,0.5384615384615384,0.6363636363636364,54412400,13,7
2,8,0.5555555555555556,0.84,70720930,18,10
2,4,0.6,0.9473684210526315,80122905,10,6
0,25,0.07407407407407407,0.273972602739726,80122907,27,2
0,18,0.0,0.0,73490074,18,0
0,1,0.0,0.0,80150265,1,0
0,6,0.14285714285714285,0.2903225806451613,82022525,7,1
1,48,0.4146341463414634,0.8914728682170543,80180357,82,34
1,3,0.25,0.6923076923076923,70759640,4,1
2,10,0.7619047619047619,0.9090909090909091,66864441,42,32
0,84,0.25,0.4895833333333333,69165341,112,28
0,4,0.0,0.0,70701316,4,0
0,76,0.02564102564102564,0.04065040650406504,70612451,78,2
2,12,0.5862068965517241,0.9824561403508771,67192370,29,17
1,72,0.2653061224489796,0.5988372093023255,80180462,98,26
0,25,0.038461538461538464,0.21296296296296297,67620840,26,1
0,81,0.024096385542168676,0.1145374449339207,67620924,83,2
2,8,0.8,0.9285714285714286,73447563,40,32
1,35,0.35185185185185186,0.7040816326530612,69840820,54,19
1,5,0.16666666666666666,0.5,70605003,6,1
2,34,0.5526315789473685,0.9782608695652174,75469065,76,42
0,6,0.0,0.0,70679511,6,0
0,48,0.2,0.40310077519379844,72775234,60,12
2,0,1.0,1.0,80018995,3,3
0,1,0.0,0.0,79791180,1,0
1,32,0.3333333333333333,0.7738095238095238,67285491,48,16
2,74,0.5033557046979866,0.9615384615384616,68532590,149,75
1,7,0.36363636363636365,0.5862068965517241,82053037,11,4
1,63,0.35714285714285715,0.863905325443787,79783662,98,35
0,70,0.06666666666666667,0.14285714285714285,73399550,75,5
2,19,0.5476190476190477,0.9803921568627451,82013630,42,23
0,25,0.16666666666666666,0.3380281690140845,66110870,30,5
1,23,0.3235294117647059,0.6851851851851852,67591650,34,11
1,42,0.3114754098360656,0.7936507936507936,70633304,61,19
1,60,0.21052631578947367,0.5833333333333334,80135053,76,16
1,19,0.2962962962962963,0.6,68905753,27,8
1,48,0.4146341463414634,0.8613861386138614,62589961,82,34
1,22,0.4358974358974359,0.7647058823529411,80132403,39,17
1,10,0.3333333333333333,0.5454545454545454,80127021,15,5
0,15,0.0,0.0,68498535,15,0
0,1,0.0,0.0,69479025,1,0
0,4,0.0,0.0,70801871,4,0
1,40,0.2982456140350877,0.5888888888888889,80133418,57,17
1,28,0.37777777777777777,0.88,72208654,45,17
1,22,0.37142857142857144,0.5,80174903,35,13
0,20,0.2,0.21052631578947367,69705356,25,5
0,56,0.2112676056338028,0.39751552795031053,67394054,71,15
0,19,0.05,0.08888888888888889,73701131,20,1
1,7,0.3,0.5714285714285714,82041234,10,3
1,7,0.2222222222222222,0.5555555555555556,69596583,9,2
0,25,0.10714285714285714,0.22340425531914893,60514055,28,3
0,6,0.14285714285714285,0.15384615384615385,82200542,7,1
2,4,0.5,0.6666666666666666,79783781,8,4
1,23,0.3611111111111111,0.7380952380952381,67859841,36,13
0,12,0.14285714285714285,0.16,62771156,14,2
2,4,0.7142857142857143,0.9411764705882353,70868511,14,10
0,43,0.1568627450980392,0.21678321678321677,73176292,51,8
0,16,0.2,0.4594594594594595,70908873,20,4
0,20,0.13043478260869565,0.43548387096774194,68743451,23,3
2,6,0.7272727272727273,0.95,68561451,22,16
1,7,0.4166666666666667,0.8125,70854371,12,5
1,15,0.34782608695652173,0.8378378378378378,74725735,23,8
1,6,0.45454545454545453,0.8333333333333334,72031183,11,5
0,13,0.0,0.0,82003736,13,0
1,2,0.3333333333333333,0.8333333333333334,70820092,3,1
0,5,0.0,0.0,70820246,5,0
0,10,0.23076923076923078,0.4117647058823529,70820253,13,3
1,13,0.3157894736842105,0.7037037037037037,65282910,19,6
1,4,0.42857142857142855,0.9444444444444444,65288993,7,3
1,20,0.3939393939393939,0.7818181818181819,65281174,33,13
0,19,0.24,0.45454545454545453,65282952,25,6
1,12,0.3333333333333333,0.7666666666666667,65286193,18,6
0,23,0.20689655172413793,0.33962264150943394,65290295,29,6
0,17,0.19047619047619047,0.3103448275862069,70037555,21,4
2,4,0.6363636363636364,0.9090909090909091,69538966,11,7
1,15,0.375,0.868421052631579,67218683,24,9
0,71,0.06578947368421052,0.04225352112676056,69416865,76,5
0,19,0.0,0.0,68784926,19,0
0,1,0.0,0.0,80132960,1,0
0,91,0.2222222222222222,0.25153374233128833,82004781,117,26
1,40,0.16666666666666666,0.6111111111111112,300531,48,8
1,21,0.19230769230769232,0.581081081081081,70703360,26,5
2,15,0.5454545454545454,0.9814814814814815,80176637,33,18
2,30,0.5238095238095238,0.9107142857142857,80134723,63,33
1,48,0.29411764705882354,0.5333333333333333,80134760,68,20
0,58,0.17142857142857143,0.24571428571428572,82145365,70,12
0,28,0.06666666666666667,0.45454545454545453,62839840,30,2
2,6,0.75,0.9444444444444444,70546511,24,18
2,0,1.0,1.0,68755344,1,1
1,50,0.40476190476190477,0.8660714285714286,69978433,84,34
1,25,0.3055555555555556,0.6046511627906976,69603681,36,11
1,29,0.46296296296296297,0.9180327868852459,68372171,54,25
1,21,0.46153846153846156,0.8809523809523809,69172831,39,18
2,2,0.5,0.8,70678650,4,2
0,33,0.15384615384615385,0.3888888888888889,82163478,39,6
1,19,0.4722222222222222,0.5517241379310345,80056522,36,17
0,69,0.1686746987951807,0.25365853658536586,68391932,83,14
1,51,0.2916666666666667,0.5869565217391305,69693043,72,21
2,7,0.5625,0.75,68035331,16,9
0,3,0.25,0.2857142857142857,82020016,4,1
0,20,0.16666666666666666,0.24074074074074073,75892761,24,4
1,11,0.42105263157894735,0.8518518518518519,69964741,19,8
0,25,0.07407407407407407,0.16793893129770993,73739092,27,2
1,2,0.3333333333333333,0.6,80165145,3,1
2,16,0.673469387755102,0.9642857142857143,80178921,49,33
0,41,0.08888888888888889,0.07964601769911504,82128638,45,4
0,9,0.1,0.21739130434782608,70405713,10,1
2,3,0.5714285714285714,0.3333333333333333,80128841,7,4
0,2,0.0,0.0,19488042,2,0
0,1,0.0,0.0,82022162,1,0
2,1,0.6666666666666666,0.6666666666666666,82023138,3,2
2,2,0.75,0.75,15764154,8,6
2,0,1.0,1.0,80080112,10,10
0,79,0.036585365853658534,0.13740458015267176,73064544,82,3
2,2,0.7142857142857143,0.6666666666666666,68884543,7,5
0,84,0.011764705882352941,0.028169014084507043,80124389,85,1
0,19,0.09523809523809523,0.11538461538461539,15781313,21,2
1,2,0.3333333333333333,0.6666666666666666,72803843,3,1
2,3,0.6666666666666666,0.75,80158324,9,6
2,3,0.8235294117647058,0.6666666666666666,80159150,17,14
1,46,0.41025641025641024,0.9090909090909091,70741545,78,32
0,14,0.0,0.0,82001450,14,0
0,9,0.1,0.23333333333333334,82001451,10,1
0,101,0.23484848484848486,0.43846153846153846,68283054,132,31
2,27,0.55,0.9473684210526315,66837603,60,33
1,16,0.23809523809523808,0.5094339622641509,80150378,21,5
2,8,0.6,0.7777777777777778,80118207,20,12
1,12,0.25,0.65,82096276,16,4
1,5,0.4444444444444444,0.7272727272727273,69731571,9,4
2,12,0.6129032258064516,0.92,80158090,31,19
2,2,0.875,0.75,80052763,16,14
2,0,1.0,1.0,82033540,4,4
2,0,1.0,1.0,80090906,6,6
2,0,1.0,1.0,80162572,10,10
2,0,1.0,1.0,80136599,2,2
2,1,0.8,0.5,82102215,5,4
2,8,0.5,0.9375,80054723,16,8
2,2,0.8,0.75,73652222,10,8
2,0,1.0,1.0,80169814,6,6
2,2,0.75,0.0,70712180,8,6
1,112,0.3563218390804598,0.8004866180048662,75115341,174,62
2,0,1.0,1.0,80165272,15,15
2,3,0.7692307692307693,0.96,80118945,13,10
2,1,0.5,0.5,80145710,2,1
2,8,0.7241379310344828,0.9166666666666666,70632184,29,21
1,15,0.375,0.9178082191780822,80118445,24,9
0,15,0.25,0.2,82041271,20,5
2,0,1.0,1.0,80162166,9,9
2,0,1.0,1.0,80159289,1,1
1,51,0.37037037037037035,0.5595238095238095,80178985,81,30
2,1,0.9871794871794872,0.5,70869400,78,77
2,4,0.7142857142857143,0.9285714285714286,70494396,14,10
2,13,0.7045454545454546,0.9166666666666666,82171876,44,31
2,3,0.6666666666666666,0.75,74363366,9,6
0,7,0.36363636363636365,0.3333333333333333,68731642,11,4
1,35,0.38596491228070173,0.7341772151898734,72426473,57,22
2,24,0.6666666666666666,0.9782608695652174,65815505,72,48
2,5,0.7619047619047619,0.8333333333333334,80050173,21,16
2,0,1.0,1.0,82036973,22,22
2,0,1.0,1.0,70851200,3,3
2,5,0.5,0.625,69733293,10,5
2,9,0.8363636363636363,0.9666666666666667,82096250,55,46
2,2,0.5,0.8,63767410,4,2
1,7,0.3,0.6923076923076923,82095530,10,3
2,0,1.0,1.0,82041894,2,2
0,12,0.3333333333333333,0.4090909090909091,80019240,18,6
0,3,0.0,0.0,80145884,3,0
2,17,0.5405405405405406,0.9558823529411765,70202783,37,20
2,20,0.5652173913043478,0.8888888888888888,82096256,46,26
2,2,0.75,0.8571428571428571,80127382,8,6
2,0,1.0,1.0,70314265,18,18
0,7,0.36363636363636365,0.2,80125220,11,4
2,30,0.5454545454545454,0.7,82171880,66,36
1,6,0.3333333333333333,0.6470588235294118,80135021,9,3
0,2,0.0,0.0,80128327,2,0
2,2,0.5,0.5714285714285714,80128357,4,2
0,3,0.0,0.0,80128360,3,0
0,30,0.16666666666666666,0.0,75576536,36,6
1,12,0.42857142857142855,0.8095238095238095,73472560,21,9
0,51,0.2153846153846154,0.328,70655403,65,14
2,1,0.5,0.5,73870755,2,1
0,3,0.0,0.0,70326354,3,0
1,16,0.4482758620689655,0.8571428571428571,80028592,29,13
1,24,0.22580645161290322,0.6341463414634146,70474691,31,7
2,1,0.5,0.5,70413042,2,1
0,65,0.16666666666666666,0.3150684931506849,62234536,78,13
0,2,0.0,0.0,72357726,2,0
0,1,0.0,0.0,69211674,1,0
0,23,0.25806451612903225,0.36585365853658536,68401634,31,8
1,47,0.4470588235294118,0.9038461538461539,82043025,85,38
1,7,0.125,0.7857142857142857,68498983,8,1
0,1,0.0,0.0,70036141,1,0
2,15,0.5833333333333334,0.8,80018596,36,21
1,31,0.27906976744186046,0.5411764705882353,62497834,43,12
2,7,0.5333333333333333,0.875,82050069,15,8
1,9,0.35714285714285715,0.9354838709677419,70621341,14,5
0,26,0.0,0.0,70918316,26,0
1,19,0.17391304347826086,0.6949152542372882,70918743,23,4
0,9,0.0,0.0,73460065,9,0
2,4,0.6363636363636364,0.8888888888888888,67584153,11,7
0,51,0.1206896551724138,0.1610738255033557,73977890,58,7
1,14,0.44,0.8571428571428571,75102881,25,11
1,18,0.1,0.5853658536585366,69526030,20,2
1,6,0.45454545454545453,0.875,80165737,11,5
1,25,0.24242424242424243,0.5714285714285714,82059792,33,8
1,3,0.4,0.75,82113197,5,2
0,10,0.0,0.0,67466574,10,0
0,46,0.08,0.4195804195804196,67468590,50,4
1,20,0.2857142857142857,0.7887323943661971,69886796,28,8
2,1,0.9791666666666666,0.5,65043076,48,47
1,13,0.35,0.6862745098039216,66551751,20,7
2,0,1.0,1.0,82016259,1,1
0,30,0.0625,0.2549019607843137,67467771,32,2
0,6,0.0,0.0,69526191,6,0
0,87,0.21621621621621623,0.4778761061946903,68621133,111,24
2,9,0.5714285714285714,0.9117647058823529,80019170,21,12
1,48,0.4606741573033708,0.9408284023668639,80137144,89,41
1,21,0.08695652173913043,0.6,62841156,23,2
2,15,0.6428571428571429,0.9583333333333334,67221756,42,27
1,6,0.4,0.8333333333333334,68444040,10,4
2,27,0.5423728813559322,0.9714285714285714,69180762,59,32
2,1,0.75,0.5,75347440,4,3
1,18,0.3793103448275862,0.7692307692307693,80134797,29,11
0,24,0.1111111111111111,0.12121212121212122,80128638,27,3
1,32,0.2,0.5157894736842106,63955731,40,8
2,2,0.5,0.9285714285714286,66899063,4,2
0,77,0.02531645569620253,0.03867403314917127,70669620,79,2
1,7,0.36363636363636365,0.8235294117647058,75363736,11,4
2,4,0.5555555555555556,0.75,68115243,9,5
0,2,0.0,0.0,66782051,2,0
0,2,0.0,0.0,66786335,2,0
0,60,0.15492957746478872,0.3274336283185841,73700725,71,11
0,22,0.12,0.3670886075949367,70211274,25,3
1,19,0.20833333333333334,0.6538461538461539,80153581,24,5
1,14,0.2222222222222222,0.5,80118138,18,4
2,3,0.5714285714285714,0.7777777777777778,80124760,7,4
0,4,0.2,0.35714285714285715,71619170,5,1
1,21,0.46153846153846156,0.9111111111111111,80180475,39,18
1,17,0.43333333333333335,0.6176470588235294,74887764,30,13
2,34,0.5072463768115942,0.8333333333333334,80180259,69,35
2,9,0.6086956521739131,0.8717948717948718,74361532,23,14
0,1,0.0,0.0,66783864,1,0
1,36,0.4,0.875,67995053,60,24
1,32,0.13513513513513514,0.5333333333333333,62529481,37,5
0,39,0.15217391304347827,0.265625,61712980,46,7
1,37,0.26,0.5473684210526316,70718361,50,13
0,107,0.1640625,0.3963963963963964,63615286,128,21
1,11,0.3125,0.6521739130434783,68600875,16,5
2,25,0.6428571428571429,0.9782608695652174,80158344,70,45
1,4,0.42857142857142855,0.6538461538461539,82013589,7,3
2,9,0.6666666666666666,0.84,80174682,27,18
2,2,0.6666666666666666,0.5,82102165,6,4
0,2,0.0,0.0,82102186,2,0
2,9,0.5714285714285714,0.9824561403508771,69150942,21,12
0,13,0.07142857142857142,0.125,70181132,14,1
1,58,0.40816326530612246,0.7164179104477612,80158286,98,40
1,33,0.4107142857142857,0.875,69056841,56,23
1,7,0.36363636363636365,0.8571428571428571,70213815,11,4
0,13,0.1875,0.375,70175644,16,3
0,62,0.046153846153846156,0.2956989247311828,68497772,65,3
0,2,0.0,0.0,69006532,2,0
0,34,0.02857142857142857,0.21904761904761905,69007071,35,1
1,5,0.16666666666666666,0.6086956521739131,69007085,6,1
2,11,0.5217391304347826,0.8846153846153846,70718564,23,12
0,5,0.16666666666666666,0.16666666666666666,69149311,6,1
1,16,0.4666666666666667,0.9523809523809523,69997914,30,14
1,4,0.42857142857142855,0.7777777777777778,67053721,7,3
2,2,0.7777777777777778,0.8,72802576,9,7
2,2,0.6,0.6666666666666666,70768180,5,3
0,5,0.0,0.0,70768334,5,0
0,31,0.20512820512820512,0.45689655172413796,70489076,39,8
1,2,0.3333333333333333,0.9,80167232,3,1
1,53,0.39080459770114945,0.819047619047619,80180960,87,34
1,10,0.4117647058823529,0.9285714285714286,69666555,17,7
1,24,0.29411764705882354,0.6901408450704225,69184101,34,10
1,48,0.323943661971831,0.574468085106383,68401235,71,23
2,0,1.0,1.0,70036883,1,1
1,33,0.3888888888888889,0.6851851851851852,72632112,54,21
1,36,0.3898305084745763,0.7837837837837838,70061383,59,23
0,6,0.3333333333333333,0.35714285714285715,82013623,9,3
2,16,0.5789473684210527,0.9838709677419355,69162891,38,22
0,4,0.0,0.0,62849941,4,0
2,3,0.8,0.8,70060746,15,12
0,25,0.07407407407407407,0.15841584158415842,70181244,27,2
0,15,0.0625,0.11594202898550725,70704550,16,1
0,6,0.14285714285714285,0.25,70707630,7,1
0,18,0.05263157894736842,0.10869565217391304,70605682,19,1
2,1,0.5,0.0,70819406,2,1
1,56,0.2911392405063291,0.5692307692307692,80053400,79,23
1,36,0.4098360655737705,0.6615384615384615,80132370,61,25
1,11,0.45,0.782608695652174,80155224,20,9
1,157,0.29910714285714285,0.7237569060773481,69481902,224,67
1,22,0.35294117647058826,0.7777777777777778,82095534,34,12
1,19,0.3870967741935484,0.7878787878787878,70568470,31,12
0,6,0.0,0.0,72775220,6,0
1,47,0.32857142857142857,0.66,69183982,70,23
1,41,0.3387096774193548,0.85,82118072,62,21
0,32,0.28888888888888886,0.46511627906976744,66613911,45,13
1,30,0.3333333333333333,0.5569620253164557,71288686,45,15
1,36,0.34545454545454546,0.7692307692307693,69167441,55,19
1,5,0.4444444444444444,0.8571428571428571,70867265,9,4
1,12,0.07692307692307693,0.7872340425531915,67893133,13,1
1,28,0.48148148148148145,0.8591549295774648,80160473,54,26
2,0,1.0,1.0,70701645,1,1
1,25,0.3055555555555556,0.5106382978723404,80180192,36,11
0,178,0.14423076923076922,0.2517482517482518,68018041,208,30
1,19,0.2962962962962963,0.5849056603773585,82096247,27,8
1,7,0.3,0.8,66379460,10,3
0,48,0.1111111111111111,0.1440677966101695,82128640,54,6
2,19,0.5957446808510638,0.9795918367346939,70241346,47,28
0,5,0.16666666666666666,0.22727272727272727,80113453,6,1
1,77,0.4338235294117647,0.8714285714285714,80180242,136,59
1,24,0.29411764705882354,0.8108108108108109,70240205,34,10
1,123,0.24074074074074073,0.54,68338620,162,39
1,6,0.25,0.6923076923076923,80074435,8,2
1,37,0.22916666666666666,0.7380952380952381,64962982,48,11
2,0,1.0,1.0,82134989,1,1
0,8,0.1111111111111111,0.2765957446808511,82128653,9,1
0,14,0.125,0.35714285714285715,67758600,16,2
1,27,0.41304347826086957,0.9850746268656716,82120537,46,19
1,15,0.4642857142857143,0.94,72802653,28,13
0,35,0.2391304347826087,0.4387755102040816,82126813,46,11
1,8,0.2727272727272727,0.7857142857142857,64229291,11,3
1,13,0.38095238095238093,0.8,62878221,21,8
2,5,0.7916666666666666,0.9285714285714286,69333005,24,19
0,29,0.12121212121212122,0.4368932038834951,80128709,33,4
2,7,0.65,0.9166666666666666,80165419,20,13
0,51,0.08928571428571429,0.24509803921568626,82003731,56,5
1,15,0.21052631578947367,0.7435897435897436,70468160,19,4
0,19,0.13636363636363635,0.18309859154929578,69736996,22,3
0,8,0.1111111111111111,0.14285714285714285,69596891,9,1
1,45,0.3076923076923077,0.5138888888888888,64224923,65,20
1,40,0.3442622950819672,0.6,64224993,61,21
2,0,1.0,1.0,69958924,2,2
2,10,0.6551724137931034,0.8125,72805173,29,19
2,2,0.6,0.8,70348894,5,3
1,35,0.36363636363636365,0.768595041322314,82002248,55,20
0,22,0.2413793103448276,0.296875,66551765,29,7
1,187,0.3175182481751825,0.7194805194805195,76043422,274,87
1,30,0.3333333333333333,0.7982456140350878,80130758,45,15
0,32,0.15789473684210525,0.4069767441860465,70812952,38,6
2,15,0.625,0.9444444444444444,70350070,40,25
2,20,0.6296296296296297,0.9583333333333334,79817122,54,34
2,5,0.5,0.8333333333333334,70253771,10,5
2,5,0.6428571428571429,0.8888888888888888,63188643,14,9
2,1,0.6666666666666666,0.5,80093713,3,2
2,4,0.7647058823529411,0.7142857142857143,80118335,17,13
2,0,1.0,1.0,82070190,2,2
2,1,0.5,0.5,82019661,2,1
0,12,0.14285714285714285,0.03571428571428571,68162451,14,2
0,28,0.17647058823529413,0.19117647058823528,65281181,34,6
0,83,0.15306122448979592,0.1507537688442211,82126656,98,15
0,7,0.0,0.0,67646061,7,0
0,2,0.3333333333333333,0.25,69604136,3,1
1,19,0.32142857142857145,0.7073170731707317,82128652,28,9
2,11,0.6451612903225806,0.9333333333333333,63592382,31,20
0,18,0.14285714285714285,0.038461538461538464,68449955,21,3
2,11,0.5,0.96875,82004784,22,11
0,74,0.13953488372093023,0.19736842105263158,70567840,86,12
2,3,0.5,0.6,65567215,6,3
0,73,0.17045454545454544,0.3862433862433862,70466165,88,15
0,27,0.25,0.3246753246753247,79954021,36,9
2,11,0.56,0.9523809523809523,69904065,25,14
0,49,0.15517241379310345,0.12949640287769784,70539812,58,9
1,4,0.2,0.625,62527255,5,1
0,22,0.18518518518518517,0.29411764705882354,67287815,27,5
0,78,0.23529411764705882,0.2653061224489796,82009525,102,24
1,32,0.42857142857142855,0.6349206349206349,70718900,56,24
0,20,0.13043478260869565,0.023255813953488372,65290253,23,3
1,25,0.3055555555555556,0.66,70759843,36,11
0,41,0.18,0.20967741935483872,66613981,50,9
1,10,0.2857142857142857,0.6825396825396826,63188244,14,4
1,18,0.35714285714285715,0.6382978723404256,70646471,28,10
0,8,0.0,0.0,67435284,8,0
1,51,0.25,0.5546875,68932255,68,17
1,26,0.2972972972972973,0.7054794520547946,82124929,37,11
2,15,0.5714285714285714,0.8,70189910,35,20
2,1,0.6666666666666666,0.8571428571428571,70683431,3,2
1,39,0.35,0.6744186046511628,69406911,60,21
1,6,0.45454545454545453,0.5384615384615384,82041903,11,5
1,21,0.34375,0.7702702702702703,66903333,32,11
1,64,0.24705882352941178,0.5370370370370371,82126685,85,21
0,11,0.08333333333333333,0.16666666666666666,73266480,12,1
0,29,0.03333333333333333,0.05142857142857143,64973993,30,1
0,3,0.25,0.4,73399564,4,1
2,12,0.5714285714285714,0.9473684210526315,68279946,28,16
2,88,0.5368421052631579,0.9117647058823529,69585733,190,102
2,14,0.6,0.7647058823529411,65994621,35,21
0,75,0.11764705882352941,0.17488789237668162,80070970,85,10
1,10,0.4117647058823529,0.8181818181818182,80083570,17,7
2,1,0.5,0.5,80054541,2,1
0,31,0.08823529411764706,0.19834710743801653,74924066,34,3
2,29,0.5606060606060606,0.9473684210526315,69530545,66,37
1,26,0.23529411764705882,0.8557692307692307,69084554,34,8
2,4,0.5555555555555556,0.7777777777777778,65785335,9,5
1,7,0.46153846153846156,0.625,69522880,13,6
1,21,0.3,0.7333333333333333,64231230,30,9
2,0,1.0,1.0,80165160,2,2
2,1,0.8,0.6666666666666666,70711326,5,4
2,9,0.6896551724137931,0.9090909090909091,80178136,29,20
2,46,0.603448275862069,0.9770992366412213,70350546,116,70
0,57,0.0,0.0,80150470,57,0
0,49,0.0,0.0,80150471,49,0
1,8,0.38461538461538464,0.8666666666666667,69611234,13,5
1,37,0.28846153846153844,0.6309523809523809,69179691,52,15
2,4,0.5555555555555556,0.9523809523809523,70418194,9,5
1,12,0.45454545454545453,0.896551724137931,82251482,22,10
0,1,0.0,0.0,64248513,1,0
1,13,0.2777777777777778,0.6730769230769231,61748750,18,5
0,16,0.23809523809523808,0.2222222222222222,72846844,21,5
0,16,0.058823529411764705,0.022222222222222223,70646296,17,1
0,10,0.16666666666666666,0.19047619047619047,70646443,12,2
0,50,0.12280701754385964,0.06666666666666667,82116850,57,7
0,21,0.08695652173913043,0.4868421052631579,80028900,23,2
0,17,0.05555555555555555,0.2689075630252101,68356652,18,1
2,3,0.7692307692307693,0.8,80178965,13,10
1,44,0.22807017543859648,0.5612244897959183,69965070,57,13
2,0,1.0,1.0,70190106,1,1
1,6,0.4,0.7857142857142857,68400913,10,4
0,34,0.2916666666666667,0.4827586206896552,69198626,48,14
1,13,0.38095238095238093,0.7916666666666666,63897043,21,8
1,12,0.29411764705882354,0.7954545454545454,80121204,17,5
0,14,0.17647058823529413,0.16666666666666666,69509104,17,3
0,159,0.05917159763313609,0.24822695035460993,67887302,169,10
1,9,0.4375,0.8484848484848485,67455031,16,7
1,16,0.23809523809523808,0.5757575757575758,64400413,21,5
2,2,0.8571428571428571,0.75,67590285,14,12
2,4,0.7647058823529411,0.9565217391304348,63523341,17,13
1,23,0.425,0.75,68249720,40,17
0,1,0.0,0.0,66917746,1,0
0,14,0.125,0.2542372881355932,69400555,16,2
2,21,0.7236842105263158,0.8181818181818182,63675171,76,55
1,7,0.36363636363636365,0.7586206896551724,70013230,11,4
1,3,0.4,0.9090909090909091,81900747,5,2
1,68,0.26881720430107525,0.5214723926380368,64966293,93,25
2,11,0.8962264150943396,0.6666666666666666,67797611,106,95
2,1,0.9473684210526315,0.8333333333333334,70395661,19,18
0,3,0.0,0.0,80126782,3,0
0,34,0.17073170731707318,0.3902439024390244,66855873,41,7
1,27,0.2894736842105263,0.5285714285714286,66855894,38,11
2,1,0.6666666666666666,0.8,70792575,3,2
0,15,0.2857142857142857,0.3333333333333333,69165733,21,6
0,14,0.125,0.19642857142857142,80145810,16,2
0,10,0.09090909090909091,0.42857142857142855,70818496,11,1
2,5,0.5454545454545454,0.75,69666702,11,6
1,2,0.3333333333333333,0.7692307692307693,70701421,3,1
1,23,0.14814814814814814,0.6296296296296297,67836916,27,4
1,63,0.29213483146067415,0.6616541353383458,80136829,89,26
2,9,0.8235294117647058,0.96875,80177433,51,42
2,0,1.0,1.0,80165263,3,3
0,66,0.12,0.4189189189189189,72765952,75,9
1,75,0.44029850746268656,0.9145299145299145,70781501,134,59
2,0,1.0,1.0,67371374,8,8
0,51,0.22727272727272727,0.39751552795031053,80176712,66,15
0,14,0.125,0.05263157894736842,80180215,16,2
1,17,0.41379310344827586,0.75,80019380,29,12
1,22,0.3125,0.6588235294117647,80167077,32,10
1,44,0.34328358208955223,0.7941176470588235,68556411,67,23
0,5,0.2857142857142857,0.45454545454545453,82013521,7,2
1,6,0.4,0.75,80145781,10,4
2,0,1.0,1.0,75362280,4,4
1,25,0.4318181818181818,0.6976744186046512,69733146,44,19
2,2,0.7142857142857143,0.8888888888888888,72803381,7,5
1,23,0.425,0.9512195121951219,68995514,40,17
0,4,0.3333333333333333,0.0,68437964,6,2
1,51,0.2608695652173913,0.8131868131868132,80135178,69,18
2,1,0.5,0.7894736842105263,68217814,2,1
0,4,0.2,0.4117647058823529,72522205,5,1
1,35,0.35185185185185186,0.9263803680981595,69726706,54,19
0,3,0.0,0.0,69021456,3,0
0,2,0.0,0.0,69021631,2,0
2,1,0.6666666666666666,0.6666666666666666,69021736,3,2
1,27,0.35714285714285715,0.7341772151898734,69538672,42,15
0,5,0.16666666666666666,0.0,70404250,6,1
0,23,0.28125,0.4909090909090909,69180510,32,9
0,23,0.17857142857142858,0.27184466019417475,82128663,28,5
0,11,0.15384615384615385,0.2545454545454545,82128664,13,2
2,1,0.8333333333333334,0.5,79788590,6,5
2,8,0.5,0.9444444444444444,70418222,16,8
1,4,0.3333333333333333,0.5454545454545454,82068728,6,2
2,8,0.5294117647058824,0.9473684210526315,78023050,17,9
0,8,0.2,0.3333333333333333,72717701,10,2
2,1,0.5,0.5,72803871,2,1
2,1,0.5,0.5,80177545,2,1
1,55,0.375,0.7372881355932204,80135017,88,33
0,30,0.09090909090909091,0.2845528455284553,75147975,33,3
0,111,0.017699115044247787,0.05363984674329502,72775115,113,2
0,4,0.0,0.0,70674884,4,0
0,19,0.0,0.0,70679140,19,0
2,0,1.0,1.0,80158244,7,7
0,30,0.4117647058823529,0.23529411764705882,70631610,51,21
1,80,0.10112359550561797,0.5274390243902439,62836242,89,9
0,2,0.0,0.0,67053553,2,0
0,2,0.0,0.0,66202416,2,0
2,8,0.5,0.8947368421052632,69483743,16,8
0,1,0.0,0.0,67307233,1,0
0,2,0.0,0.0,75033224,2,0
1,16,0.2727272727272727,0.9322033898305084,69033510,22,6
0,39,0.04878048780487805,0.19672131147540983,70639352,41,2
1,5,0.2857142857142857,0.6666666666666666,65279746,7,2
0,78,0.13333333333333333,0.1984126984126984,80124768,90,12
1,24,0.35135135135135137,0.824,72794344,37,13
2,8,0.5555555555555556,0.6111111111111112,70637371,18,10
2,12,0.6571428571428571,0.8333333333333334,80093545,35,23
2,12,0.7333333333333333,0.9696969696969697,70925722,45,33
1,71,0.2755102040816326,0.7255639097744361,68600861,98,27
0,42,0.19230769230769232,0.2109375,62499332,52,10
0,4,0.2,0.2,68401823,5,1
1,10,0.16666666666666666,0.723404255319149,75456675,12,2
0,17,0.05555555555555555,0.044444444444444446,66304854,18,1
1,20,0.2857142857142857,0.75,66305113,28,8
0,6,0.14285714285714285,0.14285714285714285,70582540,7,1
0,25,0.2647058823529412,0.3541666666666667,82005367,34,9
2,1,0.5,0.9166666666666666,58866514,2,1
0,153,0.04375,0.16129032258064516,62836200,160,7
0,5,0.0,0.0,66657773,5,0
1,61,0.2375,0.5028901734104047,66423000,80,19
0,83,0.04597701149425287,0.0880503144654088,69509013,87,4
2,6,0.5,0.8636363636363636,70812763,12,6
1,48,0.29411764705882354,0.6344086021505376,67554116,68,20
0,63,0.2222222222222222,0.49473684210526314,80128514,81,18
0,32,0.030303030303030304,0.09090909090909091,62841184,33,1
1,8,0.38461538461538464,0.7045454545454546,75121060,13,5
1,10,0.2857142857142857,0.74,70238805,14,4
1,6,0.3333333333333333,0.5714285714285714,69213536,9,3
1,21,0.19230769230769232,0.6413043478260869,69084533,26,5
1,24,0.4146341463414634,0.8666666666666667,65633932,41,17
1,25,0.4318181818181818,0.92,65982420,44,19
0,48,0.1111111111111111,0.0784313725490196,77676522,54,6
1,17,0.48484848484848486,0.8837209302325582,71752961,33,16
1,30,0.25,0.5245901639344263,69070554,40,10
1,48,0.26153846153846155,0.5986842105263158,82118073,65,17
2,0,1.0,1.0,82105392,2,2
1,8,0.2,0.6428571428571429,69117160,10,2
0,41,0.1276595744680851,0.2857142857142857,61186902,47,6
2,44,0.5268817204301075,0.975609756097561,82018855,93,49
2,3,0.7272727272727273,0.875,80176668,11,8
1,31,0.2619047619047619,0.6176470588235294,70078211,42,11
2,0,1.0,1.0,82010293,3,3
1,49,0.15517241379310345,0.5847953216374269,80135175,58,9
1,38,0.42424242424242425,0.7808219178082192,82024046,66,28
1,36,0.42857142857142855,0.8571428571428571,80067295,63,27
1,3,0.25,0.75,70705922,4,1
0,16,0.2727272727272727,0.3333333333333333,68449941,22,6
1,7,0.2222222222222222,0.6956521739130435,64343412,9,2
1,23,0.17857142857142858,0.5735294117647058,69638891,28,5
1,30,0.34782608695652173,0.7910447761194029,80124707,46,16
2,3,0.5,0.9090909090909091,70256970,6,3
1,5,0.2857142857142857,0.6,64343622,7,2
0,5,0.2857142857142857,0.39285714285714285,73801581,7,2
0,2,0.0,0.0,70621761,2,0
2,10,0.5454545454545454,0.875,67823350,22,12
0,68,0.014492753623188406,0.1095890410958904,82003714,69,1
0,33,0.029411764705882353,0.23076923076923078,80049452,34,1
0,65,0.09722222222222222,0.42,80049543,72,7
0,12,0.14285714285714285,0.0625,67400893,14,2
0,6,0.25,0.23076923076923078,80135229,8,2
0,3,0.0,0.0,19989403,3,0
0,3,0.0,0.0,82164475,3,0
0,11,0.21428571428571427,0.391304347826087,73007200,14,3
1,12,0.2,0.5,82019428,15,3
0,13,0.07142857142857142,0.15,82022513,14,1
2,3,0.85,0.9166666666666666,82139991,20,17
2,6,0.7272727272727273,0.967741935483871,70174916,22,16
0,14,0.0,0.0,68239815,14,0
2,10,0.8305084745762712,0.8666666666666667,80178127,59,49
2,34,0.5072463768115942,0.8723404255319149,72805341,69,35
2,10,0.6551724137931034,0.9565217391304348,67625845,29,19
2,0,1.0,1.0,82159941,22,22
2,8,0.5789473684210527,0.9375,65289245,19,11
1,15,0.4230769230769231,0.6363636363636364,72426494,26,11
1,92,0.264,0.5675675675675675,82126782,125,33
1,50,0.43820224719101125,0.9696969696969697,67173372,89,39
1,13,0.35,0.7894736842105263,82001455,20,7
2,3,0.5714285714285714,0.4,70174055,7,4
1,22,0.21428571428571427,0.7254901960784313,69660003,28,6
0,21,0.0,0.0,70848400,21,0
2,12,0.52,0.9285714285714286,82018895,25,13
0,2,0.3333333333333333,0.3333333333333333,82024273,3,1
2,7,0.7941176470588235,0.9166666666666666,54887266,34,27
1,8,0.42857142857142855,0.8333333333333334,80137613,14,6
2,21,0.6612903225806451,0.9166666666666666,69958035,62,41
0,76,0.09523809523809523,0.14173228346456693,70005033,84,8
0,26,0.1875,0.2077922077922078,82126811,32,6
1,22,0.40540540540540543,0.9230769230769231,68283061,37,15
1,8,0.4666666666666667,0.7,80178153,15,7
1,6,0.3333333333333333,0.7586206896551724,82096246,9,3
1,12,0.42857142857142855,0.8518518518518519,82096262,21,9
1,17,0.34615384615384615,0.7727272727272727,69184143,26,9
0,18,0.1,0.10526315789473684,70568750,20,2
1,23,0.28125,0.5679012345679012,72543870,32,9
2,2,0.5,0.9333333333333333,69489126,4,2
2,18,0.6785714285714286,0.9811320754716981,80176857,56,38
1,81,0.25688073394495414,0.6083916083916084,70234682,109,28
0,13,0.0,0.0,68237645,13,0
0,13,0.0,0.0,68237652,13,0
0,15,0.0,0.0,68237666,15,0
0,101,0.07339449541284404,0.2857142857142857,61976166,109,8
0,38,0.20833333333333334,0.45222929936305734,82116855,48,10
1,12,0.3333333333333333,0.8,68229462,18,6
0,2,0.0,0.0,79817024,2,0
0,8,0.0,0.0,69611332,8,0
0,20,0.09090909090909091,0.1694915254237288,70060466,22,2
2,5,0.6666666666666666,0.8461538461538461,79792370,15,10
0,9,0.1,0.16666666666666666,69726496,10,1
0,16,0.23809523809523808,0.3684210526315789,82126774,21,5
2,1,0.8888888888888888,0.5,65835504,9,8
0,36,0.05263157894736842,0.05,69643224,38,2
1,27,0.47058823529411764,0.9487179487179487,65180444,51,24
1,36,0.35714285714285715,0.9203539823008849,80108735,56,20
0,72,0.14285714285714285,0.4673913043478261,69084526,84,12
2,7,0.6956521739130435,0.9523809523809523,79792503,23,16
0,13,0.13333333333333333,0.2413793103448276,72909690,15,2
2,9,0.64,0.9459459459459459,72803332,25,16
2,2,0.8,0.8,82024361,10,8
2,17,0.6530612244897959,0.9508196721311475,80139939,49,32
1,28,0.125,0.6106870229007634,67836902,32,4
1,11,0.26666666666666666,0.6333333333333333,62767775,15,4
1,105,0.2857142857142857,0.6822429906542056,81956136,147,42
2,1,0.5,0.75,68167946,2,1
2,1,0.5,0.3333333333333333,82012772,2,1
0,10,0.23076923076923078,0.42424242424242425,69981744,13,3
1,34,0.3333333333333333,0.6071428571428571,70719215,51,17
2,11,0.5,0.9565217391304348,67066692,22,11
0,30,0.11764705882352941,0.11538461538461539,80128560,34,4
2,1,0.6666666666666666,0.9,82105391,3,2
2,9,0.625,0.96,80150446,24,15
0,5,0.0,0.0,72808673,5,0
2,9,0.5714285714285714,0.9142857142857143,65768913,21,12
2,12,0.6666666666666666,0.8947368421052632,80118211,36,24
0,49,0.24615384615384617,0.47096774193548385,70660485,65,16
2,1,0.875,0.5,71458611,8,7
0,1,0.0,0.0,67753623,1,0
1,179,0.3193916349809886,0.7764423076923077,80133419,263,84
2,2,0.5,0.9090909090909091,80053582,4,2
2,2,0.5,0.8,69003312,4,2
2,12,0.8356164383561644,0.9772727272727273,73588872,73,61
0,25,0.13793103448275862,0.16129032258064516,73977694,29,4
1,14,0.3,0.8076923076923077,73977736,20,6
2,4,0.5555555555555556,0.75,71458625,9,5
0,8,0.0,0.0,82152768,8,0
1,13,0.3157894736842105,0.7727272727272727,65950892,19,6
0,29,0.2564102564102564,0.4,73412206,39,10
0,14,0.125,0.023809523809523808,80124814,16,2
1,12,0.3333333333333333,0.6388888888888888,69602974,18,6
2,3,0.88,0.6666666666666666,80181543,25,22
2,1,0.5,0.6,67295620,2,1
0,1,0.0,0.0,67295683,1,0
0,1,0.0,0.0,67297706,1,0
2,3,0.5714285714285714,0.6666666666666666,80118269,7,4
2,1,0.5,0.6666666666666666,80083675,2,1
0,1,0.0,0.0,80083913,1,0
0,2,0.0,0.0,80083941,2,0
0,16,0.15789473684210525,0.29545454545454547,73709244,19,3
1,9,0.35714285714285715,0.75,65289805,14,5
2,3,0.7272727272727273,0.8,79792573,11,8
1,36,0.25,0.5844155844155844,73637690,48,12
1,20,0.4117647058823529,0.7241379310344828,82251158,34,14
2,7,0.5882352941176471,0.9411764705882353,82251168,17,10
1,23,0.28125,0.6547619047619048,69640046,32,9
1,19,0.4722222222222222,0.9571428571428572,77555261,36,17
1,22,0.4358974358974359,0.8764044943820225,80104913,39,17
0,9,0.18181818181818182,0.3333333333333333,73634981,11,2
2,7,0.65,0.5833333333333334,69667444,20,13
2,0,1.0,1.0,82010302,1,1
0,1,0.0,0.0,82016102,1,0
0,1,0.0,0.0,82016110,1,0
2,0,1.0,1.0,82050061,7,7
1,24,0.25,0.717948717948718,62795516,32,8
0,3,0.0,0.0,67291266,3,0
0,19,0.20833333333333334,0.28,67291602,24,5
2,8,0.5789473684210527,0.8888888888888888,72038015,19,11
2,2,0.5,0.9285714285714286,82046930,4,2
0,7,0.0,0.0,82046952,7,0
1,15,0.4827586206896552,0.875,82049176,29,14
2,0,1.0,1.0,82182809,2,2
1,6,0.25,0.5,73102491,8,2
1,3,0.4,0.5714285714285714,80124946,5,2
1,7,0.4166666666666667,0.7368421052631579,82023571,12,5
1,32,0.36,0.9,82124922,50,18
0,9,0.18181818181818182,0.391304347826087,62827296,11,2
0,5,0.16666666666666666,0.25,70246701,6,1
1,15,0.4230769230769231,0.9655172413793104,80124662,26,11
1,15,0.34782608695652173,0.6379310344827587,80153657,23,8
1,24,0.35135135135135137,0.6530612244897959,70608993,37,13
1,32,0.28888888888888886,0.5918367346938775,73634792,45,13
1,76,0.4411764705882353,0.8514851485148515,70063413,136,60
1,25,0.4318181818181818,0.7580645161290323,80176028,44,19
0,13,0.13333333333333333,0.4523809523809524,69485871,15,2
2,3,0.5714285714285714,0.9230769230769231,80069780,7,4
1,2,0.3333333333333333,0.8571428571428571,64231860,3,1
0,103,0.10434782608695652,0.07462686567164178,73346896,115,12
2,3,0.5,0.8,82061338,6,3
1,19,0.4722222222222222,0.9411764705882353,74811471,36,17
2,0,1.0,1.0,67584342,2,2
2,2,0.6,0.8,82052046,5,3
1,7,0.36363636363636365,0.5,82052048,11,4
0,53,0.3026315789473684,0.37209302325581395,80178939,76,23
2,1,0.6666666666666666,0.5,82018718,3,2
1,36,0.29411764705882354,0.5789473684210527,80051713,51,15
0,23,0.08,0.328125,61977020,25,2
0,2,0.0,0.0,66379271,2,0
2,0,1.0,1.0,80055815,14,14
2,13,0.7291666666666666,0.9714285714285714,63159551,48,35
0,1,0.0,0.0,68109223,1,0
0,2,0.0,0.0,66886351,2,0
0,43,0.17307692307692307,0.4628099173553719,67120284,52,9
1,28,0.3488372093023256,0.819672131147541,82126675,43,15
0,3,0.0,0.0,67715200,3,0
0,3,0.0,0.0,67715256,3,0
0,3,0.0,0.0,67715333,3,0
0,1,0.0,0.0,67715382,1,0
0,5,0.0,0.0,67715711,5,0
0,1,0.0,0.0,70198212,1,0
2,5,0.5454545454545454,0.9655172413793104,72417170,11,6
2,5,0.8571428571428571,0.9473684210526315,77319095,35,30
0,53,0.05357142857142857,0.24431818181818182,63529536,56,3
1,31,0.3111111111111111,0.8469387755102041,63999341,45,14
0,7,0.125,0.3055555555555556,70674380,8,1
0,7,0.125,0.17391304347826086,70680806,8,1
0,4,0.0,0.0,70693252,4,0
0,4,0.0,0.0,70705425,4,0
2,0,1.0,1.0,82033538,2,2
0,46,0.041666666666666664,0.27722772277227725,80124328,48,2
2,21,0.5116279069767442,0.5172413793103449,68475085,43,22
0,59,0.15714285714285714,0.35909090909090907,70174062,70,11
1,8,0.2727272727272727,0.8235294117647058,74086614,11,3
2,2,0.5,0.75,65280145,4,2
2,0,1.0,1.0,67652970,1,1
2,24,0.5,0.9642857142857143,70508893,48,24
2,5,0.8529411764705882,0.9166666666666666,80181789,34,29
0,145,0.026845637583892617,0.14219474497681608,66024840,149,4
0,12,0.0,0.0,66025540,12,0
2,8,0.5,0.875,453922,16,8
1,18,0.18181818181818182,0.5324675324675324,80128199,22,4
1,9,0.25,0.5416666666666666,64467732,12,3
0,117,0.03305785123966942,0.15246636771300448,62839084,121,4
0,30,0.14285714285714285,0.15217391304347827,82038364,35,5
0,21,0.08695652173913043,0.3333333333333333,74439883,23,2
0,9,0.3076923076923077,0.325,69964692,13,4
2,1,0.5,0.875,80128094,2,1
0,21,0.16,0.2647058823529412,80140091,25,4
1,29,0.4528301886792453,0.9464285714285714,69622476,53,24
0,1,0.0,0.0,82020023,1,0
2,1,0.8,0.8,72814651,5,4
1,33,0.47619047619047616,0.8831168831168831,82021838,63,30
0,30,0.0625,0.12244897959183673,66289230,32,2
2,6,0.6470588235294118,0.875,82041326,17,11
1,70,0.38596491228070173,0.9502762430939227,69155884,114,44
0,19,0.13636363636363635,0.35555555555555557,80123380,22,3
2,0,1.0,1.0,73345230,2,2
1,4,0.3333333333333333,0.56,69991544,6,2
0,41,0.24074074074074073,0.3783783783783784,68401606,54,13
0,8,0.0,0.0,70702401,8,0
0,7,0.0,0.0,70705012,7,0
2,9,0.7692307692307693,0.9230769230769231,73411695,39,30
0,18,0.21739130434782608,0.12727272727272726,70934255,23,5
0,92,0.0707070707070707,0.15028901734104047,70746284,99,7
0,86,0.09473684210526316,0.4429530201342282,60382504,95,9
0,4,0.0,0.0,72717715,4,0
2,2,0.75,0.9090909090909091,82070172,8,6
2,28,0.5333333333333333,0.9583333333333334,69162604,60,32
2,6,0.625,0.8571428571428571,69170563,16,10
1,32,0.23809523809523808,0.5301204819277109,66304931,42,10
1,22,0.2413793103448276,0.627906976744186,66304973,29,7
0,84,0.22935779816513763,0.3422459893048128,66857616,109,25
0,5,0.0,0.0,66192140,5,0
2,0,1.0,1.0,82052085,13,13
0,35,0.05405405405405406,0.045454545454545456,70677376,37,2
2,1,0.875,0.5,70072450,8,7
1,50,0.4791666666666667,0.8961038961038961,80180127,96,46
0,25,0.13793103448275862,0.3875,82096333,29,4
1,24,0.35135135135135137,0.8375,80135258,37,13
1,11,0.35294117647058826,0.6071428571428571,80135260,17,6
0,74,0.05128205128205128,0.3237822349570201,62838916,78,4
1,25,0.34210526315789475,0.7474747474747475,69964524,38,13
0,15,0.0,0.0,70482104,15,0
1,8,0.1111111111111111,0.5121951219512195,80172550,9,1
1,10,0.16666666666666666,0.5925925925925926,80172666,12,2
1,34,0.1282051282051282,0.6031746031746031,69250510,39,5
0,20,0.09090909090909091,0.32894736842105265,65716595,22,2
1,37,0.24489795918367346,0.7281553398058253,68191235,49,12
1,27,0.41304347826086957,0.9583333333333334,67454562,46,19
2,3,0.6666666666666666,0.9444444444444444,66060841,9,6
1,13,0.4583333333333333,0.9166666666666666,64473304,24,11
0,11,0.0,0.0,69256334,11,0
0,60,0.03225806451612903,0.14349775784753363,70467285,62,2
0,120,0.12408759124087591,0.36033519553072624,70646702,137,17
0,2,0.0,0.0,70194593,2,0
0,2,0.0,0.0,80180266,2,0
0,47,0.0,0.0,70467404,47,0
1,75,0.13793103448275862,0.5675675675675675,70482125,87,12
1,33,0.15384615384615385,0.6637931034482759,64213954,39,6
1,19,0.2692307692307692,0.6666666666666666,67966535,26,7
0,21,0.045454545454545456,0.23404255319148937,70923615,22,1
1,22,0.35294117647058826,0.875,74924045,34,12
0,27,0.1,0.25263157894736843,64002456,30,3
1,8,0.3333333333333333,0.8620689655172413,63188272,12,4
0,4,0.3333333333333333,0.1111111111111111,75033000,6,2
1,8,0.2727272727272727,0.8529411764705882,80150702,11,3
0,10,0.09090909090909091,0.2903225806451613,70759920,11,1
0,12,0.0,0.0,80150703,12,0
0,15,0.0625,0.29245283018867924,80135298,16,1
1,8,0.2727272727272727,0.7714285714285715,80135304,11,3
0,62,0.3111111111111111,0.3333333333333333,80051832,90,28
1,25,0.2647058823529412,0.8666666666666667,66476123,34,9
0,17,0.05555555555555555,0.0641025641025641,67887393,18,1
1,11,0.3888888888888889,0.8666666666666667,80176672,18,7
0,47,0.24193548387096775,0.2903225806451613,72445625,62,15
0,3,0.25,0.4,68603885,4,1
2,1,0.5,0.5,70961912,2,1
0,93,0.11428571428571428,0.487012987012987,67839100,105,12
0,27,0.06896551724137931,0.4146341463414634,66877160,29,2
0,37,0.075,0.16535433070866143,70629902,40,3
0,7,0.0,0.0,80163214,7,0
1,37,0.13953488372093023,0.5285714285714286,64027845,43,6
0,65,0.12162162162162163,0.3855421686746988,80153595,74,9
1,11,0.26666666666666666,0.631578947368421,75338802,15,4
1,12,0.14285714285714285,0.5340909090909091,67975292,14,2
1,20,0.4444444444444444,0.625,74361546,36,16
1,9,0.4375,0.7692307692307693,70701085,16,7
2,7,0.5,0.9523809523809523,70821415,14,7
1,21,0.16,0.6024096385542169,64047711,25,4
0,40,0.047619047619047616,0.23157894736842105,67045650,42,2
0,10,0.0,0.0,80170979,10,0
0,24,0.0,0.0,70630042,24,0
0,17,0.05555555555555555,0.140625,70630126,18,1
1,22,0.21428571428571427,0.8297872340425532,80089296,28,6
1,5,0.2857142857142857,0.6,69042680,7,2
1,12,0.3684210526315789,0.7560975609756098,63870905,19,7
0,4,0.0,0.0,82006308,4,0
0,27,0.03571428571428571,0.14414414414414414,70482230,28,1
1,12,0.2,0.7222222222222222,70482286,15,3
0,9,0.0,0.0,80162792,9,0
1,5,0.16666666666666666,0.625,80172630,6,1
0,2,0.0,0.0,82006718,2,0
0,4,0.0,0.0,82118271,4,0
0,77,0.04938271604938271,0.15161290322580645,70621733,81,4
1,9,0.3076923076923077,0.9259259259259259,70565446,13,4
0,52,0.2,0.40789473684210525,69050205,65,13
0,8,0.1111111111111111,0.2727272727272727,80153541,9,1
0,8,0.0,0.0,82006655,8,0
1,72,0.35135135135135137,0.9248826291079812,69910183,111,39
1,79,0.16842105263157894,0.6058394160583942,70687596,95,16
0,29,0.03333333333333333,0.25,80138874,30,1
0,1,0.0,0.0,82006587,1,0
0,10,0.0,0.0,82006632,10,0
1,11,0.21428571428571427,0.6333333333333333,67277945,14,3
2,3,0.5,0.75,80135222,6,3
1,57,0.2875,0.7300613496932515,79816940,80,23
2,6,0.625,0.9666666666666667,64469293,16,10
1,4,0.2,0.7777777777777778,82102605,5,1
0,19,0.0,0.0,80155863,19,0
1,19,0.20833333333333334,0.8444444444444444,67900322,24,5
0,50,0.2537313432835821,0.4583333333333333,80176705,67,17
0,8,0.2,0.23529411764705882,70116865,10,2
0,58,0.0,0.0,80150890,58,0
0,6,0.0,0.0,78762740,6,0
0,5,0.0,0.0,65111095,5,0
1,25,0.16666666666666666,0.7063492063492064,69911562,30,5
0,15,0.0625,0.3373493975903614,74924192,16,1
0,49,0.125,0.46113989637305697,67900203,56,7
0,21,0.0,0.0,64359582,21,0
1,5,0.2857142857142857,0.75,71081031,7,2
0,92,0.010752688172043012,0.11650485436893204,80150900,93,1
0,59,0.04838709677419355,0.27717391304347827,62841485,62,3
1,6,0.25,0.7407407407407407,80163386,8,2
0,96,0.07692307692307693,0.34300791556728233,67051551,104,8
1,15,0.4444444444444444,0.9534883720930233,65402750,27,12
0,5,0.0,0.0,70343826,5,0
0,5,0.0,0.0,82006590,5,0
0,3,0.0,0.0,72801666,3,0
0,15,0.0,0.0,72808694,15,0
2,17,0.5641025641025641,0.975,80139938,39,22
0,14,0.17647058823529413,0.3380281690140845,70174202,17,3
1,34,0.34615384615384615,0.8526315789473684,68330283,52,18
0,3,0.25,0.2857142857142857,68942993,4,1
1,7,0.2222222222222222,0.5185185185185185,73266501,9,2
0,105,0.09482758620689655,0.10726643598615918,80133444,116,11
0,22,0.12,0.23376623376623376,68500110,25,3
2,5,0.7222222222222222,0.8,69172530,18,13
2,6,0.5714285714285714,0.5555555555555556,82165045,14,8
0,24,0.04,0.0,82018248,25,1
1,37,0.38333333333333336,0.9464285714285714,66404331,60,23
1,13,0.23529411764705882,0.6296296296296297,69421926,17,4
2,0,1.0,1.0,67809371,1,1
0,99,0.15384615384615385,0.4624505928853755,69007043,117,18
0,65,0.12162162162162163,0.1893939393939394,64163512,74,9
0,16,0.1111111111111111,0.36585365853658536,80126837,18,2
0,49,0.19672131147540983,0.3314917127071823,69057884,61,12
1,45,0.3181818181818182,0.7714285714285715,69177171,66,21
1,25,0.2647058823529412,0.6153846153846154,68558406,34,9
2,3,0.5,0.8333333333333334,69561023,6,3
0,68,0.2,0.37433155080213903,67557315,85,17
2,2,0.6666666666666666,0.6666666666666666,69734280,6,4
0,5,0.16666666666666666,0.20833333333333334,70516656,6,1
1,27,0.4,0.8625,73376366,45,18
2,0,1.0,1.0,69146840,4,4
0,1,0.0,0.0,63510174,1,0
0,9,0.3076923076923077,0.30434782608695654,82013614,13,4
2,29,0.6233766233766234,0.9903846153846154,69017991,77,48
1,109,0.30128205128205127,0.678030303030303,73709195,156,47
0,6,0.25,0.36363636363636365,65286564,8,2
0,2,0.0,0.0,69735274,2,0
0,11,0.08333333333333333,0.0,65286935,12,1
0,14,0.17647058823529413,0.2,67053595,17,3
0,59,0.10606060606060606,0.0703125,62901426,66,7
2,1,0.8,0.8,75048183,5,4
1,11,0.42105263157894735,0.9142857142857143,72803836,19,8
2,1,0.8,0.6666666666666666,80139967,5,4
1,18,0.3793103448275862,0.7333333333333333,70612325,29,11
0,51,0.08928571428571429,0.17679558011049723,67809196,56,5
1,15,0.25,0.6222222222222222,68745635,20,5
1,57,0.3132530120481928,0.723404255319149,69135031,83,26
2,0,1.0,1.0,65931173,6,6
1,6,0.25,0.625,67822370,8,2
0,19,0.05,0.19230769230769232,67822622,20,1
1,7,0.46153846153846156,0.8888888888888888,82002222,13,6
1,33,0.37735849056603776,0.8421052631578947,80124706,53,20
1,19,0.32142857142857145,0.7222222222222222,66475332,28,9
1,7,0.4166666666666667,0.6923076923076923,67526396,12,5
1,6,0.14285714285714285,0.5625,80162854,7,1
1,16,0.4482758620689655,0.9411764705882353,69042715,29,13
2,2,0.5,0.8333333333333334,66194310,4,2
1,6,0.25,0.8235294117647058,70237902,8,2
0,98,0.02,0.031088082901554404,70568526,100,2
1,28,0.3,0.609375,70395822,40,12
1,29,0.30952380952380953,0.5853658536585366,70395815,42,13
2,0,1.0,1.0,69754006,1,1
0,12,0.2,0.4838709677419355,515536,15,3
1,6,0.45454545454545453,0.9047619047619048,515550,11,5
2,1,0.6666666666666666,0.5,72866724,3,2
0,4,0.2,0.42857142857142855,70405902,5,1
0,23,0.08,0.18181818181818182,70693756,25,2
1,13,0.38095238095238093,0.7906976744186046,80150333,21,8
0,62,0.015873015873015872,0.06097560975609756,80124423,63,1
2,0,1.0,1.0,80134833,1,1
1,49,0.46153846153846156,0.927007299270073,67532962,91,42
0,45,0.0625,0.06770833333333333,69417243,48,3
2,2,0.6,0.75,67276804,5,3
2,7,0.5882352941176471,0.9333333333333333,69226500,17,10
2,1,0.5,0.6666666666666666,70213801,2,1
2,2,0.75,0.75,69153035,8,6
1,54,0.44329896907216493,0.92,69230840,97,43
0,9,0.4375,0.4444444444444444,80128910,16,7
2,15,0.5945945945945946,0.75,82171877,37,22
2,17,0.5405405405405406,0.9666666666666667,70222523,37,20
2,1,0.5,0.0,82009366,2,1
1,6,0.3333333333333333,0.625,80145883,9,3
1,23,0.30303030303030304,0.6140350877192983,82010275,33,10
0,22,0.043478260869565216,0.3333333333333333,63337106,23,1
0,31,0.11428571428571428,0.4594594594594595,521885,35,4
0,7,0.0,0.0,60899853,7,0
0,60,0.15492957746478872,0.35294117647058826,80098865,71,11
2,4,0.5,0.8888888888888888,67930856,8,4
1,17,0.22727272727272727,0.5294117647058824,82018901,22,5
2,8,0.5789473684210527,0.8181818181818182,70933702,19,11
2,10,0.6774193548387096,0.8125,66280872,31,21
0,12,0.14285714285714285,0.2786885245901639,67862452,14,2
1,2,0.3333333333333333,0.6666666666666666,70687092,3,1
0,75,0.013157894736842105,0.13405797101449277,69946940,76,1
1,5,0.16666666666666666,0.6428571428571429,68255222,6,1
0,23,0.14814814814814814,0.4189189189189189,80128814,27,4
1,29,0.3695652173913043,0.7941176470588235,70934171,46,17
1,26,0.16129032258064516,0.52,80155851,31,5
0,5,0.375,0.4,66861662,8,3
1,57,0.2191780821917808,0.592964824120603,80098606,73,16
1,42,0.3,0.574468085106383,62496756,60,18
2,2,0.6,0.5,82070156,5,3
2,26,0.5272727272727272,0.9818181818181818,68401935,55,29
1,10,0.2857142857142857,0.6818181818181818,66305106,14,4
1,8,0.3333333333333333,0.782608695652174,82018780,12,4
2,4,0.6,0.9375,69184066,10,6
0,21,0.16,0.2653061224489796,66304742,25,4
1,4,0.3333333333333333,0.9444444444444444,70661311,6,2
0,84,0.0967741935483871,0.1471698113207547,82000083,93,9
1,6,0.45454545454545453,0.875,70520450,11,5
0,6,0.0,0.0,82102599,6,0
0,19,0.09523809523809523,0.4268292682926829,82102886,21,2
0,44,0.10204081632653061,0.32335329341317365,80128145,49,5
0,54,0.16923076923076924,0.4166666666666667,82103872,65,11
0,35,0.10256410256410256,0.26153846153846155,82150127,39,4
0,14,0.0,0.0,64064000,14,0
0,21,0.16,0.463768115942029,67780062,25,4
1,22,0.3125,0.704225352112676,70843871,32,10
1,10,0.4117647058823529,0.8333333333333334,67588234,17,7
1,4,0.3333333333333333,0.5833333333333334,67656953,6,2
0,20,0.09090909090909091,0.20714285714285716,67895051,22,2
2,21,0.6911764705882353,0.6388888888888888,73447605,68,47
1,42,0.34375,0.717391304347826,80055843,64,22
2,5,0.782608695652174,0.875,70255885,23,18
0,104,0.16129032258064516,0.31275720164609055,80176720,124,20
1,10,0.4117647058823529,0.8717948717948718,3031,17,7
0,48,0.07692307692307693,0.045112781954887216,79650914,52,4
1,39,0.3275862068965517,0.6923076923076923,80124666,58,19
2,8,0.5294117647058824,0.967741935483871,70182973,17,9
1,23,0.28125,0.5294117647058824,73623186,32,9
1,19,0.36666666666666664,0.7058823529411765,73623445,30,11
0,31,0.2619047619047619,0.4942528735632184,62497792,42,11
1,43,0.25862068965517243,0.5416666666666666,82126658,58,15
1,13,0.2777777777777778,0.6875,75327266,18,5
2,1,0.6666666666666666,0.6666666666666666,80162647,3,2
0,51,0.1774193548387097,0.3617021276595745,60812346,62,11
1,4,0.3333333333333333,0.5,80134736,6,2
0,33,0.21428571428571427,0.4368932038834951,69949124,42,9
0,24,0.0,0.0,62841996,24,0
0,23,0.041666666666666664,0.09565217391304348,80028872,24,1
0,19,0.05,0.20270270270270271,80029026,20,1
0,83,0.08791208791208792,0.07246376811594203,82126667,91,8
0,22,0.0,0.0,69895273,22,0
0,35,0.10256410256410256,0.4032258064516129,82150115,39,4
0,14,0.06666666666666667,0.15384615384615385,82150116,15,1
2,0,1.0,1.0,66848551,3,3
0,85,0.11458333333333333,0.38741721854304634,70908796,96,11
1,7,0.125,0.5945945945945946,82164884,8,1
1,5,0.2857142857142857,0.7692307692307693,69638324,7,2
0,15,0.0,0.0,70674324,15,0
0,29,0.0,0.0,80126812,29,0
2,4,0.5555555555555556,0.875,82019432,9,5
0,10,0.0,0.0,82022533,10,0
1,36,0.4098360655737705,0.8666666666666667,69172901,61,25
1,39,0.23529411764705882,0.6226415094339622,63992796,51,12
0,16,0.058823529411764705,0.18518518518518517,63993314,17,1
1,46,0.25806451612903225,0.6967213114754098,69182141,62,16
0,46,0.08,0.16161616161616163,73460114,50,4
0,23,0.17857142857142858,0.38636363636363635,73650444,28,5
1,44,0.2413793103448276,0.6530612244897959,77676732,58,14
1,5,0.4444444444444444,0.8235294117647058,61356372,9,4
0,9,0.1,0.19444444444444445,66503136,10,1
0,50,0.24242424242424243,0.41216216216216217,82126784,66,16
0,5,0.16666666666666666,0.2727272727272727,60812353,6,1
2,2,0.5,0.8333333333333334,80154142,4,2
1,43,0.18867924528301888,0.59375,70629930,53,10
2,2,0.6666666666666666,0.8,66365306,6,4
0,10,0.16666666666666666,0.43243243243243246,70693623,12,2
2,7,0.65,0.9,62402284,20,13
2,2,0.5,0.8,69003340,4,2
0,55,0.16666666666666666,0.22857142857142856,70625842,66,11
1,14,0.4166666666666667,0.8846153846153846,69729471,24,10
1,53,0.24285714285714285,0.6048387096774194,72906666,70,17
2,25,0.691358024691358,0.9777777777777777,65270863,81,56
1,51,0.35443037974683544,0.8468468468468469,80133416,79,28
1,3,0.4,0.8461538461538461,70575176,5,2
2,68,0.5802469135802469,0.9375,74002124,162,94
1,2,0.3333333333333333,0.5714285714285714,80125467,3,1
2,0,1.0,1.0,82102228,2,2
2,34,0.5466666666666666,0.9152542372881356,70611933,75,41
2,2,0.6,0.6666666666666666,68558280,5,3
0,61,0.10294117647058823,0.09016393442622951,69184661,68,7
1,2,0.3333333333333333,0.75,69483316,3,1
0,8,0.3333333333333333,0.25,69484212,12,4
0,27,0.06896551724137931,0.07894736842105263,80149841,29,2
1,3,0.4,0.8571428571428571,67435032,5,2
0,30,0.0,0.0,82049135,30,0
2,0,1.0,1.0,66761751,3,3
0,51,0.1206896551724138,0.1223021582733813,68383651,58,7
1,17,0.43333333333333335,0.8913043478260869,69634362,30,13
0,57,0.25,0.4766355140186916,63051086,76,19
1,2,0.3333333333333333,0.8181818181818182,68498080,3,1
0,2,0.0,0.0,69006763,2,0
0,4,0.0,0.0,69007162,4,0
0,3,0.0,0.0,69007183,3,0
0,38,0.19148936170212766,0.2236842105263158,79788534,47,9
0,33,0.029411764705882353,0.014285714285714285,73113593,34,1
1,8,0.3333333333333333,0.6428571428571429,62403082,12,4
0,6,0.0,0.0,79843953,6,0
1,15,0.4230769230769231,0.6666666666666666,79849084,26,11
2,3,0.5,0.5555555555555556,69039033,6,3
0,210,0.19540229885057472,0.3393829401088929,80118950,261,51
1,17,0.32,0.5,68552351,25,8
0,61,0.18666666666666668,0.3493975903614458,68741176,75,14
2,5,0.8333333333333334,0.782608695652174,80080091,30,25
1,27,0.325,0.7019230769230769,82002243,40,13
1,4,0.3333333333333333,0.75,70759241,6,2
0,13,0.23529411764705882,0.2608695652173913,69490085,17,4
1,9,0.35714285714285715,0.8620689655172413,70183435,14,5
2,3,0.625,0.75,80117714,8,5
0,24,0.22580645161290322,0.38461538461538464,82014531,31,7
1,30,0.3023255813953488,0.6666666666666666,67922750,43,13
2,3,0.6666666666666666,0.8888888888888888,70183771,9,6
0,84,0.17647058823529413,0.34269662921348315,68534060,102,18
1,20,0.3939393939393939,0.8356164383561644,80141349,33,13
2,1,0.9473684210526315,0.5,70720202,19,18
2,3,0.5,0.9,66844582,6,3
2,0,1.0,1.0,82039371,7,7
1,3,0.4,0.5,69033734,5,2
0,55,0.19117647058823528,0.32460732984293195,80069885,68,13
1,77,0.4076923076923077,0.9017341040462428,67553605,130,53
2,4,0.6363636363636364,0.9523809523809523,70051695,11,7
0,9,0.1,0.375,80145729,10,1
0,29,0.03333333333333333,0.15384615384615385,82164464,30,1
0,27,0.0,0.0,82164465,27,0
1,9,0.4375,0.8695652173913043,70051716,16,7
0,20,0.047619047619047616,0.08928571428571429,70677271,21,1
0,16,0.058823529411764705,0.2054794520547945,70692020,17,1
2,2,0.5,0.9230769230769231,72803682,4,2
2,0,1.0,1.0,82038230,1,1
1,27,0.25,0.5967741935483871,70573496,36,9
2,1,0.5,0.5,69417453,2,1
1,13,0.3157894736842105,0.7428571428571429,66413851,19,6
2,1,0.9166666666666666,0.5,74048394,12,11
1,6,0.45454545454545453,0.8857142857142857,67035374,11,5
0,20,0.2857142857142857,0.4927536231884058,70759934,28,8
1,30,0.34782608695652173,0.7446808510638298,82038766,46,16
1,31,0.225,0.5280898876404494,70854154,40,9
0,26,0.1875,0.2857142857142857,70854252,32,6
1,26,0.4583333333333333,0.890625,68603920,48,22
0,11,0.3125,0.45,80168338,16,5
1,14,0.391304347826087,0.7307692307692307,80168339,23,9
2,3,0.5714285714285714,0.6,68498633,7,4
0,9,0.35714285714285715,0.3333333333333333,70717962,14,5
0,7,0.125,0.4,70224084,8,1
1,35,0.375,0.6041666666666666,80176072,56,21
0,16,0.058823529411764705,0.4057971014492754,69946982,17,1
0,11,0.15384615384615385,0.06818181818181818,69946723,13,2
0,17,0.19047619047619047,0.10526315789473684,68400696,21,4
1,19,0.32142857142857145,0.7123287671232876,67656932,28,9
0,54,0.05263157894736842,0.18181818181818182,67867016,57,3
0,32,0.030303030303030304,0.1111111111111111,67867023,33,1
0,3,0.25,0.0,80132362,4,1
1,66,0.4358974358974359,0.8654708520179372,65634016,117,51
1,16,0.2727272727272727,0.5333333333333333,65282042,22,6
1,3,0.25,0.5454545454545454,66379201,4,1
1,14,0.36363636363636365,0.6451612903225806,65289105,22,8
0,18,0.14285714285714285,0.1956521739130435,65286886,21,3
2,6,0.5,0.8461538461538461,70591654,12,6
2,13,0.7346938775510204,0.9666666666666667,66010224,49,36
2,24,0.5636363636363636,0.88,80118932,55,31
2,3,0.5714285714285714,0.75,62257580,7,4
2,0,1.0,1.0,66083213,1,1
0,2,0.0,0.0,70743596,2,0
1,19,0.4411764705882353,0.918918918918919,79280922,34,15
2,4,0.5555555555555556,0.8,82056735,9,5
0,61,0.06153846153846154,0.016,79650963,65,4
2,3,0.625,0.9090909090909091,80135026,8,5
2,34,0.5,0.8,69639815,68,34
1,22,0.21428571428571427,0.6363636363636364,68289781,28,6
1,12,0.2,0.625,65013333,15,3
1,7,0.3,0.7045454545454546,68241474,10,3
0,10,0.23076923076923078,0.20833333333333334,68241530,13,3
1,7,0.36363636363636365,0.85,80137360,11,4
0,2,0.0,0.0,80137364,2,0
0,5,0.0,0.0,80137365,5,0
0,5,0.16666666666666666,0.24324324324324326,68655916,6,1
0,24,0.04,0.07142857142857142,70078295,25,1
0,22,0.043478260869565216,0.05660377358490566,70078344,23,1
1,7,0.3,0.6956521739130435,80067582,10,3
2,1,0.5,0.75,68541746,2,1
0,13,0.1875,0.24324324324324326,70072282,16,3
2,0,1.0,1.0,82090152,5,5
2,4,0.5555555555555556,0.7872340425531915,73635023,9,5
0,12,0.2,0.2857142857142857,74708725,15,3
2,3,0.7,0.9375,80124947,10,7
1,68,0.40869565217391307,0.8703703703703703,54291202,115,47
1,8,0.3333333333333333,0.8709677419354839,74439925,12,4
0,22,0.21428571428571427,0.488,237755,28,6
1,16,0.30434782608695654,0.6296296296296297,80070242,23,7
2,0,1.0,1.0,80159258,6,6
2,5,0.8387096774193549,0.9615384615384616,80089506,31,26
0,2,0.0,0.0,70179270,2,0
1,29,0.4423076923076923,0.8846153846153846,63414400,52,23
2,3,0.75,0.9,80176635,12,9
0,30,0.0625,0.17777777777777778,70676095,32,2
1,4,0.3333333333333333,0.5238095238095238,69997886,6,2
0,8,0.2,0.4090909090909091,70175805,10,2
0,68,0.0684931506849315,0.32616487455197135,62839903,73,5
1,4,0.42857142857142855,0.8333333333333334,80176836,7,3
0,4,0.3333333333333333,0.16666666666666666,80176838,6,2
0,25,0.07407407407407407,0.22429906542056074,80126803,27,2
2,8,0.7333333333333333,0.9615384615384616,80176863,30,22
1,71,0.3238095238095238,0.5684931506849316,71478316,105,34
0,32,0.13513513513513514,0.22448979591836735,82018983,37,5
2,3,0.5714285714285714,0.75,82018988,7,4
0,38,0.15555555555555556,0.3493975903614458,82018984,45,7
1,6,0.25,0.5714285714285714,82018986,8,2
1,32,0.23809523809523808,0.625,80098851,42,10
0,97,0.13392857142857142,0.24358974358974358,82001865,112,15
2,0,1.0,1.0,80176497,3,3
2,1,0.8,0.6666666666666666,80118904,5,4
1,8,0.38461538461538464,0.5714285714285714,80137602,13,5
2,1,0.9333333333333333,0.6666666666666666,80178974,15,14
2,1,0.9565217391304348,0.5,80118216,23,22
1,56,0.16417910447761194,0.5,82019107,67,11
0,4,0.0,0.0,73650682,4,0
1,6,0.3333333333333333,0.85,73650703,9,3
2,0,1.0,1.0,80117887,1,1
2,3,0.625,0.875,79816485,8,5
2,0,1.0,1.0,68746825,1,1
0,4,0.2,0.06666666666666667,80145820,5,1
0,23,0.14814814814814814,0.2692307692307692,69622063,27,4
2,0,1.0,1.0,75636176,4,4
0,3,0.0,0.0,72365832,3,0
0,1,0.0,0.0,72366042,1,0
1,8,0.42857142857142855,0.6190476190476191,82009597,14,6
2,0,1.0,1.0,66237892,1,1
1,51,0.23880597014925373,0.6578947368421053,70621810,67,16
2,0,1.0,1.0,80117726,13,13
0,23,0.3611111111111111,0.3888888888888889,80172973,36,13
2,0,1.0,1.0,66235491,2,2
1,7,0.3,0.7735849056603774,68497800,10,3
2,0,1.0,1.0,82127872,21,21
2,0,1.0,1.0,82138721,1,1
2,0,1.0,1.0,82096290,6,6
2,16,0.5555555555555556,0.8055555555555556,73870132,36,20
2,3,0.7857142857142857,0.75,68286820,14,11
0,1,0.0,0.0,70037506,1,0
0,17,0.19047619047619047,0.375,70842982,21,4
0,32,0.15789473684210525,0.35294117647058826,80124201,38,6
2,0,1.0,1.0,80159718,4,4
2,6,0.9325842696629213,0.6,80126597,89,83
1,28,0.4909090909090909,0.8,80126993,55,27
2,0,1.0,1.0,80136542,6,6
2,2,0.6,0.9090909090909091,70343322,5,3
2,3,0.7,0.9,72757734,10,7
2,1,0.75,0.8333333333333334,80165169,4,3
2,0,1.0,1.0,82060529,2,2
2,1,0.9736842105263158,0.5,80047065,38,37
2,20,0.5918367346938775,0.9672131147540983,68289235,49,29
2,0,1.0,1.0,68747805,1,1
2,0,1.0,1.0,82145125,8,8
2,0,1.0,1.0,82039375,4,4
2,2,0.5,0.5714285714285714,69729212,4,2
2,0,1.0,1.0,70593922,4,4
2,2,0.9459459459459459,0.8,82020624,37,35
2,24,0.6,0.9574468085106383,82018823,60,36
2,2,0.7777777777777778,0.8333333333333334,75636141,9,7
2,6,0.5384615384615384,0.9411764705882353,54607413,13,7
2,1,0.6666666666666666,0.5,68586931,3,2
2,1,0.75,0.5,82039351,4,3
2,0,1.0,1.0,80159233,8,8
2,0,1.0,1.0,80092320,1,1
0,47,0.1896551724137931,0.3956043956043956,69522362,58,11
2,3,0.8235294117647058,0.875,82046283,17,14
0,32,0.1794871794871795,0.24242424242424243,80140098,39,7
0,5,0.16666666666666666,0.1111111111111111,80141486,6,1
0,3,0.4,0.3333333333333333,72366021,5,2
2,1,0.8571428571428571,0.6666666666666666,80003721,7,6
2,3,0.6666666666666666,0.8333333333333334,74512326,9,6
2,0,1.0,1.0,80159726,4,4
1,33,0.45901639344262296,0.9153846153846154,73266515,61,28
1,59,0.3723404255319149,0.675,69401220,94,35
0,42,0.045454545454545456,0.17543859649122806,70417151,44,2
0,26,0.07142857142857142,0.23636363636363636,70746074,28,2
0,27,0.03571428571428571,0.14736842105263157,70746116,28,1
0,11,0.08333333333333333,0.375,70746536,12,1
1,42,0.17647058823529413,0.6442953020134228,70746606,51,9
2,9,0.5263157894736842,0.96875,71277570,19,10
0,32,0.058823529411764705,0.14423076923076922,80124247,34,2
1,19,0.3448275862068966,0.7037037037037037,69180713,29,10
2,4,0.7777777777777778,0.4,82153541,18,14
0,19,0.20833333333333334,0.46938775510204084,82103830,24,5
1,5,0.375,0.8461538461538461,80156746,8,3
0,27,0.2894736842105263,0.4791666666666667,68401900,38,11
2,0,1.0,1.0,74965653,1,1
1,49,0.27941176470588236,0.5943396226415094,69498436,68,19
1,35,0.2553191489361702,0.5795454545454546,70756700,47,12
1,35,0.2553191489361702,0.660377358490566,69091512,47,12
1,11,0.3888888888888889,0.75,70405923,18,7
2,10,0.5454545454545454,0.2,69548801,22,12
0,15,0.16666666666666666,0.37777777777777777,73783220,18,3
0,60,0.16666666666666666,0.3220338983050847,69621230,72,12
1,23,0.17857142857142858,0.509090909090909,70633423,28,5
0,20,0.16666666666666666,0.36363636363636365,80176718,24,4
2,3,0.8333333333333334,0.8333333333333334,82041307,18,15
0,1,0.0,0.0,80133895,1,0
0,1,0.0,0.0,80133923,1,0
0,1,0.0,0.0,80150354,1,0
2,3,0.5,0.8333333333333334,81866254,6,3
2,43,0.6475409836065574,0.9874213836477987,80175673,122,79
2,1,0.5,0.9230769230769231,82012791,2,1
1,15,0.16666666666666666,0.6181818181818182,67758922,18,3
0,17,0.10526315789473684,0.18,80145623,19,2
2,9,0.5,0.9333333333333333,73650472,18,9
2,10,0.6153846153846154,0.9310344827586207,69042925,26,16
1,19,0.45714285714285713,0.8085106382978723,70633612,35,16
0,6,0.14285714285714285,0.0,71230110,7,1
1,12,0.3684210526315789,0.8157894736842105,70467516,19,7
0,6,0.14285714285714285,0.18181818181818182,70621285,7,1
1,3,0.25,0.5714285714285714,66783850,4,1
2,26,0.6,0.8769230769230769,70200165,65,39
0,6,0.14285714285714285,0.25,75338256,7,1
0,3,0.0,0.0,80172645,3,0
1,10,0.16666666666666666,0.7142857142857143,65882495,12,2
0,2,0.0,0.0,70818293,2,0
0,10,0.09090909090909091,0.41818181818181815,66786811,11,1
0,4,0.0,0.0,66787021,4,0
1,5,0.4444444444444444,0.8181818181818182,70634774,9,4
0,7,0.125,0.24,65209081,8,1
0,1,0.0,0.0,82109301,1,0
0,14,0.125,0.49056603773584906,80163192,16,2
2,0,1.0,1.0,66287711,4,4
0,13,0.1875,0.46153846153846156,70467390,16,3
0,11,0.21428571428571427,0.37037037037037035,70242676,14,3
2,6,0.6470588235294118,0.75,70121961,17,11
1,28,0.42857142857142855,0.8780487804878049,57210230,49,21
2,19,0.7076923076923077,0.9473684210526315,80019002,65,46
0,49,0.10909090909090909,0.42105263157894735,69204793,55,6
1,41,0.22641509433962265,0.5952380952380952,61712994,53,12
1,17,0.48484848484848486,0.9285714285714286,67672864,33,16
1,22,0.2903225806451613,0.6233766233766234,80145886,31,9
1,89,0.288,0.5681818181818182,66857476,125,36
2,5,0.8611111111111112,0.875,60129160,36,31
2,0,1.0,1.0,82090158,13,13
2,1,0.6666666666666666,0.9090909090909091,71434790,3,2
2,7,0.851063829787234,0.9615384615384616,80135036,47,40
0,45,0.16666666666666666,0.2896551724137931,74921791,54,9
0,28,0.06666666666666667,0.10526315789473684,69416613,30,2
0,28,0.034482758620689655,0.0,69416676,29,1
1,2,0.3333333333333333,0.5,70037401,3,1
1,18,0.41935483870967744,0.7272727272727273,79251914,31,13
1,4,0.3333333333333333,0.76,70239260,6,2
0,1,0.0,0.0,69831755,1,0
2,15,0.7413793103448276,0.9622641509433962,79817115,58,43
0,47,0.21666666666666667,0.4077669902912621,70660590,60,13
1,79,0.3130434782608696,0.5885416666666666,65903593,115,36
1,57,0.40625,0.912621359223301,67173386,96,39
0,12,0.2,0.2894736842105263,80145421,15,3
2,2,0.75,0.8,82062057,8,6
0,8,0.0,0.0,82019439,8,0
2,19,0.525,0.9607843137254902,63767396,40,21
0,24,0.14285714285714285,0.3274336283185841,70686014,28,4
2,37,0.5432098765432098,0.6521739130434783,70637140,81,44
1,30,0.2857142857142857,0.7972972972972973,67812682,42,12
1,6,0.25,0.5714285714285714,70649320,8,2
2,15,0.6153846153846154,0.9117647058823529,70913801,39,24
0,11,0.08333333333333333,0.1111111111111111,76685812,12,1
0,10,0.0,0.0,76685826,10,0
0,6,0.0,0.0,70684054,6,0
0,4,0.0,0.0,70694953,4,0
0,2,0.0,0.0,70697900,2,0
0,17,0.05555555555555555,0.15384615384615385,70678741,18,1
2,12,0.8723404255319149,0.9811320754716981,82038246,94,82
0,21,0.19230769230769232,0.4074074074074074,68391582,26,5
1,33,0.484375,0.925,70965993,64,31
0,24,0.04,0.0,80137543,25,1
1,29,0.32558139534883723,0.5769230769230769,70751184,43,14
2,1,0.6666666666666666,0.5,80165152,3,2
1,46,0.3235294117647059,0.8623853211009175,69421702,68,22
0,20,0.0,0.0,68130615,20,0
2,0,1.0,1.0,79994950,5,5
0,19,0.2962962962962963,0.4915254237288136,71340220,27,8
2,2,0.5,0.6,66588403,4,2
0,27,0.12903225806451613,0.045454545454545456,80141488,31,4
0,4,0.42857142857142855,0.0,70327341,7,3
1,9,0.47058823529411764,0.875,79976673,17,8
2,22,0.5111111111111111,0.9315068493150684,80161908,45,23
1,8,0.2727272727272727,0.9,69005881,11,3
0,43,0.17307692307692307,0.37142857142857144,69510392,52,9
2,10,0.782608695652174,0.9285714285714286,82145110,46,36
2,6,0.6842105263157895,0.9375,64332604,19,13
1,9,0.4,0.6842105263157895,70612346,15,6
0,103,0.1271186440677966,0.22281167108753316,80168509,118,15
0,100,0.12280701754385964,0.29069767441860467,82150071,114,14
1,46,0.23333333333333334,0.5857142857142857,68603983,60,14
1,4,0.2,0.8947368421052632,82134976,5,1
0,47,0.0,0.0,78762971,47,0
0,43,0.0,0.0,78763013,43,0
1,10,0.2857142857142857,0.7857142857142857,63870821,14,4
1,11,0.26666666666666666,0.8095238095238095,80149989,15,4
1,46,0.34285714285714286,0.6619718309859155,68401053,70,24
1,17,0.19047619047619047,0.5625,80159892,21,4
0,45,0.21052631578947367,0.35294117647058826,70755860,57,12
2,3,0.5714285714285714,0.75,68402194,7,4
1,11,0.3888888888888889,0.9692307692307692,80122934,18,7
0,70,0.19540229885057472,0.3865979381443299,69622175,87,17
2,1,0.8,0.75,80051895,5,4
2,39,0.5517241379310345,0.9642857142857143,62261381,87,48
2,3,0.5714285714285714,0.875,68632060,7,4
0,42,0.14285714285714285,0.2894736842105263,68784940,49,7
2,1,0.5,0.9090909090909091,65812355,2,1
0,24,0.07692307692307693,0.09195402298850575,69157263,26,2
2,1,0.6666666666666666,0.6666666666666666,67059874,3,2
1,21,0.4,0.8571428571428571,71689576,35,14
2,4,0.5555555555555556,0.3333333333333333,82039774,9,5
0,7,0.125,0.16666666666666666,80128459,8,1
0,90,0.03225806451612903,0.0,82011790,93,3
2,1,0.9090909090909091,0.6666666666666666,61949580,11,10
0,16,0.2,0.23333333333333334,80131306,20,4
1,9,0.25,0.5333333333333333,80131307,12,3
1,20,0.3548387096774194,0.8953488372093024,82041238,31,11
1,59,0.3218390804597701,0.7192982456140351,62508082,87,28
2,13,0.5185185185185185,0.6153846153846154,339010,27,14
0,9,0.3076923076923077,0.0,401030,13,4
0,40,0.024390243902439025,0.09420289855072464,82003715,41,1
0,54,0.0,0.0,82003749,54,0
0,61,0.046875,0.08465608465608465,70681646,64,3
0,2,0.0,0.0,70701624,2,0
1,4,0.3333333333333333,0.7333333333333333,70701995,6,2
2,20,0.5,0.8611111111111112,65288923,40,20
0,6,0.14285714285714285,0.3333333333333333,82024258,7,1
0,7,0.0,0.0,82024340,7,0
1,11,0.45,0.875,69977446,20,9
0,20,0.047619047619047616,0.17757009345794392,70692986,21,1
0,6,0.0,0.0,70700014,6,0
0,20,0.047619047619047616,0.1917808219178082,70674933,21,1
1,3,0.25,0.9565217391304348,71537606,4,1
2,17,0.5526315789473685,0.9090909090909091,80126948,38,21
1,24,0.3333333333333333,0.7619047619047619,70645995,36,12
0,1,0.0,0.0,69222006,1,0
1,24,0.25,0.8181818181818182,69033300,32,8
1,20,0.2857142857142857,0.5116279069767442,69058276,28,8
0,50,0.13793103448275862,0.450261780104712,70621460,58,8
0,82,0.15463917525773196,0.3673469387755102,80155850,97,15
0,12,0.0,0.0,67775183,12,0
1,15,0.3181818181818182,0.6585365853658537,67775211,22,7
0,54,0.03571428571428571,0.12403100775193798,70678706,56,2
2,8,0.5294117647058824,0.972972972972973,80104850,17,9
1,89,0.3945578231292517,0.7951807228915663,82010237,147,58
0,65,0.13333333333333333,0.2564102564102564,70620984,75,10
0,11,0.15384615384615385,0.3125,68391603,13,2
2,4,0.5,0.8,80004092,8,4
0,25,0.13793103448275862,0.3194444444444444,80128240,29,4
1,9,0.25,0.7333333333333333,69500200,12,3
0,13,0.23529411764705882,0.45714285714285713,72691983,17,4
1,58,0.2564102564102564,0.572289156626506,80121104,78,20
0,1,0.0,0.0,82039896,1,0
2,7,0.5625,0.9615384615384616,80028585,16,9
0,105,0.125,0.1407942238267148,66471314,120,15
0,93,0.2184873949579832,0.37373737373737376,80130002,119,26
2,0,1.0,1.0,73403554,6,6
2,13,0.8888888888888888,0.9615384615384616,74965632,117,104
2,6,0.625,0.875,67694571,16,10
2,1,0.5,0.5,69538623,2,1
0,34,0.10526315789473684,0.26865671641791045,68499844,38,4
1,10,0.375,0.8148148148148148,67261180,16,6
0,1,0.0,0.0,69726573,1,0
1,12,0.3333333333333333,0.8333333333333334,69509055,18,6
2,4,0.5,0.5,69589023,8,4
1,15,0.4827586206896552,0.9534883720930233,70283752,29,14
0,8,0.1111111111111111,0.13043478260869565,69538714,9,1
1,49,0.33783783783783783,0.7848837209302325,82018966,74,25
0,17,0.15,0.4,68500124,20,3
1,61,0.26506024096385544,0.5433526011560693,66263512,83,22
0,2,0.0,0.0,74619762,2,0
1,31,0.44642857142857145,0.8266666666666667,71288735,56,25
2,5,0.7916666666666666,0.8333333333333334,82041900,24,19
1,30,0.4444444444444444,0.7375,66499111,54,24
1,51,0.32894736842105265,0.6240601503759399,79765553,76,25
1,23,0.30303030303030304,0.90625,62842031,33,10
2,7,0.5333333333333333,0.9259259259259259,70494431,15,8
1,9,0.47058823529411764,0.9629629629629629,75996732,17,8
2,4,0.5,0.8571428571428571,68402061,8,4
2,13,0.5,0.9459459459459459,68400584,26,13
1,9,0.4,0.5925925925925926,80168335,15,6
1,111,0.27450980392156865,0.5875912408759124,82126733,153,42
1,8,0.2,0.5555555555555556,65713550,10,2
1,68,0.31313131313131315,0.8024691358024691,66493175,99,31
0,7,0.125,0.1,69064065,8,1
2,54,0.5178571428571429,0.953125,54291181,112,58
0,1,0.0,0.0,82095517,1,0
1,26,0.2972972972972973,0.8627450980392157,64399692,37,11
0,35,0.125,0.19402985074626866,69953940,40,5
1,35,0.3269230769230769,0.8082191780821918,70660016,52,17
0,90,0.1588785046728972,0.2563176895306859,73739106,107,17
0,3,0.0,0.0,70597786,3,0
0,5,0.0,0.0,82022521,5,0
1,37,0.3148148148148148,0.616822429906542,81989278,54,17
0,1,0.0,0.0,76326803,1,0
1,15,0.34782608695652173,0.8627450980392157,70748223,23,8
1,28,0.3170731707317073,0.7341772151898734,82116584,41,13
2,0,1.0,1.0,82042833,2,2
1,4,0.2,0.5333333333333333,82019451,5,1
0,34,0.10526315789473684,0.2702702702702703,82022512,38,4
2,15,0.5,0.8421052631578947,82051894,30,15
2,2,0.92,0.6666666666666666,62793570,25,23
2,20,0.5238095238095238,0.8947368421052632,69472536,42,22
1,19,0.2962962962962963,0.5714285714285714,70676851,27,8
2,2,0.8333333333333334,0.875,67751362,12,10
1,33,0.2978723404255319,0.5625,68191900,47,14
1,15,0.3181818181818182,0.717948717948718,69532694,22,7
1,97,0.20491803278688525,0.6638655462184874,64931020,122,25
0,19,0.2692307692307692,0.25,69418664,26,7
1,32,0.38461538461538464,0.6716417910447762,70348803,52,20
0,39,0.07142857142857142,0.2823529411764706,70639821,42,3
1,7,0.2222222222222222,0.5,67131750,9,2
0,16,0.058823529411764705,0.42424242424242425,62836501,17,1
1,5,0.4444444444444444,0.8888888888888888,70669550,9,4
2,1,0.6666666666666666,0.8333333333333334,70637441,3,2
2,16,0.6595744680851063,0.6666666666666666,61434632,47,31
2,0,1.0,1.0,82046296,1,1
2,13,0.75,0.9629629629629629,73829945,52,39
2,29,0.6375,0.9761904761904762,65579626,80,51
0,18,0.25,0.21428571428571427,68401431,24,6
1,14,0.3333333333333333,0.7241379310344828,70414064,21,7
1,19,0.4411764705882353,0.9339622641509434,80166917,34,15
0,13,0.13333333333333333,0.22448979591836735,73735410,15,2
1,8,0.2727272727272727,0.9024390243902439,80135183,11,3
1,70,0.3577981651376147,0.8578431372549019,70687995,109,39
0,1,0.0,0.0,70968751,1,0
1,10,0.375,0.8857142857142857,82176580,16,6
0,10,0.0,0.0,63781935,10,0
1,7,0.36363636363636365,0.7857142857142857,82010285,11,4
0,2,0.0,0.0,82010296,2,0
2,2,0.5,0.6666666666666666,82200540,4,2
1,26,0.3157894736842105,0.8243243243243243,73644186,38,12
0,2,0.0,0.0,69634222,2,0
0,12,0.0,0.0,82003710,12,0
0,9,0.0,0.0,82003753,9,0
0,4,0.0,0.0,70474593,4,0
0,49,0.10909090909090909,0.15894039735099338,70397873,55,6
1,41,0.359375,0.8571428571428571,70245651,64,23
2,0,1.0,1.0,80126498,11,11
2,1,0.5,0.6666666666666666,65637901,2,1
2,1,0.875,0.5,80066392,8,7
2,10,0.5454545454545454,0.8461538461538461,70121065,22,12
0,1,0.0,0.0,69629553,1,0
1,8,0.42857142857142855,0.875,69226353,14,6
1,32,0.30434782608695654,0.6282051282051282,68710096,46,14
1,3,0.4,0.875,262850,5,2
2,5,0.5,0.9285714285714286,67053770,10,5
1,27,0.34146341463414637,0.8076923076923077,69180251,41,14
1,4,0.2,0.8333333333333334,70747733,5,1
2,5,0.5833333333333334,0.125,80137921,12,7
1,20,0.4594594594594595,0.8431372549019608,70253876,37,17
2,0,1.0,1.0,69589240,4,4
0,23,0.23333333333333334,0.4262295081967213,66855796,30,7
1,37,0.4032258064516129,0.7142857142857143,82165051,62,25
2,12,0.5,0.8571428571428571,69528900,24,12
0,4,0.3333333333333333,0.25,75033042,6,2
1,48,0.323943661971831,0.6346153846153846,80104934,71,23
1,138,0.23333333333333334,0.594847775175644,80071166,180,42
2,17,0.6851851851851852,0.8888888888888888,70615076,54,37
2,3,0.6666666666666666,0.3333333333333333,72337335,9,6
0,33,0.21428571428571427,0.4482758620689655,70761131,42,9
1,33,0.4406779661016949,0.8837209302325582,70690550,59,26
0,55,0.2361111111111111,0.41237113402061853,82118071,72,17
2,0,1.0,1.0,80175965,18,18
1,10,0.3333333333333333,0.5,65509850,15,5
2,9,0.625,0.8,75264350,24,15
2,0,1.0,1.0,70927556,1,1
0,2,0.0,0.0,69058542,2,0
0,39,0.0,0.0,70199612,39,0
0,6,0.0,0.0,69997494,6,0
1,27,0.2894736842105263,0.6666666666666666,64002820,38,11
0,44,0.13725490196078433,0.3092105263157895,80155844,51,7
1,36,0.3076923076923077,0.7222222222222222,70753851,52,16
1,5,0.4444444444444444,0.7777777777777778,80130705,9,4
1,10,0.4117647058823529,0.9210526315789473,82116883,17,7
2,1,0.8888888888888888,0.5,69539841,9,8
0,2,0.0,0.0,79816093,2,0
1,16,0.42857142857142855,0.8627450980392157,68383616,28,12
0,68,0.13924050632911392,0.2463768115942029,69534171,79,11
0,57,0.05,0.125,82008949,60,3
0,9,0.25,0.4827586206896552,80139723,12,3
0,37,0.1590909090909091,0.17777777777777778,80137541,44,7
1,18,0.41935483870967744,0.8723404255319149,80180109,31,13
2,0,1.0,1.0,80159749,8,8
2,2,0.75,0.6666666666666666,66836770,8,6
2,3,0.6666666666666666,0.6666666666666666,62482231,9,6
1,3,0.4,0.7692307692307693,68164320,5,2
1,8,0.3333333333333333,0.9473684210526315,80135188,12,4
1,6,0.4,0.6666666666666666,69626256,10,4
0,9,0.0,0.0,66378886,9,0
0,6,0.25,0.42857142857142855,68577754,8,2
2,10,0.7058823529411765,0.9444444444444444,79838822,34,24
0,16,0.15789473684210525,0.1935483870967742,70464135,19,3
2,20,0.6296296296296297,0.875,82096248,54,34
2,7,0.851063829787234,0.9333333333333333,69692343,47,40
0,26,0.07142857142857142,0.05,66801231,28,2
2,1,0.75,0.5,80168310,4,3
0,29,0.14705882352941177,0.18691588785046728,68621084,34,5
1,28,0.3170731707317073,0.7195121951219512,67591664,41,13
0,28,0.0967741935483871,0.30526315789473685,69391161,31,3
0,17,0.10526315789473684,0.19444444444444445,60081735,19,2
1,4,0.3333333333333333,0.8888888888888888,60595962,6,2
0,40,0.13043478260869565,0.1506849315068493,69630120,46,6
0,5,0.0,0.0,80133946,5,0
0,5,0.16666666666666666,0.4074074074074074,80133954,6,1
0,63,0.16,0.2153846153846154,80140103,75,12
0,16,0.058823529411764705,0.3333333333333333,69965126,17,1
1,8,0.2,0.7543859649122807,69965161,10,2
0,18,0.05263157894736842,0.3645833333333333,70746571,19,1
2,0,1.0,1.0,82140322,3,3
2,5,0.6666666666666666,0.8181818181818182,668542,15,10
1,7,0.46153846153846156,0.8235294117647058,68802223,13,6
2,20,0.5348837209302325,0.9333333333333333,72805362,43,23
0,21,0.19230769230769232,0.23728813559322035,80152633,26,5
1,5,0.4444444444444444,0.9333333333333333,63351281,9,4
1,26,0.38095238095238093,0.8787878787878788,69184276,42,16
2,0,1.0,1.0,68286946,2,2
1,15,0.4444444444444444,0.75,73642191,27,12
2,3,0.7857142857142857,0.8,69547660,14,11
2,8,0.7241379310344828,0.9411764705882353,76940094,29,21
1,11,0.45,0.82,80158241,20,9
1,25,0.2647058823529412,0.5,69195413,34,9
2,4,0.5555555555555556,0.9473684210526315,65282455,9,5
1,10,0.2857142857142857,0.7547169811320755,65282560,14,4
1,13,0.2777777777777778,0.8048780487804879,65289910,18,5
1,8,0.2727272727272727,0.7222222222222222,65280453,11,3
1,3,0.4,0.8,67896780,5,2
2,2,0.6666666666666666,0.6666666666666666,65279613,6,4
2,8,0.6190476190476191,0.972972972972973,80137719,21,13
0,13,0.13333333333333333,0.1836734693877551,65290883,15,2
2,0,1.0,1.0,80176009,4,4
0,7,0.125,0.038461538461538464,80176692,8,1
0,32,0.15789473684210525,0.38571428571428573,69143431,38,6
0,11,0.0,0.0,69479382,11,0
0,5,0.16666666666666666,0.47368421052631576,70684803,6,1
1,47,0.3088235294117647,0.5384615384615384,69458473,68,21
0,24,0.2727272727272727,0.45714285714285713,68434093,33,9
0,5,0.0,0.0,70114744,5,0
2,4,0.5,0.8571428571428571,70648165,8,4
2,8,0.5789473684210527,0.625,82113193,19,11
1,14,0.46153846153846156,0.7297297297297297,70245245,26,12
1,14,0.46153846153846156,0.6428571428571429,66371886,26,12
2,19,0.5957446808510638,0.7021276595744681,70617876,47,28
2,4,0.7142857142857143,0.9411764705882353,82024248,14,10
2,2,0.8461538461538461,0.8,69898171,13,11
0,22,0.043478260869565216,0.14084507042253522,69162954,23,1
1,11,0.21428571428571427,0.7321428571428571,68607175,14,3
0,6,0.0,0.0,69548395,6,0
1,23,0.28125,0.6506024096385542,80061996,32,9
0,4,0.0,0.0,82046929,4,0
1,15,0.2857142857142857,0.5172413793103449,82049175,21,6
1,28,0.3333333333333333,0.7777777777777778,80055094,42,14
1,20,0.47368421052631576,0.925,65017183,38,18
1,22,0.18518518518518517,0.5873015873015873,82150100,27,5
2,6,0.6842105263157895,0.9615384615384616,79792622,19,13
1,16,0.4074074074074074,0.8333333333333334,70256956,27,11
1,9,0.25,0.8333333333333334,64001021,12,3
0,10,0.09090909090909091,0.14285714285714285,66195675,11,1
2,3,0.7272727272727273,0.8,69840743,11,8
1,57,0.2692307692307692,0.5984848484848485,66808931,78,21
0,30,0.14285714285714285,0.14473684210526316,63213206,35,5
1,5,0.4444444444444444,0.75,67282446,9,4
0,6,0.25,0.4375,82018996,8,2
0,47,0.12962962962962962,0.2153846153846154,82103788,54,7
2,5,0.5454545454545454,0.9230769230769231,80053596,11,6
0,30,0.0625,0.15789473684210525,70674891,32,2
1,28,0.391304347826087,0.8571428571428571,68995521,46,18
2,0,1.0,1.0,60261726,18,18
1,13,0.1875,0.5925925925925926,70674331,16,3
1,9,0.3076923076923077,0.5428571428571428,80162653,13,4
0,3,0.0,0.0,67199713,3,0
0,29,0.09375,0.2736842105263158,80135065,32,3
1,16,0.38461538461538464,0.8428571428571429,80163150,26,10
1,17,0.34615384615384615,0.6666666666666666,782691,26,9
0,56,0.05084745762711865,0.04132231404958678,68743332,59,3
2,6,0.5714285714285714,0.8181818181818182,69085170,14,8
2,13,0.5357142857142857,0.9655172413793104,80137335,28,15
2,0,1.0,1.0,67784962,12,12
1,7,0.3,0.9130434782608695,62840652,10,3
1,46,0.28125,0.6698113207547169,75551875,64,18
0,21,0.16,0.296875,66264604,25,4
1,75,0.10714285714285714,0.5933147632311978,62836424,84,9
2,3,0.8695652173913043,0.9285714285714286,80066322,23,20
2,0,1.0,1.0,82070199,3,3
2,0,1.0,1.0,82018626,1,1
2,1,0.9,0.6666666666666666,73313884,10,9
2,6,0.625,0.9090909090909091,82039825,16,10
1,24,0.3333333333333333,0.78125,72426424,36,12
1,27,0.3076923076923077,0.7439024390243902,70719782,39,12
0,15,0.0,0.0,66885805,15,0
0,4,0.0,0.0,82010291,4,0
0,26,0.07142857142857142,0.01904761904761905,82124911,28,2
2,5,0.5454545454545454,0.8888888888888888,68406023,11,6
2,5,0.6428571428571429,0.9322033898305084,79989693,14,9
2,8,0.5,0.896551724137931,72802863,16,8
1,109,0.31875,0.6942148760330579,67627056,160,51
1,63,0.3,0.5172413793103449,80180207,90,27
1,37,0.38333333333333336,0.8709677419354839,82175728,60,23
0,36,0.3333333333333333,0.25806451612903225,70544180,54,18
1,11,0.26666666666666666,0.5,17080434,15,4
2,6,0.8125,0.9375,76084694,32,26
1,16,0.15789473684210525,0.6119402985074627,80124406,19,3
2,7,0.7083333333333334,0.9090909090909091,54904241,24,17
0,44,0.16981132075471697,0.2608695652173913,64225133,53,9
1,36,0.29411764705882354,0.6161616161616161,70637875,51,15
0,22,0.2413793103448276,0.4845360824742268,72555623,29,7
1,37,0.4126984126984127,0.8958333333333334,70234871,63,26
1,5,0.16666666666666666,0.5384615384615384,66886001,6,1
1,18,0.28,0.5227272727272727,72909991,25,7
0,11,0.08333333333333333,0.1875,73295796,12,1
2,1,0.75,0.6666666666666666,69149346,4,3
1,33,0.26666666666666666,0.6632653061224489,70174104,45,12
0,5,0.0,0.0,69611206,5,0
1,6,0.3333333333333333,0.6666666666666666,69611255,9,3
2,38,0.5632183908045977,0.8888888888888888,80118348,87,49
1,23,0.25806451612903225,0.5172413793103449,73399641,31,8
1,24,0.25,0.6351351351351351,73460023,32,8
2,0,1.0,1.0,60261635,1,1
2,3,0.8421052631578947,0.8571428571428571,69732845,19,16
1,34,0.3333333333333333,0.6082474226804123,82023524,51,17
0,65,0.08450704225352113,0.1583710407239819,80180485,71,6
0,21,0.125,0.14814814814814814,73977764,24,3
2,3,0.75,0.75,70225085,12,9
0,55,0.0,0.0,82158901,55,0
0,55,0.0,0.0,82158902,55,0
0,27,0.15625,0.3274336283185841,80135277,32,5
2,1,0.8333333333333334,0.5,70174125,6,5
2,2,0.6666666666666666,0.8571428571428571,72801876,6,4
2,7,0.5882352941176471,0.9130434782608695,80132787,17,10
2,7,0.9041095890410958,0.9523809523809523,82143467,73,66
1,17,0.34615384615384615,0.7419354838709677,67744243,26,9
1,2,0.3333333333333333,0.8333333333333334,70320341,3,1
1,41,0.2545454545454545,0.5984251968503937,80069955,55,14
0,66,0.1951219512195122,0.41836734693877553,69602890,82,16
1,4,0.2,0.5882352941176471,80153654,5,1
2,0,1.0,1.0,80178903,1,1
1,12,0.4782608695652174,0.75,70198093,23,11
0,33,0.10810810810810811,0.03571428571428571,70198121,37,4
0,19,0.13636363636363635,0.30434782608695654,70573643,22,3
2,32,0.5,0.875,67214210,64,32
1,10,0.375,0.8163265306122449,72523080,16,6
2,1,0.5,0.5,70485933,2,1
2,0,1.0,1.0,80159153,1,1
1,12,0.4,0.7777777777777778,73870034,20,8
0,10,0.16666666666666666,0.4090909090909091,70279475,12,2
0,33,0.15384615384615385,0.3870967741935484,80125937,39,6
0,44,0.2413793103448276,0.44554455445544555,987476,58,14
1,9,0.3076923076923077,0.7692307692307693,72523115,13,4
2,0,1.0,1.0,80131362,23,23
2,3,0.75,0.75,82037201,12,9
2,8,0.5555555555555556,0.9285714285714286,70912611,18,10
0,24,0.2,0.2619047619047619,68401242,30,6
0,30,0.09090909090909091,0.4857142857142857,69033496,33,3
0,10,0.2857142857142857,0.4583333333333333,69733174,14,4
1,116,0.2795031055900621,0.7,80135080,161,45
2,2,0.7142857142857143,0.6666666666666666,80172940,7,5
2,1,0.8,0.5,80094644,5,4
0,28,0.125,0.08823529411764706,68754343,32,4
0,5,0.0,0.0,68784135,5,0
2,1,0.8333333333333334,0.75,82009532,6,5
0,5,0.0,0.0,82009536,5,0
0,1,0.0,0.0,82009540,1,0
0,8,0.1111111111111111,0.4444444444444444,82009545,9,1
2,4,0.8518518518518519,0.9166666666666666,69958672,27,23
1,32,0.38461538461538464,0.8831168831168831,70768985,52,20
2,2,0.5,0.5,68531085,4,2
1,94,0.17543859649122806,0.6112852664576802,80135170,114,20
1,70,0.36936936936936937,0.8125,65683730,111,41
2,9,0.6896551724137931,0.9705882352941176,79730966,29,20
0,15,0.0625,0.15151515151515152,72522191,16,1
1,11,0.45,0.9230769230769231,69098316,20,9
2,3,0.6666666666666666,0.8,80175658,9,6
2,9,0.5263157894736842,0.5,80155302,19,10
0,19,0.2692307692307692,0.4423076923076923,82116583,26,7
0,13,0.13333333333333333,0.27586206896551724,70700133,15,2
0,36,0.0,0.0,82158897,36,0
0,36,0.0,0.0,82158898,36,0
0,43,0.0,0.0,82003748,43,0
2,0,1.0,1.0,80136553,22,22
1,18,0.18181818181818182,0.5490196078431373,70675514,22,4
0,54,0.06896551724137931,0.06521739130434782,70679280,58,4
2,6,0.6842105263157895,0.95,82018854,19,13
1,13,0.2777777777777778,0.84375,67551204,18,5
0,23,0.14814814814814814,0.4936708860759494,69551405,27,4
1,36,0.2653061224489796,0.71875,65997743,49,13
1,30,0.25,0.75,69560022,40,10
0,71,0.10126582278481013,0.27044025157232704,70474572,79,8
0,32,0.2,0.35,65613702,40,8
0,31,0.03125,0.1557377049180328,82102909,32,1
0,18,0.05263157894736842,0.3684210526315789,62841891,19,1
0,15,0.16666666666666666,0.3488372093023256,80156748,18,3
0,98,0.1694915254237288,0.2610294117647059,80135727,118,20
1,43,0.29508196721311475,0.5294117647058824,61500950,61,18
0,28,0.06666666666666667,0.05405405405405406,60439386,30,2
1,23,0.34285714285714286,0.7575757575757576,68688074,35,12
2,0,1.0,1.0,70745136,5,5
1,16,0.3333333333333333,0.5625,80130739,24,8
2,5,0.6153846153846154,0.6,67823273,13,8
0,2,0.0,0.0,70704242,2,0
0,3,0.0,0.0,70707602,3,0
1,19,0.36666666666666664,0.7857142857142857,80135060,30,11
0,13,0.07142857142857142,0.02702702702702703,67159953,14,1
0,3,0.25,0.16666666666666666,69704621,4,1
2,11,0.5416666666666666,0.8,80178930,24,13
2,17,0.5277777777777778,0.5333333333333333,64336384,36,19
1,19,0.36666666666666664,0.7058823529411765,70597114,30,11
2,2,0.875,0.6666666666666666,66237773,16,14
1,23,0.46511627906976744,0.9298245614035088,67657611,43,20
1,4,0.42857142857142855,0.7777777777777778,69831972,7,3
0,16,0.15789473684210525,0.25,69117181,19,3
2,0,1.0,1.0,82090151,7,7
0,34,0.0,0.0,66859723,34,0
1,16,0.4838709677419355,0.7,75264560,31,15
2,9,0.55,0.9761904761904762,69575730,20,11
2,0,1.0,1.0,60261796,1,1
0,24,0.14285714285714285,0.3,78825264,28,4
0,38,0.11627906976744186,0.21374045801526717,66225124,43,5
1,9,0.3076923076923077,0.5,69184493,13,4
1,20,0.4117647058823529,0.8431372549019608,69183891,34,14
2,3,0.5,0.8,70071225,6,3
0,31,0.18421052631578946,0.36470588235294116,82008916,38,7
0,25,0.07407407407407407,0.1391304347826087,70694904,27,2
0,13,0.07142857142857142,0.26666666666666666,65907751,14,1
0,8,0.0,0.0,67898831,8,0
0,5,0.0,0.0,68655062,5,0
0,45,0.021739130434782608,0.11377245508982035,70706566,46,1
0,7,0.0,0.0,72910096,7,0
1,32,0.3469387755102041,0.8712121212121212,70831334,49,17
1,34,0.24444444444444444,0.5934065934065934,69596422,45,11
0,9,0.1,0.16216216216216217,66892980,10,1
0,2,0.3333333333333333,0.2857142857142857,71764245,3,1
0,67,0.12987012987012986,0.12056737588652482,67555390,77,10
0,3,0.0,0.0,69573154,3,0
1,13,0.4090909090909091,0.9285714285714286,80135264,22,9
0,15,0.0,0.0,82096336,15,0
0,1,0.0,0.0,68402754,1,0
0,25,0.10714285714285714,0.14864864864864866,74924080,28,3
0,17,0.0,0.0,80150030,17,0
1,12,0.4,0.8974358974358975,73421593,20,8
0,5,0.16666666666666666,0.47619047619047616,82050504,6,1
0,31,0.0,0.0,65882481,31,0
0,10,0.0,0.0,70818062,10,0
0,4,0.0,0.0,82102553,4,0
0,1,0.0,0.0,82006323,1,0
1,9,0.47058823529411764,0.9090909090909091,69964762,17,8
0,6,0.0,0.0,70908425,6,0
0,40,0.06976744186046512,0.328125,70923755,43,3
1,12,0.25,0.725,64697171,16,4
1,30,0.21052631578947367,0.5363636363636364,63188293,38,8
2,11,0.6764705882352942,0.6956521739130435,80132325,34,23
0,4,0.0,0.0,80169891,4,0
0,6,0.0,0.0,80173404,6,0
0,4,0.0,0.0,80173412,4,0
1,2,0.3333333333333333,0.75,80180264,3,1
0,30,0.11764705882352941,0.43157894736842106,69527892,34,4
0,11,0.08333333333333333,0.38235294117647056,80155861,12,1
1,3,0.4,0.8,73635142,5,2
0,27,0.03571428571428571,0.1837837837837838,67051621,28,1
0,9,0.1,0.14285714285714285,80168234,10,1
1,3,0.25,0.8125,80173402,4,1
0,48,0.0,0.0,80150918,48,0
2,17,0.7301587301587301,0.9696969696969697,70567084,63,46
1,13,0.1875,0.6981132075471698,64359575,16,3
1,26,0.2972972972972973,0.5208333333333334,69042764,37,11
1,10,0.4444444444444444,0.9333333333333333,66899084,18,8
0,7,0.0,0.0,66025211,7,0
1,26,0.4222222222222222,0.803030303030303,80180191,45,19
0,15,0.0,0.0,69549641,15,0
0,16,0.058823529411764705,0.3709677419354839,80168235,17,1
1,30,0.4642857142857143,0.941747572815534,68520711,56,26
1,20,0.3548387096774194,0.851063829787234,69187986,31,11
0,14,0.17647058823529413,0.49056603773584906,77676592,17,3
2,9,0.8235294117647058,0.9722222222222222,66779503,51,42
1,12,0.25,0.7384615384615385,70917574,16,4
0,4,0.0,0.0,82102540,4,0
1,35,0.18604651162790697,0.5321100917431193,63265496,43,8
1,16,0.2727272727272727,0.7692307692307693,70629783,22,6
1,20,0.2,0.654320987654321,80135211,25,5
0,26,0.037037037037037035,0.11504424778761062,70463414,27,1
0,8,0.0,0.0,80150592,8,0
1,17,0.32,0.6363636363636364,69964475,25,8
1,18,0.4,0.9,73668833,30,12
0,16,0.058823529411764705,0.10294117647058823,67122174,17,1
0,22,0.12,0.48,70671804,25,3
0,113,0.06611570247933884,0.1925287356321839,70908075,121,8
0,82,0.05747126436781609,0.13836477987421383,70908922,87,5
2,2,0.75,0.875,65713802,8,6
2,1,0.5,0.6666666666666666,80169901,2,1
1,7,0.36363636363636365,0.8461538461538461,80162877,11,4
0,16,0.058823529411764705,0.1509433962264151,70482944,17,1
0,56,0.2328767123287671,0.4142857142857143,80176695,73,17
0,26,0.13333333333333333,0.47474747474747475,65713130,30,4
0,3,0.0,0.0,69643231,3,0
0,15,0.0625,0.32142857142857145,80089226,16,1
0,17,0.15,0.23333333333333334,69058563,20,3
1,40,0.2857142857142857,0.625,68725720,56,16
1,54,0.23943661971830985,0.6045197740112994,80135237,71,17
0,31,0.0,0.0,67758495,31,0
0,31,0.0,0.0,70922852,31,0
0,2,0.0,0.0,70635082,2,0
0,10,0.09090909090909091,0.2765957446808511,80165832,11,1
0,32,0.058823529411764705,0.3105590062111801,64235206,34,2
0,61,0.07575757575757576,0.33073929961089493,70482265,66,5
1,4,0.42857142857142855,0.9230769230769231,65176531,7,3
1,22,0.35294117647058826,0.8823529411764706,68288920,34,12
0,36,0.1,0.2459016393442623,81878414,40,4
0,1,0.0,0.0,82006777,1,0
0,21,0.045454545454545456,0.3333333333333333,69033475,22,1
2,0,1.0,1.0,65094960,6,6
2,17,0.5641025641025641,0.9444444444444444,69129452,39,22
2,1,0.5,0.6666666666666666,80126772,2,1
1,10,0.23076923076923078,0.5714285714285714,70861875,13,3
0,38,0.17391304347826086,0.3194444444444444,82158792,46,8
1,14,0.48148148148148145,0.84375,63158571,27,13
1,9,0.3076923076923077,0.7272727272727273,68812352,13,4
1,3,0.4,0.5,70494473,5,2
2,0,1.0,1.0,63632800,7,7
2,14,0.6111111111111112,0.875,80055010,36,22
2,4,0.6,0.7777777777777778,69172733,10,6
0,17,0.15,0.1794871794871795,82005369,20,3
1,21,0.34375,0.7454545454545455,19173532,32,11
1,41,0.29310344827586204,0.7578947368421053,67554095,58,17
0,3,0.0,0.0,63273630,3,0
2,0,1.0,1.0,66114111,6,6
2,0,1.0,1.0,80118201,7,7
2,3,0.625,0.8333333333333334,72411185,8,5
0,1,0.0,0.0,64124823,1,0
2,4,0.5,0.9166666666666666,70242634,8,4
2,3,0.5714285714285714,0.8333333333333334,69072416,7,4
1,9,0.25,0.6,65279522,12,3
0,6,0.14285714285714285,0.1875,69621475,7,1
2,11,0.5416666666666666,0.96,73634995,24,13
0,4,0.0,0.0,70679686,4,0
0,6,0.14285714285714285,0.36363636363636365,68796035,7,1
1,3,0.25,0.5263157894736842,681702,4,1
2,18,0.6086956521739131,0.9333333333333333,75158321,46,28
2,5,0.5833333333333334,0.9142857142857143,69662824,12,7
0,6,0.0,0.0,80019156,6,0
0,11,0.0,0.0,80019163,11,0
0,8,0.1111111111111111,0.2222222222222222,64052562,9,1
2,2,0.5,0.6666666666666666,72073645,4,2
0,45,0.11764705882352941,0.38461538461538464,70646730,51,6
0,8,0.2,0.30434782608695654,69390552,10,2
1,6,0.3333333333333333,0.8225806451612904,71434783,9,3
2,2,0.6,0.3333333333333333,66283112,5,3
2,0,1.0,1.0,70944951,2,2
0,20,0.2857142857142857,0.48484848484848486,66857700,28,8
1,30,0.4339622641509434,0.8426966292134831,80176603,53,23
0,2,0.3333333333333333,0.4,82145133,3,1
1,18,0.41935483870967744,0.9146341463414634,68434471,31,13
1,69,0.39473684210526316,0.7619047619047619,79765574,114,45
1,19,0.4864864864864865,0.9024390243902439,64158444,37,18
2,4,0.5,0.7272727272727273,80024252,8,4
2,3,0.8125,0.9166666666666666,82060530,16,13
1,11,0.26666666666666666,0.8205128205128205,69417173,15,4
2,1,0.5,0.3333333333333333,69065395,2,1
2,1,0.8888888888888888,0.5,80176066,9,8
1,31,0.29545454545454547,0.6881720430107527,69183093,44,13
0,11,0.0,0.0,67554123,11,0
1,13,0.35,0.9322033898305084,80135205,20,7
1,12,0.42857142857142855,0.926829268292683,69058304,21,9
1,16,0.15789473684210525,0.5227272727272727,80135217,19,3
0,41,0.06818181818181818,0.08943089430894309,67049115,44,3
1,18,0.41935483870967744,0.6470588235294118,80172923,31,13
0,42,0.06666666666666667,0.2413793103448276,80049515,45,3
0,2,0.0,0.0,67667201,2,0
1,27,0.4375,0.9058823529411765,80125515,48,21
1,24,0.4418604651162791,0.9454545454545454,68288913,43,19
2,2,0.6,0.8333333333333334,80180336,5,3
0,87,0.06451612903225806,0.13953488372093023,80128310,93,6
1,6,0.4,0.7407407407407407,70063315,10,4
1,5,0.4444444444444444,0.875,70064043,9,4
0,8,0.1111111111111111,0.19607843137254902,70214291,9,1
0,25,0.07407407407407407,0.16129032258064516,70214326,27,2
0,24,0.0,0.0,70214333,24,0
2,1,0.5,0.9333333333333333,80150308,2,1
0,15,0.16666666666666666,0.3958333333333333,73704925,18,3
1,3,0.4,0.625,70669382,5,2
0,19,0.13636363636363635,0.1346153846153846,80137549,22,3
1,2,0.3333333333333333,0.6666666666666666,68498206,3,1
0,55,0.03508771929824561,0.08490566037735849,82152067,57,2
1,21,0.3225806451612903,0.66,60195163,31,10
1,18,0.25,0.7647058823529411,68500082,24,6
1,11,0.21428571428571427,0.5925925925925926,68500103,14,3
1,37,0.3148148148148148,0.7051282051282052,70669543,54,17
0,5,0.0,0.0,80126838,5,0
0,31,0.03125,0.024096385542168676,70080892,32,1
0,24,0.1111111111111111,0.22388059701492538,70081361,27,3
0,72,0.2087912087912088,0.41605839416058393,72776214,91,19
0,8,0.0,0.0,65290953,8,0
2,1,0.5,0.5,68805870,2,1
2,2,0.7142857142857143,0.6666666666666666,82145112,7,5
2,2,0.6,0.5,80019422,5,3
1,8,0.4666666666666667,0.9047619047619048,66305036,15,7
2,0,1.0,1.0,69158754,12,12
2,3,0.8421052631578947,0.8571428571428571,70860321,19,16
1,33,0.4107142857142857,0.8125,68040315,56,23
0,67,0.1728395061728395,0.36213991769547327,67291623,81,14
2,1,0.9,0.6666666666666666,82053815,10,9
1,7,0.3,0.5454545454545454,69596506,10,3
1,29,0.35555555555555557,0.7023809523809523,73974992,45,16
1,5,0.375,0.8947368421052632,82206063,8,3
0,14,0.2222222222222222,0.3611111111111111,66816841,18,4
0,15,0.16666666666666666,0.25,67324761,18,3
1,25,0.2857142857142857,0.5454545454545454,68400885,35,10
0,25,0.038461538461538464,0.16494845360824742,62838251,26,1
1,32,0.1794871794871795,0.6222222222222222,68497786,39,7
2,24,0.5294117647058824,0.9555555555555556,68765571,51,27
1,52,0.36585365853658536,0.7894736842105263,69468196,82,30
0,23,0.28125,0.4126984126984127,69180664,32,9
0,20,0.047619047619047616,0.07317073170731707,64063384,21,1
2,13,0.5,0.9620253164556962,80070221,26,13
2,5,0.7058823529411765,0.9333333333333333,80152797,17,12
1,5,0.2857142857142857,0.7272727272727273,80154115,7,2
0,6,0.0,0.0,67758873,6,0
0,10,0.09090909090909091,0.16,80180214,11,1
0,234,0.18181818181818182,0.296875,69415101,286,52
0,56,0.05084745762711865,0.24242424242424243,80149830,59,3
2,1,0.8571428571428571,0.6666666666666666,70712453,7,6
1,33,0.4107142857142857,0.8977272727272727,69868722,56,23
1,49,0.379746835443038,0.7051282051282052,69098190,79,30
0,63,0.2125,0.21794871794871795,70658770,80,17
2,0,1.0,1.0,82090157,21,21
2,23,0.54,0.9285714285714286,70690571,50,27
2,0,1.0,1.0,80139960,1,1
1,16,0.2727272727272727,0.6415094339622641,70659575,22,6
2,2,0.5,0.6666666666666666,80150322,4,2
0,7,0.0,0.0,80150323,7,0
2,1,0.5,0.6,80150329,2,1
1,6,0.45454545454545453,0.68,73494596,11,5
0,12,0.0,0.0,70702520,12,0
0,3,0.0,0.0,70702842,3,0
2,2,0.8181818181818182,0.75,74047421,11,9
0,1,0.0,0.0,80153529,1,0
1,40,0.3103448275862069,0.5591397849462365,69069273,58,18
1,3,0.4,0.5,80019023,5,2
1,8,0.1111111111111111,0.5714285714285714,82049119,9,1
2,2,0.5,0.75,73644172,4,2
2,1,0.8571428571428571,0.0,12162584,7,6
0,4,0.2,0.25,72803290,5,1
0,5,0.0,0.0,70684355,5,0
0,8,0.2,0.47619047619047616,74086705,10,2
1,53,0.29333333333333333,0.6805555555555556,65381764,75,22
0,95,0.14414414414414414,0.4671814671814672,69390965,111,16
0,7,0.125,0.4117647058823529,69841163,8,1
1,11,0.47619047619047616,0.926829268292683,80135289,21,10
1,26,0.16129032258064516,0.5301204819277109,63992943,31,5
0,21,0.125,0.3181818181818182,60081693,24,3
0,3,0.0,0.0,66782016,3,0
1,11,0.21428571428571427,0.5294117647058824,80131232,14,3
1,24,0.2,0.7402597402597403,62530545,30,6
0,4,0.0,0.0,60909471,4,0
0,6,0.25,0.1111111111111111,82024049,8,2
0,8,0.0,0.0,66782450,8,0
2,50,0.5098039215686274,0.96,69404055,102,52
2,11,0.6857142857142857,0.9565217391304348,69899802,35,24
0,29,0.0,0.0,72775122,29,0
0,1,0.0,0.0,70679161,1,0
0,1,0.0,0.0,70700273,1,0
0,18,0.14285714285714285,0.26,81992744,21,3
2,4,0.84,0.75,80055395,25,21
2,3,0.5714285714285714,0.8,82033335,7,4
1,43,0.2037037037037037,0.525974025974026,141141,54,11
0,29,0.09375,0.2882882882882883,141232,32,3
1,11,0.3125,0.7307692307692307,67315122,16,5
0,2,0.0,0.0,70468811,2,0
2,4,0.5,0.9411764705882353,81989788,8,4
2,1,0.6666666666666666,0.0,65206134,3,2
2,18,0.625,0.9347826086956522,62581295,48,30
0,3,0.25,0.3333333333333333,69164473,4,1
0,7,0.3,0.4,69666905,10,3
1,6,0.3333333333333333,0.7894736842105263,70417662,9,3
2,9,0.64,0.975609756097561,82023691,25,16
0,64,0.13513513513513514,0.08670520231213873,76932296,74,10
0,32,0.2,0.4742268041237113,62263943,40,8
0,20,0.2,0.43373493975903615,80124665,25,5
0,22,0.15384615384615385,0.38028169014084506,82150101,26,4
0,62,0.10144927536231885,0.3094170403587444,82150092,69,7
0,30,0.0,0.0,80124200,30,0
1,33,0.21428571428571427,0.6435643564356436,70908012,42,9
1,16,0.38461538461538464,0.7580645161290323,80137409,26,10
2,7,0.5333333333333333,0.8947368421052632,890533,15,8
0,47,0.2033898305084746,0.45569620253164556,70057603,59,12
2,24,0.5714285714285714,0.961038961038961,60013373,56,32
1,3,0.4,0.8571428571428571,68191634,5,2
2,19,0.5,0.9795918367346939,69152552,38,19
0,8,0.2,0.07142857142857142,67421746,10,2
1,5,0.375,0.5384615384615384,69660745,8,3
0,16,0.1111111111111111,0.08,66892504,18,2
0,35,0.05405405405405406,0.09473684210526316,70678496,37,2
2,5,0.6153846153846154,0.9,82145113,13,8
0,6,0.0,0.0,65018261,6,0
0,14,0.06666666666666667,0.25,70568680,15,1
0,20,0.0,0.0,80122867,20,0
2,0,1.0,1.0,80134869,1,1
1,72,0.22580645161290322,0.7692307692307693,61100473,93,21
2,15,0.5454545454545454,0.9705882352941176,68248761,33,18
0,15,0.21052631578947367,0.4878048780487805,72411500,19,4
0,12,0.2,0.41025641025641024,70184002,15,3
2,6,0.5,0.9761904761904762,77676970,12,6
2,7,0.5625,0.96,78863624,16,9
1,10,0.23076923076923078,0.5,19277776,13,3
1,9,0.4375,0.8571428571428571,80105025,16,7
2,0,1.0,1.0,78287531,4,4
0,12,0.25,0.36363636363636365,80139725,16,4
2,1,0.6666666666666666,0.9,68635623,3,2
1,16,0.42857142857142855,0.8666666666666667,66938830,28,12
1,24,0.3333333333333333,0.6666666666666666,80123736,36,12
0,7,0.125,0.4,70680155,8,1
1,3,0.25,0.5454545454545454,68601974,4,1
2,1,0.5,0.0,69708786,2,1
0,1,0.0,0.0,69603205,1,0
2,3,0.75,0.875,68480615,12,9
2,2,0.7142857142857143,0.8,80133890,7,5
0,23,0.17857142857142858,0.4825174825174825,70669606,28,5
0,2,0.0,0.0,80105235,2,0
2,4,0.5,0.9565217391304348,68688046,8,4
0,10,0.0,0.0,82095677,10,0
1,55,0.35294117647058826,0.575,70051254,85,30
2,7,0.72,0.9565217391304348,80125950,25,18
1,60,0.4444444444444444,0.936,80110184,108,48
1,43,0.2711864406779661,0.8028169014084507,61897101,59,16
2,2,0.8,0.8888888888888888,70241374,10,8
1,10,0.4117647058823529,0.8064516129032258,67591342,17,7
2,6,0.6,0.8333333333333334,70399301,15,9
1,21,0.3225806451612903,0.835820895522388,70633311,31,10
2,2,0.5,0.75,68060573,4,2
2,7,0.5,0.9642857142857143,66152821,14,7
0,2,0.0,0.0,73870363,2,0
0,98,0.04854368932038835,0.17142857142857143,60382511,103,5
0,1,0.0,0.0,67041366,1,0
1,6,0.3333333333333333,0.7333333333333333,82200543,9,3
0,14,0.0,0.0,80121199,14,0
0,10,0.16666666666666666,0.17857142857142858,62771163,12,2
1,6,0.3333333333333333,0.7,68754322,9,3
1,27,0.25,0.5135135135135135,65282322,36,9
0,15,0.16666666666666666,0.1111111111111111,67053581,18,3
1,10,0.23076923076923078,0.5333333333333333,65280852,13,3
1,13,0.3157894736842105,0.75,65286396,19,6
2,6,0.5,0.875,82037502,12,6
2,18,0.5135135135135135,0.896551724137931,69005503,37,19
0,46,0.17857142857142858,0.3984375,70812945,56,10
2,10,0.5,0.875,69861722,20,10
0,3,0.0,0.0,68631703,3,0
2,1,0.8333333333333334,0.5,79816576,6,5
2,10,0.5652173913043478,0.9361702127659575,72417926,23,13
2,3,0.5,0.8,73869516,6,3
2,3,0.8235294117647058,0.75,70190533,17,14
2,5,0.6875,0.9230769230769231,69489182,16,11
0,24,0.1724137931034483,0.36923076923076925,77676844,29,5
2,5,0.6428571428571429,0.9411764705882353,70058905,14,9
1,17,0.46875,0.7916666666666666,74362232,32,15
0,27,0.18181818181818182,0.22807017543859648,65812320,33,6
0,8,0.1111111111111111,0.038461538461538464,67282523,9,1
0,25,0.038461538461538464,0.017241379310344827,69180804,26,1
1,44,0.34328358208955223,0.7151515151515152,80137384,67,23
1,13,0.4090909090909091,0.8813559322033898,80137408,22,9
0,24,0.1724137931034483,0.057692307692307696,68400864,29,5
1,13,0.4583333333333333,0.8275862068965517,69514452,24,11
0,9,0.0,0.0,72808995,9,0
2,1,0.6666666666666666,0.6666666666666666,67311195,3,2
0,2,0.0,0.0,67311230,2,0
1,28,0.3333333333333333,0.7049180327868853,66493350,42,14
1,26,0.48,0.9464285714285714,62143242,50,24
0,2,0.3333333333333333,0.3333333333333333,82010315,3,1
0,2,0.0,0.0,82022954,2,0
1,6,0.25,0.65,70695044,8,2
2,2,0.8666666666666667,0.8,82059800,15,13
0,17,0.46875,0.45454545454545453,70567105,32,15
1,20,0.3548387096774194,0.6296296296296297,80126969,31,11
1,27,0.47058823529411764,0.967032967032967,69868736,51,24
2,1,0.5,0.9375,69479102,2,1
1,13,0.48,0.9322033898305084,72802933,25,12
2,6,0.7931034482758621,0.9565217391304348,80117732,29,23
2,3,0.7272727272727273,0.75,80180116,11,8
2,8,0.6363636363636364,0.9230769230769231,54607385,22,14
2,0,1.0,1.0,18856523,4,4
0,5,0.2857142857142857,0.3333333333333333,82013543,7,2
2,0,1.0,1.0,80094651,2,2
1,12,0.3333333333333333,0.6296296296296297,80141480,18,6
2,1,0.8,0.8333333333333334,80176630,5,4
2,0,1.0,1.0,70720230,7,7
2,0,1.0,1.0,82037554,3,3
2,0,1.0,1.0,82033535,5,5
2,6,0.5,0.8,80141475,12,6
2,0,1.0,1.0,80169831,7,7
2,0,1.0,1.0,75636211,3,3
2,0,1.0,1.0,82039315,1,1
1,15,0.4827586206896552,0.8888888888888888,82052112,29,14
2,2,0.5,0.5,66233013,4,2
2,1,0.8571428571428571,0.8,66810366,7,6
2,0,1.0,1.0,80132798,24,24
2,0,1.0,1.0,82041283,1,1
0,3,0.25,0.3333333333333333,80145927,4,1
0,4,0.42857142857142855,0.4,80158297,7,3
2,2,0.8571428571428571,0.6666666666666666,82041306,14,12
2,15,0.7,0.9883720930232558,80137358,50,35
2,0,1.0,1.0,69205794,10,10
2,0,1.0,1.0,67970483,6,6
2,3,0.7857142857142857,0.8,82011255,14,11
1,5,0.375,0.9411764705882353,73713234,8,3
2,0,1.0,1.0,80136562,6,6
2,0,1.0,1.0,80083556,19,19
2,2,0.75,0.0,69284950,8,6
2,0,1.0,1.0,80176467,2,2
2,10,0.855072463768116,0.75,74043522,69,59
1,7,0.2222222222222222,0.6875,82009363,9,2
0,8,0.0,0.0,82009364,8,0
2,3,0.625,0.8,80134748,8,5
1,5,0.375,0.5,80134761,8,3
1,6,0.4,0.5,74027800,10,4
0,22,0.12,0.2891566265060241,70621383,25,3
2,0,1.0,1.0,82041709,2,2
2,0,1.0,1.0,82033557,41,41
2,3,0.8421052631578947,0.9333333333333333,82008301,19,16
2,1,0.9375,0.5,69394262,16,15
0,77,0.19791666666666666,0.4564102564102564,67291672,96,19
0,2,0.0,0.0,68625865,2,0
0,8,0.2727272727272727,0.45454545454545453,67591363,11,3
2,14,0.6410256410256411,0.9523809523809523,69639843,39,25
2,0,1.0,1.0,66379376,1,1
2,0,1.0,1.0,67779740,1,1
0,3,0.25,0.35714285714285715,75381985,4,1
2,4,0.6923076923076923,0.9230769230769231,70769531,13,9
2,18,0.5909090909090909,0.9636363636363636,66677191,44,26
2,1,0.5,0.5,68784310,2,1
2,3,0.7,0.7692307692307693,69985300,10,7
0,41,0.1276595744680851,0.2564102564102564,78763601,47,6
0,30,0.03225806451612903,0.1889763779527559,80150790,31,1
1,9,0.18181818181818182,0.6,80150792,11,2
1,19,0.2692307692307692,0.625,63780563,26,7
1,22,0.2413793103448276,0.6271186440677966,69890730,29,7
0,23,0.23333333333333334,0.39285714285714285,82023575,30,7
1,19,0.24,0.6507936507936508,82103840,25,6
1,15,0.16666666666666666,0.5384615384615384,71619401,18,3
2,3,0.7857142857142857,0.75,66114020,14,11
2,3,0.7,0.75,69979805,10,7
0,40,0.024390243902439025,0.061224489795918366,70081102,41,1
0,60,0.15492957746478872,0.36936936936936937,70081382,71,11
1,11,0.35294117647058826,0.6470588235294118,68372311,17,6
0,6,0.25,0.47368421052631576,68380375,8,2
0,39,0.0,0.0,67467533,39,0
0,5,0.16666666666666666,0.15789473684210525,75103182,6,1
0,8,0.0,0.0,69526205,8,0
0,30,0.03225806451612903,0.15748031496062992,80150801,31,1
2,8,0.6521739130434783,0.95,72802632,23,15
0,5,0.0,0.0,72808722,5,0
1,15,0.34782608695652173,0.6,82010236,23,8
0,30,0.09090909090909091,0.391304347826087,67403805,33,3
0,7,0.0,0.0,68384554,7,0
1,65,0.19753086419753085,0.6038961038961039,69638373,81,16
1,5,0.2857142857142857,0.7741935483870968,80131199,7,2
2,7,0.5,0.8888888888888888,278691,14,7
0,24,0.25,0.375,65716182,32,8
1,60,0.09090909090909091,0.6278195488721805,80149980,66,6
0,24,0.3142857142857143,0.4788732394366197,73551793,35,11
1,5,0.4444444444444444,0.6666666666666666,64359806,9,4
1,33,0.34,0.6973684210526315,80130158,50,17
1,13,0.43478260869565216,0.8909090909090909,69058171,23,10
2,10,0.6428571428571429,0.8947368421052632,68274941,28,18
2,43,0.5473684210526316,0.9801980198019802,65914870,95,52
0,19,0.17391304347826086,0.18,71783761,23,4
0,30,0.09090909090909091,0.25547445255474455,69134093,33,3
0,14,0.125,0.19642857142857142,73047401,16,2
2,4,0.6666666666666666,0.375,69708583,12,8
0,18,0.14285714285714285,0.23404255319148937,70719201,21,3
0,62,0.10144927536231885,0.104,66015782,69,7
2,1,0.9090909090909091,0.5,68344570,11,10
1,4,0.42857142857142855,0.8571428571428571,74688572,7,3
1,7,0.36363636363636365,0.7142857142857143,67653866,11,4
2,3,0.5,0.6666666666666666,68561612,6,3
0,21,0.045454545454545456,0.025974025974025976,68655951,22,1
0,29,0.21621621621621623,0.35294117647058826,70910973,37,8
1,10,0.3333333333333333,0.6,69998124,15,5
1,10,0.3333333333333333,0.6428571428571429,70480550,15,5
0,19,0.09523809523809523,0.21739130434782608,71761795,21,2
0,21,0.125,0.2564102564102564,82128669,24,3
2,18,0.5135135135135135,0.9512195121951219,66520706,37,19
0,7,0.125,0.13793103448275862,54468435,8,1
1,8,0.3333333333333333,0.8695652173913043,82018744,12,4
0,14,0.125,0.0,80132358,16,2
0,29,0.03333333333333333,0.2980769230769231,70489335,30,1
1,33,0.34,0.7261904761904762,78110844,50,17
2,1,0.5,0.5,65687041,2,1
1,5,0.16666666666666666,0.6764705882352942,70488964,6,1
1,24,0.3142857142857143,0.72,73459652,35,11
1,35,0.35185185185185186,0.7640449438202247,63454594,54,19
1,33,0.2826086956521739,0.797979797979798,60081770,46,13
0,43,0.12244897959183673,0.3504273504273504,60081742,49,6
1,19,0.40625,0.8985507246376812,65767933,32,13
2,9,0.5,0.8461538461538461,70857465,18,9
0,11,0.08333333333333333,0.34375,82019469,12,1
2,30,0.6052631578947368,0.94,82018822,76,46
2,2,0.9,0.6666666666666666,74048401,20,18
1,12,0.25,0.5769230769230769,70614880,16,4
1,45,0.25,0.5454545454545454,68115495,60,15
2,9,0.7428571428571429,0.95,69912955,35,26
2,0,1.0,1.0,80117727,8,8
2,5,0.5454545454545454,0.92,69129466,11,6
1,4,0.42857142857142855,0.8,82102383,7,3
1,48,0.3684210526315789,0.8461538461538461,70117180,76,28
1,18,0.4,0.926829268292683,67553003,30,12
2,0,1.0,1.0,82041329,1,1
0,5,0.0,0.0,70698544,5,0
0,3,0.0,0.0,70700203,3,0
0,35,0.07894736842105263,0.045454545454545456,68784100,38,3
2,6,0.5,0.9047619047619048,71458786,12,6
1,31,0.2619047619047619,0.8305084745762712,81979736,42,11
0,3,0.0,0.0,82018692,3,0
0,46,0.0,0.0,73245550,46,0
2,8,0.6666666666666666,0.8333333333333334,80137910,24,16
0,85,0.22018348623853212,0.4220532319391635,67627315,109,24
0,71,0.13414634146341464,0.14871794871794872,68391596,82,11
1,21,0.25,0.8148148148148148,81973009,28,7
2,6,0.5,0.8823529411764706,66614240,12,6
2,22,0.6944444444444444,0.9824561403508771,80139933,72,50
0,20,0.0,0.0,70629664,20,0
1,18,0.21739130434782608,0.6282051282051282,80128095,23,5
0,58,0.03333333333333333,0.14511041009463724,62839595,60,2
0,3,0.0,0.0,70677124,3,0
0,3,0.0,0.0,70696535,3,0
1,12,0.3333333333333333,0.9230769230769231,80150936,18,6
1,25,0.34210526315789475,0.9032258064516129,80160441,38,13
1,3,0.25,0.7142857142857143,70698453,4,1
1,3,0.4,0.6666666666666666,69482525,5,2
0,29,0.21621621621621623,0.32941176470588235,80070053,37,8
2,0,1.0,1.0,80159226,8,8
1,6,0.25,0.5238095238095238,70754915,8,2
1,59,0.3979591836734694,0.7247706422018348,72322012,98,39
2,0,1.0,1.0,82102208,9,9
1,21,0.38235294117647056,0.8421052631578947,72417142,34,13
1,22,0.35294117647058826,0.9080459770114943,64921164,34,12
2,3,0.5714285714285714,0.75,73599631,7,4
0,37,0.22916666666666666,0.49206349206349204,81965831,48,11
1,36,0.21739130434782608,0.6446280991735537,80124652,46,10
2,1,0.5,0.6666666666666666,71588062,2,1
2,1,0.6666666666666666,0.3333333333333333,80093874,3,2
2,1,0.8,0.6666666666666666,80095183,5,4
2,0,1.0,1.0,82047506,3,3
2,3,0.7,0.8,72801463,10,7
0,55,0.0,0.0,80155235,55,0
0,55,0.017857142857142856,0.06,80155236,56,1
1,4,0.3333333333333333,0.8421052631578947,73848740,6,2
2,7,0.5625,0.8125,82108574,16,9
1,10,0.375,0.875,65280264,16,6
2,3,0.7,0.8333333333333334,72475165,10,7
0,25,0.1935483870967742,0.46938775510204084,70678090,31,6
0,15,0.11764705882352941,0.037037037037037035,67910381,17,2
0,38,0.11627906976744186,0.26229508196721313,80128121,43,5
0,5,0.0,0.0,82049142,5,0
1,24,0.48936170212765956,0.6857142857142857,74047764,47,23
1,7,0.4166666666666667,0.5,75576452,12,5
0,8,0.0,0.0,69479123,8,0
0,7,0.0,0.0,69633781,7,0
0,10,0.09090909090909091,0.32727272727272727,69634082,11,1
0,8,0.0,0.0,69634236,8,0
0,7,0.0,0.0,69634313,7,0
0,10,0.0,0.0,69634320,10,0
0,7,0.0,0.0,69634390,7,0
2,2,0.75,0.9473684210526315,70499646,8,6
0,8,0.1111111111111111,0.391304347826087,70697844,9,1
2,15,0.5588235294117647,0.9318181818181818,66384661,34,19
0,24,0.1111111111111111,0.0425531914893617,67963273,27,3
0,16,0.23809523809523808,0.4722222222222222,77321930,21,5
0,19,0.0,0.0,80122883,19,0
0,7,0.125,0.3235294117647059,70681135,8,1
0,15,0.0,0.0,70691656,15,0
0,25,0.07407407407407407,0.23809523809523808,70694771,27,2
0,9,0.1,0.2391304347826087,70695170,10,1
1,6,0.3333333333333333,0.6666666666666666,73634904,9,3
2,12,0.8032786885245902,0.9565217391304348,61172083,61,49
0,7,0.2222222222222222,0.2,74635141,9,2
0,14,0.2222222222222222,0.3448275862068966,82005365,18,4
2,8,0.5294117647058824,0.9032258064516129,74892370,17,9
1,16,0.2727272727272727,0.6,67793621,22,6
0,40,0.16666666666666666,0.33557046979865773,68229553,48,8
0,183,0.12857142857142856,0.149812734082397,73524612,210,27
0,5,0.375,0.36363636363636365,69621755,8,3
1,8,0.38461538461538464,0.5,69639885,13,5
1,46,0.41025641025641024,0.9310344827586207,72802744,78,32
0,23,0.08,0.2647058823529412,70678671,25,2
1,20,0.2,0.5862068965517241,68549033,25,5
0,10,0.23076923076923078,0.3181818181818182,19173490,13,3
0,39,0.07142857142857142,0.2792207792207792,67621001,42,3
2,11,0.725,0.9863013698630136,70711746,40,29
1,54,0.0847457627118644,0.5619834710743802,62840435,59,5
2,3,0.625,0.7777777777777778,70632394,8,5
1,12,0.29411764705882354,0.75,69063666,17,5
0,20,0.047619047619047616,0.06666666666666667,70486682,21,1
2,3,0.5,0.8333333333333334,82250570,6,3
0,13,0.0,0.0,80028935,13,0
0,2,0.0,0.0,68461554,2,0
2,0,1.0,1.0,82102237,3,3
0,14,0.06666666666666667,0.2033898305084746,70701463,15,1
0,6,0.0,0.0,72910271,6,0
2,4,0.6,0.8461538461538461,79792552,10,6
0,28,0.2222222222222222,0.375,67513831,36,8
2,2,0.6666666666666666,0.9333333333333333,67833325,6,4
2,0,1.0,1.0,82019950,2,2
2,0,1.0,1.0,66814944,3,3
0,23,0.30303030303030304,0.23076923076923078,80176794,33,10
0,48,0.09433962264150944,0.3333333333333333,69106905,53,5
1,39,0.2777777777777778,0.7482517482517482,62413414,54,15
0,50,0.05660377358490566,0.01020408163265306,300510,53,3
2,6,0.5384615384615384,0.8461538461538461,79849105,13,7
0,18,0.0,0.0,67094790,18,0
1,11,0.21428571428571427,0.5428571428571428,70597954,14,3
2,2,0.5,0.7142857142857143,70748636,4,2
2,3,0.5714285714285714,0.9473684210526315,73399655,7,4
0,27,0.22857142857142856,0.4222222222222222,67591545,35,8
0,2,0.0,0.0,82247817,2,0
0,15,0.25,0.43902439024390244,63050806,20,5
2,7,0.5625,0.9696969696969697,68469660,16,9
1,18,0.3076923076923077,0.717391304347826,65289063,26,8
0,19,0.20833333333333334,0.265625,65281251,24,5
2,2,0.6666666666666666,0.8571428571428571,76941641,6,4
1,12,0.3333333333333333,0.7555555555555555,67053756,18,6
1,37,0.27450980392156865,0.618421052631579,80128751,51,14
2,0,1.0,1.0,80149258,12,12
2,1,0.75,0.5,67824260,4,3
2,3,0.8125,0.8,69139182,16,13
1,5,0.2857142857142857,0.6428571428571429,69241795,7,2
1,10,0.375,0.8888888888888888,65281433,16,6
2,4,0.6666666666666666,0.3333333333333333,69731613,12,8
1,20,0.4117647058823529,0.8636363636363636,70597135,34,14
2,2,0.6666666666666666,0.8,70399350,6,4
1,7,0.4166666666666667,0.8666666666666667,68951855,12,5
2,3,0.75,0.75,73313492,12,9
1,24,0.29411764705882354,0.6410256410256411,70395885,34,10
1,44,0.2786885245901639,0.6071428571428571,64166571,61,17
2,1,0.75,0.0,70746991,4,3
1,9,0.47058823529411764,0.9791666666666666,71341781,17,8
1,18,0.25,0.7446808510638298,68255271,24,6
1,13,0.38095238095238093,0.8461538461538461,69950860,21,8
0,21,0.3,0.4838709677419355,80128858,30,9
2,5,0.8,0.9375,72426046,25,20
1,6,0.45454545454545453,0.8571428571428571,66305050,11,5
2,1,0.8888888888888888,0.6666666666666666,71374793,9,8
2,0,1.0,1.0,82014468,2,2
0,6,0.14285714285714285,0.3333333333333333,69582975,7,1
1,22,0.3888888888888889,0.8695652173913043,705586,36,14
2,1,0.5,0.6666666666666666,80128565,2,1
2,8,0.7894736842105263,0.85,69598333,38,30
0,44,0.18518518518518517,0.427536231884058,77677040,54,10
1,14,0.3333333333333333,0.6923076923076923,69944672,21,7
0,19,0.05,0.15315315315315314,69598074,20,1
2,1,0.9,0.5,12162556,10,9
0,1,0.0,0.0,69082230,1,0
0,1,0.0,0.0,68798002,1,0
1,4,0.42857142857142855,0.9,68393402,7,3
1,8,0.4666666666666667,0.8,67127795,15,7
1,51,0.44565217391304346,0.7164179104477612,70474502,92,41
1,6,0.4,0.896551724137931,66264093,10,4
1,63,0.38235294117647056,0.8802395209580839,70654241,102,39
0,2,0.3333333333333333,0.3333333333333333,65288846,3,1
0,3,0.0,0.0,66379166,3,0
0,2,0.0,0.0,69997970,2,0
2,60,0.6341463414634146,0.984251968503937,70543935,164,104
1,13,0.4090909090909091,0.9295774647887324,70049504,22,9
2,0,1.0,1.0,70745171,2,2
0,10,0.09090909090909091,0.047619047619047616,69712146,11,1
0,34,0.08108108108108109,0.11842105263157894,300566,37,3
1,20,0.3939393939393939,0.7818181818181819,67656960,33,13
2,0,1.0,1.0,72801960,6,6
0,39,0.38095238095238093,0.425531914893617,69063624,63,24
0,42,0.06666666666666667,0.17687074829931973,70702513,45,3
2,1,0.8571428571428571,0.5,82042834,7,6
1,24,0.1724137931034483,0.5748031496062992,82137454,29,5
0,25,0.0,0.0,82137459,25,0
0,50,0.0196078431372549,0.23529411764705882,82137472,51,1
0,52,0.08771929824561403,0.29411764705882354,82137482,57,5
0,39,0.025,0.25862068965517243,82137495,40,1
0,45,0.1,0.3235294117647059,82137499,50,5
2,23,0.5,0.9285714285714286,68400934,46,23
2,10,0.5238095238095238,0.8461538461538461,72425542,21,11
1,113,0.2662337662337662,0.7026239067055393,82016321,154,41
1,6,0.25,0.55,69597185,8,2
1,35,0.4166666666666667,0.775,66283035,60,25
2,7,0.5333333333333333,0.84,69489210,15,8
0,2,0.0,0.0,70681142,2,0
0,11,0.42105263157894735,0.4666666666666667,66257611,19,8
2,4,0.8620689655172413,0.9375,80019954,29,25
2,4,0.5,0.9285714285714286,72802275,8,4
0,7,0.2222222222222222,0.4634146341463415,82002269,9,2
2,10,0.6296296296296297,0.9454545454545454,80176633,27,17
1,7,0.4166666666666667,0.9523809523809523,80150940,12,5
0,9,0.1,0.0,82103835,10,1
1,27,0.47058823529411764,0.9090909090909091,65915213,51,24
1,39,0.25,0.6271186440677966,69582730,52,13
2,5,0.6153846153846154,0.8181818181818182,79784103,13,8
1,39,0.25,0.5126050420168067,82126635,52,13
1,31,0.45614035087719296,0.8695652173913043,68383525,57,26
0,32,0.058823529411764705,0.12,70684831,34,2
1,22,0.3333333333333333,0.6883116883116883,80108763,33,11
1,9,0.25,0.5333333333333333,82126769,12,3
2,0,1.0,1.0,72814700,1,1
1,17,0.39285714285714285,0.65,80176833,28,11
1,4,0.3333333333333333,0.8333333333333334,65282630,6,2
2,12,0.5,0.9038461538461539,70934192,24,12
1,4,0.3333333333333333,0.7142857142857143,82096273,6,2
0,33,0.1951219512195122,0.43956043956043955,80089730,41,8
1,4,0.2,0.5,80128512,5,1
0,115,0.14814814814814814,0.2824427480916031,80053561,135,20
2,61,0.5481481481481482,0.9577464788732394,74781784,135,74
2,15,0.6511627906976745,0.975609756097561,82052039,43,28
1,7,0.46153846153846156,0.9615384615384616,70760333,13,6
2,50,0.5192307692307693,0.8888888888888888,80175983,104,54
0,6,0.14285714285714285,0.18181818181818182,61356365,7,1
1,84,0.26956521739130435,0.5076923076923077,80136475,115,31
1,10,0.2857142857142857,0.6538461538461539,73295782,14,4
2,0,1.0,1.0,80176440,3,3
0,6,0.0,0.0,70692853,6,0
0,2,0.0,0.0,70694883,2,0
1,24,0.3142857142857143,0.711864406779661,80074295,35,11
1,29,0.32558139534883723,0.625,78863736,43,14
0,30,0.03225806451612903,0.14444444444444443,70707196,31,1
2,0,1.0,1.0,82070220,1,1
2,0,1.0,1.0,80159255,3,3
2,1,0.8333333333333334,0.75,82022384,6,5
2,4,0.5,0.8888888888888888,71264025,8,4
1,4,0.3333333333333333,0.7333333333333333,70843563,6,2
2,0,1.0,1.0,69318396,5,5
0,6,0.14285714285714285,0.15384615384615385,65280075,7,1
1,18,0.4375,0.9459459459459459,70591885,32,14
1,10,0.4117647058823529,0.875,65290134,17,7
0,25,0.24242424242424243,0.35526315789473684,65286333,33,8
1,36,0.29411764705882354,0.5384615384615384,65288461,51,15
2,3,0.9302325581395349,0.9,70583282,43,40
2,1,0.9285714285714286,0.5,80132333,14,13
2,3,0.8,0.9333333333333333,69317052,15,12
1,15,0.2857142857142857,0.6086956521739131,67903381,21,6
2,4,0.5,0.8571428571428571,70937685,8,4
1,23,0.28125,0.5217391304347826,82126659,32,9
1,20,0.4117647058823529,0.6944444444444444,80180245,34,14
0,6,0.0,0.0,63809235,6,0
2,38,0.6576576576576577,0.9603960396039604,80126958,111,73
0,5,0.16666666666666666,0.19047619047619047,67053672,6,1
2,4,0.8461538461538461,0.8,70031486,26,22
2,51,0.5,0.9191176470588235,67261705,102,51
0,22,0.26666666666666666,0.4883720930232558,69464955,30,8
0,22,0.043478260869565216,0.05952380952380952,61944834,23,1
2,0,1.0,1.0,82038287,1,1
0,33,0.175,0.39622641509433965,82052449,40,7
1,36,0.14285714285714285,0.622093023255814,80089674,42,6
1,8,0.2,0.5,68546464,10,2
0,18,0.0,0.0,73064530,18,0
1,15,0.3181818181818182,0.8857142857142857,66892805,22,7
1,62,0.32608695652173914,0.7467532467532467,80121302,92,30
1,43,0.47560975609756095,0.9375,67526543,82,39
0,2,0.0,0.0,70674352,2,0
0,5,0.16666666666666666,0.38095238095238093,70682612,6,1
0,31,0.16216216216216217,0.4891304347826087,80122903,37,6
1,14,0.391304347826087,0.9459459459459459,67841984,23,9
1,7,0.36363636363636365,0.7222222222222222,68497261,11,4
0,48,0.12727272727272726,0.3515625,80149862,55,7
1,23,0.41025641025641024,0.8529411764705882,62590003,39,16
1,61,0.3146067415730337,0.6666666666666666,72945950,89,28
1,9,0.35714285714285715,0.6818181818181818,68554003,14,5
2,2,0.6,0.75,68033301,5,3
1,10,0.4117647058823529,0.8222222222222222,82013603,17,7
2,0,1.0,1.0,69158803,7,7
2,10,0.6296296296296297,0.9795918367346939,72417226,27,17
1,2,0.3333333333333333,0.5,80055920,3,1
2,1,0.9473684210526315,0.5,80127028,19,18
1,41,0.359375,0.7692307692307693,80178134,64,23
1,17,0.45161290322580644,0.8888888888888888,80176643,31,14
0,17,0.05555555555555555,0.1038961038961039,70701771,18,1
1,15,0.4444444444444444,0.7777777777777778,69733412,27,12
0,34,0.10526315789473684,0.2054794520547945,64164604,38,4
0,9,0.0,0.0,69384154,9,0
1,5,0.4444444444444444,0.9285714285714286,68401032,9,4
1,12,0.42857142857142855,0.8181818181818182,66378865,21,9
1,16,0.42857142857142855,0.9354838709677419,69517742,28,12
2,0,1.0,1.0,70745115,5,5
2,8,0.6923076923076923,0.8888888888888888,69528592,26,18
2,5,0.5,0.9375,82120529,10,5
1,20,0.3333333333333333,0.926605504587156,67434703,30,10
0,3,0.0,0.0,70677670,3,0
0,2,0.0,0.0,70679714,2,0
0,11,0.15384615384615385,0.3469387755102041,70657762,13,2
1,59,0.3516483516483517,0.6571428571428571,66826011,91,32
2,1,0.75,0.5,70395654,4,3
1,3,0.4,0.75,62142864,5,2
2,2,0.5,0.8333333333333334,62017046,4,2
0,12,0.0,0.0,70681282,12,0
1,2,0.3333333333333333,0.631578947368421,75048134,3,1
1,7,0.4166666666666667,0.7857142857142857,70779646,12,5
0,1,0.0,0.0,70683564,1,0
0,6,0.0,0.0,70683872,6,0
2,2,0.6666666666666666,0.75,80145457,6,4
0,18,0.18181818181818182,0.34146341463414637,80118161,22,4
0,27,0.06896551724137931,0.15625,60513936,29,2
1,16,0.4074074074074074,0.8648648648648649,68558112,27,11
2,3,0.7,0.8333333333333334,82022379,10,7
2,1,0.8,0.5,65948995,5,4
0,38,0.05,0.21153846153846154,64182895,40,2
1,12,0.4782608695652174,0.8235294117647058,79976456,23,11
0,26,0.037037037037037035,0.2,70639744,27,1
2,3,0.5,0.8,63372386,6,3
0,46,0.08,0.3067484662576687,67620763,50,4
0,3,0.0,0.0,70237874,3,0
0,9,0.1,0.1956521739130435,80128818,10,1
0,12,0.07692307692307693,0.22857142857142856,80029215,13,1
2,2,0.8333333333333334,0.8,69069301,12,10
2,6,0.5,0.9545454545454546,66379495,12,6
2,2,0.75,0.875,73871343,8,6
2,2,0.7142857142857143,0.9,69404615,7,5
0,3,0.0,0.0,80165164,3,0
0,10,0.09090909090909091,0.21052631578947367,82010267,11,1
0,7,0.0,0.0,82008041,7,0
1,17,0.37037037037037035,0.8095238095238095,80061002,27,10
1,24,0.3684210526315789,0.8105263157894737,72698346,38,14
0,29,0.09375,0.3333333333333333,82003725,32,3
0,40,0.024390243902439025,0.16129032258064516,82003738,41,1
0,13,0.13333333333333333,0.0,80160438,15,2
0,20,0.2,0.3064516129032258,80125490,25,5
2,3,0.7272727272727273,0.9333333333333333,69412252,11,8
0,15,0.11764705882352941,0.3103448275862069,70694204,17,2
2,1,0.8,0.5,66237080,5,4
1,9,0.25,0.5151515151515151,80180122,12,3
1,31,0.2619047619047619,0.7419354838709677,60249476,42,11
0,23,0.23333333333333334,0.36,61889863,30,7
0,4,0.2,0.3333333333333333,65613625,5,1
1,5,0.375,0.7857142857142857,80168306,8,3
2,14,0.6666666666666666,0.8484848484848485,80128783,42,28
2,3,0.5714285714285714,0.9333333333333333,69596436,7,4
2,40,0.6039603960396039,0.97,80137141,101,61
2,0,1.0,1.0,80080140,19,19
0,15,0.0,0.0,80124291,15,0
0,13,0.0,0.0,80124325,13,0
0,40,0.06976744186046512,0.3308270676691729,80124416,43,3
1,35,0.4166666666666667,0.8295454545454546,80022005,60,25
2,2,0.6,0.6666666666666666,69634775,5,3
2,7,0.631578947368421,0.9444444444444444,69489112,19,12
0,36,0.1,0.1111111111111111,72417443,40,4
2,9,0.5,0.9705882352941176,70820715,18,9
2,10,0.6,0.9411764705882353,79787414,25,15
1,7,0.46153846153846156,0.85,68603962,13,6
0,9,0.0,0.0,82102547,9,0
0,6,0.0,0.0,82102642,6,0
2,19,0.5681818181818182,0.9733333333333334,64474795,44,25
1,21,0.4166666666666667,0.8032786885245902,66595382,36,15
1,16,0.23809523809523808,0.5405405405405406,82006695,21,5
0,70,0.06666666666666667,0.2336448598130841,54421570,75,5
1,80,0.2079207920792079,0.5958188153310104,80128174,101,21
0,9,0.4,0.375,70718403,15,6
1,8,0.2727272727272727,0.7058823529411765,69712181,11,3
0,11,0.08333333333333333,0.0,67823560,12,1
1,66,0.27472527472527475,0.5845410628019324,80133414,91,25
0,22,0.21428571428571427,0.27419354838709675,80171786,28,6
1,46,0.41025641025641024,0.8090909090909091,80180962,78,32
2,13,0.5517241379310345,0.9666666666666667,81908601,29,16
0,38,0.13636363636363635,0.14864864864864866,80126446,44,6
0,22,0.0,0.0,70081473,22,0
1,16,0.2727272727272727,0.6222222222222222,67555271,22,6
1,17,0.32,0.75,67555362,25,8
1,44,0.3230769230769231,0.7435897435897436,80027941,65,21
2,5,0.6666666666666666,0.8888888888888888,69047783,15,10
1,16,0.4838709677419355,0.9113924050632911,69045746,31,15
0,6,0.0,0.0,66464713,6,0
2,3,0.6666666666666666,0.625,68234285,9,6
0,6,0.14285714285714285,0.4,68234362,7,1
0,8,0.0,0.0,68234383,8,0
1,6,0.25,0.7058823529411765,68234390,8,2
0,5,0.16666666666666666,0.4444444444444444,68234495,6,1
1,18,0.3076923076923077,0.7361111111111112,82096274,26,8
0,75,0.10714285714285714,0.34065934065934067,82103797,84,9
0,12,0.07692307692307693,0.21428571428571427,66110961,13,1
1,15,0.25,0.6229508196721312,66111024,20,5
2,0,1.0,1.0,68162983,2,2
1,16,0.38461538461538464,0.7777777777777778,72803304,26,10
1,43,0.36764705882352944,0.7307692307692307,80145712,68,25
0,30,0.2682926829268293,0.4457831325301205,62674633,41,11
2,8,0.6521739130434783,0.6666666666666666,80091900,23,15
2,2,0.7142857142857143,0.8333333333333334,82065188,7,5
0,18,0.14285714285714285,0.16363636363636364,19430852,21,3
1,13,0.43478260869565216,0.896551724137931,82101250,23,10
1,48,0.4074074074074074,0.7731958762886598,80153694,81,33
1,2,0.3333333333333333,0.75,68539275,3,1
0,1,0.0,0.0,73951542,1,0
0,1,0.0,0.0,74047092,1,0
0,4,0.0,0.0,74047113,4,0
2,2,0.5,0.8333333333333334,74047330,4,2
0,1,0.0,0.0,74061925,1,0
0,24,0.07692307692307693,0.3333333333333333,34609750,26,2
1,13,0.07142857142857142,0.5063291139240507,70918386,14,1
0,10,0.09090909090909091,0.3409090909090909,65363984,11,1
2,2,0.5,0.7142857142857143,65716070,4,2
2,3,0.5,0.9,66496052,6,3
0,24,0.04,0.059322033898305086,80131195,25,1
0,1,0.0,0.0,70635705,1,0
1,12,0.2,0.7301587301587301,69908531,15,3
0,10,0.0,0.0,64027166,10,0
0,50,0.038461538461538464,0.36577181208053694,80150029,52,2
1,12,0.29411764705882354,0.7142857142857143,67970924,17,5
0,12,0.07692307692307693,0.05555555555555555,82150081,13,1
0,9,0.1,0.21428571428571427,82150083,10,1
1,6,0.25,0.8518518518518519,70908341,8,2
1,3,0.25,0.9411764705882353,80131189,4,1
1,51,0.13559322033898305,0.5222222222222223,82150112,59,8
1,5,0.375,0.8125,80167309,8,3
1,18,0.18181818181818182,0.5,68546450,22,4
0,14,0.0,0.0,69640704,14,0
0,12,0.07692307692307693,0.2682926829268293,69640753,13,1
2,1,0.6666666666666666,0.9,69640760,3,2
0,65,0.015151515151515152,0.04424778761061947,69640865,66,1
1,5,0.16666666666666666,0.5757575757575758,70069902,6,1
0,1,0.0,0.0,80150665,1,0
0,11,0.0,0.0,80150509,11,0
0,13,0.0,0.0,70343805,13,0
0,9,0.1,0.2631578947368421,71081346,10,1
0,1,0.0,0.0,80172605,1,0
0,1,0.0,0.0,80172624,1,0
0,26,0.037037037037037035,0.06060606060606061,67978393,27,1
1,5,0.375,0.8,75363701,8,3
1,14,0.2222222222222222,0.5952380952380952,67812696,18,4
1,10,0.4444444444444444,0.875,82163465,18,8
2,5,0.6875,0.9230769230769231,74361553,16,11
0,1,0.0,0.0,74389532,1,0
1,27,0.3076923076923077,0.6981132075471698,80150380,39,12
1,6,0.25,0.7333333333333333,82006704,8,2
1,13,0.1875,0.7166666666666667,67509064,16,3
0,16,0.058823529411764705,0.38333333333333336,70918001,17,1
1,5,0.4444444444444444,0.9285714285714286,71081024,9,4
1,14,0.44,0.9285714285714286,64471841,25,11
0,15,0.21052631578947367,0.42857142857142855,69912633,19,4
0,12,0.07692307692307693,0.36231884057971014,64767101,13,1
0,5,0.0,0.0,65596671,5,0
0,4,0.0,0.0,65596685,4,0
1,15,0.4642857142857143,0.9607843137254902,69058213,28,13
1,51,0.1774193548387097,0.697560975609756,68213600,62,11
0,27,0.1,0.4489795918367347,67434836,30,3
0,12,0.0,0.0,80131196,12,0
2,6,0.5384615384615384,0.8823529411764706,80167301,13,7
0,5,0.16666666666666666,0.4666666666666667,82118264,6,1
0,4,0.0,0.0,80168238,4,0
0,5,0.0,0.0,80168239,5,0
0,17,0.05555555555555555,0.2696629213483146,82118249,18,1
0,17,0.10526315789473684,0.38333333333333336,69528123,19,2
0,60,0.1044776119402985,0.4675324675324675,70059626,67,7
1,11,0.21428571428571427,0.8,67889430,14,3
1,58,0.2054794520547945,0.6176470588235294,69887090,73,15
1,30,0.0625,0.5677083333333334,82049128,32,2
1,34,0.22727272727272727,0.6395348837209303,70190344,44,10
1,15,0.25,0.7758620689655172,69886852,20,5
0,14,0.06666666666666667,0.23076923076923078,72816674,15,1
0,70,0.07894736842105263,0.42452830188679247,65228142,76,6
0,51,0.03773584905660377,0.40893470790378006,80150921,53,2
0,11,0.0,0.0,67978190,11,0
1,10,0.16666666666666666,0.6666666666666666,65348675,12,2
1,4,0.3333333333333333,0.6153846153846154,68240403,6,2
0,12,0.14285714285714285,0.3137254901960784,80145815,14,2
0,14,0.0,0.0,82152769,14,0
2,27,0.7352941176470589,0.9818181818181818,70915894,102,75
2,63,0.5227272727272727,0.8876404494382022,63729974,132,69
2,0,1.0,1.0,69064296,1,1
0,9,0.18181818181818182,0.39622641509433965,69416921,11,2
1,3,0.4,0.95,80004134,5,2
2,6,0.5714285714285714,0.8571428571428571,80074344,14,8
0,59,0.21333333333333335,0.2463768115942029,67131050,75,16
0,29,0.0,0.0,80028851,29,0
0,7,0.0,0.0,80029194,7,0
2,8,0.8,0.9285714285714286,69754125,40,32
0,12,0.14285714285714285,0.4772727272727273,66813586,14,2
2,0,1.0,1.0,82135127,2,2
1,4,0.3333333333333333,0.6,80122900,6,2
0,2,0.3333333333333333,0.3333333333333333,80122943,3,1
2,6,0.625,0.9,72802842,16,10
1,41,0.24074074074074073,0.55,77563822,54,13
0,34,0.24444444444444444,0.40476190476190477,82170149,45,11
0,4,0.2,0.3333333333333333,65286284,5,1
0,6,0.14285714285714285,0.3076923076923077,65291142,7,1
1,3,0.4,0.9230769230769231,67053686,5,2
0,9,0.18181818181818182,0.21568627450980393,73623221,11,2
1,10,0.3333333333333333,0.7727272727272727,70829731,15,5
1,31,0.18421052631578946,0.5851063829787234,68633481,38,7
2,10,0.7619047619047619,0.9375,80118599,42,32
2,0,1.0,1.0,80159176,1,1
2,0,1.0,1.0,74439043,1,1
0,42,0.08695652173913043,0.04040404040404041,80155193,46,4
0,13,0.13333333333333333,0.24489795918367346,80128896,15,2
1,74,0.27450980392156865,0.7883597883597884,64259405,102,28
0,3,0.25,0.2857142857142857,81989183,4,1
0,42,0.08695652173913043,0.26153846153846155,74924360,46,4
0,48,0.22580645161290322,0.3888888888888889,80118413,62,14
1,10,0.16666666666666666,0.8181818181818182,79979942,12,2
0,17,0.10526315789473684,0.15555555555555556,70677173,19,2
1,4,0.2,0.7777777777777778,70693294,5,1
0,39,0.04878048780487805,0.11842105263157894,70908145,41,2
1,32,0.2,0.5233644859813084,66536694,40,8
2,3,0.5,0.8888888888888888,69388620,6,3
0,5,0.16666666666666666,0.0,69912591,6,1
0,16,0.15789473684210525,0.2413793103448276,71618785,19,3
0,8,0.0,0.0,70630105,8,0
1,42,0.17647058823529413,0.5032258064516129,71618750,51,9
2,1,0.75,0.75,69177934,4,3
2,16,0.5555555555555556,0.9761904761904762,80024231,36,20
1,4,0.3333333333333333,0.5384615384615384,69904723,6,2
0,56,0.1111111111111111,0.10843373493975904,70871080,63,7
0,14,0.17647058823529413,0.39285714285714285,72775556,17,3
0,1,0.0,0.0,80150289,1,0
2,1,0.75,0.8,80091991,4,3
2,3,0.5,0.9166666666666666,69489420,6,3
0,1,0.0,0.0,70042280,1,0
0,35,0.18604651162790697,0.4260869565217391,80122913,43,8
0,3,0.0,0.0,68596066,3,0
0,5,0.0,0.0,68805835,5,0
0,3,0.25,0.2727272727272727,80145724,4,1
2,5,0.5,0.875,82143717,10,5
1,32,0.49206349206349204,0.9603960396039604,72417940,63,31
0,3,0.0,0.0,80130305,3,0
0,15,0.0,0.0,65280250,15,0
1,10,0.4444444444444444,0.84,79792440,18,8
0,7,0.2222222222222222,0.45454545454545453,68499662,9,2
2,7,0.6666666666666666,0.9,71416513,21,14
1,26,0.35,0.8131868131868132,68286610,40,14
0,12,0.07692307692307693,0.2857142857142857,82003733,13,1
0,18,0.05263157894736842,0.2631578947368421,62850354,19,1
0,45,0.1,0.15625,68499634,50,5
1,12,0.3333333333333333,0.8775510204081632,70802970,18,6
0,7,0.125,0.4074074074074074,78763041,8,1
2,2,0.6666666666666666,0.8571428571428571,70755300,6,4
1,2,0.3333333333333333,0.5652173913043478,69636161,3,1
0,42,0.17647058823529413,0.273972602739726,82023772,51,9
1,3,0.4,0.625,69730122,5,2
2,5,0.6153846153846154,0.875,68996312,13,8
2,5,0.5,0.8571428571428571,69489462,10,5
1,16,0.2,0.6964285714285714,65546782,20,4
0,20,0.25925925925925924,0.3888888888888889,80180248,27,7
0,4,0.0,0.0,82102484,4,0
2,6,0.6666666666666666,0.9,73588921,18,12
1,73,0.26262626262626265,0.6363636363636364,68241572,99,26
2,2,0.6,0.75,65289364,5,3
1,20,0.3939393939393939,0.8409090909090909,72803024,33,13
1,4,0.3333333333333333,0.8095238095238095,69573224,6,2
2,11,0.8705882352941177,0.9565217391304348,80118602,85,74
2,9,0.5,0.2857142857142857,80055850,18,9
0,12,0.14285714285714285,0.3389830508474576,72808792,14,2
0,11,0.08333333333333333,0.17391304347826086,72809282,12,1
1,6,0.4,0.75,64137584,10,4
1,23,0.25806451612903225,0.582089552238806,82096272,31,8
1,11,0.15384615384615385,0.7101449275362319,62841800,13,2
0,64,0.08571428571428572,0.2356020942408377,80029005,70,6
1,58,0.34831460674157305,0.8540540540540541,80121301,89,31
0,21,0.08695652173913043,0.25,60919271,23,2
0,17,0.05555555555555555,0.058823529411764705,71081332,18,1
1,7,0.2222222222222222,0.7391304347826086,66783115,9,2
0,6,0.0,0.0,66783773,6,0
2,0,1.0,1.0,82061915,13,13
2,0,1.0,1.0,82061909,3,3
1,7,0.125,0.5849056603773585,80124358,8,1
2,6,0.6,0.9090909090909091,70061180,15,9
2,8,0.7142857142857143,0.9583333333333334,80055171,28,20
0,9,0.0,0.0,69895623,9,0
0,41,0.16326530612244897,0.43333333333333335,63992691,49,8
2,4,0.5,0.9473684210526315,69895294,8,4
0,14,0.125,0.4090909090909091,63993195,16,2
1,4,0.3333333333333333,0.7692307692307693,70573615,6,2
1,14,0.3,0.6666666666666666,65654680,20,6
0,15,0.16666666666666666,0.18181818181818182,69179593,18,3
0,10,0.0,0.0,80028921,10,0
1,12,0.14285714285714285,0.5121951219512195,69318165,14,2
1,8,0.2727272727272727,0.7,70632541,11,3
0,4,0.2,0.3125,65404395,5,1
0,5,0.0,0.0,66786125,5,0
0,5,0.0,0.0,66787112,5,0
0,11,0.08333333333333333,0.48,67755072,12,1
1,18,0.3076923076923077,0.6885245901639344,69722954,26,8
1,10,0.3333333333333333,0.5,80000606,15,5
0,5,0.0,0.0,70175581,5,0
2,7,0.7307692307692307,0.875,68766593,26,19
2,17,0.5,0.9512195121951219,69729135,34,17
2,5,0.6153846153846154,0.9285714285714286,67786593,13,8
0,6,0.14285714285714285,0.0,80145827,7,1
1,10,0.4444444444444444,0.782608695652174,68400682,18,8
2,4,0.8,0.9411764705882353,80126930,20,16
2,3,0.7272727272727273,0.8888888888888888,82023681,11,8
0,1,0.0,0.0,70509684,1,0
1,21,0.4166666666666667,0.8974358974358975,69170675,36,15
1,16,0.23809523809523808,0.8787878787878788,70343665,21,5
0,46,0.11538461538461539,0.29310344827586204,80133438,52,6
1,44,0.4883720930232558,0.9795918367346939,64196412,86,42
2,3,0.8,0.8,80119017,15,12
1,51,0.2714285714285714,0.6807228915662651,82126804,70,19
0,20,0.047619047619047616,0.40298507462686567,82049100,21,1
0,49,0.057692307692307696,0.2708333333333333,77576751,52,3
0,39,0.1702127659574468,0.3492063492063492,77676830,47,8
1,19,0.2692307692307692,0.703125,72962463,26,7
1,30,0.3333333333333333,0.6710526315789473,66857574,45,15
1,25,0.24242424242424243,0.5555555555555556,66931606,33,8
1,14,0.2631578947368421,0.6896551724137931,70081221,19,5
0,15,0.0625,0.0,67449095,16,1
2,2,0.6,0.3333333333333333,69958056,5,3
1,2,0.3333333333333333,0.7,70573552,3,1
0,41,0.08888888888888889,0.035398230088495575,67833794,45,4
2,0,1.0,1.0,72697940,2,2
0,22,0.2903225806451613,0.4411764705882353,74324103,31,9
2,6,0.6470588235294118,0.8571428571428571,60024650,17,11
2,7,0.5625,0.5714285714285714,80128785,16,9
1,17,0.2916666666666667,0.6170212765957447,69964391,24,7
0,136,0.09933774834437085,0.36281179138321995,70862442,151,15
2,0,1.0,1.0,80178165,1,1
1,17,0.45161290322580644,0.9454545454545454,70694092,31,14
0,18,0.05263157894736842,0.22764227642276422,73007263,19,1
2,11,0.5,0.8333333333333334,80127538,22,11
2,1,0.5,0.7142857142857143,69700001,2,1
2,4,0.5,0.7,82053036,8,4
2,3,0.6666666666666666,0.9,72790634,9,6
0,1,0.0,0.0,80018316,1,0
2,7,0.7307692307692307,0.9375,70713363,26,19
2,3,0.6666666666666666,0.875,70585662,9,6
1,28,0.24324324324324326,0.6101694915254238,68642210,37,9
1,4,0.2,0.5652173913043478,82010303,5,1
2,0,1.0,1.0,80154043,1,1
0,8,0.0,0.0,82019472,8,0
0,7,0.0,0.0,82019480,7,0
2,10,0.6153846153846154,0.9655172413793104,70854420,26,16
0,31,0.18421052631578946,0.4375,64571822,38,7
0,8,0.1111111111111111,0.12,70921431,9,1
0,8,0.0,0.0,67787006,8,0
1,30,0.3023255813953488,0.5441176470588235,68401004,43,13
1,32,0.38461538461538464,0.8493150684931506,68532583,52,20
0,27,0.20588235294117646,0.4235294117647059,70587615,34,7
0,8,0.2,0.4782608695652174,64164653,10,2
1,20,0.4444444444444444,0.8703703703703703,69055441,36,16
2,0,1.0,1.0,80169315,13,13
1,15,0.4230769230769231,0.5384615384615384,70544222,26,11
1,8,0.3333333333333333,0.7407407407407407,65196243,12,4
1,5,0.375,0.5,70718676,8,3
1,9,0.35714285714285715,0.6842105263157895,70854273,14,5
0,2,0.0,0.0,65290001,2,0
2,1,0.875,0.8333333333333334,66810373,8,7
0,31,0.225,0.4084507042253521,75550930,40,9
2,2,0.5,0.8571428571428571,71337392,4,2
2,1,0.75,0.5,68234551,4,3
2,1,0.8571428571428571,0.75,69856451,7,6
2,11,0.8,0.9523809523809523,71433572,55,44
2,40,0.6261682242990654,0.9615384615384616,8010625,107,67
0,21,0.2222222222222222,0.25,65281146,27,6
1,10,0.2857142857142857,0.7333333333333333,65282672,14,4
1,28,0.2631578947368421,0.7384615384615385,66035284,38,10
1,7,0.36363636363636365,0.6923076923076923,65280292,11,4
1,6,0.45454545454545453,0.8181818181818182,65290505,11,5
1,26,0.35,0.75,65280054,40,14
1,37,0.4788732394366197,0.7857142857142857,81867490,71,34
0,1,0.0,0.0,69137292,1,0
1,8,0.2727272727272727,0.631578947368421,63372883,11,3
0,19,0.20833333333333334,0.4727272727272727,69603072,24,5
2,4,0.5555555555555556,0.8333333333333334,72802716,9,5
0,3,0.0,0.0,69049582,3,0
2,3,0.625,0.8571428571428571,69703963,8,5
0,18,0.0,0.0,82164466,18,0
0,18,0.0,0.0,82164467,18,0
2,0,1.0,1.0,80126500,9,9
0,6,0.25,0.42857142857142855,70751065,8,2
1,49,0.24615384615384617,0.5428571428571428,79783333,65,16
1,14,0.46153846153846156,0.9473684210526315,65458624,26,12
1,16,0.30434782608695654,0.5609756097560976,72135483,23,7
1,3,0.25,0.8,69006560,4,1
1,18,0.14285714285714285,0.6,82049133,21,3
0,10,0.09090909090909091,0.1875,80122885,11,1
0,3,0.25,0.2,72802443,4,1
1,34,0.24444444444444444,0.5268817204301075,80125656,45,11
1,2,0.3333333333333333,0.5,74595892,3,1
1,12,0.4,0.7096774193548387,68546646,20,8
1,66,0.25842696629213485,0.6386554621848739,69538392,89,23
2,0,1.0,1.0,69958651,8,8
2,0,1.0,1.0,70314244,2,2
2,2,0.7142857142857143,0.75,68035296,7,5
0,1,0.0,0.0,80095043,1,0
1,9,0.4375,0.9047619047619048,67598741,16,7
0,35,0.2708333333333333,0.4927536231884058,70637973,48,13
2,2,0.8947368421052632,0.6666666666666666,80127013,19,17
2,0,1.0,1.0,82175550,1,1
2,1,0.9230769230769231,0.75,67540592,13,12
2,0,1.0,1.0,80162167,23,23
2,0,1.0,1.0,65770943,6,6
2,2,0.8461538461538461,0.5,82060554,13,11
2,0,1.0,1.0,80117715,7,7
0,3,0.0,0.0,82041906,3,0
0,2,0.0,0.0,82041909,2,0
2,20,0.5918367346938775,0.9591836734693877,80139934,49,29
2,0,1.0,1.0,82018997,1,1
2,3,0.90625,0.5,70314251,32,29
2,0,1.0,1.0,77603120,10,10
2,0,1.0,1.0,70809242,4,4
0,29,0.23684210526315788,0.453125,80137556,38,9
2,2,0.9130434782608695,0.75,82051896,23,21
2,1,0.6666666666666666,0.5,82126277,3,2
2,1,0.967741935483871,0.5,80136538,31,30
1,35,0.2391304347826087,0.6476190476190476,69895833,46,11
2,2,0.5,0.96875,82024270,4,2
0,3,0.0,0.0,82024372,3,0
2,2,0.5,0.6666666666666666,69715604,4,2
2,0,1.0,1.0,74362540,3,3
1,14,0.48148148148148145,0.6538461538461539,69753593,27,13
2,4,0.6666666666666666,0.75,67719561,12,8
2,0,1.0,1.0,82102162,2,2
1,12,0.3333333333333333,0.6785714285714286,66304560,18,6
2,0,1.0,1.0,82036955,17,17
2,2,0.6,0.8571428571428571,80176870,5,3
2,0,1.0,1.0,80118457,7,7
2,3,0.625,0.5,70343441,8,5
2,9,0.6785714285714286,0.9523809523809523,70343490,28,19
2,2,0.7777777777777778,0.6,82095118,9,7
2,0,1.0,1.0,82037231,3,3
2,5,0.5833333333333334,0.8260869565217391,69533233,12,7
2,4,0.5,0.8888888888888888,80053792,8,4
1,10,0.47368421052631576,0.9512195121951219,75048085,19,9
1,11,0.47619047619047616,0.7073170731707317,80158250,21,10
0,18,0.21739130434782608,0.1590909090909091,80158318,23,5
2,16,0.6190476190476191,0.975,76562486,42,26
2,14,0.5172413793103449,0.3333333333333333,63691124,29,15
2,3,0.6666666666666666,0.9166666666666666,80128549,9,6
2,0,1.0,1.0,80175963,2,2
2,5,0.7222222222222222,0.7272727272727273,82062191,18,13
2,0,1.0,1.0,70521584,1,1
2,11,0.6451612903225806,0.9767441860465116,82023694,31,20
2,2,0.5,0.5,70037394,4,2
2,0,1.0,1.0,70537502,10,10
2,1,0.6666666666666666,0.6666666666666666,70508613,3,2
2,0,1.0,1.0,82052075,5,5
1,6,0.3333333333333333,0.6,70677320,9,3
1,9,0.4375,0.825,70694435,16,7
0,7,0.125,0.19230769230769232,70222362,8,1
2,0,1.0,1.0,13734490,2,2
2,6,0.7391304347826086,0.9090909090909091,72790620,23,17
1,13,0.35,0.9183673469387755,63771323,20,7
0,7,0.125,0.0,70536424,8,1
2,7,0.7666666666666667,0.9615384615384616,70611940,30,23
0,21,0.16,0.3170731707317073,70910966,25,4
1,12,0.3684210526315789,0.9142857142857143,76610814,19,7
0,15,0.0625,0.08108108108108109,82143810,16,1
2,14,0.5333333333333333,0.92,67485782,30,16
0,10,0.16666666666666666,0.125,67995823,12,2
1,22,0.37142857142857144,0.9111111111111111,69180755,35,13
0,6,0.0,0.0,69315764,6,0
0,3,0.25,0.16666666666666666,69315806,4,1
0,3,0.25,0.16666666666666666,69315813,4,1
0,27,0.0,0.0,80150802,27,0
0,26,0.23529411764705882,0.40625,82103791,34,8
0,25,0.0,0.0,69526086,25,0
0,16,0.0,0.0,69526352,16,0
0,26,0.10344827586206896,0.3939393939393939,80150803,29,3
0,9,0.18181818181818182,0.39285714285714285,64359792,11,2
0,32,0.058823529411764705,0.2037037037037037,82116593,34,2
0,9,0.0,0.0,64360156,9,0
2,10,0.5454545454545454,0.8125,80127016,22,12
0,7,0.125,0.45454545454545453,67454926,8,1
0,12,0.07692307692307693,0.07692307692307693,73460051,13,1
0,22,0.043478260869565216,0.1926605504587156,80150806,23,1
0,10,0.16666666666666666,0.39473684210526316,69890513,12,2
1,22,0.4358974358974359,0.9382716049382716,82053051,39,17
0,7,0.0,0.0,69525883,7,0
0,21,0.045454545454545456,0.25217391304347825,80150812,22,1
0,1,0.0,0.0,80126763,1,0
0,8,0.0,0.0,80126814,8,0
1,3,0.4,0.8333333333333334,70417480,5,2
0,14,0.06666666666666667,0.08695652173913043,70222355,15,1
1,11,0.45,0.926829268292683,69464983,20,9
1,33,0.4107142857142857,0.8932038834951457,67833822,56,23
0,24,0.1724137931034483,0.3880597014925373,80122909,29,5
2,15,0.5161290322580645,0.8928571428571429,80176061,31,16
1,21,0.25,0.5922330097087378,80131304,28,7
0,8,0.1111111111111111,0.11764705882352941,69664140,9,1
1,5,0.375,0.7619047619047619,80135275,8,3
1,20,0.23076923076923078,0.5833333333333334,70467964,26,6
1,34,0.30612244897959184,0.5131578947368421,74058845,49,15
2,1,0.5,0.5,64041656,2,1
1,9,0.25,0.55,82103918,12,3
1,2,0.3333333333333333,0.8461538461538461,69637981,3,1
1,22,0.40540540540540543,0.7692307692307693,65716140,37,15
2,5,0.75,0.9166666666666666,64475551,20,15
1,5,0.2857142857142857,0.7272727272727273,82006188,7,2
1,5,0.4444444444444444,0.8888888888888888,82006297,9,4
1,16,0.30434782608695654,0.8,63273924,23,7
1,16,0.4666666666666667,0.9166666666666666,80125059,30,14
0,9,0.1,0.21428571428571427,69415885,10,1
0,3,0.25,0.4375,66225971,4,1
1,7,0.36363636363636365,0.625,79854124,11,4
1,9,0.4,0.896551724137931,69726734,15,6
2,2,0.8181818181818182,0.75,82145541,11,9
2,4,0.5555555555555556,0.9,69404076,9,5
0,34,0.10526315789473684,0.21428571428571427,70681233,38,4
1,12,0.2,0.5833333333333334,70699496,15,3
1,11,0.35294117647058826,0.6666666666666666,80180600,17,6
0,33,0.21428571428571427,0.37037037037037035,70760942,42,9
1,18,0.3333333333333333,0.8833333333333333,70057596,27,9
2,10,0.7058823529411765,0.9583333333333334,67744383,34,24
0,1,0.0,0.0,66973116,1,0
1,23,0.34285714285714286,0.7,80051860,35,12
2,5,0.6153846153846154,0.9375,69831692,13,8
1,9,0.4375,0.8571428571428571,68286253,16,7
0,4,0.0,0.0,69575303,4,0
0,1,0.0,0.0,82251172,1,0
0,13,0.07142857142857142,0.30612244897959184,70703731,14,1
0,4,0.0,0.0,70705992,4,0
0,6,0.0,0.0,70742924,6,0
1,2,0.3333333333333333,0.875,70743554,3,1
0,2,0.0,0.0,70743834,2,0
0,1,0.0,0.0,70229173,1,0
0,2,0.0,0.0,70229250,2,0
0,20,0.0,0.0,70229313,20,0
2,7,0.5333333333333333,0.9523809523809523,69489140,15,8
1,23,0.25806451612903225,0.5882352941176471,69183226,31,8
0,1,0.0,0.0,69064142,1,0
2,0,1.0,1.0,82046080,2,2
2,4,0.8461538461538461,0.9047619047619048,80178932,26,22
0,7,0.125,0.0,82163476,8,1
0,32,0.13513513513513514,0.3858267716535433,69549732,37,5
2,0,1.0,1.0,80134840,2,2
0,13,0.2777777777777778,0.375,82010277,18,5
1,18,0.35714285714285715,0.8468468468468469,70494816,28,10
0,23,0.11538461538461539,0.12903225806451613,71458555,26,3
1,10,0.375,0.9428571428571428,69549564,16,6
0,29,0.12121212121212122,0.27586206896551724,70242781,33,4
0,9,0.0,0.0,70036750,9,0
0,10,0.09090909090909091,0.08695652173913043,72417471,11,1
2,3,0.5,0.8888888888888888,70751212,6,3
0,16,0.15789473684210525,0.26785714285714285,82116863,19,3
0,5,0.0,0.0,82116864,5,0
1,23,0.3235294117647059,0.8833333333333333,64030064,34,11
2,0,1.0,1.0,967631,33,33
0,44,0.12,0.310126582278481,65713116,50,6
1,8,0.3333333333333333,0.7857142857142857,68635455,12,4
0,1,0.0,0.0,82121151,1,0
2,4,0.5555555555555556,0.875,65598694,9,5
2,1,0.75,0.8333333333333334,72802191,4,3
0,10,0.09090909090909091,0.06666666666666667,82023576,11,1
2,11,0.8135593220338984,0.8571428571428571,67080405,59,48
2,0,1.0,1.0,82018924,1,1
2,3,0.625,0.75,80172019,8,5
1,13,0.35,0.8,66203900,20,7
2,6,0.6,0.9,69958665,15,9
1,17,0.43333333333333335,0.8169014084507042,65596230,30,13
1,26,0.35,0.7721518987341772,80176608,40,14
1,10,0.16666666666666666,0.5294117647058824,70759290,12,2
1,41,0.19607843137254902,0.6530612244897959,80125970,51,10
2,12,0.5384615384615384,0.9047619047619048,70720132,26,14
2,2,0.7777777777777778,0.6666666666666666,54552330,9,7
0,25,0.16666666666666666,0.3333333333333333,70693665,30,5
0,1,0.0,0.0,82010305,1,0
2,0,1.0,1.0,75636225,12,12
0,153,0.13559322033898305,0.17537313432835822,67630661,177,24
0,1,0.0,0.0,65293312,1,0
0,15,0.0,0.0,66378851,15,0
0,7,0.125,0.1,69544251,8,1
0,55,0.11290322580645161,0.40993788819875776,80149808,62,7
0,3,0.0,0.0,82102800,3,0
2,0,1.0,1.0,79838570,4,4
1,16,0.38461538461538464,0.5925925925925926,70720146,26,10
0,11,0.26666666666666666,0.2727272727272727,70720174,15,4
0,70,0.10256410256410256,0.38666666666666666,67887246,78,8
0,4,0.0,0.0,82102760,4,0
1,19,0.2962962962962963,0.6883116883116883,70078176,27,8
0,9,0.1,0.0,80162642,10,1
0,5,0.0,0.0,70692902,5,0
0,1,0.0,0.0,70694526,1,0
0,35,0.027777777777777776,0.16176470588235295,70639534,36,1
0,26,0.0,0.0,82173337,26,0
2,0,1.0,1.0,70720601,1,1
0,17,0.2608695652173913,0.2727272727272727,62148450,23,6
0,53,0.15873015873015872,0.25,65715853,63,10
2,2,0.6,0.75,66560655,5,3
1,20,0.3548387096774194,0.6808510638297872,69318242,31,11
2,1,0.5,0.5,69726384,2,1
1,33,0.42105263157894735,0.9532710280373832,63781914,57,24
1,10,0.2857142857142857,0.8529411764705882,75456654,14,4
0,46,0.041666666666666664,0.12060301507537688,67846422,48,2
2,20,0.5348837209302325,0.9459459459459459,68294275,43,23
0,11,0.26666666666666666,0.3793103448275862,74635176,15,4
2,2,0.5,0.9166666666666666,69589282,4,2
0,34,0.02857142857142857,0.06666666666666667,80124254,35,1
0,9,0.0,0.0,72809240,9,0
1,67,0.30927835051546393,0.5588235294117647,81978956,97,30
1,19,0.32142857142857145,0.5675675675675675,80133075,28,9
2,2,0.6,0.9285714285714286,68415956,5,3
2,37,0.6509433962264151,0.9078947368421053,70867111,106,69
1,33,0.37735849056603776,0.6818181818181818,70867230,53,20
2,1,0.75,0.5,68613846,4,3
0,13,0.07142857142857142,0.28,70746746,14,1
2,0,1.0,1.0,80134067,9,9
0,28,0.125,0.296875,79784096,32,4
2,12,0.52,0.9545454545454546,72802765,25,13
2,24,0.5384615384615384,0.9512195121951219,76918030,52,28
0,22,0.043478260869565216,0.21649484536082475,70675591,23,1
0,12,0.14285714285714285,0.2765957446808511,70683074,14,2
2,2,0.8888888888888888,0.8,70892353,18,16
1,11,0.21428571428571427,0.6216216216216216,69534220,14,3
1,10,0.375,0.88,80052672,16,6
1,16,0.4482758620689655,0.9607843137254902,69183821,29,13
1,6,0.4,0.6666666666666666,67782960,10,4
2,0,1.0,1.0,67199244,7,7
1,9,0.4,0.85,72802625,15,6
2,1,0.5,0.6666666666666666,71619191,2,1
0,12,0.07692307692307693,0.03636363636363636,66423651,13,1
2,15,0.5161290322580645,0.96,81989266,31,16
0,15,0.0,0.0,67094202,15,0
1,17,0.05555555555555555,0.5151515151515151,67094412,18,1
1,8,0.2727272727272727,0.7272727272727273,69555290,11,3
0,3,0.0,0.0,69555381,3,0
0,4,0.2,0.3,67376512,5,1
1,7,0.4166666666666667,0.85,82054048,12,5
2,2,0.5,0.8571428571428571,72522142,4,2
1,15,0.4230769230769231,0.8780487804878049,68791303,26,11
1,13,0.13333333333333333,0.5483870967741935,67225914,15,2
1,10,0.4117647058823529,0.9333333333333333,705621,17,7
1,18,0.25,0.5,80131226,24,6
0,88,0.043478260869565216,0.16517857142857142,82003742,92,4
2,2,0.5,0.7777777777777778,69404622,4,2
2,1,0.5,0.0,67744502,2,1
1,33,0.25,0.6739130434782609,67591573,44,11
2,5,0.5,0.3333333333333333,80176345,10,5
0,47,0.0784313725490196,0.2366412213740458,80118316,51,4
0,54,0.1,0.3357142857142857,80118318,60,6
1,18,0.18181818181818182,0.6542056074766355,69003172,22,4
1,4,0.3333333333333333,0.8823529411764706,82152069,6,2
0,26,0.037037037037037035,0.027777777777777776,76080844,27,1
1,20,0.3939393939393939,0.8205128205128205,82062238,33,13
0,8,0.1111111111111111,0.4838709677419355,82019420,9,1
0,14,0.0,0.0,82022537,14,0
2,4,0.6923076923076923,0.625,80172919,13,9
0,3,0.0,0.0,67980003,3,0
1,5,0.375,0.8260869565217391,70695002,8,3
1,56,0.3,0.5901639344262295,69183100,80,24
0,3,0.25,0.2,69092716,4,1
2,2,0.5,0.6666666666666666,70611674,4,2
2,0,1.0,1.0,74043550,2,2
0,69,0.1686746987951807,0.3055555555555556,80141459,83,14
0,34,0.17073170731707318,0.3870967741935484,80141467,41,7
0,11,0.21428571428571427,0.05263157894736842,70413511,14,3
1,21,0.19230769230769232,0.6185567010309279,82040805,26,5
0,26,0.13333333333333333,0.1650485436893204,70045234,30,4
1,7,0.36363636363636365,0.8,70842884,11,4
0,36,0.1,0.3211009174311927,61976922,40,4
1,12,0.29411764705882354,0.8095238095238095,61977062,17,5
1,17,0.41379310344827586,0.9545454545454546,61977104,29,12
0,17,0.10526315789473684,0.17857142857142858,66221505,19,2
1,9,0.4,0.88,65908472,15,6
2,0,1.0,1.0,66138716,2,2
1,11,0.35294117647058826,0.84375,65291114,17,6
0,9,0.1,0.3181818181818182,70629734,10,1
0,10,0.0,0.0,72808806,10,0
2,0,1.0,1.0,65282602,3,3
1,3,0.25,0.6,80141495,4,1
2,1,0.9375,0.5,68191725,16,15
1,12,0.3333333333333333,0.6666666666666666,70585753,18,6
2,8,0.5789473684210527,0.875,70585781,19,11
2,17,0.6046511627906976,0.9444444444444444,71416506,43,26
1,31,0.38,0.75,69708534,50,19
0,41,0.14583333333333334,0.12280701754385964,62703382,48,7
0,11,0.08333333333333333,0.06382978723404255,67888723,12,1
0,1,0.0,0.0,67592196,1,0
0,2,0.0,0.0,64222585,2,0
1,25,0.3902439024390244,0.7755102040816326,70005313,41,16
1,13,0.4583333333333333,0.9493670886075949,81971188,24,11
0,1,0.0,0.0,82015871,1,0
2,5,0.8214285714285714,0.8571428571428571,75576501,28,23
1,16,0.4666666666666667,0.8292682926829268,67063010,30,14
2,15,0.625,0.9827586206896551,72417870,40,25
1,10,0.2857142857142857,0.6153846153846154,76905381,14,4
0,17,0.05555555555555555,0.24615384615384617,70649663,18,1
1,3,0.25,0.6470588235294118,80125412,4,1
2,15,0.7,0.972972972972973,69068986,50,35
2,3,0.5,0.9090909090909091,70869953,6,3
0,31,0.11428571428571428,0.16666666666666666,69534150,35,4
0,15,0.16666666666666666,0.26666666666666666,69534234,18,3
0,9,0.1,0.15789473684210525,69534241,10,1
1,19,0.24,0.8,80028816,25,6
1,23,0.28125,0.6825396825396826,69582982,32,9
2,2,0.8666666666666667,0.75,70760200,15,13
0,26,0.10344827586206896,0.21296296296296297,67706023,29,3
1,4,0.2,0.6744186046511628,69839546,5,1
2,13,0.6904761904761905,0.9830508474576272,80126944,42,29
0,4,0.2,0.35714285714285715,70494564,5,1
2,2,0.875,0.6666666666666666,67404022,16,14
0,77,0.0,0.0,68743500,77,0
0,41,0.22641509433962265,0.4791666666666667,82005351,53,12
1,15,0.34782608695652173,0.8055555555555556,69391175,23,8
0,11,0.21428571428571427,0.4166666666666667,70633332,14,3
1,18,0.45454545454545453,0.9,63738486,33,15
1,16,0.3333333333333333,0.75,66892826,24,8
0,55,0.06779661016949153,0.11510791366906475,66931193,59,4
0,37,0.11904761904761904,0.3247863247863248,70746816,42,5
0,39,0.15217391304347827,0.34408602150537637,72906785,46,7
2,7,0.7407407407407407,0.9411764705882353,69729772,27,20
0,9,0.1,0.038461538461538464,70957096,10,1
2,21,0.6037735849056604,0.8947368421052632,80019730,53,32
1,32,0.13513513513513514,0.5151515151515151,80124216,37,5
2,1,0.5,0.8571428571428571,70704235,2,1
1,3,0.4,0.6666666666666666,82002288,5,2
1,18,0.3333333333333333,0.7105263157894737,65282175,27,9
1,12,0.3333333333333333,0.7931034482758621,65280880,18,6
1,6,0.3333333333333333,0.8148148148148148,66379544,9,3
0,17,0.2608695652173913,0.4444444444444444,65281321,23,6
1,28,0.42857142857142855,0.9230769230769231,70688156,49,21
2,7,0.5882352941176471,0.8333333333333334,82164891,17,10
2,7,0.6818181818181818,0.9642857142857143,80176869,22,15
2,16,0.5294117647058824,0.8275862068965517,80165323,34,18
1,13,0.2777777777777778,0.5,80130840,18,5
0,30,0.11764705882352941,0.23529411764705882,73460135,34,4
2,18,0.55,0.9523809523809523,62580714,40,22
0,9,0.1,0.07407407407407407,75327273,10,1
2,13,0.5806451612903226,0.9791666666666666,62141324,31,18
0,28,0.2631578947368421,0.44776119402985076,67187190,38,10
2,3,0.8125,0.8,68163074,16,13
0,14,0.0,0.0,67094426,14,0
0,4,0.0,0.0,67094804,4,0
2,1,0.6666666666666666,0.8,80165167,3,2
0,4,0.0,0.0,70850682,4,0
2,2,0.6,0.6666666666666666,82022950,5,3
0,1,0.0,0.0,82022956,1,0
0,25,0.07407407407407407,0.034482758620689655,82096293,27,2
0,2,0.0,0.0,68680451,2,0
2,7,0.5,0.8888888888888888,69188042,14,7
1,42,0.25,0.5677966101694916,82126686,56,14
0,16,0.058823529411764705,0.13043478260869565,70036932,17,1
2,6,0.8064516129032258,0.9230769230769231,72964570,31,25
1,13,0.1875,0.5526315789473685,82103809,16,3
0,7,0.0,0.0,70678391,7,0
2,3,0.5,0.75,72475200,6,3
0,24,0.1111111111111111,0.2647058823529412,80140075,27,3
0,25,0.07407407407407407,0.2,80141447,27,2
2,1,0.6666666666666666,0.75,82152761,3,2
1,9,0.4,0.7368421052631579,82041325,15,6
0,10,0.0,0.0,69520640,10,0
0,29,0.14705882352941177,0.18681318681318682,82141886,34,5
1,14,0.3333333333333333,0.6875,68238044,21,7
0,23,0.14814814814814814,0.1935483870967742,73634596,27,4
2,0,1.0,1.0,80134063,17,17
1,32,0.49206349206349204,0.8636363636363636,80083465,63,31
1,20,0.3103448275862069,0.5,80176681,29,9
0,31,0.225,0.4235294117647059,69415976,40,9
0,14,0.125,0.25862068965517243,70063595,16,2
2,37,0.5194805194805194,0.8923076923076924,69697796,77,40
0,2,0.3333333333333333,0.4,65279585,3,1
0,2,0.0,0.0,70812910,2,0
0,8,0.0,0.0,80140087,8,0
0,12,0.0,0.0,67435914,12,0
2,12,0.5714285714285714,0.9615384615384616,66103310,28,16
1,3,0.4,0.7058823529411765,63984123,5,2
0,15,0.0,0.0,82202362,15,0
2,2,0.9,0.8888888888888888,82060081,20,18
2,1,0.75,0.0,82039326,4,3
1,5,0.4444444444444444,0.6470588235294118,69616673,9,4
1,45,0.3835616438356164,0.8035714285714286,70508921,73,28
2,1,0.5,0.5,66238165,2,1
2,1,0.9,0.5,69058556,10,9
0,5,0.16666666666666666,0.0,70250621,6,1
2,0,1.0,1.0,80126551,4,4
1,5,0.375,0.6923076923076923,82109936,8,3
1,6,0.3333333333333333,0.72,82010280,9,3
0,16,0.15789473684210525,0.047619047619047616,80172977,19,3
0,3,0.0,0.0,70702912,3,0
0,1,0.0,0.0,70707623,1,0
1,6,0.4,0.8461538461538461,73522526,10,4
1,9,0.4375,0.8235294117647058,69404601,16,7
1,40,0.3548387096774194,0.8311688311688312,80128517,62,22
2,7,0.5333333333333333,0.7647058823529411,69530944,15,8
2,2,0.7142857142857143,0.6666666666666666,69967240,7,5
0,4,0.2,0.16666666666666666,68791156,5,1
0,3,0.0,0.0,82040649,3,0
2,3,0.5,0.8,64303946,6,3
2,1,0.96875,0.5,80137911,32,31
2,7,0.65,0.8,82165049,20,13
0,8,0.0,0.0,72808701,8,0
2,3,0.8421052631578947,0.8,68625046,19,16
2,10,0.5454545454545454,0.96875,65281531,22,12
1,7,0.36363636363636365,0.625,70919233,11,4
0,5,0.2857142857142857,0.46153846153846156,69560834,7,2
1,5,0.4444444444444444,0.7777777777777778,65602243,9,4
0,14,0.2631578947368421,0.1,80178152,19,5
2,2,0.8333333333333334,0.9230769230769231,80137034,12,10
2,2,0.6666666666666666,0.8333333333333334,66086804,6,4
0,44,0.10204081632653061,0.13131313131313133,68500061,49,5
0,5,0.0,0.0,69479585,5,0
0,53,0.07017543859649122,0.32786885245901637,63526855,57,4
1,27,0.2894736842105263,0.6301369863013698,80125517,38,11
2,2,0.6,0.9166666666666666,66842202,5,3
0,23,0.17857142857142858,0.2647058823529412,67513810,28,5
2,2,0.8181818181818182,0.6666666666666666,70509145,11,9
1,7,0.36363636363636365,0.5555555555555556,80139895,11,4
2,5,0.6428571428571429,0.875,80139896,14,9
0,7,0.0,0.0,82022531,7,0
1,6,0.45454545454545453,0.8095238095238095,80145759,11,5
0,62,0.07462686567164178,0.109375,70681604,67,5
0,10,0.09090909090909091,0.2972972972972973,80046113,11,1
2,19,0.6545454545454545,0.92,73651865,55,36
0,46,0.14814814814814814,0.44274809160305345,71620066,54,8
0,7,0.125,0.34375,82102935,8,1
1,53,0.2318840579710145,0.7471910112359551,70917413,69,16
1,7,0.4166666666666667,0.9090909090909091,73171805,12,5
1,15,0.3181818181818182,0.6578947368421053,80178111,22,7
1,6,0.25,0.5714285714285714,69729695,8,2
0,3,0.0,0.0,70705306,3,0
1,14,0.46153846153846156,0.8709677419354839,68025195,26,12
2,1,0.75,0.5,68757465,4,3
0,45,0.021739130434782608,0.015228426395939087,63527471,46,1
0,41,0.14583333333333334,0.12903225806451613,62497743,48,7
0,60,0.16666666666666666,0.1657142857142857,69180272,72,12
1,10,0.2857142857142857,0.6486486486486487,82002292,14,4
0,13,0.13333333333333333,0.0625,68211556,15,2
1,11,0.3125,0.7843137254901961,68715031,16,5
2,1,0.6666666666666666,0.6666666666666666,68341581,3,2
1,15,0.4444444444444444,0.8775510204081632,75974143,27,12
1,14,0.4166666666666667,0.8536585365853658,76117741,24,10
0,65,0.13333333333333333,0.24113475177304963,70680281,75,10
1,25,0.2857142857142857,0.5891472868217055,70843941,35,10
0,5,0.16666666666666666,0.3333333333333333,70685321,6,1
2,10,0.6153846153846154,0.972972972972973,73588886,26,16
2,15,0.53125,0.9473684210526315,69522873,32,17
0,3,0.0,0.0,60032574,3,0
0,11,0.15384615384615385,0.10810810810810811,68044753,13,2
2,2,0.6666666666666666,0.75,68040042,6,4
2,9,0.7,0.9230769230769231,70520604,30,21
2,0,1.0,1.0,82033189,17,17
1,32,0.15789473684210525,0.5206611570247934,74924304,38,6
1,13,0.35,0.7368421052631579,66964254,20,7
1,10,0.375,0.8571428571428571,69064541,16,6
1,6,0.3333333333333333,0.6923076923076923,69042722,9,3
1,13,0.07142857142857142,0.5,80150730,14,1
1,45,0.11764705882352941,0.5606060606060606,70918491,51,6
0,17,0.10526315789473684,0.40298507462686567,68213586,19,2
0,4,0.0,0.0,70634620,4,0
0,1,0.0,0.0,82006533,1,0
0,29,0.06451612903225806,0.2,67978155,31,2
0,28,0.0,0.0,82049095,28,0
0,14,0.0,0.0,80150712,14,0
1,13,0.07142857142857142,0.5441176470588235,70923104,14,1
0,13,0.13333333333333333,0.45,78166284,15,2
1,20,0.13043478260869565,0.5833333333333334,70463106,23,3
0,9,0.1,0.44642857142857145,80163389,10,1
0,22,0.043478260869565216,0.10833333333333334,70468195,23,1
0,25,0.10714285714285714,0.4153846153846154,67585546,28,3
1,6,0.4,0.9310344827586207,67977931,10,4
1,107,0.13008130081300814,0.512396694214876,70671811,123,16
2,1,0.75,0.3333333333333333,68618375,4,3
1,7,0.2222222222222222,0.6666666666666666,82006737,9,2
0,1,0.0,0.0,82006771,1,0
0,8,0.0,0.0,80150682,8,0
1,21,0.38235294117647056,0.8108108108108109,69733125,34,13
0,3,0.0,0.0,80176299,3,0
2,4,0.5,0.9444444444444444,70629825,8,4
1,7,0.2222222222222222,0.6578947368421053,82118280,9,2
0,25,0.07407407407407407,0.36585365853658536,67045713,27,2
1,17,0.2608695652173913,0.7,69559105,23,6
1,13,0.23529411764705882,0.7073170731707317,71081535,17,4
0,7,0.125,0.4230769230769231,80135066,8,1
0,2,0.0,0.0,80150537,2,0
0,7,0.0,0.0,80150595,7,0
0,74,0.0975609756097561,0.4894366197183099,67839072,82,8
0,1,0.0,0.0,80162883,1,0
0,2,0.0,0.0,80170912,2,0
0,26,0.10344827586206896,0.36470588235294116,67435123,29,3
0,10,0.0,0.0,80089191,10,0
1,19,0.20833333333333334,0.5862068965517241,80135238,24,5
0,9,0.0,0.0,80150591,9,0
0,3,0.0,0.0,80150651,3,0
1,19,0.17391304347826086,0.5087719298245614,72868124,23,4
1,62,0.1388888888888889,0.5099601593625498,69497806,72,10
0,4,0.3333333333333333,0.45454545454545453,70036694,6,2
1,9,0.1,0.6041666666666666,80150508,10,1
1,4,0.2,0.625,80150530,5,1
0,1,0.0,0.0,80150628,1,0
0,13,0.0,0.0,66889410,13,0
0,30,0.14285714285714285,0.40229885057471265,67862865,35,5
0,5,0.0,0.0,67758425,5,0
0,49,0.02,0.2066420664206642,67004350,50,1
0,15,0.0,0.0,82102561,15,0
0,16,0.058823529411764705,0.27586206896551724,82102918,17,1
0,35,0.0,0.0,67051446,35,0
2,33,0.5769230769230769,0.8666666666666667,69733153,78,45
0,3,0.0,0.0,80153660,3,0
0,5,0.0,0.0,80150626,5,0
1,9,0.18181818181818182,0.7142857142857143,65363935,11,2
0,29,0.03333333333333333,0.2721518987341772,82103946,30,1
1,12,0.25,0.8032786885245902,68246402,16,4
1,14,0.06666666666666667,0.6565656565656566,80150861,15,1
1,16,0.2,0.8103448275862069,64359820,20,4
0,4,0.0,0.0,80176286,4,0
0,8,0.0,0.0,67051355,8,0
0,39,0.04878048780487805,0.2413793103448276,70923384,41,2
1,10,0.16666666666666666,0.675,74924150,12,2
0,10,0.0,0.0,80170978,10,0
1,12,0.2,0.6144578313253012,69887076,15,3
1,19,0.20833333333333334,0.7746478873239436,63782061,24,5
0,10,0.0,0.0,80150859,10,0
1,14,0.125,0.5128205128205128,70463015,16,2
0,14,0.2631578947368421,0.4117647058823529,73588914,19,5
0,18,0.0,0.0,78540735,18,0
2,7,0.5,0.9811320754716981,69879390,14,7
1,8,0.1111111111111111,0.5824175824175825,82118244,9,1
0,27,0.03571428571428571,0.23577235772357724,69858222,28,1
0,21,0.045454545454545456,0.3258426966292135,70343602,22,1
0,21,0.0,0.0,80150911,21,0
1,17,0.15,0.5161290322580645,82034199,20,3
0,14,0.125,0.44680851063829785,80128456,16,2
0,11,0.08333333333333333,0.29411764705882354,80172582,12,1
0,8,0.2727272727272727,0.375,82002270,11,3
0,11,0.45,0.4117647058823529,70121814,20,9
0,16,0.1111111111111111,0.06896551724137931,74882514,18,2
0,4,0.0,0.0,70459466,4,0
1,6,0.25,0.5714285714285714,70459473,8,2
2,1,0.5,0.875,70459522,2,1
2,3,0.7272727272727273,0.8,80093755,11,8
1,34,0.2916666666666667,0.7076923076923077,79788492,48,14
2,22,0.5416666666666666,0.9,69054475,48,26
2,0,1.0,1.0,69980176,1,1
0,3,0.0,0.0,82165048,3,0
1,32,0.3191489361702128,0.7227722772277227,69534906,47,15
1,26,0.4090909090909091,0.972972972972973,73637683,44,18
1,7,0.46153846153846156,0.8,72802590,13,6
0,9,0.0,0.0,72809233,9,0
1,6,0.3333333333333333,0.53125,68530175,9,3
0,6,0.14285714285714285,0.4,69143403,7,1
1,16,0.2,0.52,70850815,20,4
0,11,0.3888888888888889,0.42857142857142855,69514410,18,7
0,33,0.26666666666666666,0.4375,65278696,45,12
0,6,0.0,0.0,66035221,6,0
0,10,0.0,0.0,80131239,10,0
2,0,1.0,1.0,67181744,3,3
1,5,0.2857142857142857,0.631578947368421,69185445,7,2
0,12,0.07692307692307693,0.027777777777777776,65280180,13,1
2,4,0.6,0.8181818181818182,80126926,10,6
2,8,0.7894736842105263,0.875,82020064,38,30
1,15,0.2857142857142857,0.725,68255264,21,6
0,22,0.08333333333333333,0.0,82187812,24,2
2,2,0.5,0.9285714285714286,82070158,4,2
0,6,0.0,0.0,70509656,6,0
1,11,0.45,0.9302325581395349,72801491,20,9
0,4,0.3333333333333333,0.4444444444444444,69064044,6,2
0,10,0.2857142857142857,0.26666666666666666,82039849,14,4
0,11,0.15384615384615385,0.2,63317590,13,2
1,35,0.33962264150943394,0.855072463768116,67526515,53,18
0,5,0.0,0.0,69910575,5,0
1,10,0.2857142857142857,0.7058823529411765,80162867,14,4
0,36,0.14285714285714285,0.4825174825174825,74923842,42,6
1,9,0.25,0.8793103448275862,70581931,12,3
0,12,0.14285714285714285,0.25396825396825395,80105130,14,2
1,4,0.42857142857142855,0.9166666666666666,81971190,7,3
2,1,0.8571428571428571,0.5,74316410,7,6
0,45,0.11764705882352941,0.2702702702702703,68199670,51,6
1,5,0.16666666666666666,0.5,82022517,6,1
0,5,0.0,0.0,61871915,5,0
1,20,0.2857142857142857,0.52,75099220,28,8
0,19,0.2692307692307692,0.3448275862068966,70823445,26,7
1,43,0.23214285714285715,0.5692307692307692,81965340,56,13
0,13,0.2777777777777778,0.42857142857142855,80123729,18,5
1,17,0.41379310344827586,0.8620689655172413,80175652,29,12
1,8,0.3333333333333333,0.75,18570090,12,4
0,19,0.09523809523809523,0.07692307692307693,66304791,21,2
0,23,0.23333333333333334,0.4,66305141,30,7
2,1,0.5,0.3333333333333333,70712145,2,1
1,46,0.3235294117647059,0.6776859504132231,67657765,68,22
0,16,0.23809523809523808,0.08823529411764706,61702550,21,5
0,43,0.23214285714285715,0.4015748031496063,68434233,56,13
1,4,0.42857142857142855,0.8461538461538461,73172155,7,3
1,23,0.425,0.8135593220338984,66589082,40,17
2,4,0.5555555555555556,0.9375,70926352,9,5
1,3,0.25,0.6060606060606061,75149634,4,1
0,3,0.0,0.0,67182304,3,0
2,2,0.5,0.7692307692307693,69966316,4,2
2,8,0.5294117647058824,0.9354838709677419,70925603,17,9
2,0,1.0,1.0,80159545,16,16
2,0,1.0,1.0,63159803,1,1
2,0,1.0,1.0,70324856,1,1
1,5,0.2857142857142857,0.6,68996326,7,2
1,26,0.43478260869565216,0.98,69180790,46,20
0,6,0.25,0.47619047619047616,67627070,8,2
0,22,0.08333333333333333,0.20253164556962025,70474495,24,2
0,54,0.11475409836065574,0.42857142857142855,63628474,61,7
0,34,0.10526315789473684,0.375,63630133,38,4
0,44,0.10204081632653061,0.3511450381679389,69857872,49,5
0,14,0.0,0.0,70474873,14,0
0,23,0.14814814814814814,0.2037037037037037,82062470,27,4
1,12,0.14285714285714285,0.5882352941176471,80149976,14,2
0,2,0.0,0.0,69064324,2,0
0,2,0.0,0.0,67052972,2,0
2,10,0.5238095238095238,0.3333333333333333,82132595,21,11
2,12,0.5384615384615384,0.8918918918918919,72574803,26,14
0,15,0.0,0.0,80124207,15,0
0,17,0.10526315789473684,0.30434782608695654,70843444,19,2
1,6,0.45454545454545453,0.7755102040816326,73623172,11,5
0,5,0.2857142857142857,0.47058823529411764,70216391,7,2
1,14,0.2631578947368421,0.7608695652173914,80122860,19,5
0,40,0.0,0.0,63992971,40,0
0,17,0.10526315789473684,0.19696969696969696,70703101,19,2
1,4,0.3333333333333333,0.75,70704165,6,2
0,27,0.03571428571428571,0.14705882352941177,72909683,28,1
1,13,0.23529411764705882,0.864406779661017,71359456,17,4
1,6,0.3333333333333333,0.8823529411764706,70760410,9,3
2,2,0.5,0.5,74361511,4,2
0,7,0.125,0.0,75733651,8,1
0,40,0.09090909090909091,0.3157894736842105,63993356,44,4
0,2,0.0,0.0,69163486,2,0
0,13,0.07142857142857142,0.2558139534883721,67475296,14,1
1,29,0.3409090909090909,0.8103448275862069,69607776,44,15
0,7,0.0,0.0,70036582,7,0
0,7,0.2222222222222222,0.375,67551302,9,2
2,1,0.75,0.5,67787524,4,3
0,6,0.0,0.0,80126813,6,0
1,8,0.38461538461538464,0.7777777777777778,80172955,13,5
1,7,0.125,0.56,70676060,8,1
0,5,0.16666666666666666,0.4827586206896552,80126769,6,1
2,0,1.0,1.0,80150287,1,1
0,9,0.1,0.2,68625851,10,1
1,32,0.2727272727272727,0.5357142857142857,73635121,44,12
0,2,0.3333333333333333,0.42857142857142855,64173690,3,1
0,51,0.03773584905660377,0.18478260869565216,67434815,53,2
1,10,0.2857142857142857,0.8285714285714286,67434654,14,4
2,0,1.0,1.0,70037443,2,2
0,1,0.0,0.0,80165470,1,0
2,2,0.5,0.6666666666666666,80165472,4,2
1,12,0.3333333333333333,0.631578947368421,80131185,18,6
1,25,0.3055555555555556,0.6846846846846847,69953954,36,11
1,3,0.25,0.5,70702100,4,1
0,4,0.0,0.0,70702282,4,0
1,22,0.3333333333333333,0.7017543859649122,80122853,33,11
0,11,0.15384615384615385,0.3902439024390244,80123386,13,2
1,4,0.42857142857142855,0.9285714285714286,82010258,7,3
0,4,0.0,0.0,70703346,4,0
0,3,0.0,0.0,70707231,3,0
2,0,1.0,1.0,68191102,3,3
1,20,0.13043478260869565,0.6301369863013698,80028970,23,3
0,7,0.125,0.21052631578947367,79792293,8,1
1,10,0.23076923076923078,0.5416666666666666,70183785,13,3
1,39,0.36065573770491804,0.8125,82002258,61,22
1,5,0.4444444444444444,0.5714285714285714,80177410,9,4
2,3,0.6666666666666666,0.9629629629629629,72801855,9,6
0,14,0.125,0.3488372093023256,70568540,16,2
0,2,0.0,0.0,70866873,2,0
2,2,0.9,0.75,70537152,20,18
0,3,0.25,0.15384615384615385,70413525,4,1
1,11,0.3125,0.75,78901186,16,5
1,12,0.2,0.625,80149450,15,3
2,29,0.6627906976744186,0.8888888888888888,61388075,86,57
1,5,0.375,0.8,70608531,8,3
1,17,0.41379310344827586,0.8461538461538461,80175651,29,12
1,4,0.2,0.5789473684210527,69158173,5,1
2,6,0.5384615384615384,0.9444444444444444,67131001,13,7
2,3,0.5714285714285714,0.8571428571428571,68558105,7,4
0,6,0.25,0.42105263157894735,70415534,8,2
0,4,0.0,0.0,70692321,4,0
1,2,0.3333333333333333,0.8,70854224,3,1
2,5,0.5833333333333334,0.9285714285714286,70854413,12,7
1,11,0.42105263157894735,0.8064516129032258,68615456,19,8
2,2,0.5,0.8,67865581,4,2
1,7,0.46153846153846156,0.5454545454545454,70718753,13,6
0,5,0.2857142857142857,0.38461538461538464,66957030,7,2
1,17,0.32,0.7,70854105,25,8
1,8,0.42857142857142855,0.8181818181818182,66930255,14,6
0,1,0.0,0.0,72765910,1,0
0,1,0.0,0.0,72768346,1,0
2,0,1.0,1.0,68740280,1,1
2,0,1.0,1.0,69204002,1,1
1,27,0.2894736842105263,0.5409836065573771,69180356,38,11
0,5,0.16666666666666666,0.34782608695652173,70744954,6,1
0,12,0.07692307692307693,0.029411764705882353,70744961,13,1
1,17,0.2916666666666667,0.6857142857142857,69666744,24,7
1,5,0.16666666666666666,0.53125,82018912,6,1
2,5,0.7916666666666666,0.5714285714285714,65819586,24,19
2,2,0.5,0.75,65601403,4,2
1,16,0.3333333333333333,0.65625,82047598,24,8
1,7,0.3,0.7692307692307693,66035396,10,3
0,7,0.2222222222222222,0.4,65279655,9,2
2,11,0.56,0.9655172413793104,65282931,25,14
2,1,0.8,0.8333333333333334,80176260,5,4
1,18,0.21739130434782608,0.5454545454545454,69886285,23,5
0,14,0.2222222222222222,0.4594594594594595,80125557,18,4
0,38,0.09523809523809523,0.4954954954954955,64130185,42,4
2,3,0.7272727272727273,0.9375,69481090,11,8
0,4,0.3333333333333333,0.3333333333333333,80130720,6,2
1,27,0.3076923076923077,0.8461538461538461,62530426,39,12
2,0,1.0,1.0,69669376,1,1
1,49,0.3287671232876712,0.8481012658227848,70049413,73,24
2,1,0.6666666666666666,0.6666666666666666,67810155,3,2
2,3,0.5714285714285714,0.8571428571428571,69660633,7,4
0,15,0.25,0.4117647058823529,77012761,20,5
0,33,0.21428571428571427,0.4383561643835616,70568071,42,9
0,76,0.12643678160919541,0.24855491329479767,80122897,87,11
1,39,0.23529411764705882,0.5503875968992248,69421604,51,12
2,2,0.8571428571428571,0.6666666666666666,72802940,14,12
2,2,0.6,0.3333333333333333,70245280,5,3
1,6,0.25,0.5925925925925926,69549683,8,2
2,0,1.0,1.0,75397686,19,19
2,2,0.5,0.8333333333333334,80162652,4,2
2,2,0.7142857142857143,0.75,72844002,7,5
2,0,1.0,1.0,80151038,4,4
2,0,1.0,1.0,80080021,9,9
2,3,0.6666666666666666,0.6666666666666666,75577173,9,6
2,0,1.0,1.0,82102222,4,4
2,5,0.8484848484848485,0.875,74047064,33,28
2,1,0.5,0.0,75545890,2,1
2,7,0.7941176470588235,0.9285714285714286,70700721,34,27
2,0,1.0,1.0,80159558,11,11
2,1,0.8,0.5,69972700,5,4
2,3,0.8235294117647058,0.8571428571428571,70566503,17,14
1,8,0.42857142857142855,0.7857142857142857,82013597,14,6
0,9,0.1,0.0,70115185,10,1
2,0,1.0,1.0,80145850,1,1
2,0,1.0,1.0,70279636,7,7
2,2,0.5,0.6666666666666666,82054032,4,2
2,2,0.9130434782608695,0.75,69547611,23,21
2,6,0.5714285714285714,0.96875,80004155,14,8
0,7,0.0,0.0,70681226,7,0
2,3,0.5714285714285714,0.5,70543690,7,4
2,2,0.6666666666666666,0.8181818181818182,80158317,6,4
2,9,0.55,0.7142857142857143,68731656,20,11
2,0,1.0,1.0,75577551,9,9
1,4,0.2,0.8529411764705882,80164928,5,1
0,1,0.0,0.0,67286233,1,0
0,1,0.0,0.0,67286275,1,0
0,4,0.0,0.0,67286352,4,0
1,7,0.36363636363636365,0.6666666666666666,69117020,11,4
2,0,1.0,1.0,82041886,8,8
2,9,0.5,0.8928571428571429,82002225,18,9
1,7,0.3,0.6153846153846154,74539262,10,3
2,7,0.5,0.95,70860412,14,7
2,2,0.5,0.75,68254592,4,2
0,36,0.07692307692307693,0.304,77576744,39,3
0,21,0.045454545454545456,0.12962962962962962,77576772,22,1
0,11,0.15384615384615385,0.45454545454545453,77577241,13,2
0,14,0.3333333333333333,0.3157894736842105,70718872,21,7
2,1,0.6666666666666666,0.75,65899792,3,2
1,49,0.3,0.6859504132231405,80135838,70,21
2,1,0.8888888888888888,0.8,69979840,9,8
2,7,0.5333333333333333,0.9333333333333333,74816665,15,8
0,6,0.14285714285714285,0.058823529411764705,73783234,7,1
0,68,0.15,0.20454545454545456,68398162,80,12
1,9,0.25,0.5454545454545454,70045563,12,3
0,1,0.0,0.0,80150823,1,0
0,27,0.06896551724137931,0.3492063492063492,80150789,29,2
0,4,0.0,0.0,70712334,4,0
0,4,0.0,0.0,70704564,4,0
2,2,0.6,0.8,82105396,5,3
1,14,0.36363636363636365,0.6818181818181818,69967156,22,8
2,2,0.7777777777777778,0.75,82039364,9,7
0,32,0.13513513513513514,0.3387096774193548,76695332,37,5
0,38,0.20833333333333334,0.28865979381443296,70516033,48,10
1,9,0.4375,0.9,73522561,16,7
1,3,0.25,0.5333333333333333,82022893,4,1
0,5,0.16666666666666666,0.45454545454545453,67467932,6,1
2,5,0.8148148148148148,0.875,68942013,27,22
1,26,0.44680851063829785,0.8205128205128205,66859961,47,21
0,3,0.0,0.0,66784256,3,0
1,2,0.3333333333333333,0.75,66784270,3,1
0,3,0.0,0.0,69638002,3,0
0,77,0.16304347826086957,0.4303030303030303,70629510,92,15
2,0,1.0,1.0,66784326,2,2
1,5,0.375,0.625,68115222,8,3
0,20,0.0,0.0,80163368,20,0
2,4,0.5,0.9230769230769231,82206027,8,4
0,7,0.125,0.2857142857142857,66783192,8,1
0,5,0.0,0.0,66786741,5,0
0,3,0.0,0.0,66784816,3,0
1,11,0.42105263157894735,0.875,70629482,19,8
0,20,0.09090909090909091,0.3333333333333333,80072181,22,2
2,2,0.8461538461538461,0.75,68341063,13,11
1,30,0.3333333333333333,0.6436781609195402,80176723,45,15
2,1,0.8,0.75,69404195,5,4
2,3,0.6666666666666666,0.7777777777777778,67071865,9,6
2,9,0.5909090909090909,0.9583333333333334,80155299,22,13
2,1,0.5,0.5,70707511,2,1
0,77,0.24509803921568626,0.48226950354609927,67043046,102,25
1,8,0.38461538461538464,0.8636363636363636,65290645,13,5
2,0,1.0,1.0,77114184,9,9
0,18,0.05263157894736842,0.36082474226804123,62840561,19,1
0,29,0.09375,0.1592356687898089,73914344,32,3
0,6,0.14285714285714285,0.21428571428571427,81989154,7,1
0,7,0.125,0.23333333333333334,82213159,8,1
0,57,0.14925373134328357,0.31451612903225806,82128643,67,10
0,51,0.1774193548387097,0.2231404958677686,70234850,62,11
2,1,0.75,0.5,68461645,4,3
0,2,0.3333333333333333,0.375,80174676,3,1
1,19,0.4411764705882353,0.6153846153846154,8017870,34,15
1,28,0.3333333333333333,0.7464788732394366,66855901,42,14
0,10,0.4117647058823529,0.46153846153846156,68044424,17,7
1,17,0.34615384615384615,0.7966101694915254,70224455,26,9
0,33,0.21428571428571427,0.35353535353535354,71903993,42,9
2,0,1.0,1.0,82037898,1,1
2,6,0.8064516129032258,0.9,60024573,31,25
0,17,0.0,0.0,66412045,17,0
2,1,0.5,0.5,80141407,2,1
0,3,0.0,0.0,70685412,3,0
0,5,0.16666666666666666,0.36363636363636365,69064051,6,1
1,23,0.3235294117647059,0.7397260273972602,70760970,34,11
0,17,0.2608695652173913,0.47058823529411764,80125049,23,6
0,14,0.06666666666666667,0.21739130434782608,72809072,15,1
1,13,0.3157894736842105,0.8,76941774,19,6
0,5,0.0,0.0,70705530,5,0
0,8,0.0,0.0,72909900,8,0
1,9,0.47058823529411764,0.9032258064516129,69483393,17,8
1,16,0.4666666666666667,0.9375,72803675,30,14
1,7,0.4166666666666667,0.8695652173913043,72803654,12,5
1,36,0.2653061224489796,0.5507246376811594,71387995,49,13
0,9,0.1,0.08333333333333333,82113174,10,1
2,19,0.6274509803921569,0.8214285714285714,70485555,51,32
0,17,0.15,0.24390243902439024,73650514,20,3
1,13,0.3157894736842105,0.782608695652174,68631521,19,6
1,37,0.32727272727272727,0.5806451612903226,70781872,55,18
0,12,0.2,0.3333333333333333,68248824,15,3
0,24,0.1724137931034483,0.36923076923076925,66304756,29,5
0,5,0.0,0.0,66304784,5,0
0,18,0.0,0.0,66305092,18,0
0,38,0.15555555555555556,0.24285714285714285,73977743,45,7
1,33,0.23255813953488372,0.7936507936507936,82134970,43,10
0,14,0.125,0.34545454545454546,70468545,16,2
0,7,0.0,0.0,82206105,7,0
2,4,0.5,0.9615384615384616,69559154,8,4
1,5,0.2857142857142857,0.8260869565217391,69953933,7,2
1,8,0.2,0.5384615384615384,80149985,10,2
1,87,0.2627118644067797,0.7095435684647303,69551510,118,31
0,9,0.18181818181818182,0.47368421052631576,80126809,11,2
1,37,0.44776119402985076,0.9322033898305084,80180354,67,30
2,13,0.5517241379310345,0.7666666666666667,80178950,29,16
1,2,0.3333333333333333,0.8,68748295,3,1
2,4,0.6,0.9375,82018861,10,6
1,5,0.375,0.8421052631578947,72785783,8,3
2,0,1.0,1.0,80176364,1,1
1,13,0.13333333333333333,0.7368421052631579,80124357,15,2
1,29,0.2564102564102564,0.5795454545454546,80121200,39,10
0,49,0.19672131147540983,0.44285714285714284,80133445,61,12
0,10,0.23076923076923078,0.3076923076923077,70080864,13,3
1,4,0.2,0.6153846153846154,69699896,5,1
1,30,0.21052631578947367,0.76,62529152,38,8
0,10,0.0,0.0,70047796,10,0
0,16,0.15789473684210525,0.26666666666666666,69724256,19,3
2,1,0.5,0.6666666666666666,70591626,2,1
1,33,0.2978723404255319,0.6666666666666666,69179544,47,14
1,5,0.16666666666666666,0.5263157894736842,70229936,6,1
1,14,0.391304347826087,0.8913043478260869,70801472,23,9
1,11,0.26666666666666666,0.7441860465116279,67887722,15,4
0,88,0.053763440860215055,0.15625,80124172,93,5
2,1,0.6666666666666666,0.25,68167715,3,2
0,15,0.0,0.0,69691972,15,0
2,1,0.5,0.5,72814455,2,1
0,22,0.15384615384615385,0.3103448275862069,70677404,26,4
1,15,0.375,0.8333333333333334,70694421,24,9
2,7,0.6111111111111112,0.9655172413793104,82002318,18,11
0,15,0.0,0.0,69551881,15,0
0,9,0.25,0.47058823529411764,65423855,12,3
0,6,0.14285714285714285,0.3333333333333333,82152068,7,1
1,34,0.3333333333333333,0.6944444444444444,82095523,51,17
1,9,0.18181818181818182,0.660377358490566,67846233,11,2
0,24,0.07692307692307693,0.46798029556650245,68356666,26,2
2,1,0.8571428571428571,0.8888888888888888,66353756,7,6
0,12,0.2,0.40540540540540543,82108575,15,3
1,30,0.4339622641509434,0.8793103448275862,66632321,53,23
2,4,0.7647058823529411,0.5,67823252,17,13
0,16,0.0,0.0,82002406,16,0
1,9,0.1,0.5161290322580645,82003741,10,1
1,6,0.14285714285714285,0.5365853658536586,70489041,7,1
0,42,0.20754716981132076,0.43243243243243246,65412620,53,11
2,1,0.5,0.8571428571428571,72802324,2,1
0,1,0.0,0.0,82185020,1,0
1,18,0.3333333333333333,0.7755102040816326,69621531,27,9
2,4,0.7777777777777778,0.9545454545454546,66354505,18,14
2,0,1.0,1.0,82046127,3,3
1,84,0.26956521739130435,0.6,80121255,115,31
0,2,0.0,0.0,82024250,2,0
2,3,0.7272727272727273,0.9166666666666666,72803136,11,8
1,19,0.20833333333333334,0.5138888888888888,70081445,24,5
0,2,0.0,0.0,69627852,2,0
0,22,0.08333333333333333,0.1282051282051282,69100962,24,2
2,4,0.9148936170212766,0.9777777777777777,76545462,47,43
0,33,0.10810810810810811,0.35,82158904,37,4
0,39,0.07142857142857142,0.2553191489361702,82158907,42,3
1,28,0.28205128205128205,0.626984126984127,82116852,39,11
0,6,0.25,0.46153846153846156,69596471,8,2
0,6,0.0,0.0,69073333,6,0
0,7,0.0,0.0,70675801,7,0
0,2,0.0,0.0,70685895,2,0
2,2,0.5,0.8461538461538461,69961311,4,2
0,1,0.0,0.0,60558582,1,0
0,23,0.28125,0.27906976744186046,80110170,32,9
2,7,0.5,0.9,73848754,14,7
1,3,0.25,0.5555555555555556,69481461,4,1
1,17,0.45161290322580644,0.7692307692307693,80151033,31,14
2,16,0.6363636363636364,0.8780487804878049,66837036,44,28
0,3,0.0,0.0,70681716,3,0
2,11,0.7555555555555555,0.98,80124709,45,34
1,4,0.3333333333333333,0.7142857142857143,69207481,6,2
2,8,0.5,0.75,71399111,16,8
2,9,0.5,0.75,69063631,18,9
0,1,0.0,0.0,82012790,1,0
2,13,0.5185185185185185,0.9393939393939394,70013272,27,14
2,1,0.5,0.3333333333333333,73161466,2,1
0,11,0.08333333333333333,0.0,65286963,12,1
2,1,0.5,0.6666666666666666,68241635,2,1
1,14,0.3,0.8243243243243243,80176326,20,6
0,23,0.08,0.11475409836065574,70568624,25,2
0,15,0.0625,0.15625,70568631,16,1
0,23,0.20689655172413793,0.4927536231884058,72543884,29,6
0,29,0.23684210526315788,0.43137254901960786,74059076,38,9
2,0,1.0,1.0,65806573,2,2
0,2,0.0,0.0,80165331,2,0
2,5,0.7727272727272727,0.9473684210526315,70597345,22,17
2,5,0.7058823529411765,0.8,69406771,17,12
1,30,0.2857142857142857,0.6808510638297872,70515284,42,12
2,2,0.9047619047619048,0.8571428571428571,80177430,21,19
2,5,0.5454545454545454,0.9230769230769231,68414241,11,6
0,1,0.0,0.0,70768236,1,0
1,29,0.4423076923076923,0.7551020408163265,80019842,52,23
2,2,0.6,0.7777777777777778,80176716,5,3
2,10,0.7222222222222222,0.9444444444444444,80178925,36,26
2,2,0.75,0.6666666666666666,70240170,8,6
0,1,0.0,0.0,72814560,1,0
0,5,0.0,0.0,66876355,5,0
2,5,0.8648648648648649,0.8333333333333334,69166503,37,32
2,17,0.575,0.7142857142857143,63328776,40,23
2,2,0.7777777777777778,0.75,80175663,9,7
0,4,0.0,0.0,80122871,4,0
1,20,0.23076923076923078,0.6285714285714286,75148241,26,6
0,9,0.0,0.0,82152063,9,0
0,7,0.0,0.0,82152199,7,0
0,3,0.0,0.0,82037230,3,0
0,3,0.25,0.16666666666666666,80130729,4,1
1,51,0.3855421686746988,0.8571428571428571,70816641,83,32
2,5,0.6153846153846154,0.9310344827586207,80128189,13,8
2,1,0.6666666666666666,0.5,70803054,3,2
1,22,0.3333333333333333,0.75,70081403,33,11
0,3,0.4,0.25,66228141,5,2
2,1,0.8333333333333334,0.5,66228596,6,5
1,3,0.4,0.75,82019847,5,2
0,1,0.0,0.0,67822076,1,0
1,10,0.4117647058823529,0.6333333333333333,81976042,17,7
0,5,0.0,0.0,70682024,5,0
0,21,0.045454545454545456,0.17757009345794392,70692923,22,1
0,28,0.15151515151515152,0.36036036036036034,70694736,33,5
0,6,0.0,0.0,70697725,6,0
0,4,0.2,0.36363636363636365,66304980,5,1
1,42,0.373134328358209,0.8461538461538461,67557644,67,25
2,28,0.5087719298245614,0.875,72700180,57,29
0,2,0.0,0.0,70927696,2,0
2,8,0.5,0.9714285714285714,70629762,16,8
0,1,0.0,0.0,82102617,1,0
1,2,0.3333333333333333,0.6666666666666666,82103834,3,1
0,16,0.2,0.28205128205128205,67775225,20,4
0,4,0.0,0.0,67053791,4,0
1,12,0.2,0.5227272727272727,79453255,15,3
2,3,0.625,0.9166666666666666,80150941,8,5
1,14,0.36363636363636365,0.8108108108108109,82126772,22,8
0,16,0.058823529411764705,0.18604651162790697,82024357,17,1
0,9,0.0,0.0,70692111,9,0
0,8,0.1111111111111111,0.3,70694211,9,1
1,26,0.4090909090909091,0.9054054054054054,72393412,44,18
1,15,0.3181818181818182,0.8275862068965517,68295010,22,7
0,22,0.15384615384615385,0.4155844155844156,70621432,26,4
1,3,0.4,0.7272727272727273,82023655,5,2
1,62,0.3111111111111111,0.6071428571428571,81989276,90,28
0,27,0.15625,0.11458333333333333,66188213,32,5
2,1,0.5,0.8888888888888888,69458550,2,1
0,9,0.1,0.04,68294660,10,1
0,5,0.0,0.0,69506815,5,0
2,0,1.0,1.0,66235414,2,2
2,6,0.5,0.7222222222222222,70631974,12,6
2,4,0.7894736842105263,0.9411764705882353,82052113,19,15
1,8,0.42857142857142855,0.8666666666666667,80175668,14,6
2,3,0.5,0.7,72472841,6,3
1,11,0.3125,0.75,67438791,16,5
0,15,0.11764705882352941,0.2857142857142857,69841254,17,2
1,2,0.3333333333333333,0.9,19411343,3,1
0,38,0.07317073170731707,0.18627450980392157,811615,41,3
2,1,0.9285714285714286,0.8333333333333334,69728463,14,13
1,4,0.3333333333333333,0.7272727272727273,70843353,6,2
2,0,1.0,1.0,72802394,9,9
1,10,0.2857142857142857,0.6,62143382,14,4
1,15,0.16666666666666666,0.5352112676056338,81965687,18,3
2,6,0.6470588235294118,0.8181818181818182,66283084,17,11
2,1,0.75,0.5,70508865,4,3
2,3,0.5714285714285714,0.9375,79989672,7,4
2,7,0.6111111111111112,0.9473684210526315,72803073,18,11
1,4,0.42857142857142855,0.75,82010281,7,3
2,0,1.0,1.0,69961262,3,3
2,8,0.5,0.9259259259259259,70843815,16,8
1,8,0.38461538461538464,0.8,65280446,13,5
2,7,0.65,0.8181818181818182,70494676,20,13
1,17,0.34615384615384615,0.8,68281766,26,9
2,0,1.0,1.0,82019835,1,1
1,4,0.2,0.5,80089723,5,1
0,5,0.0,0.0,80181327,5,0
1,14,0.44,0.8484848484848485,70591724,25,11
2,4,0.7647058823529411,0.9333333333333333,70868490,17,13
1,21,0.43243243243243246,0.8243243243243243,18870653,37,16
0,6,0.14285714285714285,0.2727272727272727,70705901,7,1
2,15,0.7272727272727273,0.975609756097561,76694240,55,40
1,11,0.45,0.8571428571428571,70646226,20,9
2,5,0.7058823529411765,0.8888888888888888,79816471,17,12
1,27,0.41304347826086957,0.9130434782608695,80074323,46,19
0,4,0.2,0.09090909090909091,68192425,5,1
1,16,0.3333333333333333,0.7317073170731707,69389915,24,8
0,17,0.10526315789473684,0.189873417721519,69416522,19,2
2,0,1.0,1.0,75295143,3,3
0,15,0.16666666666666666,0.2727272727272727,70682864,18,3
1,3,0.25,0.5384615384615384,70843332,4,1
2,0,1.0,1.0,82145516,1,1
0,50,0.10714285714285714,0.4114285714285714,62529726,56,6
1,16,0.42857142857142855,0.9122807017543859,69498702,28,12
1,5,0.375,0.8181818181818182,80030496,8,3
0,31,0.225,0.4835164835164835,80135287,40,9
0,11,0.15384615384615385,0.2,67910346,13,2
0,28,0.2,0.3972602739726027,82023574,35,7
2,8,0.5,0.975,82012240,16,8
0,5,0.16666666666666666,0.08333333333333333,70843101,6,1
0,32,0.13513513513513514,0.39805825242718446,82206188,37,5
0,5,0.375,0.45454545454545453,67070451,8,3
1,3,0.4,0.8,80049872,5,2
1,50,0.12280701754385964,0.5380434782608695,64076950,57,7
1,12,0.4,0.72,63704186,20,8
0,5,0.0,0.0,68798450,5,0
1,8,0.38461538461538464,0.76,69499213,13,5
1,10,0.3333333333333333,0.5151515151515151,74361525,15,5
1,8,0.4666666666666667,0.8571428571428571,58879016,15,7
2,1,0.6666666666666666,0.5,69478612,3,2
2,8,0.7241379310344828,0.6,70756826,29,21
0,2,0.0,0.0,70280511,2,0
2,0,1.0,1.0,79953811,3,3
0,8,0.1111111111111111,0.37209302325581395,70703633,9,1
1,12,0.42857142857142855,0.8387096774193549,71458856,21,9
0,7,0.0,0.0,70238252,7,0
0,8,0.0,0.0,70239533,8,0
1,3,0.4,0.8181818181818182,69596492,5,2
2,1,0.8,0.3333333333333333,69520500,5,4
2,2,0.6,0.25,69315876,5,3
0,9,0.25,0.16666666666666666,82163427,12,3
2,0,1.0,1.0,67199223,8,8
1,8,0.2727272727272727,0.8709677419354839,62849892,11,3
1,13,0.1875,0.5945945945945946,62849976,16,3
2,9,0.7906976744186046,0.9583333333333334,80114454,43,34
0,10,0.16666666666666666,0.3829787234042553,73709293,12,2
0,3,0.0,0.0,73650990,3,0
0,45,0.27419354838709675,0.47435897435897434,68029626,62,17
2,0,1.0,1.0,80132790,7,7
2,1,0.5,0.5,67485824,2,1
2,5,0.5,0.9,69577606,10,5
1,15,0.375,0.95,80155203,24,9
0,18,0.05263157894736842,0.0,67880484,19,1
1,5,0.4444444444444444,0.8095238095238095,68645962,9,4
0,6,0.14285714285714285,0.1276595744680851,80153624,7,1
1,4,0.42857142857142855,0.9047619047619048,80153625,7,3
1,13,0.43478260869565216,0.8490566037735849,82052110,23,10
1,18,0.35714285714285715,0.9210526315789473,69665064,28,10
0,10,0.16666666666666666,0.16666666666666666,80137555,12,2
1,3,0.4,0.6923076923076923,68060580,5,2
0,9,0.25,0.4,80139724,12,3
2,4,0.6363636363636364,0.7142857142857143,80055822,11,7
0,22,0.26666666666666666,0.34545454545454546,71288700,30,8
2,0,1.0,1.0,67744691,8,8
2,0,1.0,1.0,68665730,1,1
2,0,1.0,1.0,80178162,5,5
0,22,0.043478260869565216,0.043478260869565216,82145535,23,1
1,7,0.4166666666666667,0.875,61717593,12,5
0,16,0.058823529411764705,0.12121212121212122,80029264,17,1
0,1,0.0,0.0,80054702,1,0
1,5,0.375,0.8333333333333334,80132912,8,3
2,0,1.0,1.0,80124773,6,6
0,8,0.1111111111111111,0.09375,70493444,9,1
0,5,0.16666666666666666,0.0,69611472,6,1
0,11,0.21428571428571427,0.2222222222222222,69057926,14,3
2,2,0.6,0.875,68273716,5,3
0,13,0.3157894736842105,0.25,82165046,19,6
0,11,0.3125,0.15789473684210525,82165044,16,5
1,22,0.42105263157894735,0.9487179487179487,64866270,38,16
1,3,0.25,0.625,67795952,4,1
2,1,0.5,0.75,74776884,2,1
1,9,0.35714285714285715,0.8709677419354839,82116844,14,5
0,17,0.0,0.0,69640844,17,0
0,1,0.0,0.0,67966983,1,0
1,12,0.25,0.625,67376491,16,4
1,9,0.35714285714285715,0.7872340425531915,76941662,14,5
1,15,0.4,0.9193548387096774,78413195,25,10
0,2,0.0,0.0,73800853,2,0
0,33,0.0,0.0,80124212,33,0
2,0,1.0,1.0,80092446,1,1
1,6,0.4,0.8888888888888888,65286144,10,4
1,14,0.2631578947368421,0.673469387755102,66892770,19,5
0,1,0.0,0.0,69182694,1,0
2,1,0.75,0.5,68191340,4,3
2,5,0.9285714285714286,0.8888888888888888,80127024,70,65
0,5,0.0,0.0,82102782,5,0
1,28,0.3488372093023256,0.7662337662337663,69042610,43,15
0,29,0.03333333333333333,0.15294117647058825,65911132,30,1
0,1,0.0,0.0,82102592,1,0
0,34,0.10526315789473684,0.35398230088495575,70917224,38,4
0,21,0.08695652173913043,0.1643835616438356,82118287,23,2
2,7,0.5,0.8947368421052632,69042631,14,7
1,12,0.3684210526315789,0.9142857142857143,71618820,19,7
0,1,0.0,0.0,69318060,1,0
0,11,0.15384615384615385,0.13157894736842105,70812791,13,2
0,17,0.19047619047619047,0.29411764705882354,67589081,21,4
0,20,0.0,0.0,82102922,20,0
0,56,0.16417910447761194,0.25903614457831325,70242522,67,11
1,21,0.43243243243243246,0.8387096774193549,70475034,37,16
1,3,0.25,0.5,70037030,4,1
0,20,0.3333333333333333,0.1,82051999,30,10
1,64,0.2558139534883721,0.5284090909090909,61501153,86,22
1,16,0.36,0.6,69080284,25,9
0,2,0.0,0.0,82024298,2,0
0,7,0.2222222222222222,0.38461538461538464,82024348,9,2
2,10,0.5238095238095238,0.9473684210526315,72176524,21,11
0,4,0.2,0.46153846153846156,80122859,5,1
2,5,0.6153846153846154,0.9285714285714286,80175670,13,8
2,6,0.76,0.875,80176867,25,19
0,7,0.0,0.0,82019434,7,0
2,1,0.5,0.5,70009576,2,1
2,0,1.0,1.0,82012000,28,28
0,11,0.0,0.0,80124298,11,0
0,31,0.0,0.0,82173343,31,0
0,32,0.0,0.0,82173344,32,0
0,22,0.15384615384615385,0.40625,73460142,26,4
0,9,0.18181818181818182,0.11764705882352941,68689005,11,2
1,9,0.3076923076923077,0.8181818181818182,68689012,13,4
0,8,0.1111111111111111,0.0,68689026,9,1
1,2,0.3333333333333333,0.75,69603233,3,1
2,12,0.7647058823529411,0.9230769230769231,69171214,51,39
1,4,0.2,0.5714285714285714,82001452,5,1
2,7,0.5333333333333333,0.6,66257555,15,8
1,9,0.4,0.8,68499613,15,6
0,32,0.1111111111111111,0.4580152671755725,70488992,36,4
1,16,0.30434782608695654,0.71875,69870206,23,7
1,13,0.23529411764705882,0.5333333333333333,65279242,17,4
0,6,0.14285714285714285,0.14285714285714285,80046134,7,1
1,24,0.25,0.5538461538461539,19838133,32,8
2,0,1.0,1.0,82020363,3,3
2,2,0.6,0.75,81967367,5,3
0,10,0.09090909090909091,0.19230769230769232,69534255,11,1
1,14,0.36363636363636365,0.875,80125037,22,8
0,3,0.0,0.0,70350672,3,0
1,5,0.16666666666666666,0.5,67917374,6,1
0,20,0.0,0.0,80150720,20,0
0,10,0.0,0.0,80150725,10,0
2,5,0.6153846153846154,0.8888888888888888,70541212,13,8
2,1,0.5,0.8333333333333334,80167312,2,1
2,0,1.0,1.0,70483546,1,1
2,2,0.6,0.75,65713900,5,3
0,3,0.0,0.0,80150860,3,0
0,26,0.0,0.0,80150862,26,0
0,3,0.0,0.0,82006507,3,0
1,19,0.09523809523809523,0.5294117647058824,64234170,21,2
0,36,0.0,0.0,80149925,36,0
0,40,0.047619047619047616,0.27419354838709675,65716973,42,2
2,18,0.5384615384615384,0.9215686274509803,69733496,39,21
0,12,0.2,0.44,68603934,15,3
0,34,0.0,0.0,80150864,34,0
0,33,0.05714285714285714,0.29714285714285715,63628964,35,2
1,7,0.36363636363636365,0.8888888888888888,75363722,11,4
0,53,0.07017543859649122,0.2205128205128205,64220723,57,4
0,6,0.14285714285714285,0.35714285714285715,82118258,7,1
2,0,1.0,1.0,70633290,3,3
0,2,0.0,0.0,82118279,2,0
0,6,0.14285714285714285,0.2222222222222222,71357300,7,1
0,49,0.02,0.047619047619047616,69528235,50,1
1,15,0.21052631578947367,0.7733333333333333,67977994,19,4
0,9,0.0,0.0,70069832,9,0
1,6,0.25,0.72,66065293,8,2
1,10,0.16666666666666666,0.7903225806451613,74924430,12,2
1,50,0.2857142857142857,0.5487804878048781,80061156,70,20
0,4,0.0,0.0,68115215,4,0
1,17,0.22727272727272727,0.5535714285714286,69910722,22,5
2,0,1.0,1.0,69075062,1,1
1,23,0.11538461538461539,0.5106382978723404,65716455,26,3
0,15,0.0,0.0,80155858,15,0
0,43,0.06521739130434782,0.2976190476190476,64399426,46,3
0,6,0.14285714285714285,0.35714285714285715,70821450,7,1
0,5,0.0,0.0,80165846,5,0
0,13,0.07142857142857142,0.08333333333333333,69964503,14,1
0,2,0.0,0.0,80019296,2,0
0,4,0.0,0.0,82006706,4,0
1,22,0.18518518518518517,0.6744186046511628,68226781,27,5
0,4,0.0,0.0,82006779,4,0
1,2,0.3333333333333333,0.6,80172556,3,1
1,12,0.25,0.8153846153846154,65350985,16,4
1,24,0.22580645161290322,0.6415094339622641,80162879,31,7
0,14,0.0,0.0,68579245,14,0
0,14,0.125,0.25,69160420,16,2
0,5,0.0,0.0,68226851,5,0
1,24,0.3684210526315789,0.5,69514361,38,14
0,14,0.125,0.3877551020408163,69148310,16,2
0,21,0.08695652173913043,0.26666666666666666,69549676,23,2
0,6,0.0,0.0,71619653,6,0
0,47,0.11320754716981132,0.3236994219653179,70908642,53,6
1,5,0.4444444444444444,0.9444444444444444,82119999,9,4
2,2,0.5,0.75,63594776,4,2
0,8,0.0,0.0,82158883,8,0
0,8,0.0,0.0,82158884,8,0
2,6,0.5,0.625,64998136,12,6
1,10,0.3333333333333333,0.6216216216216216,75048043,15,5
2,2,0.5,0.75,80157093,4,2
1,8,0.2,0.5,67841991,10,2
2,3,0.6666666666666666,0.0,82020096,9,6
2,1,0.8333333333333334,0.5,82020099,6,5
2,0,1.0,1.0,80136966,5,5
0,7,0.0,0.0,69965112,7,0
0,38,0.05,0.18947368421052632,70239071,40,2
0,32,0.2,0.4880952380952381,70059710,40,8
0,2,0.0,0.0,73295964,2,0
0,2,0.3333333333333333,0.0,61724992,3,1
0,1,0.0,0.0,54609660,1,0
2,14,0.6585365853658537,0.7857142857142857,70182581,41,27
1,64,0.3118279569892473,0.6948051948051948,80172005,93,29
0,2,0.3333333333333333,0.4,69185361,3,1
1,28,0.24324324324324326,0.7142857142857143,70252875,37,9
0,2,0.0,0.0,67246193,2,0
1,25,0.32432432432432434,0.7123287671232876,66404310,37,12
0,5,0.0,0.0,65289763,5,0
1,9,0.3076923076923077,0.7647058823529411,65289770,13,4
0,14,0.2222222222222222,0.4074074074074074,65281573,18,4
2,3,0.85,0.8,68170921,20,17
0,21,0.16,0.4105263157894737,82002274,25,4
0,35,0.07894736842105263,0.3283582089552239,82137493,38,3
0,15,0.0625,0.1836734693877551,80124275,16,1
2,1,0.5,0.5,68255201,2,1
1,12,0.3333333333333333,0.5217391304347826,68241551,18,6
2,1,0.5,0.5,69574526,2,1
2,0,1.0,1.0,68960213,10,10
0,12,0.14285714285714285,0.2647058823529412,80167328,14,2
1,22,0.37142857142857144,0.9333333333333333,71619303,35,13
1,22,0.21428571428571427,0.6056338028169014,79145955,28,6
0,14,0.125,0.3076923076923077,80154143,16,2
2,8,0.5555555555555556,0.9230769230769231,69167413,18,10
2,3,0.5714285714285714,0.8823529411764706,80145708,7,4
2,1,0.5,0.8,80125448,2,1
2,2,0.6666666666666666,0.75,80118259,6,4
0,1,0.0,0.0,69034063,1,0
0,25,0.2647058823529412,0.4845360824742268,73421474,34,9
2,27,0.578125,0.9411764705882353,70485576,64,37
0,12,0.25,0.42857142857142855,70524636,16,4
0,18,0.18181818181818182,0.2653061224489796,80127421,22,4
0,11,0.0,0.0,70684502,11,0
0,4,0.3333333333333333,0.14285714285714285,69458711,6,2
1,10,0.4117647058823529,0.8,73623144,17,7
1,3,0.4,0.9166666666666666,69528893,5,2
0,2,0.3333333333333333,0.3333333333333333,70063294,3,1
2,7,0.6666666666666666,0.9,62624212,21,14
2,8,0.5555555555555556,0.7777777777777778,73977141,18,10
0,24,0.1724137931034483,0.024390243902439025,60735402,29,5
1,3,0.4,0.75,68402110,5,2
0,1,0.0,0.0,66228491,1,0
1,8,0.42857142857142855,0.8205128205128205,82002320,14,6
0,14,0.3,0.4827586206896552,66855831,20,6
0,1,0.0,0.0,66236450,1,0
2,1,0.5,0.5,66236471,2,1
2,6,0.6,0.9722222222222222,69974702,15,9
2,13,0.6578947368421053,0.9130434782608695,72286893,38,25
2,7,0.5625,0.9230769230769231,70493976,16,9
2,3,0.5714285714285714,0.5,69581554,7,4
0,2,0.3333333333333333,0.25,70768544,3,1
0,51,0.13559322033898305,0.17692307692307693,82126671,59,8
2,6,0.6470588235294118,0.75,68996340,17,11
2,1,0.5,0.0,82022397,2,1
1,61,0.1643835616438356,0.551219512195122,64069733,73,12
0,14,0.125,0.07317073170731707,80130186,16,2
1,6,0.4,0.7857142857142857,80130187,10,4
1,11,0.42105263157894735,0.7954545454545454,70646541,19,8
2,3,0.5,0.8421052631578947,80176649,6,3
1,36,0.3898305084745763,0.8470588235294118,69691391,59,23
2,4,0.5,0.8,71588083,8,4
1,11,0.45,0.8518518518518519,82119997,20,9
2,0,1.0,1.0,79785923,3,3
0,4,0.0,0.0,70677495,4,0
1,12,0.14285714285714285,0.5897435897435898,69416452,14,2
0,2,0.3333333333333333,0.25,67252661,3,1
0,2,0.0,0.0,70568603,2,0
0,28,0.0,0.0,70568722,28,0
1,13,0.23529411764705882,0.6190476190476191,70183890,17,4
2,14,0.7627118644067796,0.88,65255890,59,45
2,3,0.6666666666666666,0.8571428571428571,79815911,9,6
0,16,0.0,0.0,67475401,16,0
0,27,0.03571428571428571,0.10989010989010989,69895280,28,1
2,3,0.8333333333333334,0.875,69621944,18,15
0,7,0.125,0.13333333333333333,70350616,8,1
0,36,0.12195121951219512,0.41935483870967744,63992936,41,5
0,7,0.0,0.0,66782205,7,0
0,18,0.0,0.0,69638142,18,0
2,0,1.0,1.0,67779635,2,2
1,10,0.09090909090909091,0.6,66784284,11,1
0,22,0.12,0.17777777777777778,69638135,25,3
0,6,0.0,0.0,77352086,6,0
2,12,0.5714285714285714,0.8,80174699,28,16
2,11,0.56,0.9333333333333333,80066434,25,14
0,1,0.0,0.0,82039356,1,0
2,0,1.0,1.0,66232894,2,2
1,11,0.15384615384615385,0.6274509803921569,63781942,13,2
0,6,0.14285714285714285,0.058823529411764705,65596482,7,1
0,4,0.0,0.0,73460121,4,0
1,18,0.21739130434782608,0.6847826086956522,64041831,23,5
0,13,0.0,0.0,65306815,13,0
1,32,0.2558139534883721,0.7452830188679245,80135234,43,11
0,32,0.1111111111111111,0.3877551020408163,63993013,36,4
1,7,0.2222222222222222,0.7575757575757576,61356435,9,2
1,16,0.30434782608695654,0.7543859649122807,80135210,23,7
0,4,0.2,0.4444444444444444,80054604,5,1
1,7,0.125,0.5428571428571428,69004411,8,1
0,1,0.0,0.0,80153638,1,0
2,0,1.0,1.0,80019086,1,1
0,2,0.0,0.0,69233990,2,0
0,5,0.16666666666666666,0.47058823529411764,69059382,6,1
2,1,0.9375,0.9375,82050062,16,15
1,13,0.35,0.5555555555555556,79854166,20,7
2,0,1.0,1.0,82059912,2,2
2,0,1.0,1.0,80165275,5,5
0,5,0.16666666666666666,0.3333333333333333,65286844,6,1
0,1,0.0,0.0,65286851,1,0
2,4,0.5,0.5714285714285714,70279930,8,4
2,7,0.5333333333333333,0.95,77970543,15,8
0,6,0.14285714285714285,0.24,81967363,7,1
0,8,0.0,0.0,80136722,8,0
0,5,0.0,0.0,80136723,5,0
2,6,0.8378378378378378,0.9,64998150,37,31
0,4,0.2,0.3,70843185,5,1
2,4,0.5,0.75,67786796,8,4
2,1,0.5,0.9230769230769231,70063973,2,1
0,8,0.2,0.43478260869565216,77677005,10,2
2,1,0.5,0.5,67665493,2,1
0,6,0.14285714285714285,0.125,67775302,7,1
1,26,0.36585365853658536,0.8518518518518519,54295661,41,15
2,8,0.7837837837837838,0.975609756097561,73024616,37,29
1,3,0.4,0.8666666666666667,80029292,5,2
0,5,0.0,0.0,70743274,5,0
1,11,0.3125,0.75,69624212,16,5
0,11,0.21428571428571427,0.19047619047619047,70110285,14,3
2,4,0.6363636363636364,0.8571428571428571,74123980,11,7
0,38,0.19148936170212766,0.3541666666666667,80133422,47,9
0,20,0.09090909090909091,0.05555555555555555,77676984,22,2
1,6,0.45454545454545453,0.84,79792734,11,5
2,6,0.6470588235294118,0.8333333333333334,73102414,17,11
2,0,1.0,1.0,18867632,1,1
2,1,0.6666666666666666,0.9166666666666666,81971191,3,2
1,5,0.375,0.8181818181818182,82025262,8,3
0,15,0.16666666666666666,0.4489795918367347,76695556,18,3
1,3,0.25,0.8333333333333334,80178130,4,1
2,5,0.6875,0.9473684210526315,65714733,16,11
1,5,0.2857142857142857,0.7391304347826086,65716035,7,2
1,11,0.21428571428571427,0.5434782608695652,65716042,14,3
0,5,0.16666666666666666,0.46153846153846156,65716063,6,1
0,8,0.1111111111111111,0.1875,69416711,9,1
2,3,0.5,0.9090909090909091,75140254,6,3
1,26,0.35,0.7368421052631579,82014177,40,14
2,2,0.6666666666666666,0.8571428571428571,82022389,6,4
1,14,0.2222222222222222,0.5428571428571428,69726594,18,4
1,23,0.20689655172413793,0.5747126436781609,67299694,29,6
1,51,0.35443037974683544,0.7471264367816092,66802904,79,28
2,3,0.5,0.8571428571428571,70252630,6,3
0,26,0.23529411764705882,0.45454545454545453,70853993,34,8
0,14,0.17647058823529413,0.19047619047619047,69588036,17,3
0,32,0.1794871794871795,0.3269230769230769,80159891,39,7
0,3,0.0,0.0,80159894,3,0
0,7,0.0,0.0,68948915,7,0
1,7,0.46153846153846156,0.8333333333333334,71618911,13,6
2,0,1.0,1.0,80150286,1,1
0,3,0.0,0.0,70568043,3,0
1,15,0.4,0.8095238095238095,64768816,25,10
1,15,0.4,0.71875,71458793,25,10
1,10,0.3333333333333333,0.5833333333333334,66802694,15,5
1,30,0.2857142857142857,0.6515151515151515,70854126,42,12
2,7,0.5,0.875,77319004,14,7
2,1,0.8,0.0,66744741,5,4
1,31,0.27906976744186046,0.7073170731707317,65282021,43,12
0,10,0.16666666666666666,0.1,65286431,12,2
0,6,0.25,0.3333333333333333,65290155,8,2
0,7,0.125,0.06666666666666667,65289350,8,1
2,0,1.0,1.0,61440582,1,1
0,3,0.0,0.0,80069934,3,0
1,13,0.23529411764705882,0.6607142857142857,70674765,17,4
1,9,0.47058823529411764,0.9444444444444444,68402152,17,8
0,10,0.0,0.0,69479361,10,0
0,9,0.18181818181818182,0.4838709677419355,64158640,11,2
0,7,0.125,0.1111111111111111,70685384,8,1
0,34,0.08108108108108109,0.034482758620689655,77084413,37,3
0,5,0.0,0.0,70508935,5,0
1,8,0.2727272727272727,0.8181818181818182,70175560,11,3
2,9,0.55,0.7857142857142857,67138190,20,11
2,11,0.7708333333333334,0.972972972972973,69314973,48,37
0,1,0.0,0.0,82013593,1,0
2,1,0.6666666666666666,0.6666666666666666,70046501,3,2
1,9,0.3076923076923077,0.8260869565217391,80003203,13,4
2,9,0.5909090909090909,0.9615384615384616,61740980,22,13
0,5,0.2857142857142857,0.36,80145901,7,2
1,14,0.2631578947368421,0.5,70769650,19,5
2,3,0.5,0.9,70078400,6,3
0,13,0.13333333333333333,0.42424242424242425,72775514,15,2
2,1,0.9230769230769231,0.8,64302875,13,12
2,1,0.95,0.5,82110451,20,19
1,7,0.36363636363636365,0.5,75545911,11,4
2,3,0.7,0.0,77603106,10,7
2,0,1.0,1.0,80136541,19,19
2,1,0.8333333333333334,0.5,75636092,6,5
1,14,0.4166666666666667,0.6551724137931034,80176835,24,10
2,0,1.0,1.0,80118903,2,2
2,1,0.9583333333333334,0.5,80169822,24,23
2,2,0.8181818181818182,0.6666666666666666,70746900,11,9
2,1,0.9473684210526315,0.5,80176439,19,18
0,2,0.0,0.0,80145841,2,0
2,0,1.0,1.0,80178178,10,10
2,1,0.9705882352941176,0.0,70869393,34,33
1,6,0.4,0.7857142857142857,80066364,10,4
0,4,0.2,0.3333333333333333,80128683,5,1
0,9,0.18181818181818182,0.2222222222222222,69404825,11,2
2,10,0.5238095238095238,0.7777777777777778,82096282,21,11
0,3,0.25,0.0,75545932,4,1
2,1,0.8888888888888888,0.5,82055435,9,8
2,2,0.8181818181818182,0.5,80126599,11,9
2,7,0.5625,0.6666666666666666,80178931,16,9
2,7,0.5333333333333333,0.7857142857142857,80176861,15,8
2,0,1.0,1.0,80165266,11,11
2,1,0.8,0.75,68904983,5,4
2,0,1.0,1.0,80178215,3,3
2,1,0.6666666666666666,0.8,80049844,3,2
2,3,0.7272727272727273,0.8,70719012,11,8
1,18,0.35714285714285715,0.7857142857142857,82110218,28,10
2,1,0.6666666666666666,0.5,82145131,3,2
2,8,0.6666666666666666,0.5555555555555556,69394360,24,16
2,2,0.8666666666666667,0.5,82140297,15,13
0,4,0.3333333333333333,0.0,66972220,6,2
2,14,0.7627118644067796,0.9090909090909091,70076384,59,45
2,1,0.8,0.8,82041310,5,4
2,0,1.0,1.0,80159298,1,1
2,0,1.0,1.0,82020383,13,13
0,5,0.375,0.2,80158239,8,3
2,1,0.9,0.5,80162113,10,9
2,0,1.0,1.0,80176008,7,7
0,14,0.125,0.25,66402371,16,2
0,15,0.11764705882352941,0.125,66402392,17,2
0,6,0.25,0.47058823529411764,68400640,8,2
2,0,1.0,1.0,70749532,1,1
0,7,0.2222222222222222,0.3870967741935484,82129390,9,2
0,9,0.25,0.16666666666666666,80056326,12,3
2,1,0.5,0.9285714285714286,67665381,2,1
2,0,1.0,1.0,82135121,5,5
1,14,0.46153846153846156,0.6363636363636364,80172965,26,12
2,3,0.7,0.9285714285714286,67154486,10,7
1,11,0.45,0.8571428571428571,74816686,20,9
1,3,0.25,0.5,82018659,4,1
0,25,0.07407407407407407,0.0,80018855,27,2
1,4,0.42857142857142855,0.8695652173913043,82018245,7,3
1,5,0.2857142857142857,0.6923076923076923,67746000,7,2
1,9,0.3076923076923077,0.6,80176691,13,4
2,40,0.5294117647058824,0.958904109589041,70324905,85,45
0,24,0.1724137931034483,0.21818181818181817,73459701,29,5
1,27,0.20588235294117646,0.6266666666666667,80149936,34,7
2,12,0.52,0.9117647058823529,80180112,25,13
1,32,0.21951219512195122,0.6343283582089553,70761236,41,9
0,26,0.0,0.0,69526002,26,0
1,10,0.47368421052631576,0.8148148148148148,79849091,19,9
2,1,0.6666666666666666,0.9166666666666666,70747901,3,2
0,1,0.0,0.0,70701680,1,0
0,8,0.0,0.0,70702492,8,0
1,34,0.40350877192982454,0.86,70012236,57,23
2,1,0.8,0.6666666666666666,70747432,5,4
2,17,0.5641025641025641,0.9491525423728814,71433565,39,22
1,9,0.1,0.7142857142857143,70248073,10,1
2,8,0.5789473684210527,0.8235294117647058,69042771,19,11
2,1,0.75,0.5,65715132,4,3
0,17,0.0,0.0,62840526,17,0
2,1,0.5,0.8571428571428571,69638331,2,1
0,7,0.125,0.2962962962962963,64041586,8,1
1,3,0.4,0.6666666666666666,80167295,5,2
2,4,0.6923076923076923,0.8235294117647058,82018981,13,9
0,6,0.0,0.0,70760095,6,0
2,0,1.0,1.0,80162795,3,3
1,7,0.36363636363636365,0.88,82205995,11,4
1,3,0.25,0.7142857142857143,80163188,4,1
0,14,0.0,0.0,68356400,14,0
0,23,0.11538461538461539,0.1836734693877551,64885513,26,3
2,2,0.6,0.6666666666666666,82062244,5,3
1,18,0.3333333333333333,0.7254901960784313,73871420,27,9
1,15,0.4444444444444444,0.9285714285714286,70688114,27,12
0,58,0.09375,0.2561576354679803,82103885,64,6
1,23,0.23333333333333334,0.6172839506172839,70621425,30,7
1,8,0.2727272727272727,0.5483870967741935,80158282,11,3
0,47,0.020833333333333332,0.017543859649122806,70568001,48,1
0,29,0.21621621621621623,0.475,81989281,37,8
0,14,0.2222222222222222,0.3055555555555556,70919646,18,4
0,9,0.1,0.34210526315789475,70675892,10,1
0,2,0.0,0.0,70684096,2,0
0,16,0.15789473684210525,0.3333333333333333,70676263,19,3
0,4,0.2,0.45454545454545453,70684495,5,1
2,2,0.6,0.8,72803402,5,3
0,1,0.0,0.0,72808813,1,0
0,4,0.2,0.2,69390643,5,1
1,59,0.313953488372093,0.803921568627451,69873734,86,27
0,6,0.0,0.0,69117076,6,0
1,4,0.3333333333333333,0.7,69575576,6,2
1,2,0.3333333333333333,0.6666666666666666,69117034,3,1
2,12,0.5,0.9090909090909091,82018899,24,12
1,9,0.4,0.5789473684210527,74363982,15,6
2,0,1.0,1.0,80133912,2,2
2,0,1.0,1.0,80118202,14,14
0,15,0.16666666666666666,0.46153846153846156,69417320,18,3
0,15,0.21052631578947367,0.3958333333333333,73302383,19,4
0,48,0.1111111111111111,0.2721518987341772,69415962,54,6
1,2,0.3333333333333333,0.6666666666666666,69635125,3,1
1,30,0.3877551020408163,0.8529411764705882,80053456,49,19
1,5,0.4444444444444444,0.6363636363636364,70036813,9,4
2,18,0.6666666666666666,0.9032258064516129,80089366,54,36
2,2,0.5,0.75,62449604,4,2
0,1,0.0,0.0,67519431,1,0
2,3,0.5714285714285714,0.9,65288531,7,4
0,51,0.08928571428571429,0.09278350515463918,72135476,56,5
2,0,1.0,1.0,82009402,12,12
2,6,0.6470588235294118,0.9375,82041814,17,11
0,6,0.0,0.0,70703486,6,0
0,16,0.2,0.3448275862068966,70245252,20,4
1,18,0.4,0.84,82002245,30,12
2,1,0.75,0.5,73102841,4,3
2,6,0.7142857142857143,0.9,69520486,21,15
0,37,0.075,0.33858267716535434,70239470,40,3
0,6,0.0,0.0,70746760,6,0
2,0,1.0,1.0,82039827,10,10
0,47,0.09615384615384616,0.16417910447761194,73331321,52,5
0,18,0.1,0.328125,69549613,20,2
0,13,0.07142857142857142,0.18,68497142,14,1
0,28,0.034482758620689655,0.12209302325581395,68798415,29,1
0,22,0.043478260869565216,0.07352941176470588,69005944,23,1
1,49,0.1694915254237288,0.5666666666666667,69857732,59,10
1,6,0.3333333333333333,0.6470588235294118,71879003,9,3
0,1,0.0,0.0,71879066,1,0
0,14,0.3,0.48484848484848486,61751662,20,6
0,19,0.13636363636363635,0.33783783783783783,73176285,22,3
0,42,0.0,0.0,80155233,42,0
0,42,0.0,0.0,80155234,42,0
1,9,0.4,0.6666666666666666,69864130,15,6
0,19,0.05,0.31666666666666665,73064313,20,1
1,7,0.36363636363636365,0.8727272727272727,80133897,11,4
2,1,0.5,0.75,80113614,2,1
1,17,0.2916666666666667,0.6,72522226,24,7
0,2,0.0,0.0,80105256,2,0
0,2,0.0,0.0,70681275,2,0
1,51,0.23880597014925373,0.5585585585585585,82021844,67,16
1,4,0.42857142857142855,0.8333333333333334,66110485,7,3
1,44,0.21428571428571427,0.7736842105263158,79990050,56,12
2,4,0.5555555555555556,0.9090909090909091,66190005,9,5
2,0,1.0,1.0,64976324,1,1
2,2,0.7142857142857143,0.9285714285714286,69034210,7,5
1,15,0.25,0.71875,70259280,20,5
2,10,0.5,0.94,63870611,20,10
0,23,0.20689655172413793,0.3617021276595745,77065121,29,6
0,13,0.07142857142857142,0.024390243902439025,67887442,14,1
0,14,0.06666666666666667,0.47540983606557374,66031686,15,1
0,27,0.12903225806451613,0.09230769230769231,77065156,31,4
0,5,0.0,0.0,68760132,5,0
1,27,0.2702702702702703,0.5825242718446602,65633946,37,10
2,0,1.0,1.0,82019743,5,5
0,32,0.15789473684210525,0.3333333333333333,70850822,38,6
2,0,1.0,1.0,67779796,7,7
2,1,0.5,0.5,69069350,2,1
0,5,0.0,0.0,69726552,5,0
2,0,1.0,1.0,65888620,4,4
1,2,0.3333333333333333,0.5,890750,3,1
0,18,0.1,0.44285714285714284,67846226,20,2
2,5,0.5,0.7777777777777778,72801743,10,5
0,1,0.0,0.0,63605024,1,0
1,7,0.4166666666666667,0.9444444444444444,74460554,12,5
0,8,0.2,0.3333333333333333,70908516,10,2
0,27,0.0,0.0,72766001,27,0
0,1,0.0,0.0,70705082,1,0
0,3,0.0,0.0,70706062,3,0
1,3,0.4,0.7,81989188,5,2
1,8,0.2727272727272727,0.5277777777777778,72417254,11,3
1,13,0.23529411764705882,0.7391304347826086,63159621,17,4
0,44,0.16981132075471697,0.2733812949640288,70957075,53,9
0,32,0.1111111111111111,0.0759493670886076,80091130,36,4
2,10,0.5238095238095238,0.9565217391304348,82204392,21,11
1,22,0.3333333333333333,0.673469387755102,80175649,33,11
1,56,0.15151515151515152,0.5172413793103449,72918720,66,10
2,1,0.8888888888888888,0.5,80118180,9,8
1,13,0.35,0.5238095238095238,68400962,20,7
0,8,0.0,0.0,73800965,8,0
0,15,0.11764705882352941,0.2545454545454545,73800993,17,2
2,0,1.0,1.0,67979961,3,3
0,12,0.0,0.0,69705104,12,0
0,18,0.05263157894736842,0.4158415841584158,68521831,19,1
1,7,0.3,0.8333333333333334,72439591,10,3
1,8,0.42857142857142855,0.7619047619047619,69589296,14,6
1,11,0.35294117647058826,0.90625,69739292,17,6
2,0,1.0,1.0,69832301,1,1
2,5,0.5833333333333334,0.9090909090909091,77329504,12,7
0,2,0.0,0.0,70683396,2,0
0,4,0.0,0.0,80126762,4,0
0,1,0.0,0.0,70696640,1,0
1,12,0.29411764705882354,0.8378378378378378,69158761,17,5
1,4,0.42857142857142855,0.6,70598794,7,3
0,35,0.05405405405405406,0.10909090909090909,80135043,37,2
0,35,0.07894736842105263,0.19626168224299065,70693042,38,3
2,0,1.0,1.0,75362882,1,1
1,12,0.2,0.6470588235294118,70674604,15,3
0,12,0.0,0.0,70694701,12,0
2,2,0.8666666666666667,0.75,1064833,15,13
2,4,0.5,0.5,69187356,8,4
1,5,0.375,0.8333333333333334,68932374,8,3
2,2,0.6666666666666666,0.8571428571428571,82047575,6,4
0,43,0.12244897959183673,0.22580645161290322,69039362,49,6
0,66,0.25,0.33663366336633666,69464871,88,22
0,63,0.14864864864864866,0.33879781420765026,73914351,74,11
2,3,0.5,0.9411764705882353,68567016,6,3
2,2,0.5,0.6666666666666666,71588132,4,2
1,8,0.4666666666666667,0.6666666666666666,69972686,15,7
2,6,0.6,0.9117647058823529,68662874,15,9
2,8,0.7142857142857143,0.625,67123784,28,20
0,3,0.0,0.0,69316926,3,0
2,15,0.5,0.9574468085106383,68285994,30,15
2,6,0.5384615384615384,0.85,80070081,13,7
0,8,0.1111111111111111,0.034482758620689655,65286620,9,1
2,1,0.6666666666666666,0.5,70037114,3,2
0,11,0.08333333333333333,0.25,62358506,12,1
2,0,1.0,1.0,69498156,1,1
2,14,0.5,0.9743589743589743,80133813,28,14
2,0,1.0,1.0,69154806,2,2
2,1,0.8571428571428571,0.5,67784983,7,6
0,3,0.0,0.0,70683095,3,0
1,11,0.42105263157894735,0.92,80123724,19,8
0,13,0.13333333333333333,0.14285714285714285,80123726,15,2
1,14,0.4166666666666667,0.875,81971194,24,10
2,3,0.8636363636363636,0.875,70718025,22,19
2,1,0.8571428571428571,0.9166666666666666,65744434,7,6
1,8,0.4666666666666667,0.9354838709677419,70202713,15,7
1,29,0.4528301886792453,0.9090909090909091,66825353,53,24
2,3,0.5,0.875,82041258,6,3
0,1,0.0,0.0,82054055,1,0
1,2,0.3333333333333333,0.8181818181818182,69549704,3,1
2,2,0.7142857142857143,0.8461538461538461,80117741,7,5
0,1,0.0,0.0,69125140,1,0
1,6,0.4,0.8333333333333334,68173616,10,4
0,10,0.23076923076923078,0.0,68250245,13,3
1,14,0.2222222222222222,0.5806451612903226,70516691,18,4
0,16,0.23809523809523808,0.4716981132075472,67568704,21,5
1,26,0.3157894736842105,0.72,66804304,38,12
1,7,0.3,0.8214285714285714,81971193,10,3
1,21,0.34375,0.7558139534883721,80037972,32,11
1,9,0.35714285714285715,0.660377358490566,82013610,14,5
0,6,0.0,0.0,70693763,6,0
0,1,0.0,0.0,70696486,1,0
2,1,0.8,0.6666666666666666,62512030,5,4
2,14,0.7142857142857143,0.9473684210526315,80145463,49,35
0,13,0.0,0.0,70694841,13,0
1,4,0.3333333333333333,0.6,72804662,6,2
0,7,0.0,0.0,70701582,7,0
0,1,0.0,0.0,70707084,1,0
0,1,0.0,0.0,66035305,1,0
1,12,0.3333333333333333,0.75,66035242,18,6
1,15,0.2857142857142857,0.6176470588235294,65281545,21,6
1,9,0.4375,0.7619047619047619,70925645,16,7
2,3,0.8636363636363636,0.5,82060533,22,19
2,0,1.0,1.0,70536515,4,4
2,6,0.5,0.9459459459459459,62507494,12,6
0,16,0.1111111111111111,0.22857142857142856,80133448,18,2
1,23,0.41025641025641024,0.9148936170212766,75273100,39,16
2,16,0.5428571428571428,0.9230769230769231,64866606,35,19
2,2,0.6,0.8571428571428571,12762299,5,3
2,0,1.0,1.0,64353562,21,21
2,1,0.8571428571428571,0.75,70575463,7,6
2,9,0.5909090909090909,0.96875,80145770,22,13
1,72,0.28,0.577922077922078,80176735,100,28
2,6,0.5,0.9047619047619048,82096265,12,6
0,1,0.0,0.0,65276694,1,0
2,1,0.6666666666666666,0.5,82039430,3,2
0,2,0.0,0.0,70706496,2,0
2,1,0.5,0.8,70684376,2,1
2,1,0.8333333333333334,0.0,70418341,6,5
0,8,0.1111111111111111,0.0,80053974,9,1
1,24,0.2,0.6619718309859155,61976600,30,6
0,6,0.0,0.0,82145528,6,0
0,44,0.22807017543859648,0.2966101694915254,68688865,57,13
0,2,0.0,0.0,67123882,2,0
0,24,0.2,0.48333333333333334,69582891,30,6
2,1,0.5,0.875,80130700,2,1
0,8,0.1111111111111111,0.41935483870967744,69388634,9,1
1,6,0.25,0.5151515151515151,73366062,8,2
1,7,0.3,0.75,80150935,10,3
0,40,0.1836734693877551,0.42028985507246375,82103792,49,9
2,6,0.5714285714285714,0.8181818181818182,74363954,14,8
2,0,1.0,1.0,82013620,1,1
1,10,0.16666666666666666,0.6,80124219,12,2
2,1,0.8,0.5,68423460,5,4
0,14,0.2222222222222222,0.34545454545454546,82126693,18,4
0,2,0.0,0.0,64356936,2,0
1,10,0.23076923076923078,0.5555555555555556,65280460,13,3
0,31,0.03125,0.04794520547945205,70658574,32,1
1,21,0.46153846153846156,0.9390243902439024,65238544,39,18
1,12,0.3333333333333333,0.5925925925925926,69167546,18,6
1,18,0.45454545454545453,0.8867924528301887,65768941,33,15
0,18,0.05263157894736842,0.0,82045550,19,1
0,1,0.0,0.0,72814364,1,0
1,23,0.39473684210526316,0.8775510204081632,78978802,38,15
1,15,0.3181818181818182,0.5526315789473685,68958435,22,7
0,16,0.15789473684210525,0.359375,70691922,19,3
0,25,0.10714285714285714,0.38,69479620,28,3
2,10,0.5833333333333334,0.8301886792452831,73623214,24,14
2,0,1.0,1.0,69390125,1,1
2,1,0.8571428571428571,0.5,80119178,7,6
0,27,0.03571428571428571,0.16176470588235295,68356750,28,1
2,2,0.6666666666666666,0.6666666666666666,82019926,6,4
0,6,0.14285714285714285,0.3,782684,7,1
1,4,0.3333333333333333,0.5,69640060,6,2
0,8,0.1111111111111111,0.2,66202192,9,1
1,41,0.39705882352941174,0.7840909090909091,80161484,68,27
1,2,0.3333333333333333,0.7142857142857143,70491141,3,1
0,3,0.0,0.0,70702604,3,0
0,8,0.2727272727272727,0.25,82140366,11,3
0,8,0.2727272727272727,0.21428571428571427,80153645,11,3
0,6,0.0,0.0,70649761,6,0
0,1,0.0,0.0,70672490,1,0
2,1,0.9,0.75,68445804,10,9
2,5,0.75,0.8333333333333334,65994656,20,15
0,35,0.18604651162790697,0.17777777777777778,70864465,43,8
0,2,0.3333333333333333,0.0,80084025,3,1
2,1,0.8,0.5,70259413,5,4
2,19,0.6041666666666666,0.8285714285714286,80128771,48,29
1,14,0.391304347826087,0.5,82140140,23,9
2,0,1.0,1.0,66236870,1,1
0,1,0.0,0.0,82208199,1,0
0,6,0.0,0.0,82137453,6,0
0,12,0.07692307692307693,0.075,66378921,13,1
2,11,0.5925925925925926,0.9705882352941176,70688121,27,16
1,7,0.3,0.7727272727272727,69416074,10,3
0,27,0.22857142857142856,0.375,80019996,35,8
2,1,0.75,0.8333333333333334,70541254,4,3
1,37,0.3018867924528302,0.8495575221238938,81965791,53,16
2,0,1.0,1.0,67744425,5,5
1,2,0.3333333333333333,0.75,67970553,3,1
1,23,0.39473684210526316,0.7792207792207793,67656974,38,15
2,4,0.6,0.9,13733496,10,6
2,1,0.5,0.0,66238025,2,1
2,12,0.5,0.6,80168322,24,12
2,1,0.8571428571428571,0.5,70189203,7,6
1,6,0.3333333333333333,0.7142857142857143,80163120,9,3
0,6,0.0,0.0,67822510,6,0
1,15,0.4230769230769231,0.5263157894736842,71399104,26,11
0,20,0.09090909090909091,0.25,70694351,22,2
2,8,0.6,0.971830985915493,80163457,20,12
1,20,0.48717948717948717,0.9302325581395349,69512212,39,19
0,15,0.0625,0.025,69520633,16,1
1,24,0.3142857142857143,0.8275862068965517,66892294,35,11
2,2,0.96,0.6666666666666666,80181546,50,48
1,46,0.20689655172413793,0.618421052631579,73103114,58,12
2,1,0.875,0.5,68904962,8,7
1,47,0.29850746268656714,0.7243243243243244,70005866,67,20
2,8,0.5,0.9090909090909091,82145524,16,8
0,7,0.125,0.037037037037037035,72493771,8,1
1,9,0.25,0.631578947368421,66046876,12,3
2,29,0.5166666666666667,0.9024390243902439,80131289,60,31
0,13,0.1875,0.475,64063916,16,3
0,6,0.25,0.4482758620689655,74389525,8,2
0,3,0.0,0.0,82102504,3,0
1,8,0.3333333333333333,0.8518518518518519,66110604,12,4
1,25,0.3055555555555556,0.7567567567567568,19277783,36,11
0,18,0.1,0.17647058823529413,70467950,20,2
1,12,0.45454545454545453,0.9183673469387755,69058136,22,10
0,7,0.0,0.0,69160826,7,0
0,11,0.0,0.0,64063993,11,0
1,23,0.23333333333333334,0.5384615384615384,70121044,30,7
0,14,0.0,0.0,71761781,14,0
0,17,0.0,0.0,71761823,17,0
0,40,0.06976744186046512,0.15789473684210525,71762635,43,3
0,9,0.18181818181818182,0.42105263157894735,70026621,11,2
2,2,0.6,0.75,82019676,5,3
0,6,0.14285714285714285,0.05263157894736842,66204005,7,1
0,20,0.25925925925925924,0.15789473684210525,66608815,27,7
2,0,1.0,1.0,82020100,7,7
1,38,0.19148936170212766,0.5967741935483871,68467833,47,9
0,37,0.02631578947368421,0.125,80124390,38,1
0,1,0.0,0.0,70230531,1,0
0,10,0.16666666666666666,0.4358974358974359,70674282,12,2
0,4,0.2,0.2222222222222222,70081431,5,1
0,24,0.14285714285714285,0.11363636363636363,80124458,28,4
2,7,0.5333333333333333,0.75,75346355,15,8
0,9,0.0,0.0,75346964,9,0
1,4,0.3333333333333333,0.8,70712215,6,2
1,41,0.3050847457627119,0.8615384615384616,68475190,59,18
0,16,0.0,0.0,62841261,16,0
0,24,0.0,0.0,62841275,24,0
1,8,0.4666666666666667,0.5,82001874,15,7
1,15,0.375,0.8461538461538461,80133800,24,9
2,0,1.0,1.0,80079636,1,1
2,9,0.6538461538461539,0.875,82047572,26,17
1,10,0.375,0.8076923076923077,70867356,16,6
1,7,0.2222222222222222,0.7333333333333333,65981916,9,2
1,19,0.3870967741935484,0.847457627118644,68454645,31,12
1,6,0.14285714285714285,0.5833333333333334,70621551,7,1
2,7,0.5625,0.9444444444444444,69870220,16,9
0,3,0.25,0.08333333333333333,69870185,4,1
0,7,0.36363636363636365,0.375,66257233,11,4
0,1,0.0,0.0,69925051,1,0
0,33,0.175,0.4166666666666667,68229602,40,7
0,65,0.07142857142857142,0.05223880597014925,67653110,70,5
0,60,0.01639344262295082,0.14760147601476015,67896696,61,1
1,6,0.25,0.5833333333333334,63188090,8,2
0,5,0.0,0.0,68227362,5,0
0,4,0.0,0.0,69973022,4,0
0,3,0.25,0.3333333333333333,69973134,4,1
0,9,0.1,0.22727272727272727,80163385,10,1
2,6,0.6470588235294118,0.96,68725755,17,11
0,29,0.0,0.0,70463645,29,0
1,8,0.1111111111111111,0.6363636363636364,63991662,9,1
0,14,0.0,0.0,80150510,14,0
0,11,0.0,0.0,80150697,11,0
0,26,0.07142857142857142,0.2727272727272727,80155859,28,2
0,17,0.10526315789473684,0.358974358974359,69527773,19,2
0,11,0.08333333333333333,0.3137254901960784,82103801,12,1
0,19,0.09523809523809523,0.44594594594594594,69481482,21,2
0,12,0.0,0.0,80089233,12,0
0,58,0.1076923076923077,0.4885844748858447,64027852,65,7
0,7,0.0,0.0,80163382,7,0
0,1,0.0,0.0,80165847,1,0
0,16,0.2,0.4931506849315068,69886642,20,4
1,11,0.21428571428571427,0.7,70481985,14,3
1,13,0.13333333333333333,0.576271186440678,70482923,15,2
1,19,0.09523809523809523,0.6727272727272727,70467915,21,2
0,8,0.1111111111111111,0.32142857142857145,69549725,9,1
1,19,0.42424242424242425,0.78125,80050432,33,14
1,10,0.4117647058823529,0.975609756097561,67359544,17,7
0,10,0.16666666666666666,0.46808510638297873,74924101,12,2
0,20,0.047619047619047616,0.136986301369863,80149809,21,1
0,5,0.0,0.0,80172662,5,0
0,1,0.0,0.0,82006270,1,0
0,9,0.0,0.0,82006298,9,0
0,13,0.0,0.0,82006492,13,0
0,14,0.06666666666666667,0.45348837209302323,67467603,15,1
0,23,0.0,0.0,82049124,23,0
0,11,0.08333333333333333,0.32142857142857145,82102892,12,1
1,3,0.25,0.5714285714285714,82150108,4,1
1,5,0.16666666666666666,0.7272727272727273,64076880,6,1
0,18,0.05263157894736842,0.32142857142857145,70917945,19,1
1,10,0.2857142857142857,0.9591836734693877,82205882,14,4
2,5,0.5454545454545454,0.8333333333333334,82039839,11,6
0,8,0.0,0.0,80150513,8,0
0,8,0.0,0.0,80150719,8,0
1,44,0.2413793103448276,0.7651515151515151,68213565,58,14
0,22,0.0,0.0,80150892,22,0
0,2,0.0,0.0,67917402,2,0
0,1,0.0,0.0,69188175,1,0
1,13,0.4583333333333333,0.782608695652174,70036610,24,11
1,14,0.4166666666666667,0.6060606060606061,80056270,24,10
0,8,0.0,0.0,80167274,8,0
1,21,0.25,0.7938144329896907,66040436,28,7
0,51,0.03773584905660377,0.05952380952380952,67122202,53,2
0,104,0.06306306306306306,0.3048245614035088,69911233,111,7
2,0,1.0,1.0,80165345,2,2
2,7,0.5333333333333333,0.9545454545454546,70515305,15,8
1,12,0.29411764705882354,0.6774193548387096,70219723,17,5
0,26,0.0,0.0,70568092,26,0
0,22,0.26666666666666666,0.38461538461538464,80132357,30,8
2,0,1.0,1.0,70669095,2,2
0,39,0.20408163265306123,0.20512820512820512,69180545,49,10
0,24,0.07692307692307693,0.22784810126582278,69158264,26,2
2,1,0.5,0.5,80094315,2,1
0,46,0.08,0.08796296296296297,69724326,50,4
2,0,1.0,1.0,65715832,6,6
0,9,0.0,0.0,65279270,9,0
1,14,0.2631578947368421,0.6590909090909091,67690553,19,5
1,4,0.42857142857142855,0.9545454545454546,68273604,7,3
0,2,0.3333333333333333,0.3333333333333333,72802331,3,1
0,3,0.0,0.0,69998145,3,0
1,3,0.25,0.5454545454545454,65280061,4,1
0,4,0.3333333333333333,0.2857142857142857,80180602,6,2
1,10,0.375,0.84,64053346,16,6
1,7,0.36363636363636365,0.5555555555555556,70718844,11,4
0,15,0.0,0.0,82137496,15,0
0,7,0.0,0.0,82137498,7,0
2,0,1.0,1.0,68240305,2,2
0,4,0.0,0.0,67667971,4,0
2,3,0.6666666666666666,0.4,80179229,9,6
2,2,0.7142857142857143,0.75,65288482,7,5
0,12,0.14285714285714285,0.40425531914893614,69097770,14,2
0,14,0.06666666666666667,0.25,80162819,15,1
1,14,0.2631578947368421,0.6388888888888888,80162875,19,5
0,8,0.2,0.28,69508943,10,2
1,6,0.25,0.625,69508950,8,2
0,9,0.1,0.3548387096774194,69509202,10,1
0,14,0.0,0.0,70629545,14,0
1,17,0.2916666666666667,0.6097560975609756,82108569,24,7
0,6,0.25,0.15384615384615385,65025765,8,2
2,0,1.0,1.0,82013503,1,1
2,2,0.8181818181818182,0.5,75576403,11,9
1,36,0.28,0.5540540540540541,77577535,50,14
1,5,0.2857142857142857,0.6363636363636364,68499816,7,2
0,8,0.1111111111111111,0.12,68499865,9,1
0,4,0.0,0.0,68499984,4,0
1,4,0.3333333333333333,0.75,66856825,6,2
0,15,0.0,0.0,70178570,15,0
1,8,0.38461538461538464,0.8333333333333334,69699833,13,5
2,5,0.5454545454545454,0.9354838709677419,69699854,11,6
1,42,0.3333333333333333,0.7358490566037735,70767305,63,21
0,44,0.21428571428571427,0.19753086419753085,62497876,56,12
1,5,0.2857142857142857,0.625,70759696,7,2
1,16,0.23809523809523808,0.6296296296296297,69560652,21,5
2,1,0.75,0.8,67667152,4,3
1,13,0.38095238095238093,0.9117647058823529,70192535,21,8
1,50,0.35064935064935066,0.700507614213198,69084862,77,27
2,10,0.5833333333333334,0.8888888888888888,80180398,24,14
2,1,0.5,0.5,67753532,2,1
0,14,0.06666666666666667,0.17647058823529413,70629692,15,1
1,22,0.21428571428571427,0.7397260273972602,79453234,28,6
1,49,0.30985915492957744,0.6306306306306306,66856090,71,22
0,11,0.0,0.0,74709082,11,0
1,17,0.2916666666666667,0.5909090909090909,66304735,24,7
0,3,0.25,0.0,73871070,4,1
0,14,0.125,0.22916666666666666,70246330,16,2
0,22,0.15384615384615385,0.4878048780487805,70246344,26,4
1,7,0.46153846153846156,0.9090909090909091,66413746,13,6
1,6,0.4,0.8064516129032258,69551384,10,4
0,23,0.0,0.0,80155237,23,0
0,23,0.0,0.0,80155238,23,0
2,2,0.9230769230769231,0.6666666666666666,80176360,26,24
0,22,0.043478260869565216,0.19696969696969696,80124324,23,1
2,1,0.5,0.5,72805376,2,1
1,22,0.35294117647058826,0.875,69159930,34,12
0,13,0.0,0.0,66423560,13,0
0,7,0.125,0.1875,69726503,8,1
0,13,0.07142857142857142,0.2727272727272727,69726580,14,1
0,17,0.05555555555555555,0.13793103448275862,80124203,18,1
2,4,0.6666666666666666,0.75,73102330,12,8
1,3,0.25,0.7857142857142857,78735482,4,1
0,3,0.0,0.0,80150477,3,0
0,10,0.0,0.0,80150479,10,0
0,23,0.08,0.04918032786885246,61167225,25,2
0,21,0.16,0.20930232558139536,64918686,25,4
0,13,0.13333333333333333,0.4666666666666667,70629636,15,2
1,40,0.2727272727272727,0.6421052631578947,69898213,55,15
2,9,0.5714285714285714,0.92,68025594,21,12
1,25,0.24242424242424243,0.6666666666666666,70675262,33,8
0,7,0.0,0.0,67379704,7,0
2,2,0.6,0.5,70687680,5,3
2,6,0.7142857142857143,0.9696969696969697,80158335,21,15
2,3,0.6666666666666666,0.75,72802646,9,6
0,21,0.16,0.42,64287776,25,4
1,9,0.3076923076923077,0.6363636363636364,80134745,13,4
0,6,0.3333333333333333,0.2857142857142857,70252931,9,3
0,3,0.0,0.0,64345505,3,0
1,27,0.4,0.8961038961038961,65713704,45,18
1,10,0.3333333333333333,0.8518518518518519,77676676,15,5
1,9,0.47058823529411764,0.8636363636363636,68996333,17,8
0,11,0.15384615384615385,0.25,80158327,13,2
2,1,0.6666666666666666,0.8333333333333334,70874034,3,2
2,2,0.7777777777777778,0.8333333333333334,82013500,9,7
2,13,0.5806451612903226,0.9534883720930233,77329672,31,18
1,14,0.3,0.6153846153846154,80125949,20,6
2,1,0.6666666666666666,0.6666666666666666,80125453,3,2
0,22,0.15384615384615385,0.417910447761194,69704691,26,4
1,5,0.4444444444444444,0.8787878787878788,80145757,9,4
1,18,0.25,0.5384615384615384,70843276,24,6
1,7,0.2222222222222222,0.5,70675325,9,2
1,3,0.4,0.7777777777777778,72362185,5,2
2,3,0.5,0.9523809523809523,70615741,6,3
0,35,0.027777777777777776,0.128,70239043,36,1
2,24,0.6,0.9774436090225563,75115376,60,36
1,11,0.3125,0.7666666666666667,69389334,16,5
0,5,0.0,0.0,70681212,5,0
1,7,0.46153846153846156,0.8260869565217391,79807595,13,6
0,6,0.3333333333333333,0.4,80113432,9,3
1,16,0.2727272727272727,0.5365853658536586,65025842,22,6
1,29,0.32558139534883723,0.6923076923076923,65006011,43,14
0,1,0.0,0.0,66387790,1,0
0,24,0.07692307692307693,0.16842105263157894,69640746,26,2
0,33,0.08333333333333333,0.24390243902439024,69640830,36,3
2,7,0.6111111111111112,0.8,68996305,18,11
0,14,0.0,0.0,70567973,14,0
2,7,0.7586206896551724,0.9090909090909091,61005805,29,22
2,2,0.8181818181818182,0.75,69959281,11,9
2,0,1.0,1.0,70692510,1,1
0,2,0.3333333333333333,0.4,68748106,3,1
0,12,0.0,0.0,72474640,12,0
0,23,0.0,0.0,80124456,23,0
2,6,0.5384615384615384,0.8846153846153846,80132797,13,7
1,10,0.23076923076923078,0.5483870967741935,70701106,13,3
2,8,0.6521739130434783,0.9,66848495,23,15
0,24,0.07692307692307693,0.23809523809523808,70680141,26,2
0,2,0.0,0.0,70698432,2,0
0,7,0.125,0.3333333333333333,70193284,8,1
2,9,0.5909090909090909,0.7142857142857143,73102400,22,13
0,8,0.0,0.0,66226013,8,0
1,6,0.45454545454545453,0.8936170212765957,69153182,11,5
0,38,0.15555555555555556,0.4186046511627907,65907730,45,7
1,21,0.3,0.6521739130434783,66802764,30,9
1,31,0.3541666666666667,0.6231884057971014,70854084,48,17
2,0,1.0,1.0,80018484,2,2
2,1,0.9166666666666666,0.5,80117735,12,11
2,0,1.0,1.0,82090148,2,2
2,0,1.0,1.0,74749640,8,8
2,0,1.0,1.0,80135804,1,1
2,4,0.5555555555555556,0.9,79385404,9,5
0,10,0.16666666666666666,0.28,515522,12,2
0,16,0.15789473684210525,0.16666666666666666,65280376,19,3
2,0,1.0,1.0,82033192,8,8
1,16,0.36,0.5666666666666667,70854294,25,9
1,8,0.42857142857142855,0.8,70854315,14,6
1,7,0.4166666666666667,0.75,70854462,12,5
2,0,1.0,1.0,82033532,11,11
0,22,0.21428571428571427,0.37735849056603776,65289014,28,6
1,10,0.4117647058823529,0.875,65279305,17,7
0,14,0.2222222222222222,0.3,70803082,18,4
1,6,0.45454545454545453,0.7777777777777778,67053630,11,5
1,14,0.391304347826087,0.8478260869565217,68546744,23,9
1,13,0.48,0.8611111111111112,73508792,25,12
0,19,0.13636363636363635,0.2,68546345,22,3
0,8,0.1111111111111111,0.3953488372093023,80079286,9,1
0,6,0.14285714285714285,0.12,80126846,7,1
0,1,0.0,0.0,66082555,1,0
0,8,0.0,0.0,80122863,8,0
1,2,0.3333333333333333,0.7941176470588235,80166922,3,1
0,16,0.15789473684210525,0.2727272727272727,77676613,19,3
0,40,0.024390243902439025,0.08053691275167785,70109802,41,1
0,29,0.06451612903225806,0.3228346456692913,73064593,31,2
2,3,0.625,0.6,67694634,8,5
0,6,0.0,0.0,67894974,6,0
0,19,0.13636363636363635,0.05405405405405406,80123590,22,3
2,0,1.0,1.0,68032685,2,2
1,11,0.3125,0.59375,82018794,16,5
0,6,0.0,0.0,70175504,6,0
2,1,0.9565217391304348,0.5,80080126,23,22
2,2,0.6666666666666666,0.5,80169812,6,4
2,2,0.6,0.0,82003956,5,3
1,6,0.3333333333333333,0.6086956521739131,72803633,9,3
2,3,0.8333333333333334,0.75,69394346,18,15
2,0,1.0,1.0,80126504,24,24
0,12,0.45454545454545453,0.3333333333333333,69394241,22,10
2,4,0.8,0.8571428571428571,80139940,20,16
2,0,1.0,1.0,80080154,6,6
2,1,0.875,0.5,70813316,8,7
2,10,0.6,0.7777777777777778,80158331,25,15
2,0,1.0,1.0,67248314,3,3
1,5,0.2857142857142857,0.9259259259259259,70829493,7,2
2,1,0.9090909090909091,0.6666666666666666,70813561,11,10
2,0,1.0,1.0,82159942,24,24
2,1,0.96,0.6666666666666666,80174188,25,24
2,0,1.0,1.0,80159553,6,6
2,1,0.75,0.75,82054071,4,3
2,0,1.0,1.0,82042166,3,3
2,0,1.0,1.0,82020837,3,3
2,5,0.5,0.9411764705882353,82020089,10,5
2,0,1.0,1.0,73313450,8,8
2,0,1.0,1.0,77114002,2,2
2,3,0.5714285714285714,0.8888888888888888,70620704,7,4
2,1,0.8,0.0,80137914,5,4
2,14,0.65,0.6,75576431,40,26
0,1,0.0,0.0,82041276,1,0
1,15,0.375,0.8,82041278,24,9
2,0,1.0,1.0,68287415,3,3
2,2,0.6,0.6666666666666666,80158287,5,3
2,3,0.7857142857142857,0.8888888888888888,82018788,14,11
0,20,0.3548387096774194,0.09090909090909091,75577180,31,11
2,0,1.0,1.0,82037606,5,5
1,35,0.2391304347826087,0.5,79783340,46,11
1,7,0.4166666666666667,0.8695652173913043,80178918,12,5
2,1,0.9166666666666666,0.6666666666666666,70314496,12,11
2,0,1.0,1.0,82036975,7,7
1,8,0.3333333333333333,0.875,80155207,12,4
2,17,0.5277777777777778,0.926829268292683,72270982,36,19
0,5,0.16666666666666666,0.15625,72135490,6,1
0,1,0.0,0.0,69632990,1,0
0,3,0.0,0.0,69633011,3,0
0,6,0.0,0.0,66539830,6,0
1,6,0.3333333333333333,0.7222222222222222,72439584,9,3
1,29,0.14705882352941177,0.5042735042735043,60551673,34,5
1,5,0.2857142857142857,0.75,70235200,7,2
2,3,0.5714285714285714,0.9047619047619048,67271414,7,4
2,2,0.5,0.75,65008132,4,2
1,11,0.42105263157894735,0.8,62510042,19,8
2,4,0.6666666666666666,0.7777777777777778,82051898,12,8
0,7,0.125,0.12,78763685,8,1
2,2,0.7142857142857143,0.6666666666666666,70829122,7,5
0,21,0.125,0.12727272727272726,73783241,24,3
1,33,0.3125,0.7669902912621359,70242746,48,15
0,27,0.03571428571428571,0.13559322033898305,80150811,28,1
0,1,0.0,0.0,80149875,1,0
0,18,0.14285714285714285,0.39285714285714285,73460072,21,3
1,4,0.3333333333333333,0.7142857142857143,77676361,6,2
2,1,0.6666666666666666,0.8823529411764706,71964816,3,2
0,1,0.0,0.0,69464682,1,0
0,2,0.0,0.0,70967946,2,0
0,1,0.0,0.0,70968156,1,0
1,10,0.2857142857142857,0.8571428571428571,65360540,14,4
2,1,0.5,0.5,70417473,2,1
0,1,0.0,0.0,69463590,1,0
2,17,0.6046511627906976,0.8571428571428571,73588900,43,26
0,24,0.0,0.0,67468100,24,0
0,22,0.043478260869565216,0.26136363636363635,70746361,23,1
0,30,0.11764705882352941,0.4628099173553719,70746501,34,4
1,19,0.2692307692307692,0.7837837837837838,69693204,26,7
2,3,0.625,0.75,80162804,8,5
1,12,0.25,0.7317073170731707,63969066,16,4
0,4,0.0,0.0,66782226,4,0
0,2,0.0,0.0,66786685,2,0
0,14,0.125,0.0,82018982,16,2
2,2,0.8,0.6666666666666666,82108147,10,8
1,44,0.2786885245901639,0.7142857142857143,82143806,61,17
1,29,0.43137254901960786,0.8846153846153846,70674065,51,22
2,26,0.5,0.8769230769230769,67920755,52,26
1,4,0.42857142857142855,0.7272727272727273,65606765,7,3
0,18,0.0,0.0,70681163,18,0
2,6,0.6666666666666666,0.9393939393939394,69033664,18,12
1,5,0.2857142857142857,0.6818181818181818,69549620,7,2
1,7,0.3,0.7083333333333334,71588111,10,3
0,29,0.06451612903225806,0.1643835616438356,82152070,31,2
2,0,1.0,1.0,68667130,3,3
1,17,0.48484848484848486,0.85,69388074,33,16
0,23,0.30303030303030304,0.38095238095238093,68401522,33,10
2,0,1.0,1.0,70322826,1,1
0,2,0.3333333333333333,0.4,80135023,3,1
1,7,0.4166666666666667,0.7777777777777778,69561016,12,5
0,9,0.1,0.10714285714285714,67403812,10,1
2,2,0.6,0.8,82251171,5,3
2,5,0.5,0.6666666666666666,80155253,10,5
0,3,0.4,0.0,80155254,5,2
0,1,0.0,0.0,69597402,1,0
0,36,0.02702702702702703,0.38636363636363635,69724025,37,1
1,21,0.4473684210526316,0.8571428571428571,69589226,38,17
2,0,1.0,1.0,80084830,1,1
0,16,0.058823529411764705,0.125,68519822,17,1
0,21,0.08695652173913043,0.19402985074626866,80176624,23,2
0,23,0.08,0.2755905511811024,70608566,25,2
1,4,0.42857142857142855,0.8333333333333334,70063245,7,3
0,8,0.0,0.0,75121151,8,0
1,22,0.4358974358974359,0.8648648648648649,80167079,39,17
1,12,0.3684210526315789,0.8,69031284,19,7
1,13,0.4090909090909091,0.84375,67084640,22,9
1,7,0.2222222222222222,0.5384615384615384,70821793,9,2
1,5,0.375,0.9375,69603891,8,3
0,10,0.16666666666666666,0.4473684210526316,70629580,12,2
2,5,0.5454545454545454,0.9,70649642,11,6
1,28,0.4166666666666667,0.8309859154929577,68401123,48,20
1,26,0.21212121212121213,0.5894736842105263,72801974,33,7
0,18,0.0,0.0,72808932,18,0
2,0,1.0,1.0,79785146,2,2
1,5,0.375,0.75,70913115,8,3
2,0,1.0,1.0,65716084,2,2
2,1,0.75,0.5,82019836,4,3
2,2,0.7142857142857143,0.3333333333333333,82019843,7,5
2,1,0.6666666666666666,0.5,66232215,3,2
1,10,0.2857142857142857,0.5277777777777778,81978953,14,4
1,21,0.475,0.8979591836734694,81989147,40,19
0,16,0.1111111111111111,0.06976744186046512,69390636,18,2
2,2,0.6,0.9230769230769231,69169996,5,3
0,3,0.25,0.2857142857142857,80004085,4,1
0,8,0.0,0.0,82102483,8,0
0,4,0.0,0.0,63984242,4,0
2,7,0.6956521739130435,0.8571428571428571,82018964,23,16
2,1,0.6666666666666666,0.0,80181400,3,2
2,1,0.75,0.8,80149488,4,3
1,27,0.2702702702702703,0.5294117647058824,60195114,37,10
2,2,0.75,0.8,82070160,8,6
1,19,0.36666666666666664,0.6153846153846154,71288693,30,11
0,39,0.09302325581395349,0.09230769230769231,80126445,43,4
2,1,0.5,0.6666666666666666,68784086,2,1
0,20,0.13043478260869565,0.20253164556962025,82050501,23,3
0,26,0.07142857142857142,0.011363636363636364,82128672,28,2
0,39,0.1875,0.4935064935064935,61566400,48,9
1,14,0.44,0.8,79995251,25,11
1,6,0.4,0.875,69597262,10,4
2,2,0.5,0.9285714285714286,80163131,4,2
2,2,0.5,0.7142857142857143,69577655,4,2
0,8,0.38461538461538464,0.38461538461538464,80018722,13,5
1,8,0.38461538461538464,0.5882352941176471,67980101,13,5
0,4,0.2,0.2,82250565,5,1
1,4,0.42857142857142855,0.8181818181818182,82250569,7,3
0,21,0.2222222222222222,0.4782608695652174,68757395,27,6
2,9,0.5263157894736842,0.8461538461538461,80052693,19,10
1,12,0.3333333333333333,0.5714285714285714,82010269,18,6
1,8,0.42857142857142855,0.8085106382978723,72803192,14,6
0,27,0.1,0.208955223880597,70679133,30,3
0,27,0.20588235294117646,0.2413793103448276,70515263,34,7
0,35,0.16666666666666666,0.32,70769790,42,7
1,13,0.23529411764705882,0.6756756756756757,69033384,17,4
2,1,0.8571428571428571,0.75,66634680,7,6
2,0,1.0,1.0,67641441,3,3
0,3,0.0,0.0,69500284,3,0
2,26,0.6119402985074627,0.8867924528301887,80089485,67,41
1,9,0.3076923076923077,0.5185185185185185,70404775,13,4
0,33,0.1951219512195122,0.39285714285714285,82116867,41,8
0,7,0.0,0.0,70493451,7,0
0,2,0.0,0.0,82247768,2,0
0,1,0.0,0.0,82251448,1,0
2,31,0.6172839506172839,0.9791666666666666,70612493,81,50
1,18,0.4857142857142857,0.9090909090909091,69700295,35,17
0,14,0.17647058823529413,0.11764705882352941,65281412,17,3
0,2,0.0,0.0,65292850,2,0
1,19,0.24,0.5818181818181818,66034913,25,6
2,14,0.5172413793103449,0.8857142857142857,70493815,29,15
1,19,0.3870967741935484,0.8095238095238095,68616842,31,12
2,0,1.0,1.0,65279053,1,1
0,4,0.0,0.0,80131236,4,0
2,0,1.0,1.0,70330701,2,2
0,5,0.0,0.0,82039191,5,0
0,5,0.16666666666666666,0.21739130434782608,65278752,6,1
0,26,0.21212121212121213,0.42857142857142855,70643034,33,7
0,7,0.0,0.0,68784786,7,0
2,2,0.5,0.625,70190281,4,2
1,64,0.21951219512195122,0.6170212765957447,80154007,82,18
1,9,0.35714285714285715,0.75,69698363,14,5
1,4,0.3333333333333333,0.8181818181818182,70682122,6,2
0,3,0.0,0.0,70693133,3,0
0,3,0.0,0.0,70698670,3,0
0,31,0.225,0.34328358208955223,68616856,40,9
1,26,0.23529411764705882,0.7580645161290323,66552430,34,8
2,7,0.6111111111111112,0.9166666666666666,66027514,18,11
2,1,0.75,0.5,70417494,4,3
2,0,1.0,1.0,82037858,1,1
1,12,0.45454545454545453,0.9375,82005347,22,10
2,31,0.5230769230769231,0.92,65972095,65,34
1,3,0.25,0.8333333333333334,80150540,4,1
1,10,0.2857142857142857,0.8536585365853658,82116613,14,4
1,30,0.34782608695652173,0.7402597402597403,66332896,46,16
1,3,0.4,0.6666666666666666,82018826,5,2
2,1,0.75,0.5,80152718,4,3
0,27,0.35714285714285715,0.46153846153846156,69025131,42,15
1,9,0.47058823529411764,0.6451612903225806,67686276,17,8
2,2,0.6666666666666666,0.6666666666666666,72802926,6,4
0,1,0.0,0.0,73704813,1,0
0,11,0.0,0.0,69597171,11,0
0,23,0.14814814814814814,0.25757575757575757,68392072,27,4
1,7,0.46153846153846156,0.8888888888888888,73460366,13,6
0,1,0.0,0.0,82102557,1,0
1,4,0.2,0.5555555555555556,70908313,5,1
1,24,0.29411764705882354,0.5652173913043478,67053693,34,10
2,4,0.5555555555555556,0.8,69551370,9,5
1,6,0.3333333333333333,0.782608695652174,70230216,9,3
1,17,0.34615384615384615,0.875,72475172,26,9
1,21,0.27586206896551724,0.6197183098591549,80104885,29,8
2,3,0.5,0.9090909090909091,80134693,6,3
2,16,0.5,0.95,69896813,32,16
0,1,0.0,0.0,70679952,1,0
2,2,0.8823529411764706,0.8571428571428571,82025206,17,15
0,15,0.11764705882352941,0.24444444444444444,73801560,17,2
1,7,0.4166666666666667,0.75,75550314,12,5
2,4,0.5,0.9166666666666666,79025772,8,4
0,4,0.2,0.375,79980152,5,1
0,5,0.0,0.0,70681821,5,0
0,1,0.0,0.0,70694890,1,0
2,16,0.7333333333333333,0.9642857142857143,71416534,60,44
1,10,0.375,0.7941176470588235,69735071,16,6
0,21,0.2222222222222222,0.0,80132354,27,6
1,5,0.375,0.8666666666666667,67665360,8,3
0,14,0.2631578947368421,0.3125,80125548,19,5
2,1,0.5,0.5,80053904,2,1
0,6,0.3333333333333333,0.0,80019751,9,3
1,13,0.48,0.875,80155300,25,12
2,2,0.75,0.9333333333333333,82037167,8,6
0,6,0.4,0.375,69406764,10,4
2,5,0.5,0.8,80028403,10,5
1,9,0.47058823529411764,0.8695652173913043,65280824,17,8
2,2,0.7142857142857143,0.5,70408170,7,5
1,4,0.42857142857142855,0.8333333333333334,69164585,7,3
0,1,0.0,0.0,54252044,1,0
1,6,0.25,0.6923076923076923,80121036,8,2
0,36,0.2,0.2558139534883721,82045529,45,9
2,4,0.5,0.0,70868504,8,4
1,56,0.2727272727272727,0.5722222222222222,80107692,77,21
2,3,0.6666666666666666,0.6,66258073,9,6
1,3,0.25,0.5,66304896,4,1
2,9,0.55,0.95,66305022,20,11
0,1,0.0,0.0,80055143,1,0
0,26,0.07142857142857142,0.04918032786885246,69534164,28,2
0,4,0.2,0.3888888888888889,70081424,5,1
1,10,0.4444444444444444,0.72,66580472,18,8
0,38,0.13636363636363635,0.37681159420289856,74924262,44,6
0,26,0.10344827586206896,0.23809523809523808,69172803,29,3
1,11,0.26666666666666666,0.582089552238806,70701232,15,4
0,7,0.0,0.0,70685272,7,0
0,15,0.11764705882352941,0.16666666666666666,70684033,17,2
0,12,0.0,0.0,70210385,12,0
0,1,0.0,0.0,66815840,1,0
0,28,0.3170731707317073,0.46875,69959106,41,13
0,41,0.08888888888888889,0.2,80149845,45,4
2,11,0.6206896551724138,0.9523809523809523,80149480,29,18
0,10,0.09090909090909091,0.3333333333333333,69321532,11,1
2,2,0.6,0.8,66304966,5,3
1,2,0.3333333333333333,0.6666666666666666,70330834,3,1
2,2,0.6666666666666666,0.75,70060361,6,4
2,0,1.0,1.0,74320785,9,9
1,9,0.25,0.5555555555555556,69596261,12,3
1,4,0.42857142857142855,0.6666666666666666,68645934,7,3
0,6,0.0,0.0,80122893,6,0
1,6,0.25,0.6470588235294118,80123385,8,2
2,17,0.6964285714285714,0.9682539682539683,79816044,56,39
2,2,0.9166666666666666,0.6666666666666666,75576480,24,22
1,8,0.4666666666666667,0.7777777777777778,71288714,15,7
1,12,0.3684210526315789,0.5862068965517241,71288721,19,7
2,2,0.8571428571428571,0.8333333333333334,80062325,14,12
0,21,0.0,0.0,69417061,21,0
1,13,0.35,0.6571428571428571,82009593,20,7
2,16,0.5675675675675675,0.8181818181818182,73870006,37,21
1,23,0.43902439024390244,0.8172043010752689,68398344,41,18
0,15,0.11764705882352941,0.19230769230769232,66892091,17,2
0,10,0.09090909090909091,0.125,69417152,11,1
1,14,0.125,0.5957446808510638,80116911,16,2
1,2,0.3333333333333333,0.7894736842105263,70509341,3,1
1,26,0.35,0.6438356164383562,82052041,40,14
2,4,0.8181818181818182,0.9,79323804,22,18
2,1,0.75,0.5,80118886,4,3
0,3,0.25,0.16666666666666666,69596324,4,1
2,1,0.5,0.3333333333333333,80117721,2,1
0,2,0.0,0.0,69311655,2,0
1,16,0.15789473684210525,0.5769230769230769,67435053,19,3
1,5,0.375,0.8222222222222222,67035521,8,3
1,6,0.25,0.5853658536585366,68499592,8,2
0,8,0.0,0.0,70230013,8,0
2,6,0.5,0.88,72803493,12,6
2,2,0.5,0.5,80150233,4,2
1,16,0.30434782608695654,0.6774193548387096,67793635,23,7
2,2,0.75,0.8,82009605,8,6
0,23,0.11538461538461539,0.06382978723404255,68317746,26,3
0,46,0.08,0.16551724137931034,72775570,50,4
2,6,0.625,0.8461538461538461,80128801,16,10
0,2,0.0,0.0,68563222,2,0
1,16,0.23809523809523808,0.5333333333333333,73634862,21,5
2,0,1.0,1.0,80176495,5,5
2,0,1.0,1.0,67867646,2,2
0,3,0.0,0.0,72472855,3,0
2,1,0.6666666666666666,0.5,82018714,3,2
0,86,0.2037037037037037,0.37662337662337664,70234724,108,22
2,8,0.5789473684210527,0.8235294117647058,80172938,19,11
0,24,0.2,0.2916666666666667,70045633,30,6
1,32,0.2,0.6833333333333333,80150436,40,8
0,32,0.15789473684210525,0.14583333333333334,70058702,38,6
2,6,0.5384615384615384,0.9767441860465116,81992768,13,7
0,5,0.0,0.0,69597514,5,0
0,23,0.0,0.0,82173338,23,0
0,19,0.13636363636363635,0.4925373134328358,69693323,22,3
2,3,0.5,0.8571428571428571,65292654,6,3
0,1,0.0,0.0,70712341,1,0
2,0,1.0,1.0,69959211,11,11
2,2,0.6,0.8333333333333334,72803241,5,3
0,7,0.125,0.3333333333333333,70467054,8,1
1,58,0.2564102564102564,0.6,69134982,78,20
0,5,0.16666666666666666,0.21739130434782608,70467040,6,1
0,12,0.14285714285714285,0.2,80128179,14,2
1,14,0.17647058823529413,0.5555555555555556,82102802,17,3
0,25,0.13793103448275862,0.39285714285714285,80155847,29,4
1,13,0.4090909090909091,0.9130434782608695,67422796,22,9
0,14,0.2631578947368421,0.3181818181818182,69733363,19,5
2,4,0.6,0.16666666666666666,69959302,10,6
2,3,0.7692307692307693,0.75,66371893,13,10
1,30,0.25,0.6805555555555556,71618834,40,10
2,0,1.0,1.0,68294254,5,5
2,1,0.8571428571428571,0.5,80181397,7,6
2,1,0.8333333333333334,0.5,80118123,6,5
0,24,0.07692307692307693,0.19626168224299065,82109292,26,2
1,9,0.3076923076923077,0.6410256410256411,70060473,13,4
2,2,0.5,0.8888888888888888,70842926,4,2
1,6,0.14285714285714285,0.5333333333333333,82019476,7,1
2,4,0.7142857142857143,0.75,70566524,14,10
2,4,0.5555555555555556,0.8571428571428571,67189010,9,5
0,7,0.125,0.0,82008044,8,1
1,13,0.43478260869565216,0.8409090909090909,80163145,23,10
2,2,0.6666666666666666,0.75,70253722,6,4
1,11,0.35294117647058826,0.8888888888888888,70921396,17,6
0,13,0.0,0.0,70682696,13,0
0,6,0.14285714285714285,0.38095238095238093,70691824,7,1
2,0,1.0,1.0,68294191,4,4
0,26,0.037037037037037035,0.15151515151515152,82164462,27,1
0,21,0.0,0.0,82164463,21,0
0,33,0.175,0.3142857142857143,74850461,40,7
2,2,0.5,0.9565217391304348,70398342,4,2
1,31,0.2619047619047619,0.7009345794392523,63967043,42,11
1,7,0.36363636363636365,0.7222222222222222,69560092,11,4
0,25,0.07407407407407407,0.27692307692307694,68318320,27,2
2,5,0.5454545454545454,0.9230769230769231,80119181,11,6
0,32,0.21951219512195122,0.42592592592592593,80135614,41,9
0,15,0.0625,0.0,65554272,16,1
1,10,0.4117647058823529,0.9259259259259259,70185395,17,7
0,9,0.18181818181818182,0.13333333333333333,79854173,11,2
2,0,1.0,1.0,80003553,7,7
1,21,0.2222222222222222,0.5625,80126820,27,6
0,15,0.11764705882352941,0.35714285714285715,70693574,17,2
0,17,0.0,0.0,70699286,17,0
0,5,0.2857142857142857,0.45454545454545453,75124315,7,2
0,49,0.1694915254237288,0.39361702127659576,68500054,59,10
0,2,0.0,0.0,68015465,2,0
0,16,0.2,0.4523809523809524,70601552,20,4
0,1,0.0,0.0,82006730,1,0
0,2,0.0,0.0,82006731,2,0
0,5,0.0,0.0,80150608,5,0
0,7,0.125,0.375,73533313,8,1
2,4,0.5555555555555556,0.8888888888888888,68904955,9,5
2,2,0.5,0.8095238095238095,80135290,4,2
0,33,0.05714285714285714,0.2695035460992908,78166291,35,2
0,9,0.0,0.0,82118250,9,0
2,1,0.5,0.7142857142857143,82150109,2,1
2,3,0.5,0.9523809523809523,67917794,6,3
0,29,0.0,0.0,70923685,29,0
2,5,0.5454545454545454,0.8571428571428571,75663042,11,6
2,10,0.5652173913043478,0.96,80090220,23,13
0,2,0.0,0.0,80172548,2,0
1,11,0.45,0.9743589743589743,70184611,20,9
0,13,0.07142857142857142,0.23529411764705882,70630014,14,1
1,19,0.36666666666666664,0.7916666666666666,80019093,30,11
0,8,0.1111111111111111,0.09090909090909091,80019135,9,1
0,19,0.05,0.15789473684210525,80155866,20,1
2,0,1.0,1.0,67511045,1,1
0,32,0.13513513513513514,0.11267605633802817,70676844,37,5
2,6,0.5384615384615384,0.96,66496045,13,7
0,3,0.0,0.0,70194775,3,0
0,7,0.0,0.0,63525532,7,0
0,1,0.0,0.0,80172551,1,0
1,2,0.3333333333333333,0.6666666666666666,80172634,3,1
0,24,0.04,0.17985611510791366,67467554,25,1
1,8,0.2727272727272727,0.625,70202692,11,3
1,10,0.47368421052631576,0.9534883720930233,80153608,19,9
0,9,0.18181818181818182,0.23809523809523808,82103919,11,2
0,6,0.0,0.0,70634732,6,0
0,4,0.0,0.0,80172521,4,0
0,5,0.0,0.0,80150658,5,0
1,22,0.12,0.5051546391752577,70463155,25,3
0,21,0.045454545454545456,0.18691588785046728,70059584,22,1
1,8,0.3333333333333333,0.7777777777777778,65176146,12,4
0,6,0.0,0.0,67975726,6,0
2,6,0.6,0.9583333333333334,65609250,15,9
0,6,0.0,0.0,80163209,6,0
0,14,0.0,0.0,80150686,14,0
0,80,0.024390243902439025,0.09364548494983277,65350831,82,2
0,16,0.1111111111111111,0.3176470588235294,69912563,18,2
0,5,0.0,0.0,70635684,5,0
1,6,0.25,0.7692307692307693,80172553,8,2
0,21,0.045454545454545456,0.1282051282051282,82103841,22,1
0,9,0.0,0.0,71081465,9,0
0,3,0.0,0.0,80150562,3,0
0,2,0.0,0.0,67380831,2,0
0,8,0.0,0.0,70629944,8,0
0,12,0.07692307692307693,0.30303030303030304,69911373,13,1
0,15,0.16666666666666666,0.4406779661016949,66310083,18,3
0,11,0.08333333333333333,0.13043478260869565,70584213,12,1
1,22,0.26666666666666666,0.7272727272727273,66132822,30,8
1,15,0.21052631578947367,0.6808510638297872,70476126,19,4
1,7,0.3,0.6346153846153846,70843745,10,3
0,6,0.0,0.0,67364262,6,0
2,0,1.0,1.0,82021571,10,10
1,27,0.325,0.631578947368421,82055992,40,13
0,14,0.06666666666666667,0.3103448275862069,70676130,15,1
0,14,0.0,0.0,70685090,14,0
1,5,0.375,0.5,80093804,8,3
1,21,0.19230769230769232,0.5303030303030303,78763650,26,5
1,8,0.2727272727272727,0.6956521739130435,60249315,11,3
2,9,0.5909090909090909,0.9629629629629629,72802541,22,13
0,15,0.0,0.0,70721070,15,0
0,26,0.10344827586206896,0.20270270270270271,73295572,29,3
0,1,0.0,0.0,70843206,1,0
2,1,0.5,0.8,65940490,2,1
2,0,1.0,1.0,80136615,2,2
1,33,0.45,0.927536231884058,72802723,60,27
1,9,0.3076923076923077,0.7,80150332,13,4
0,2,0.0,0.0,70675731,2,0
2,3,0.5,0.75,67812864,6,3
2,5,0.6666666666666666,0.8571428571428571,80180603,15,10
0,3,0.0,0.0,72523290,3,0
1,21,0.3225806451612903,0.6732673267326733,80132791,31,10
2,0,1.0,1.0,80176463,4,4
0,23,0.0,0.0,62840113,23,0
0,30,0.1891891891891892,0.43478260869565216,73701082,37,7
2,0,1.0,1.0,72814756,1,1
2,2,0.7142857142857143,0.8571428571428571,70078162,7,5
2,1,0.5,0.8,69129893,2,1
1,75,0.27884615384615385,0.6106194690265486,82002228,104,29
2,2,0.5,0.6666666666666666,82184453,4,2
1,3,0.25,0.56,66801791,4,1
0,3,0.0,0.0,72523311,3,0
0,11,0.08333333333333333,0.29411764705882354,72909984,12,1
0,4,0.0,0.0,73295733,4,0
1,10,0.16666666666666666,0.5892857142857143,70489125,12,2
0,3,0.0,0.0,72474584,3,0
1,4,0.42857142857142855,0.6666666666666666,72475130,7,3
2,5,0.5,0.9411764705882353,69982983,10,5
0,6,0.0,0.0,70682381,6,0
1,4,0.3333333333333333,0.7142857142857143,82013600,6,2
1,16,0.2,0.5833333333333334,80122911,20,4
2,7,0.7586206896551724,0.6666666666666666,69172754,29,22
0,2,0.0,0.0,70843661,2,0
0,7,0.125,0.1111111111111111,80122857,8,1
0,1,0.0,0.0,68805926,1,0
1,8,0.38461538461538464,0.5714285714285714,70612360,13,5
2,7,0.5882352941176471,0.9375,69999650,17,10
2,2,0.7142857142857143,0.6666666666666666,70073430,7,5
0,11,0.08333333333333333,0.2413793103448276,69006196,12,1
0,14,0.06666666666666667,0.06,68546394,15,1
2,5,0.6875,0.8181818181818182,70474964,16,11
1,27,0.35714285714285715,0.711864406779661,66062976,42,15
2,0,1.0,1.0,80132788,15,15
2,0,1.0,1.0,82127873,17,17
0,20,0.047619047619047616,0.25,80124795,21,1
2,0,1.0,1.0,73652285,3,3
2,0,1.0,1.0,72803500,6,6
0,8,0.1111111111111111,0.3125,70685853,9,1
2,2,0.6,0.6666666666666666,67822972,5,3
0,7,0.0,0.0,69998103,7,0
2,1,0.75,0.9,70395591,4,3
0,50,0.12280701754385964,0.3105590062111801,81973008,57,7
0,19,0.09523809523809523,0.38095238095238093,69134450,21,2
2,6,0.5,0.9642857142857143,70917266,12,6
1,14,0.3333333333333333,0.7058823529411765,80180220,21,7
0,22,0.3333333333333333,0.4883720930232558,80180217,33,11
0,12,0.25,0.2857142857142857,69964461,16,4
0,16,0.15789473684210525,0.20588235294117646,69499304,19,3
1,47,0.3561643835616438,0.7569444444444444,80163140,73,26
2,6,0.5,0.8181818181818182,80172023,12,6
0,5,0.375,0.4666666666666667,80053372,8,3
1,5,0.4444444444444444,0.95,65286746,9,4
0,43,0.0851063829787234,0.2978723404255319,63992901,47,4
0,17,0.05555555555555555,0.12857142857142856,69895742,18,1
0,13,0.0,0.0,63993076,13,0
0,24,0.14285714285714285,0.3950617283950617,64352421,28,4
0,18,0.05263157894736842,0.28431372549019607,63375711,19,1
0,14,0.06666666666666667,0.34,63375746,15,1
2,1,0.5,0.875,60919285,2,1
0,34,0.1282051282051282,0.46511627906976744,69895406,39,5
1,24,0.1111111111111111,0.5833333333333334,63992950,27,3
0,12,0.0,0.0,66933293,12,0
0,30,0.14285714285714285,0.3235294117647059,80122901,35,5
0,9,0.0,0.0,69895945,9,0
2,0,1.0,1.0,80159683,4,4
0,7,0.0,0.0,73460086,7,0
0,7,0.0,0.0,67475352,7,0
1,6,0.14285714285714285,0.5555555555555556,69163353,7,1
1,13,0.4090909090909091,0.8837209302325582,61356386,22,9
1,7,0.36363636363636365,0.75,71081094,11,4
0,10,0.0,0.0,66783444,10,0
1,5,0.4444444444444444,0.9166666666666666,69163465,9,4
2,6,0.6666666666666666,0.8333333333333334,72186660,18,12
0,15,0.2857142857142857,0.43478260869565216,66267173,21,6
1,12,0.07692307692307693,0.5,82049115,13,1
2,0,1.0,1.0,70700616,15,15
0,16,0.058823529411764705,0.16216216216216217,70678944,17,1
2,1,0.8571428571428571,0.8,80066385,7,6
1,11,0.21428571428571427,0.6326530612244898,66224543,14,3
2,0,1.0,1.0,82127547,1,1
0,4,0.2,0.375,66225292,5,1
1,15,0.4230769230769231,0.8536585365853658,70853916,26,11
0,50,0.0196078431372549,0.030973451327433628,70669683,51,1
0,12,0.2,0.3333333333333333,72905910,15,3
2,1,0.6666666666666666,0.6666666666666666,66243191,3,2
0,24,0.1111111111111111,0.2463768115942029,73704911,27,3
1,8,0.38461538461538464,0.7333333333333333,80019611,13,5
0,3,0.0,0.0,68805485,3,0
1,24,0.25,0.5142857142857142,80177413,32,8
0,3,0.4,0.3333333333333333,71458632,5,2
0,13,0.13333333333333333,0.2647058823529412,80052616,15,2
1,17,0.41379310344827586,0.8666666666666667,82053034,29,12
0,8,0.2,0.4090909090909091,68642154,10,2
1,33,0.3125,0.7956989247311828,60506376,48,15
0,14,0.2222222222222222,0.24,68790862,18,4
1,20,0.3548387096774194,0.8461538461538461,73634834,31,11
0,26,0.13333333333333333,0.32407407407407407,80135094,30,4
2,0,1.0,1.0,82024369,1,1
2,3,0.5714285714285714,0.75,79786021,7,4
0,26,0.13333333333333333,0.07462686567164178,66930451,30,4
1,6,0.3333333333333333,0.78125,80126783,9,3
1,17,0.46875,0.9459459459459459,72802884,32,15
0,3,0.0,0.0,72809324,3,0
2,9,0.7,0.75,66816015,30,21
0,1,0.0,0.0,70282681,1,0
2,1,0.5,0.6666666666666666,67199055,2,1
2,2,0.7142857142857143,0.3333333333333333,73632370,7,5
1,19,0.2692307692307692,0.6470588235294118,73977785,26,7
0,6,0.3333333333333333,0.2727272727272727,79787680,9,3
1,12,0.4,0.88,65288741,20,8
0,12,0.2,0.3142857142857143,65282770,15,3
0,49,0.14035087719298245,0.24087591240875914,69621615,57,8
1,5,0.375,0.7777777777777778,65279543,8,3
1,7,0.36363636363636365,0.7857142857142857,65288874,11,4
1,5,0.2857142857142857,0.7857142857142857,68191704,7,2
1,9,0.4375,0.7692307692307693,82163419,16,7
0,12,0.2,0.3333333333333333,70802991,15,3
0,39,0.15217391304347827,0.23008849557522124,69712160,46,7
1,16,0.2727272727272727,0.6533333333333333,72802233,22,6
0,15,0.0625,0.07017543859649122,72809093,16,1
1,18,0.4,0.8529411764705882,67040470,30,12
0,7,0.125,0.36666666666666664,68499536,8,1
0,11,0.26666666666666666,0.43902439024390244,68497611,15,4
0,5,0.0,0.0,70610806,5,0
1,4,0.2,0.6,69164130,5,1
1,4,0.42857142857142855,0.9,68281290,7,3
0,9,0.18181818181818182,0.2653061224489796,73623256,11,2
0,52,0.11864406779661017,0.12380952380952381,70357133,59,7
0,2,0.0,0.0,67054113,2,0
0,2,0.0,0.0,67054134,2,0
0,4,0.2,0.47368421052631576,80155202,5,1
2,1,0.5,0.0,70628495,2,1
1,4,0.2,0.7647058823529411,64248646,5,1
1,25,0.358974358974359,0.7916666666666666,67775330,39,14
2,0,1.0,1.0,67667103,1,1
0,5,0.16666666666666666,0.0,64976513,6,1
2,0,1.0,1.0,69597052,1,1
1,4,0.3333333333333333,0.9545454545454546,72803045,6,2
2,1,0.8888888888888888,0.5,68364520,9,8
2,0,1.0,1.0,77237496,1,1
2,0,1.0,1.0,82154364,8,8
2,0,1.0,1.0,82051750,5,5
2,1,0.6666666666666666,0.8333333333333334,65116765,3,2
2,5,0.5454545454545454,0.8333333333333334,70792540,11,6
0,27,0.06896551724137931,0.037037037037037035,73700711,29,2
2,1,0.5,0.5,82179508,2,1
2,5,0.5454545454545454,0.7142857142857143,69972721,11,6
1,10,0.47368421052631576,0.8823529411764706,80128844,19,9
1,37,0.463768115942029,0.92,63238203,69,32
2,1,0.75,0.5,70037275,4,3
2,4,0.75,0.8333333333333334,82032895,16,12
2,0,1.0,1.0,70314510,6,6
0,16,0.2727272727272727,0.4146341463414634,66539844,22,6
2,0,1.0,1.0,82145157,1,1
2,0,1.0,1.0,82051752,9,9
2,4,0.6363636363636364,0.9,80165363,11,7
0,27,0.15625,0.2916666666666667,80140078,32,5
2,0,1.0,1.0,72844793,8,8
2,0,1.0,1.0,74626461,7,7
2,0,1.0,1.0,80079566,2,2
2,8,0.6666666666666666,0.875,80126554,24,16
2,0,1.0,1.0,82036966,5,5
2,2,0.75,0.75,80084193,8,6
2,0,1.0,1.0,70189385,7,7
2,0,1.0,1.0,80162130,13,13
2,8,0.8222222222222222,0.9230769230769231,70781774,45,37
2,58,0.5972222222222222,0.9626168224299065,70277354,144,86
2,1,0.8,0.5,82143621,5,4
0,4,0.2,0.16666666666666666,75550342,5,1
2,9,0.5909090909090909,0.5454545454545454,68556754,22,13
2,0,1.0,1.0,70314314,4,4
2,5,0.6875,0.9333333333333333,80155208,16,11
2,0,1.0,1.0,82041300,3,3
2,3,0.85,0.8571428571428571,74043536,20,17
0,8,0.2,0.047619047619047616,80172009,10,2
2,0,1.0,1.0,80175993,3,3
1,9,0.47058823529411764,0.8333333333333334,80165174,17,8
0,7,0.125,0.18181818181818182,82018991,8,1
2,2,0.9,0.8,82038251,20,18
2,2,0.7777777777777778,0.9,80172966,9,7
1,2,0.3333333333333333,0.8,69069693,3,1
2,1,0.75,0.5,65888361,4,3
2,0,1.0,1.0,82039275,3,3
2,0,1.0,1.0,82039835,5,5
2,6,0.5,0.9411764705882353,81971196,12,6
0,4,0.2,0.45454545454545453,70059766,5,1
0,1,0.0,0.0,68211430,1,0
2,1,0.75,0.75,73800846,4,3
1,4,0.42857142857142855,0.9230769230769231,69999776,7,3
2,1,0.5,0.6666666666666666,66237241,2,1
2,0,1.0,1.0,70593894,13,13
1,7,0.36363636363636365,0.8333333333333334,70476644,11,4
0,57,0.13636363636363635,0.2872340425531915,69395683,66,9
1,12,0.4,0.9285714285714286,82116882,20,8
0,31,0.18421052631578946,0.12162162162162163,79976715,38,7
0,17,0.05555555555555555,0.034482758620689655,73460100,18,1
1,31,0.39215686274509803,0.6666666666666666,66263463,51,20
2,12,0.52,0.8571428571428571,80136952,25,13
0,9,0.1,0.2727272727272727,70682402,10,1
0,29,0.17142857142857143,0.2641509433962264,80124688,35,6
0,13,0.0,0.0,82003711,13,0
0,13,0.07142857142857142,0.3888888888888889,82003723,14,1
1,17,0.2916666666666667,0.6714285714285714,80067512,24,7
0,10,0.0,0.0,70248024,10,0
1,21,0.045454545454545456,0.7368421052631579,70248031,22,1
1,7,0.36363636363636365,0.9090909090909091,70248101,11,4
2,4,0.6,0.9,64474865,10,6
2,15,0.5161290322580645,0.8823529411764706,66899042,31,16
2,2,0.5,0.75,65199001,4,2
0,16,0.1111111111111111,0.48214285714285715,80163207,18,2
0,16,0.15789473684210525,0.3870967741935484,61228776,19,3
0,25,0.07407407407407407,0.2545454545454545,69638100,27,2
0,5,0.0,0.0,66785845,5,0
2,0,1.0,1.0,74129335,4,4
0,4,0.2,0.45454545454545453,68440652,5,1
0,20,0.13043478260869565,0.45454545454545453,80163202,23,3
1,10,0.4117647058823529,0.625,73942155,17,7
0,6,0.14285714285714285,0.25925925925925924,70063280,7,1
2,10,0.7297297297297297,0.9545454545454546,63523404,37,27
2,0,1.0,1.0,70822521,1,1
1,16,0.1111111111111111,0.5128205128205128,61976243,18,2
0,18,0.28,0.2,69129914,25,7
2,10,0.5,0.9333333333333333,68338690,20,10
1,10,0.16666666666666666,0.6428571428571429,80125936,12,2
2,10,0.6666666666666666,0.9642857142857143,70851375,30,20
1,27,0.34146341463414637,0.7831325301204819,70052045,41,14
2,0,1.0,1.0,69206760,4,4
2,2,0.7777777777777778,0.5,82020097,9,7
2,0,1.0,1.0,80159229,23,23
1,18,0.18181818181818182,0.6296296296296297,82135550,22,4
1,28,0.36363636363636365,0.5918367346938775,62746565,44,16
1,30,0.3617021276595745,0.82,82128645,47,17
2,5,0.6153846153846154,0.8333333333333334,67214245,13,8
2,1,0.6666666666666666,0.5,70808360,3,2
2,3,0.5,0.8333333333333334,70286601,6,3
2,1,0.6666666666666666,0.7777777777777778,73161480,3,2
2,4,0.7142857142857143,0.95,68254781,14,10
0,3,0.0,0.0,73919923,3,0
0,14,0.06666666666666667,0.09302325581395349,70680890,15,1
0,2,0.0,0.0,67516722,2,0
2,3,0.5,0.9,70175791,6,3
1,3,0.4,0.7,68191193,5,2
0,2,0.0,0.0,70692041,2,0
0,1,0.0,0.0,80126848,1,0
0,2,0.0,0.0,67072355,2,0
0,13,0.07142857142857142,0.06557377049180328,80165151,14,1
0,34,0.10526315789473684,0.4251968503937008,68798422,38,4
2,1,0.8888888888888888,0.5,65819621,9,8
1,26,0.3157894736842105,0.6666666666666666,82045549,38,12
0,10,0.16666666666666666,0.34375,73634953,12,2
2,1,0.875,0.6666666666666666,338961,8,7
1,11,0.35294117647058826,0.7666666666666667,69389285,17,6
1,7,0.3,0.8260869565217391,69562675,10,3
1,41,0.32786885245901637,0.8943089430894309,70615461,61,20
0,11,0.15384615384615385,0.4827586206896552,70703416,13,2
0,15,0.0,0.0,80126844,15,0
2,3,0.5714285714285714,0.75,66257394,7,4
0,3,0.0,0.0,70490700,3,0
0,3,0.0,0.0,69416914,3,0
1,3,0.4,0.8461538461538461,73763872,5,2
2,1,0.75,0.5,72377172,4,3
0,31,0.06060606060606061,0.0,62746523,33,2
0,29,0.19444444444444445,0.35443037974683544,68241453,36,7
2,1,0.5,0.6666666666666666,82137404,2,1
2,3,0.9090909090909091,0.9375,80126556,33,30
1,6,0.3333333333333333,0.6428571428571429,65281034,9,3
0,38,0.02564102564102564,0.13440860215053763,69867875,39,1
1,12,0.25,0.7244897959183674,80128213,16,4
1,9,0.25,0.8,67434682,12,3
0,11,0.15384615384615385,0.41025641025641024,82096275,13,2
0,20,0.13043478260869565,0.1951219512195122,82095056,23,3
0,12,0.25,0.42424242424242425,72802912,16,4
2,6,0.5714285714285714,0.9411764705882353,82018700,14,8
0,17,0.10526315789473684,0.19047619047619047,82041235,19,2
0,3,0.25,0.0,70702310,4,1
1,2,0.3333333333333333,0.8333333333333334,70704452,3,1
0,4,0.0,0.0,80074463,4,0
1,29,0.3409090909090909,0.7545454545454545,67721150,44,15
2,7,0.65,0.8888888888888888,80112942,20,13
2,2,0.6,0.6,80165474,5,3
2,3,0.75,0.8461538461538461,77582414,12,9
1,17,0.32,0.7692307692307693,70198114,25,8
0,3,0.0,0.0,327390,3,0
0,29,0.14705882352941177,0.1553398058252427,70711312,34,5
2,1,0.5,0.8571428571428571,82154407,2,1
2,3,0.5,0.8333333333333334,82105390,6,3
0,2,0.0,0.0,64997982,2,0
0,52,0.10344827586206896,0.0603448275862069,63051772,58,6
2,6,0.5714285714285714,0.8421052631578947,70063483,14,8
0,7,0.0,0.0,70059752,7,0
0,11,0.0,0.0,70059836,11,0
2,1,0.75,0.5,67212152,4,3
0,1,0.0,0.0,70197505,1,0
0,17,0.05555555555555555,0.2,80132950,18,1
2,1,0.5,0.8,82251470,2,1
0,12,0.0,0.0,70229215,12,0
0,15,0.0625,0.46153846153846156,70230041,16,1
0,32,0.030303030303030304,0.15942028985507245,70600390,33,1
0,16,0.1111111111111111,0.375,80124342,18,2
1,18,0.3793103448275862,0.8043478260869565,80177685,29,11
2,14,0.5483870967741935,0.6956521739130435,64312416,31,17
2,7,0.65,0.5,82132594,20,13
0,1,0.0,0.0,69517805,1,0
0,15,0.11764705882352941,0.24528301886792453,70687652,17,2
2,5,0.5,0.8571428571428571,68234404,10,5
0,3,0.0,0.0,68234446,3,0
2,0,1.0,1.0,70820694,1,1
2,27,0.5,0.8918918918918919,68402131,54,27
1,27,0.2702702702702703,0.5789473684210527,81956141,37,10
1,5,0.2857142857142857,0.7647058823529411,67963126,7,2
1,10,0.47368421052631576,0.9629629629629629,69031130,19,9
1,38,0.32142857142857145,0.8117647058823529,82116873,56,18
1,14,0.46153846153846156,0.9545454545454546,67775344,26,12
0,5,0.0,0.0,67094363,5,0
1,6,0.45454545454545453,0.8181818181818182,80149803,11,5
1,14,0.3,0.6363636363636364,80070235,20,6
1,10,0.4117647058823529,0.8,80130706,17,7
2,0,1.0,1.0,82247749,1,1
0,9,0.25,0.4444444444444444,69635006,12,3
0,5,0.4444444444444444,0.25,82038372,9,4
2,13,0.5185185185185185,0.9696969696969697,80085943,27,14
0,4,0.0,0.0,69597304,4,0
1,9,0.35714285714285715,0.7560975609756098,68229532,14,5
2,2,0.5,0.8,72670045,4,2
2,4,0.6923076923076923,0.9,82039334,13,9
0,25,0.0,0.0,73459743,25,0
0,1,0.0,0.0,69092870,1,0
1,8,0.4666666666666667,0.9333333333333333,69167560,15,7
0,18,0.14285714285714285,0.14893617021276595,65290995,21,3
2,1,0.5,0.8,80114776,2,1
2,0,1.0,1.0,69404321,3,3
1,22,0.2413793103448276,0.5692307692307692,82158137,29,7
1,9,0.4375,0.9375,70646905,16,7
1,32,0.21951219512195122,0.5263157894736842,70713790,41,9
1,16,0.2,0.7534246575342466,80137533,20,4
0,1,0.0,0.0,70463785,1,0
2,1,0.8888888888888888,0.5,82062190,9,8
0,14,0.3333333333333333,0.0,80132355,21,7
0,3,0.25,0.3333333333333333,67706100,4,1
1,49,0.18333333333333332,0.6153846153846154,80128283,60,11
1,6,0.45454545454545453,0.7857142857142857,70525812,11,5
2,1,0.75,0.5,68641874,4,3
1,2,0.3333333333333333,0.5,65288580,3,1
0,2,0.3333333333333333,0.25,65293032,3,1
0,5,0.0,0.0,69724305,5,0
2,1,0.75,0.5,70395500,4,3
0,12,0.07692307692307693,0.30303030303030304,80124343,13,1
0,6,0.14285714285714285,0.4090909090909091,70692272,7,1
0,3,0.0,0.0,70744583,3,0
0,1,0.0,0.0,82023098,1,0
2,0,1.0,1.0,82039898,7,7
0,13,0.1875,0.25,69179565,16,3
2,7,0.6111111111111112,0.8235294117647058,68281801,18,11
0,15,0.0625,0.11764705882352941,66680922,16,1
1,18,0.41935483870967744,0.8688524590163934,70585893,31,13
2,1,0.5,0.5,68587414,2,1
0,21,0.2222222222222222,0.4262295081967213,69184731,27,6
1,56,0.2222222222222222,0.5705521472392638,70242571,72,16
1,14,0.3,0.7,65279571,20,6
2,2,0.5,0.875,70678853,4,2
1,4,0.2,0.8461538461538461,70080885,5,1
2,1,0.6666666666666666,0.5,82013602,3,2
0,7,0.125,0.3333333333333333,70694491,8,1
1,37,0.3728813559322034,0.84251968503937,72698332,59,22
2,10,0.6,0.9523809523809523,70324940,25,15
0,30,0.16666666666666666,0.23076923076923078,60246893,36,6
1,24,0.22580645161290322,0.6883116883116883,70201894,31,7
1,13,0.48,0.9375,69635013,25,12
0,25,0.0,0.0,82018792,25,0
1,14,0.36363636363636365,0.8125,69066396,22,8
0,21,0.25,0.4782608695652174,78863694,28,7
1,3,0.4,0.6,74129636,5,2
0,3,0.0,0.0,82070202,3,0
2,2,0.8,0.6666666666666666,80054772,10,8
1,9,0.4,0.9565217391304348,65279641,15,6
2,9,0.71875,0.9230769230769231,75550335,32,23
0,5,0.0,0.0,70684775,5,0
0,1,0.0,0.0,80126833,1,0
0,25,0.2647058823529412,0.40350877192982454,65289623,34,9
2,3,0.5714285714285714,0.5,70460201,7,4
2,0,1.0,1.0,82019724,3,3
0,13,0.13333333333333333,0.25,66464734,15,2
1,30,0.25,0.574468085106383,73701096,40,10
1,12,0.2,0.5869565217391305,69416172,15,3
2,7,0.5,0.8181818181818182,80176872,14,7
2,3,0.8125,0.9,80126543,16,13
2,0,1.0,1.0,80142804,1,1
1,66,0.25842696629213485,0.5527950310559007,82128656,89,23
2,2,0.7142857142857143,0.3333333333333333,82139990,7,5
2,5,0.7222222222222222,0.625,70862092,18,13
2,2,0.75,0.875,82018796,8,6
2,27,0.6931818181818182,0.9482758620689655,82136693,88,61
0,16,0.0,0.0,82038343,16,0
0,11,0.08333333333333333,0.2727272727272727,82038348,12,1
0,8,0.0,0.0,82038349,8,0
0,8,0.0,0.0,82038350,8,0
1,9,0.1,0.75,82038351,10,1
2,5,0.5833333333333334,0.8,67763885,12,7
2,2,0.7142857142857143,0.3333333333333333,67237555,7,5
1,13,0.4583333333333333,0.9230769230769231,68499956,24,11
0,16,0.15789473684210525,0.2857142857142857,69151376,19,3
2,6,0.6842105263157895,0.9375,70913850,19,13
2,2,0.9310344827586207,0.875,64998094,29,27
0,20,0.2,0.4857142857142857,79146060,25,5
0,3,0.0,0.0,69718782,3,0
2,3,0.6666666666666666,0.9166666666666666,66354295,9,6
1,10,0.4444444444444444,0.6129032258064516,80178914,18,8
0,4,0.0,0.0,70036925,4,0
2,0,1.0,1.0,66159590,5,5
2,6,0.5,0.9565217391304348,82002239,12,6
1,76,0.3274336283185841,0.7777777777777778,80090850,113,37
1,27,0.2702702702702703,0.651685393258427,82108578,37,10
1,4,0.3333333333333333,0.6,82039815,6,2
2,9,0.6086956521739131,0.8,75264266,23,14
1,16,0.30434782608695654,0.86,66698912,23,7
2,1,0.75,0.5,70071491,4,3
0,11,0.21428571428571427,0.375,80162646,14,3
2,2,0.6,0.75,80117737,5,3
1,22,0.3333333333333333,0.7671232876712328,70760116,33,11
2,3,0.7,0.8,72802373,10,7
2,6,0.5,0.7777777777777778,72743405,12,6
2,14,0.6,0.875,80174926,35,21
2,5,0.7916666666666666,0.7142857142857143,69124902,24,19
0,26,0.0,0.0,58862692,26,0
2,0,1.0,1.0,82175565,1,1
1,18,0.3076923076923077,0.75,80180126,26,8
1,11,0.21428571428571427,0.5111111111111111,54607420,14,3
1,13,0.38095238095238093,0.5,70197645,21,8
1,24,0.29411764705882354,0.5961538461538461,67066643,34,10
0,27,0.12903225806451613,0.13333333333333333,69737045,31,4
2,0,1.0,1.0,70184625,3,3
2,3,0.6666666666666666,0.8571428571428571,81989159,9,6
2,0,1.0,1.0,68241782,1,1
2,2,0.5,0.6666666666666666,80093916,4,2
1,16,0.42857142857142855,0.9565217391304348,69191661,28,12
1,5,0.16666666666666666,0.5882352941176471,70704361,6,1
2,5,0.7916666666666666,0.9285714285714286,80175659,24,19
0,2,0.0,0.0,67793600,2,0
1,17,0.34615384615384615,0.75,70914655,26,9
2,0,1.0,1.0,65745302,17,17
2,1,0.5,0.5,80153693,2,1
1,6,0.45454545454545453,0.96,80118443,11,5
1,7,0.46153846153846156,0.7857142857142857,80051496,13,6
2,0,1.0,1.0,80136688,3,3
0,7,0.36363636363636365,0.4666666666666667,82113191,11,4
1,23,0.41025641025641024,0.8787878787878788,67910430,39,16
2,1,0.75,0.5,70072121,4,3
0,18,0.18181818181818182,0.32786885245901637,80132270,22,4
2,4,0.5555555555555556,0.8,80175951,9,5
0,8,0.1111111111111111,0.034482758620689655,65278745,9,1
0,12,0.2,0.23076923076923078,80053925,15,3
0,3,0.25,0.4,69469631,4,1
2,7,0.5625,0.9285714285714286,70700861,16,9
1,6,0.3333333333333333,0.6190476190476191,69495846,9,3
1,21,0.46153846153846156,0.9310344827586207,73623123,39,18
1,3,0.4,0.875,80155206,5,2
0,12,0.07692307692307693,0.025,69146896,13,1
0,1,0.0,0.0,82010295,1,0
2,0,1.0,1.0,72804060,3,3
1,20,0.25925925925925924,0.5263157894736842,82005345,27,7
0,1,0.0,0.0,70759073,1,0
2,1,0.8333333333333334,0.5,70037653,6,5
0,50,0.038461538461538464,0.10218978102189781,80124340,52,2
0,50,0.0196078431372549,0.043795620437956206,80124430,51,1
1,20,0.3939393939393939,0.7575757575757576,82039840,33,13
0,3,0.0,0.0,69596604,3,0
1,38,0.20833333333333334,0.7103448275862069,62529565,48,10
2,2,0.8,0.3333333333333333,69069021,10,8
0,2,0.0,0.0,68962222,2,0
2,2,0.5,0.8888888888888888,68286624,4,2
2,1,0.8571428571428571,0.5,82105395,7,6
1,5,0.2857142857142857,0.6521739130434783,80125957,7,2
2,3,0.8235294117647058,0.8571428571428571,71219813,17,14
1,7,0.36363636363636365,0.8666666666666667,69395501,11,4
0,2,0.0,0.0,80128396,2,0
0,10,0.09090909090909091,0.2571428571428571,82110025,11,1
2,0,1.0,1.0,80165320,3,3
2,1,0.75,0.8333333333333334,74027723,4,3
1,10,0.16666666666666666,0.6176470588235294,70199752,12,2
0,11,0.26666666666666666,0.41935483870967744,70057113,15,4
2,1,0.75,0.5,69125126,4,3
2,1,0.8333333333333334,0.75,70700672,6,5
2,19,0.525,0.9074074074074074,68386451,40,21
0,22,0.043478260869565216,0.14423076923076922,80124394,23,1
0,9,0.25,0.42105263157894735,68400626,12,3
0,1,0.0,0.0,70492135,1,0
2,1,0.8571428571428571,0.6666666666666666,69172691,7,6
2,0,1.0,1.0,60125835,4,4
0,5,0.16666666666666666,0.0,70062503,6,1
2,0,1.0,1.0,70761474,3,3
1,5,0.2857142857142857,0.7894736842105263,66403435,7,2
0,11,0.08333333333333333,0.17647058823529413,73863860,12,1
1,8,0.4666666666666667,0.9285714285714286,69924995,15,7
2,2,0.6,0.75,69522432,5,3
0,1,0.0,0.0,82205615,1,0
0,1,0.0,0.0,72900471,1,0
0,3,0.0,0.0,69391903,3,0
0,2,0.0,0.0,70527331,2,0
0,2,0.0,0.0,500913,2,0
0,3,0.0,0.0,67335415,3,0
0,13,0.07142857142857142,0.09259259259259259,82002242,14,1
1,8,0.2727272727272727,0.6578947368421053,66304812,11,3
0,23,0.11538461538461539,0.125,68029360,26,3
0,3,0.0,0.0,68546800,3,0
0,1,0.0,0.0,66560683,1,0
2,1,0.5,0.5,67830161,2,1
2,3,0.7857142857142857,0.75,80137037,14,11
2,0,1.0,1.0,80139952,1,1
2,3,0.5,0.875,79989651,6,3
2,5,0.5454545454545454,0.75,65288545,11,6
1,7,0.2222222222222222,0.5,70621621,9,2
2,5,0.5833333333333334,0.7142857142857143,54412463,12,7
1,5,0.2857142857142857,0.5,65991660,7,2
0,4,0.2,0.25,73102806,5,1
1,8,0.1111111111111111,0.5263157894736842,70483126,9,1
0,19,0.0,0.0,80149907,19,0
0,45,0.021739130434782608,0.14444444444444443,70467572,46,1
1,19,0.17391304347826086,0.5205479452054794,80163185,23,4
1,16,0.30434782608695654,0.8433734939759037,70760375,23,7
1,14,0.2222222222222222,0.6341463414634146,71081472,18,4
0,33,0.05714285714285714,0.1509433962264151,69549571,35,2
1,20,0.13043478260869565,0.6083333333333333,67434850,23,3
0,4,0.0,0.0,67917801,4,0
0,29,0.03333333333333333,0.06666666666666667,69204730,30,1
2,12,0.5,0.8974358974358975,66141082,24,12
0,5,0.2857142857142857,0.4444444444444444,80135061,7,2
1,16,0.3333333333333333,0.6785714285714286,68229455,24,8
0,3,0.0,0.0,82006521,3,0
0,3,0.0,0.0,82006582,3,0
0,11,0.0,0.0,70584563,11,0
0,8,0.1111111111111111,0.1282051282051282,70597940,9,1
0,4,0.2,0.3684210526315789,80167302,5,1
0,38,0.02564102564102564,0.0189873417721519,70587020,39,1
1,40,0.2857142857142857,0.784,68228146,56,16
0,27,0.03571428571428571,0.04838709677419355,68227110,28,1
2,32,0.5151515151515151,0.9634146341463414,63462035,66,34
0,5,0.0,0.0,82102595,5,0
0,17,0.0,0.0,82102883,17,0
1,6,0.14285714285714285,0.6666666666666666,80173405,7,1
0,11,0.08333333333333333,0.2647058823529412,82006648,12,1
0,4,0.0,0.0,80150633,4,0
0,3,0.0,0.0,80150675,3,0
1,6,0.4,0.9411764705882353,70661353,10,4
0,15,0.0625,0.14457831325301204,74923982,16,1
1,19,0.17391304347826086,0.5733333333333334,70629986,23,4
1,12,0.29411764705882354,0.7906976744186046,75363680,17,5
0,5,0.0,0.0,80162847,5,0
0,7,0.0,0.0,82006709,7,0
0,28,0.034482758620689655,0.0,69559805,29,1
0,23,0.08,0.2682926829268293,69731760,25,2
0,10,0.0,0.0,80163384,10,0
0,45,0.08163265306122448,0.27325581395348836,74924164,49,4
1,6,0.45454545454545453,0.9285714285714286,71619086,11,5
0,6,0.0,0.0,80150690,6,0
0,10,0.0,0.0,80150692,10,0
2,0,1.0,1.0,82020127,1,1
0,13,0.07142857142857142,0.26865671641791045,69911793,14,1
1,34,0.32,0.5344827586206896,69548850,50,16
0,4,0.0,0.0,82006546,4,0
1,6,0.3333333333333333,0.8666666666666667,64468915,9,3
0,43,0.10416666666666667,0.43137254901960786,82150120,48,5
0,22,0.0,0.0,70481831,22,0
1,6,0.14285714285714285,0.5882352941176471,82102756,7,1
0,7,0.0,0.0,82102559,7,0
0,16,0.0,0.0,82102910,16,0
0,3,0.0,0.0,80150632,3,0
0,4,0.0,0.0,80150727,4,0
2,0,1.0,1.0,82057120,5,5
0,1,0.0,0.0,67786656,1,0
0,1,0.0,0.0,68741253,1,0
0,16,0.0,0.0,66250492,16,0
2,0,1.0,1.0,67248272,2,2
0,24,0.3333333333333333,0.25,65994565,36,12
0,15,0.375,0.3,82052000,24,9
1,14,0.3,0.5,66064516,20,6
2,2,0.6,0.6666666666666666,75032993,5,3
0,31,0.1388888888888889,0.28688524590163933,70691733,36,5
0,36,0.1,0.3176470588235294,72909571,40,4
1,9,0.4,0.8636363636363636,80163444,15,6
1,13,0.2777777777777778,0.5535714285714286,82002235,18,5
1,3,0.4,0.625,681660,5,2
1,30,0.3023255813953488,0.55,70718305,43,13
1,4,0.3333333333333333,0.6666666666666666,60877670,6,2
2,5,0.5,0.9411764705882353,69469183,10,5
1,4,0.2,0.5526315789473685,64976261,5,1
2,0,1.0,1.0,69207026,6,6
1,19,0.36666666666666664,0.7105263157894737,72802401,30,11
0,22,0.043478260869565216,0.019230769230769232,72809170,23,1
1,11,0.35294117647058826,0.8461538461538461,65286571,17,6
0,4,0.0,0.0,65279431,4,0
1,8,0.2,0.5,68625900,10,2
1,12,0.4782608695652174,0.9512195121951219,73266494,23,11
1,10,0.3333333333333333,0.7096774193548387,73871322,15,5
0,3,0.25,0.4375,80150353,4,1
1,2,0.3333333333333333,0.5714285714285714,70230006,3,1
0,5,0.0,0.0,80105172,5,0
2,1,0.8333333333333334,0.5,63064323,6,5
2,5,0.6875,0.8125,79816534,16,11
2,0,1.0,1.0,70967806,2,2
0,9,0.18181818181818182,0.4583333333333333,80162876,11,2
0,6,0.14285714285714285,0.07142857142857142,80128256,7,1
2,6,0.5714285714285714,0.9375,82054038,14,8
2,1,0.9230769230769231,0.5,82041274,13,12
0,15,0.16666666666666666,0.04,70120862,18,3
2,5,0.6875,0.9230769230769231,60242651,16,11
2,1,0.5,0.5,69034056,2,1
0,7,0.0,0.0,67899195,7,0
0,3,0.25,0.0,70485163,4,1
1,35,0.2391304347826087,0.5151515151515151,70596071,46,11
0,3,0.0,0.0,69478570,3,0
2,0,1.0,1.0,76694996,1,1
0,9,0.1,0.3333333333333333,70674961,10,1
1,18,0.3076923076923077,0.6901408450704225,72390843,26,8
2,3,0.5,0.4,80174696,6,3
1,4,0.42857142857142855,0.7333333333333333,80163683,7,3
2,0,1.0,1.0,66512880,1,1
1,15,0.4,0.8709677419354839,80062430,25,10
0,8,0.2,0.4827586206896552,65026220,10,2
0,37,0.02631578947368421,0.1056338028169014,70674632,38,1
0,45,0.0625,0.16129032258064516,70852593,48,3
2,3,0.8333333333333334,0.8,73447570,18,15
1,11,0.15384615384615385,0.52,67872945,13,2
2,4,0.6,0.875,70253792,10,6
1,39,0.2777777777777778,0.8656716417910447,65201192,54,15
0,4,0.0,0.0,69097826,4,0
2,1,0.6666666666666666,0.5,82024332,3,2
0,10,0.09090909090909091,0.3972602739726027,68497961,11,1
0,17,0.0,0.0,70230321,17,0
0,7,0.0,0.0,70238371,7,0
0,3,0.0,0.0,72809254,3,0
1,14,0.2222222222222222,0.5185185185185185,80153666,18,4
1,15,0.3181818181818182,0.7213114754098361,68688081,22,7
1,26,0.4090909090909091,0.84,70252413,44,18
2,1,0.5,0.5,82064871,2,1
2,1,0.6666666666666666,0.6666666666666666,82019684,3,2
2,8,0.5294117647058824,0.92,70112994,17,9
1,10,0.2857142857142857,0.71875,67438840,14,4
2,12,0.52,0.9565217391304348,70741573,25,13
0,12,0.07692307692307693,0.05263157894736842,82001458,13,1
2,6,0.5,0.9444444444444444,69705013,12,6
2,0,1.0,1.0,82163441,1,1
1,30,0.4915254237288136,0.9615384615384616,70216370,59,29
1,10,0.09090909090909091,0.5151515151515151,66787175,11,1
2,0,1.0,1.0,62098134,3,3
0,28,0.06666666666666667,0.20512820512820512,70607964,30,2
2,2,0.8333333333333334,0.75,976962,12,10
0,9,0.0,0.0,67475611,9,0
0,30,0.09090909090909091,0.10144927536231885,72529051,33,3
2,3,0.7,0.8888888888888888,82153818,10,7
0,34,0.05555555555555555,0.020202020202020204,69417271,36,2
0,1,0.0,0.0,65543961,1,0
1,29,0.275,0.7065217391304348,63283381,40,11
1,5,0.4444444444444444,0.8888888888888888,80135016,9,4
0,21,0.045454545454545456,0.0641025641025641,70691411,22,1
2,0,1.0,1.0,82020380,13,13
2,1,0.5,0.9375,70238294,2,1
2,0,1.0,1.0,82061349,11,11
2,0,1.0,1.0,69047762,3,3
1,7,0.36363636363636365,0.76,80177537,11,4
0,15,0.0625,0.0,67807075,16,1
2,2,0.9130434782608695,0.6666666666666666,82145118,23,21
0,12,0.0,0.0,64973741,12,0
1,9,0.47058823529411764,0.9,80131184,17,8
0,52,0.2777777777777778,0.4954128440366973,80136822,72,20
0,6,0.0,0.0,70183876,6,0
2,1,0.6666666666666666,0.8333333333333334,80132892,3,2
1,7,0.36363636363636365,0.8,19277741,11,4
0,12,0.14285714285714285,0.42424242424242425,70675374,14,2
0,11,0.08333333333333333,0.20689655172413793,70692650,12,1
0,1,0.0,0.0,74096176,1,0
0,1,0.0,0.0,77711711,1,0
2,3,0.625,0.967741935483871,15292123,8,5
2,6,0.5,0.972972972972973,70606144,12,6
2,0,1.0,1.0,80159291,6,6
2,0,1.0,1.0,66237710,1,1
2,4,0.5,0.5454545454545454,72472645,8,4
0,4,0.3333333333333333,0.3333333333333333,62771100,6,2
0,5,0.375,0.4117647058823529,73870013,8,3
1,8,0.42857142857142855,0.5882352941176471,80019261,14,6
1,9,0.3076923076923077,0.5609756097560976,80118943,13,4
1,20,0.16666666666666666,0.5,70252665,24,4
1,6,0.3333333333333333,0.8666666666666667,65289315,9,3
0,27,0.12903225806451613,0.14084507042253522,65282945,31,4
1,7,0.3,0.7741935483870968,69021785,10,3
1,5,0.2857142857142857,0.8666666666666667,69153245,7,2
1,7,0.3,0.6896551724137931,64202635,10,3
1,10,0.4444444444444444,0.8260869565217391,80158332,18,8
2,10,0.5454545454545454,0.8260869565217391,70567833,22,12
1,18,0.35714285714285715,0.55,73634785,28,10
0,2,0.0,0.0,74619720,2,0
1,14,0.3,0.6923076923076923,80155210,20,6
1,24,0.25,0.547945205479452,76941676,32,8
0,1,0.0,0.0,70684684,1,0
0,1,0.0,0.0,70692146,1,0
0,1,0.0,0.0,70695135,1,0
0,1,0.0,0.0,70696451,1,0
2,9,0.64,0.9375,67690644,25,16
2,0,1.0,1.0,80163127,4,4
1,13,0.23529411764705882,0.6086956521739131,60735430,17,4
0,10,0.09090909090909091,0.45454545454545453,70237986,11,1
2,1,0.75,0.6666666666666666,82054047,4,3
0,3,0.0,0.0,70175182,3,0
0,1,0.0,0.0,69596520,1,0
1,21,0.19230769230769232,0.6666666666666666,70908026,26,5
0,1,0.0,0.0,80159188,1,0
0,2,0.0,0.0,80159215,2,0
1,12,0.3333333333333333,0.8409090909090909,279902,18,6
2,1,0.5,0.6666666666666666,82046299,2,1
2,0,1.0,1.0,66834712,1,1
2,0,1.0,1.0,80134847,6,6
2,1,0.8333333333333334,0.5,82041867,6,5
2,2,0.8461538461538461,0.9,73850735,13,11
0,23,0.20689655172413793,0.2894736842105263,68417370,29,6
2,3,0.625,0.8888888888888888,80172914,8,5
2,3,0.8125,0.75,82037199,16,13
2,0,1.0,1.0,82127871,11,11
2,0,1.0,1.0,18476496,5,5
2,4,0.6923076923076923,0.9166666666666666,70343420,13,9
2,2,0.7142857142857143,0.6666666666666666,80141340,7,5
2,0,1.0,1.0,82102232,3,3
1,8,0.2,0.5714285714285714,69737276,10,2
0,21,0.045454545454545456,0.11363636363636363,70078183,22,1
1,5,0.2857142857142857,0.6666666666666666,82060539,7,2
2,0,1.0,1.0,76238960,15,15
2,3,0.6666666666666666,0.9230769230769231,80158233,9,6
0,6,0.0,0.0,71510152,6,0
0,6,0.0,0.0,73412850,6,0
2,1,0.9411764705882353,0.5,80159555,17,16
2,2,0.8333333333333334,0.75,82062194,12,10
2,3,0.7857142857142857,0.8823529411764706,74027940,14,11
0,2,0.0,0.0,80145833,2,0
2,18,0.5263157894736842,0.9591836734693877,73324370,38,20
2,0,1.0,1.0,69158670,10,10
1,10,0.4444444444444444,0.9166666666666666,67871160,18,8
2,3,0.5714285714285714,0.6666666666666666,82110446,7,4
2,2,0.9090909090909091,0.6666666666666666,70314272,22,20
2,0,1.0,1.0,69047776,3,3
1,6,0.45454545454545453,0.8333333333333334,72803906,11,5
0,4,0.0,0.0,70215782,4,0
0,4,0.0,0.0,67286114,4,0
1,3,0.25,0.5555555555555556,67286170,4,1
0,8,0.0,0.0,67286191,8,0
1,14,0.3333333333333333,0.8076923076923077,69633900,21,7
0,25,0.13793103448275862,0.06818181818181818,65289693,29,4
1,15,0.375,0.8918918918918919,67555404,24,9
2,6,0.5,0.9166666666666666,79792244,12,6
0,5,0.0,0.0,70229474,5,0
0,10,0.0,0.0,82205854,10,0
2,1,0.5,0.8333333333333334,70576380,2,1
1,17,0.19047619047619047,0.6133333333333333,67899454,21,4
2,1,0.9090909090909091,0.5,66114062,11,10
1,5,0.4444444444444444,0.8695652173913043,80167011,9,4
2,4,0.6,0.967741935483871,80163440,10,6
2,5,0.5,0.9583333333333334,68499501,10,5
1,10,0.2857142857142857,0.6538461538461539,63167132,14,4
1,10,0.09090909090909091,0.6111111111111112,82206128,11,1
0,4,0.0,0.0,67277973,4,0
0,2,0.0,0.0,70818314,2,0
0,4,0.0,0.0,74389574,4,0
0,18,0.14285714285714285,0.2222222222222222,77686063,21,3
0,25,0.13793103448275862,0.45614035087719296,61578986,29,4
0,6,0.25,0.46153846153846156,73588795,8,2
2,1,0.5,0.5,70635516,2,1
1,10,0.16666666666666666,0.5681818181818182,80163193,12,2
2,0,1.0,1.0,82090287,1,1
0,11,0.15384615384615385,0.41935483870967744,68499886,13,2
2,7,0.631578947368421,0.95,69222216,19,12
0,30,0.14285714285714285,0.38636363636363635,69006406,35,5
1,10,0.3333333333333333,0.7878787878787878,81956138,15,5
0,7,0.125,0.1,69508852,8,1
1,32,0.21951219512195122,0.675,80127845,41,9
2,2,0.5,0.6666666666666666,63643881,4,2
1,13,0.2777777777777778,0.65,65286403,18,5
1,2,0.3333333333333333,0.5,70679413,3,1
0,4,0.2,0.14285714285714285,68615246,5,1
0,3,0.0,0.0,70707434,3,0
2,1,0.75,0.3333333333333333,67427325,4,3
0,9,0.18181818181818182,0.3076923076923077,69117202,11,2
1,5,0.375,0.8888888888888888,66657626,8,3
2,9,0.7,0.96,72315075,30,21
2,5,0.5833333333333334,0.9,58878974,12,7
1,12,0.3684210526315789,0.7916666666666666,69703851,19,7
2,10,0.5652173913043478,0.8571428571428571,68044592,23,13
0,1,0.0,0.0,60286590,1,0
1,12,0.2,0.5918367346938775,69625885,15,3
2,5,0.5833333333333334,0.9705882352941176,80125411,12,7
0,3,0.0,0.0,70679266,3,0
0,24,0.29411764705882354,0.48,66319050,34,10
1,5,0.16666666666666666,0.6153846153846154,82205853,6,1
2,0,1.0,1.0,69832343,1,1
0,39,0.025,0.03787878787878788,63265594,40,1
1,15,0.21052631578947367,0.7868852459016393,82205993,19,4
0,13,0.13333333333333333,0.05555555555555555,71618694,15,2
1,22,0.35294117647058826,0.9047619047619048,65128525,34,12
1,57,0.32941176470588235,0.7943262411347518,70629405,85,28
1,42,0.38235294117647056,0.8548387096774194,68543552,68,26
1,17,0.2608695652173913,0.6885245901639344,70629461,23,6
2,2,0.6,0.8,69596513,5,3
0,52,0.16129032258064516,0.37398373983739835,70242606,62,10
0,4,0.2,0.45454545454545453,80145722,5,1
1,6,0.4,0.6111111111111112,70494144,10,4
0,6,0.0,0.0,69034014,6,0
0,5,0.16666666666666666,0.15384615384615385,70063854,6,1
0,5,0.16666666666666666,0.3125,70621313,6,1
1,13,0.4090909090909091,0.9411764705882353,69151313,22,9
2,0,1.0,1.0,66280774,3,3
2,14,0.5,0.96,80149456,28,14
0,13,0.0,0.0,80128212,13,0
0,63,0.05970149253731343,0.3891402714932127,67434486,67,4
0,9,0.0,0.0,67434745,9,0
0,49,0.02,0.1,80124350,50,1
0,49,0.057692307692307696,0.18055555555555555,80124436,52,3
2,16,0.5789473684210527,0.9032258064516129,63883183,38,22
1,10,0.4444444444444444,0.88,70253694,18,8
0,9,0.1,0.375,67455066,10,1
0,5,0.0,0.0,80149869,5,0
2,0,1.0,1.0,82019720,6,6
1,19,0.3448275862068966,0.6470588235294118,68902715,29,10
1,16,0.23809523809523808,0.5294117647058824,82124925,21,5
1,11,0.3125,0.7083333333333334,68499781,16,5
2,2,0.8,0.8,67411043,10,8
0,11,0.0,0.0,69726370,11,0
0,12,0.25,0.44680851063829785,70658910,16,4
1,6,0.3333333333333333,0.6086956521739131,80135982,9,3
2,10,0.6296296296296297,0.9565217391304348,890701,27,17
0,5,0.0,0.0,70681562,5,0
2,18,0.6842105263157895,0.9791666666666666,80126942,57,39
1,15,0.25,0.5833333333333334,70081256,20,5
0,1,0.0,0.0,70702961,1,0
0,1,0.0,0.0,82016173,1,0
0,9,0.18181818181818182,0.0,82051996,11,2
1,9,0.47058823529411764,0.8235294117647058,70494501,17,8
1,17,0.41379310344827586,0.8636363636363636,79783361,29,12
1,27,0.3076923076923077,0.6372549019607843,70673456,39,12
0,5,0.0,0.0,82150135,5,0
2,6,0.5384615384615384,0.95,71458842,13,7
2,1,0.5,0.5,65280992,2,1
0,3,0.25,0.4444444444444444,72038036,4,1
2,3,0.5714285714285714,0.75,69064254,7,4
0,2,0.3333333333333333,0.42857142857142855,69998054,3,1
1,5,0.2857142857142857,0.8461538461538461,69594294,7,2
2,5,0.5,0.42857142857142855,890561,10,5
2,6,0.5714285714285714,0.8571428571428571,69997543,14,8
2,7,0.6111111111111112,0.5,69166454,18,11
1,10,0.23076923076923078,0.5416666666666666,77677054,13,3
0,3,0.25,0.41379310344827586,69152664,4,1
1,15,0.2857142857142857,0.7894736842105263,68785073,21,6
0,33,0.10810810810810811,0.08571428571428572,70047803,37,4
1,3,0.4,0.5,81989171,5,2
2,10,0.5238095238095238,0.9047619047619048,80125558,21,11
1,26,0.2972972972972973,0.8151260504201681,70606200,37,11
2,7,0.6818181818181818,0.9583333333333334,80125898,22,15
2,1,0.6666666666666666,0.9444444444444444,69560764,3,2
1,11,0.35294117647058826,0.9074074074074074,82053045,17,6
1,10,0.16666666666666666,0.5833333333333334,68607056,12,2
2,5,0.5454545454545454,0.8,58878960,11,6
0,25,0.1935483870967742,0.328125,79788485,31,6
2,7,0.5625,0.9642857142857143,72803171,16,9
0,73,0.21505376344086022,0.47619047619047616,72817283,93,20
0,53,0.03636363636363636,0.011363636363636364,77676501,55,2
1,15,0.4642857142857143,0.918918918918919,68016193,28,13
1,16,0.2727272727272727,0.7,67929722,22,6
2,0,1.0,1.0,82020834,5,5
2,0,1.0,1.0,82136739,3,3
0,8,0.1111111111111111,0.1111111111111111,68317900,9,1
1,10,0.4444444444444444,0.8846153846153846,70862106,18,8
1,10,0.4444444444444444,0.8636363636363636,78636082,18,8
0,10,0.23076923076923078,0.47058823529411764,82095505,13,3
0,25,0.10714285714285714,0.31343283582089554,70908544,28,3
1,5,0.2857142857142857,0.7368421052631579,69691881,7,2
2,2,0.5,0.7777777777777778,78763755,4,2
2,0,1.0,1.0,80156001,1,1
1,9,0.3076923076923077,0.5142857142857142,69877633,13,4
2,1,0.6666666666666666,0.6666666666666666,80165801,3,2
0,2,0.0,0.0,70113603,2,0
0,21,0.045454545454545456,0.06382978723404255,70682430,22,1
0,15,0.3181818181818182,0.0,75576564,22,7
2,4,0.6363636363636364,0.6666666666666666,69054496,11,7
2,2,0.7142857142857143,0.6666666666666666,69547982,7,5
2,0,1.0,1.0,67822923,1,1
2,2,0.6666666666666666,0.75,82089995,6,4
1,11,0.26666666666666666,0.5116279069767442,70487466,15,4
1,8,0.2727272727272727,0.5882352941176471,69534115,11,3
1,8,0.42857142857142855,0.6875,68060615,14,6
0,6,0.0,0.0,69169415,6,0
1,21,0.3225806451612903,0.6363636363636364,69183506,31,10
2,2,0.6,0.9285714285714286,82013598,5,3
1,7,0.46153846153846156,0.8148148148148148,82013562,13,6
1,4,0.2,0.9285714285714286,80124292,5,1
1,11,0.42105263157894735,0.7931034482758621,68402075,19,8
1,53,0.2535211267605634,0.6118421052631579,80135270,71,18
1,51,0.3625,0.8209876543209876,70524244,80,29
0,8,0.0,0.0,80126822,8,0
2,5,0.5833333333333334,0.9473684210526315,81989160,12,7
1,22,0.37142857142857144,0.7619047619047619,80124459,35,13
2,0,1.0,1.0,80141395,1,1
1,4,0.42857142857142855,0.7272727272727273,73251381,7,3
1,22,0.3333333333333333,0.8125,65288804,33,11
1,5,0.2857142857142857,0.6875,65279704,7,2
1,11,0.26666666666666666,0.6,65292990,15,4
2,0,1.0,1.0,80165271,9,9
1,4,0.3333333333333333,0.6153846153846154,70677243,6,2
2,9,0.75,0.9230769230769231,76918023,36,27
0,8,0.0,0.0,82040804,8,0
1,14,0.391304347826087,0.8867924528301887,63631876,23,9
1,21,0.16,0.7126436781609196,77577290,25,4
1,3,0.4,0.9090909090909091,77582421,5,2
0,3,0.0,0.0,82152065,3,0
0,2,0.0,0.0,82152071,2,0
0,1,0.0,0.0,82152204,1,0
0,1,0.0,0.0,69331962,1,0
1,3,0.25,0.6111111111111112,82062261,4,1
0,8,0.2,0.3,82154138,10,2
0,9,0.1,0.3076923076923077,82062272,10,1
1,29,0.32558139534883723,0.7162162162162162,80108420,43,14
1,17,0.22727272727272727,0.5806451612903226,82145531,22,5
1,6,0.25,0.6086956521739131,66939110,8,2
0,15,0.25,0.4583333333333333,63725900,20,5
0,2,0.0,0.0,82019234,2,0
2,1,0.8333333333333334,0.5,78013670,6,5
0,15,0.25,0.43333333333333335,80124702,20,5
0,1,0.0,0.0,82010307,1,0
2,1,0.75,0.5,72804256,4,3
2,8,0.5555555555555556,0.9545454545454546,72803052,18,10
0,11,0.21428571428571427,0.27586206896551724,82009551,14,3
0,9,0.1,0.3,70669466,10,1
1,8,0.4666666666666667,0.92,70669536,15,7
0,6,0.0,0.0,70705600,6,0
1,8,0.3333333333333333,0.8461538461538461,73295586,12,4
1,5,0.375,0.7777777777777778,72905924,8,3
2,1,0.6666666666666666,0.5,69976214,3,2
0,30,0.21052631578947367,0.32978723404255317,65335795,38,8
1,11,0.3125,0.7619047619047619,70183113,16,5
0,17,0.0,0.0,62839014,17,0
2,4,0.6,0.9230769230769231,80163507,10,6
1,10,0.3333333333333333,0.8888888888888888,68785283,15,5
0,15,0.3181818181818182,0.4838709677419355,70017920,22,7
2,1,0.75,0.8333333333333334,72503725,4,3
0,8,0.0,0.0,67591566,8,0
2,0,1.0,1.0,70820701,6,6
0,9,0.25,0.42857142857142855,66464741,12,3
0,5,0.0,0.0,68234460,5,0
2,3,0.5,0.8571428571428571,82152784,6,3
0,1,0.0,0.0,82023737,1,0
0,3,0.0,0.0,75376994,3,0
1,2,0.3333333333333333,0.75,72804403,3,1
2,0,1.0,1.0,69033650,1,1
0,8,0.1111111111111111,0.2702702702702703,72910012,9,1
2,0,1.0,1.0,60964554,3,3
1,13,0.4090909090909091,0.7333333333333333,80117716,22,9
1,5,0.4444444444444444,0.8181818181818182,70282352,9,4
0,3,0.0,0.0,70701715,3,0
2,2,0.5,0.875,70702772,4,2
2,0,1.0,1.0,80069822,1,1
2,2,0.7777777777777778,0.6666666666666666,80118291,9,7
2,0,1.0,1.0,80018694,1,1
1,10,0.4117647058823529,0.6538461538461539,80176855,17,7
1,3,0.4,0.8888888888888888,70212310,5,2
2,0,1.0,1.0,75347482,3,3
2,0,1.0,1.0,69734056,2,2
2,5,0.5454545454545454,0.9545454545454546,80150324,11,6
2,8,0.6666666666666666,0.9230769230769231,62590024,24,16
0,43,0.06521739130434782,0.19863013698630136,69640676,46,3
1,5,0.375,0.8,82053047,8,3
0,13,0.0,0.0,67620616,13,0
1,8,0.3333333333333333,0.8709677419354839,80176327,12,4
0,2,0.0,0.0,82018694,2,0
1,3,0.4,0.7894736842105263,70844074,5,2
1,4,0.42857142857142855,0.8461538461538461,80067386,7,3
0,18,0.1,0.3865546218487395,82137455,20,2
0,15,0.0,0.0,82137501,15,0
2,1,0.8333333333333334,0.5,68046405,6,5
2,0,1.0,1.0,80091774,3,3
1,3,0.25,0.7647058823529411,80134729,4,1
2,5,0.6875,0.7,80172935,16,11
0,3,0.0,0.0,70697004,3,0
0,1,0.0,0.0,70699776,1,0
1,2,0.3333333333333333,0.6666666666666666,71762551,3,1
1,42,0.16,0.574468085106383,811776,50,8
0,22,0.0,0.0,82173335,22,0
0,19,0.0,0.0,82173336,19,0
2,14,0.5,0.7857142857142857,70343245,28,14
0,41,0.06818181818181818,0.27807486631016043,73007242,44,3
1,22,0.4883720930232558,0.9291338582677166,80132793,43,21
0,2,0.0,0.0,69182393,2,0
1,6,0.3333333333333333,0.75,69597416,9,3
0,2,0.0,0.0,78771413,2,0
0,5,0.16666666666666666,0.3333333333333333,80128168,6,1
1,11,0.35294117647058826,0.6785714285714286,70926996,17,6
2,1,0.5,0.6666666666666666,82012788,2,1
2,1,0.8,0.75,80019233,5,4
2,0,1.0,1.0,80163676,1,1
0,2,0.0,0.0,82018864,2,0
0,2,0.0,0.0,82023363,2,0
0,8,0.0,0.0,69693645,8,0
1,15,0.11764705882352941,0.5616438356164384,70237916,17,2
0,18,0.1,0.11764705882352941,68366795,20,2
2,0,1.0,1.0,80172026,3,3
0,6,0.14285714285714285,0.2777777777777778,82096338,7,1
2,7,0.6666666666666666,0.8571428571428571,80118585,21,14
1,3,0.25,0.5714285714285714,60877705,4,1
1,27,0.22857142857142856,0.8,70463050,35,8
2,7,0.5333333333333333,0.8571428571428571,80135227,15,8
0,2,0.0,0.0,80150619,2,0
1,6,0.45454545454545453,0.9375,66741934,11,5
0,13,0.0,0.0,70468083,13,0
0,4,0.0,0.0,80150672,4,0
0,3,0.0,0.0,80150674,3,0
0,4,0.0,0.0,80150693,4,0
0,27,0.0,0.0,82134959,27,0
1,35,0.10256410256410256,0.5316455696202531,82205875,39,4
0,3,0.0,0.0,80169889,3,0
0,5,0.0,0.0,80173403,5,0
1,14,0.3,0.6216216216216216,82106328,20,6
1,21,0.19230769230769232,0.7,70634704,26,5
2,0,1.0,1.0,82006857,3,3
0,10,0.0,0.0,69867805,10,0
2,1,0.5,0.8571428571428571,71619604,2,1
0,6,0.0,0.0,82006618,6,0
0,15,0.0625,0.29333333333333333,80163205,16,1
0,3,0.0,0.0,80167270,3,0
0,17,0.0,0.0,67896311,17,0
1,3,0.4,0.8181818181818182,82118292,5,2
1,9,0.18181818181818182,0.6097560975609756,63802683,11,2
0,12,0.07692307692307693,0.26865671641791045,63802753,13,1
1,14,0.125,0.6,64389423,16,2
2,6,0.5,0.6,69518176,12,6
1,6,0.3333333333333333,0.9487179487179487,70463442,9,3
0,12,0.0,0.0,69528081,12,0
0,6,0.0,0.0,80150609,6,0
1,4,0.2,0.5,69221355,5,1
1,7,0.4166666666666667,0.9487179487179487,67887876,12,5
0,1,0.0,0.0,71619492,1,0
1,6,0.4,0.9523809523809523,69638856,10,4
1,6,0.14285714285714285,0.5769230769230769,68769645,7,1
1,13,0.13333333333333333,0.5294117647058824,69407191,15,2
1,8,0.2,0.859375,67434773,10,2
0,11,0.0,0.0,67051530,11,0
1,7,0.3,0.7586206896551724,80163397,10,3
2,2,0.7142857142857143,0.8571428571428571,69308323,7,5
2,1,0.75,0.8571428571428571,69042876,4,3
0,1,0.0,0.0,80162863,1,0
0,1,0.0,0.0,80172641,1,0
0,2,0.0,0.0,80162780,2,0
0,5,0.0,0.0,80162911,5,0
0,1,0.0,0.0,80165753,1,0
1,6,0.14285714285714285,0.5217391304347826,67978176,7,1
0,11,0.08333333333333333,0.1746031746031746,69549711,12,1
0,12,0.0,0.0,67051544,12,0
2,6,0.5714285714285714,0.92,82163466,14,8
0,8,0.1111111111111111,0.2,73533320,9,1
0,17,0.05555555555555555,0.39622641509433965,69890541,18,1
0,9,0.0,0.0,69912185,9,0
1,4,0.42857142857142855,0.7272727272727273,66469144,7,3
1,21,0.25,0.7254901960784313,69886740,28,7
0,13,0.07142857142857142,0.2608695652173913,74460540,14,1
1,14,0.2222222222222222,0.5135135135135135,3003,18,4
1,13,0.13333333333333333,0.7058823529411765,80028914,15,2
0,23,0.23333333333333334,0.4264705882352941,82108577,30,7
2,2,0.6666666666666666,0.6666666666666666,69944413,6,4
2,8,0.5789473684210527,0.7894736842105263,70474481,19,11
2,7,0.631578947368421,0.8461538461538461,68401865,19,12
1,26,0.3333333333333333,0.746031746031746,69585614,39,13
0,5,0.0,0.0,70686245,5,0
0,1,0.0,0.0,67568732,1,0
0,1,0.0,0.0,67568746,1,0
0,2,0.0,0.0,67568781,2,0
1,5,0.16666666666666666,0.7037037037037037,67620602,6,1
0,9,0.0,0.0,67620672,9,0
0,6,0.0,0.0,67620714,6,0
0,13,0.0,0.0,67620770,13,0
1,6,0.14285714285714285,0.5588235294117647,67620875,7,1
0,4,0.0,0.0,67620882,4,0
1,2,0.3333333333333333,0.9375,67620952,3,1
0,1,0.0,0.0,67620966,1,0
1,6,0.25,0.8653846153846154,70238273,8,2
2,10,0.5652173913043478,0.9705882352941176,70078281,23,13
2,5,0.8,0.9411764705882353,157563,25,20
0,8,0.1111111111111111,0.125,80136470,9,1
1,7,0.36363636363636365,0.7222222222222222,74086803,11,4
2,5,0.5,0.875,80093552,10,5
0,8,0.0,0.0,80118328,8,0
2,1,0.5,0.75,68805352,2,1
0,11,0.15384615384615385,0.20588235294117646,70059724,13,2
0,19,0.20833333333333334,0.35294117647058826,80051692,24,5
0,2,0.0,0.0,67335352,2,0
1,14,0.3333333333333333,0.8181818181818182,66892315,21,7
2,2,0.95,0.6666666666666666,54880735,40,38
0,9,0.25,0.2692307692307692,67656946,12,3
0,9,0.18181818181818182,0.2631578947368421,80139731,11,2
0,6,0.14285714285714285,0.24,72785993,7,1
1,13,0.23529411764705882,0.6037735849056604,72545753,17,4
1,28,0.3170731707317073,0.8035714285714286,73313870,41,13
0,2,0.0,0.0,68144034,2,0
0,29,0.14705882352941177,0.1744186046511628,71081185,34,5
0,8,0.0,0.0,68241495,8,0
2,1,0.5,0.5,70684404,2,1
0,6,0.4,0.25,956872,10,4
2,7,0.5,0.6,80178917,14,7
1,15,0.2857142857142857,0.6923076923076923,80135272,21,6
0,62,0.16216216216216217,0.4797979797979798,70630035,74,12
2,1,0.5,0.5,80162882,2,1
0,3,0.0,0.0,79453276,3,0
2,2,0.6,0.6666666666666666,80124632,5,3
0,4,0.3333333333333333,0.4,67779600,6,2
2,9,0.5,0.9830508474576272,69309933,18,9
0,1,0.0,0.0,69633774,1,0
0,1,0.0,0.0,69633893,1,0
0,1,0.0,0.0,69634005,1,0
0,1,0.0,0.0,69634292,1,0
0,1,0.0,0.0,69634355,1,0
0,1,0.0,0.0,69634404,1,0
0,16,0.058823529411764705,0.12,82152073,17,1
1,9,0.3076923076923077,0.8571428571428571,67756381,13,4
2,1,0.5,0.8571428571428571,67291511,2,1
0,29,0.14705882352941177,0.08163265306122448,66603971,34,5
0,7,0.3,0.3333333333333333,70343406,10,3
1,11,0.3888888888888889,0.9047619047619048,69996521,18,7
2,4,0.6,0.875,80176673,10,6
2,1,0.5,0.6666666666666666,69597465,2,1
1,7,0.36363636363636365,0.5714285714285714,68286330,11,4
2,1,0.9,0.5,80176366,10,9
0,2,0.0,0.0,69660682,2,0
0,16,0.15789473684210525,0.4423076923076923,67591531,19,3
1,2,0.3333333333333333,0.75,80163501,3,1
1,23,0.23333333333333334,0.7666666666666667,78507436,30,7
2,0,1.0,1.0,61167750,2,2
0,15,0.11764705882352941,0.2,67809980,17,2
1,17,0.48484848484848486,0.7428571428571429,70399406,33,16
0,5,0.0,0.0,66786111,5,0
2,0,1.0,1.0,13734511,16,16
0,9,0.0,0.0,70697445,9,0
0,1,0.0,0.0,70702891,1,0
0,10,0.0,0.0,82164885,10,0
0,40,0.09090909090909091,0.325,63993055,44,4
0,17,0.0,0.0,62841982,17,0
1,46,0.22033898305084745,0.7515527950310559,62842010,59,13
0,14,0.125,0.48,69637715,16,2
0,1,0.0,0.0,79793812,1,0
0,6,0.25,0.45,80156747,8,2
2,0,1.0,1.0,67531926,1,1
2,1,0.8333333333333334,0.75,72802121,6,5
0,15,0.11764705882352941,0.19047619047619047,80104906,17,2
1,49,0.25757575757575757,0.7552447552447552,61579511,66,17
2,1,0.5,0.6666666666666666,72920323,2,1
2,2,0.5,0.8,67823476,4,2
2,1,0.6666666666666666,0.5,82023068,3,2
0,3,0.25,0.4838709677419355,80145431,4,1
0,1,0.0,0.0,82024286,1,0
0,5,0.0,0.0,69611360,5,0
2,2,0.6,0.0,67792025,5,3
0,9,0.1,0.23529411764705882,67780776,10,1
2,0,1.0,1.0,72814553,1,1
2,0,1.0,1.0,80132871,2,2
0,43,0.0851063829787234,0.25316455696202533,69640816,47,4
0,23,0.08,0.0547945205479452,68391134,25,2
2,2,0.7142857142857143,0.3333333333333333,67824253,7,5
2,0,1.0,1.0,80159274,2,2
2,3,0.625,0.75,80019436,8,5
0,14,0.2631578947368421,0.46938775510204084,75121123,19,5
0,9,0.1,0.30303030303030304,70063735,10,1
1,22,0.3888888888888889,0.8870967741935484,70854280,36,14
2,4,0.5,0.8888888888888888,66969665,8,4
2,0,1.0,1.0,68191732,1,1
0,9,0.18181818181818182,0.32,66395175,11,2
0,6,0.25,0.15384615384615385,68400815,8,2
1,10,0.375,0.5555555555555556,80125895,16,6
1,11,0.35294117647058826,0.6,80125900,17,6
2,0,1.0,1.0,82013567,1,1
2,1,0.5,0.75,80123387,2,1
2,0,1.0,1.0,82041912,2,2
2,0,1.0,1.0,80156959,4,4
1,4,0.42857142857142855,0.5,77318794,7,3
1,31,0.46551724137931033,0.8953488372093024,68671666,58,27
2,0,1.0,1.0,68748316,1,1
0,11,0.15384615384615385,0.45454545454545453,71805412,13,2
0,5,0.2857142857142857,0.4444444444444444,65281356,7,2
0,3,0.0,0.0,69977551,3,0
1,6,0.3333333333333333,0.7692307692307693,82101249,9,3
0,8,0.0,0.0,70395612,8,0
1,16,0.2,0.5,78763244,20,4
0,11,0.08333333333333333,0.04,64257704,12,1
2,1,0.8,0.875,66503465,5,4
1,7,0.2222222222222222,0.5925925925925926,82034200,9,2
1,39,0.20408163265306123,0.515625,60513971,49,10
2,0,1.0,1.0,80052406,1,1
2,9,0.5714285714285714,0.9565217391304348,82047585,21,12
0,9,0.25,0.35714285714285715,69644673,12,3
0,16,0.23809523809523808,0.3333333333333333,69644680,21,5
0,8,0.1111111111111111,0.07142857142857142,69644736,9,1
0,4,0.2,0.1111111111111111,65290274,5,1
0,2,0.0,0.0,79989686,2,0
1,7,0.2222222222222222,0.7619047619047619,70683711,9,2
1,3,0.25,0.5714285714285714,68034386,4,1
2,0,1.0,1.0,69967695,4,4
0,16,0.058823529411764705,0.043478260869565216,70679504,17,1
1,8,0.4666666666666667,0.92,80067393,15,7
2,3,0.5714285714285714,0.9615384615384616,68273611,7,4
2,9,0.5909090909090909,0.8648648648648649,79792482,22,13
2,0,1.0,1.0,80137368,1,1
2,6,0.76,0.9375,82024047,25,19
2,1,0.8571428571428571,0.5,70348075,7,6
2,3,0.625,0.8,82204816,8,5
0,75,0.07407407407407407,0.11842105263157894,80140082,81,6
1,11,0.21428571428571427,0.5365853658536586,82001869,14,3
2,2,0.6666666666666666,0.8,72801603,6,4
2,0,1.0,1.0,82043224,1,1
2,0,1.0,1.0,82033530,4,4
2,4,0.75,0.9090909090909091,66257653,16,12
2,0,1.0,1.0,80136568,4,4
2,0,1.0,1.0,80159666,4,4
0,2,0.3333333333333333,0.2,80180271,3,1
2,3,0.8,0.75,69394304,15,12
2,0,1.0,1.0,73652264,1,1
2,4,0.5,0.8461538461538461,70843465,8,4
1,32,0.2727272727272727,0.6527777777777778,70184170,44,12
2,0,1.0,1.0,82039420,9,9
1,31,0.11428571428571428,0.5051546391752577,80124286,35,4
2,0,1.0,1.0,82038871,2,2
1,3,0.4,0.5,70566552,5,2
2,1,0.8888888888888888,0.5,70314286,9,8
2,11,0.5416666666666666,0.9210526315789473,80158265,24,13
2,0,1.0,1.0,82037543,1,1
2,0,1.0,1.0,18827188,1,1
2,0,1.0,1.0,82037356,1,1
2,0,1.0,1.0,70314531,7,7
2,3,0.625,0.8888888888888888,82041265,8,5
2,3,0.5714285714285714,0.9130434782608695,68546954,7,4
2,1,0.75,0.5,70183834,4,3
2,1,0.9411764705882353,0.5,69394311,17,16
2,1,0.6666666666666666,0.0,69980022,3,2
2,1,0.6666666666666666,0.0,74363352,3,2
0,10,0.23076923076923078,0.4,501193,13,3
0,18,0.28,0.4,70808255,25,7
2,1,0.75,0.6666666666666666,74047071,4,3
2,5,0.5833333333333334,0.8,70603043,12,7
1,8,0.3333333333333333,0.5263157894736842,64866263,12,4
0,26,0.07142857142857142,0.35064935064935066,67468044,28,2
2,12,0.7818181818181819,0.9411764705882353,80118334,55,43
0,18,0.0,0.0,67899531,18,0
0,2,0.3333333333333333,0.4444444444444444,66192196,3,1
0,32,0.030303030303030304,0.08333333333333333,67467736,33,1
0,30,0.0,0.0,63169722,30,0
0,7,0.125,0.2413793103448276,70476252,8,1
2,0,1.0,1.0,67822881,2,2
0,4,0.2,0.1,70494172,5,1
0,14,0.125,0.32608695652173914,70181125,16,2
2,0,1.0,1.0,80176442,11,11
0,3,0.0,0.0,64041684,3,0
1,9,0.1,0.5476190476190477,66782751,10,1
0,8,0.0,0.0,66783682,8,0
0,13,0.07142857142857142,0.2727272727272727,66784361,14,1
1,41,0.3050847457627119,0.8074074074074075,68060475,59,18
2,4,0.5,0.7333333333333333,69559616,8,4
0,2,0.0,0.0,70635061,2,0
0,2,0.0,0.0,80163210,2,0
0,9,0.1,0.425531914893617,65968224,10,1
0,2,0.0,0.0,82006314,2,0
0,17,0.10526315789473684,0.10256410256410256,64045982,19,2
1,16,0.30434782608695654,0.7659574468085106,80135073,23,7
1,21,0.16,0.8,67434731,25,4
1,10,0.16666666666666666,0.5294117647058824,66784116,12,2
0,4,0.0,0.0,66784592,4,0
0,4,0.2,0.43478260869565216,66784704,5,1
2,4,0.5555555555555556,0.8888888888888888,65768990,9,5
1,11,0.3125,0.7,70621404,16,5
1,20,0.3333333333333333,0.5952380952380952,69585572,30,10
0,11,0.08333333333333333,0.03125,66892812,12,1
1,2,0.3333333333333333,0.9090909090909091,79816065,3,1
0,2,0.0,0.0,19720225,2,0
2,1,0.8,0.75,70761502,5,4
2,0,1.0,1.0,80003581,8,8
2,7,0.6666666666666666,0.9523809523809523,69205290,21,14
1,13,0.1875,0.7288135593220338,70109613,16,3
2,1,0.5,0.8,70691376,2,1
2,2,0.5,0.75,67982173,4,2
2,11,0.56,0.8181818181818182,65288902,25,14
2,3,0.7,0.6666666666666666,69577620,10,7
0,1,0.0,0.0,500920,1,0
2,1,0.5,0.5,69955326,2,1
0,32,0.2,0.34951456310679613,70509313,40,8
0,20,0.09090909090909091,0.06060606060606061,73982881,22,2
2,2,0.5,0.9166666666666666,67982320,4,2
2,1,0.8571428571428571,0.5,70521395,7,6
1,33,0.1951219512195122,0.7222222222222222,68357114,41,8
1,6,0.25,0.6,8017856,8,2
1,33,0.32653061224489793,0.6257668711656442,80125410,49,16
2,0,1.0,1.0,82013586,5,5
1,8,0.3333333333333333,0.5,63233093,12,4
2,6,0.6,0.8333333333333334,63233100,15,9
2,43,0.5113636363636364,0.96,66412101,88,45
2,0,1.0,1.0,82135114,4,4
2,2,0.5,0.8571428571428571,69596730,4,2
0,3,0.0,0.0,70692741,3,0
0,1,0.0,0.0,70693483,1,0
0,21,0.16,0.2413793103448276,67557322,25,4
0,3,0.0,0.0,70843626,3,0
2,3,0.625,0.75,66234630,8,5
2,12,0.5714285714285714,0.96,82002322,28,16
1,14,0.2631578947368421,0.6857142857142857,69857900,19,5
0,6,0.14285714285714285,0.36363636363636365,82205996,7,1
0,9,0.1,0.48717948717948717,82134975,10,1
0,31,0.11428571428571428,0.3516483516483517,70468125,35,4
0,40,0.0,0.0,78763020,40,0
0,13,0.13333333333333333,0.07317073170731707,80133814,15,2
0,2,0.0,0.0,69038053,2,0
0,1,0.0,0.0,71878765,1,0
0,1,0.0,0.0,71879052,1,0
0,2,0.0,0.0,80126887,2,0
0,2,0.0,0.0,66190621,2,0
2,1,0.9375,0.5,82039885,16,15
2,0,1.0,1.0,68270202,4,4
2,1,0.9,0.5,80137036,10,9
1,9,0.3076923076923077,0.8378378378378378,70760074,13,4
1,11,0.42105263157894735,0.8181818181818182,70769636,19,8
0,4,0.0,0.0,72868761,4,0
0,7,0.125,0.22727272727272727,64469034,8,1
2,22,0.5416666666666666,0.8472222222222222,80125554,48,26
1,6,0.3333333333333333,0.7142857142857143,67434661,9,3
1,17,0.34615384615384615,0.5454545454545454,76377084,26,9
1,23,0.28125,0.7555555555555555,67819325,32,9
0,20,0.09090909090909091,0.3333333333333333,65351230,22,2
2,3,0.7857142857142857,0.8,82096244,14,11
0,4,0.0,0.0,82070154,4,0
0,18,0.28,0.43333333333333335,73634820,25,7
0,7,0.3,0.45454545454545453,65901283,10,3
2,2,0.6,0.6666666666666666,65930830,5,3
0,14,0.125,0.20408163265306123,65291485,16,2
0,16,0.23809523809523808,0.4772727272727273,73975055,21,5
0,21,0.0,0.0,63239764,21,0
2,7,0.5333333333333333,0.9,80165339,15,8
2,0,1.0,1.0,82054016,2,2
0,18,0.1,0.14583333333333334,64164562,20,2
0,9,0.18181818181818182,0.45454545454545453,60081784,11,2
2,3,0.7272727272727273,0.8333333333333334,69729632,11,8
0,1,0.0,0.0,82250577,1,0
2,9,0.55,0.9473684210526315,68401704,20,11
0,5,0.16666666666666666,0.21739130434782608,81967365,6,1
1,24,0.3142857142857143,0.6470588235294118,68943595,35,11
1,10,0.2857142857142857,0.5454545454545454,68060601,14,4
2,1,0.8,0.5,82132592,5,4
2,6,0.5,0.875,73870370,12,6
0,21,0.0,0.0,69640725,21,0
0,6,0.14285714285714285,0.0,80137716,7,1
0,7,0.2222222222222222,0.35714285714285715,66423084,9,2
2,2,0.5,0.3333333333333333,72778461,4,2
2,3,0.7,0.9333333333333333,67359873,10,7
2,1,0.5,0.95,69961234,2,1
0,6,0.0,0.0,69404580,6,0
0,4,0.2,0.45454545454545453,68273674,5,1
0,9,0.1,0.36,74510002,10,1
0,14,0.06666666666666667,0.323943661971831,74510016,15,1
1,15,0.11764705882352941,0.5,74510023,17,2
0,6,0.14285714285714285,0.16666666666666666,68273562,7,1
2,1,0.5,0.5,705432,2,1
0,2,0.0,0.0,71512182,2,0
2,2,0.7777777777777778,0.8,70814436,9,7
2,2,0.9047619047619048,0.75,68274780,21,19
1,16,0.38461538461538464,0.9537037037037037,80135179,26,10
0,16,0.23809523809523808,0.46153846153846156,64166354,21,5
0,1,0.0,0.0,70705565,1,0
0,1,0.0,0.0,71212323,1,0
2,4,0.7142857142857143,0.95,82013611,14,10
0,16,0.15789473684210525,0.3484848484848485,80128194,19,3
1,7,0.3,0.7777777777777778,80154097,10,3
0,1,0.0,0.0,67159911,1,0
1,11,0.45,0.7916666666666666,67753700,20,9
1,4,0.42857142857142855,0.5,69666646,7,3
1,7,0.3,0.5882352941176471,67775316,10,3
0,6,0.0,0.0,69633200,6,0
0,19,0.0,0.0,73735466,19,0
2,11,0.5,0.5,75576396,22,11
0,3,0.25,0.25,70629811,4,1
1,7,0.4166666666666667,0.8235294117647058,71081682,12,5
0,6,0.14285714285714285,0.48148148148148145,70675521,7,1
0,36,0.05263157894736842,0.033707865168539325,70677824,38,2
0,30,0.0625,0.14606741573033707,70678825,32,2
0,5,0.0,0.0,82126770,5,0
1,13,0.43478260869565216,0.9354838709677419,66028914,23,10
2,2,0.6,0.6666666666666666,68531631,5,3
1,4,0.3333333333333333,0.7878787878787878,70703304,6,2
0,10,0.09090909090909091,0.25,72775255,11,1
2,0,1.0,1.0,80162171,6,6
0,4,0.2,0.3,70713832,5,1
1,22,0.2903225806451613,0.6170212765957447,80165853,31,9
0,3,0.0,0.0,65191392,3,0
2,2,0.5,0.3333333333333333,77318885,4,2
2,0,1.0,1.0,71458982,3,3
2,3,0.5,0.8,68273632,6,3
2,4,0.5555555555555556,0.75,69706903,9,5
2,0,1.0,1.0,68747623,1,1
0,2,0.0,0.0,70701183,2,0
0,13,0.1875,0.1935483870967742,65279662,16,3
1,7,0.36363636363636365,0.8333333333333334,65280110,11,4
1,13,0.3157894736842105,0.7352941176470589,80137562,19,6
0,6,0.0,0.0,70408436,6,0
2,9,0.5263157894736842,0.75,70250733,19,10
2,1,0.6666666666666666,0.5,67822895,3,2
1,15,0.3181818181818182,0.675,75892782,22,7
2,12,0.5384615384615384,0.96875,72390864,26,14
0,38,0.11627906976744186,0.13953488372093023,68433953,43,5
2,4,0.6363636363636364,0.8571428571428571,62750282,11,7
2,9,0.6896551724137931,0.6666666666666666,80118206,29,20
0,8,0.0,0.0,80132361,8,0
0,4,0.0,0.0,73296020,4,0
1,4,0.2,0.6666666666666666,70698873,5,1
1,14,0.36363636363636365,0.55,74362995,22,8
1,6,0.3333333333333333,0.7692307692307693,82062262,9,3
1,7,0.125,0.7037037037037037,67094223,8,1
0,14,0.0,0.0,67094405,14,0
0,7,0.0,0.0,69726300,7,0
0,7,0.0,0.0,69726391,7,0
1,12,0.25,0.59375,80150932,16,4
1,9,0.3076923076923077,0.7586206896551724,70060333,13,4
0,21,0.045454545454545456,0.14150943396226415,69133946,22,1
0,30,0.0,0.0,70597926,30,0
1,15,0.375,0.9090909090909091,69466334,24,9
1,3,0.25,0.5,69473635,4,1
2,2,0.5,0.6666666666666666,80176639,4,2
0,8,0.2,0.09090909090909091,68784373,10,2
2,2,0.7142857142857143,0.8888888888888888,72503732,7,5
1,29,0.3409090909090909,0.7714285714285715,80155963,44,15
0,10,0.09090909090909091,0.022222222222222223,70718571,11,1
1,18,0.21739130434782608,0.6949152542372882,70417004,23,5
0,6,0.14285714285714285,0.3333333333333333,69582905,7,1
0,18,0.3076923076923077,0.35294117647058826,80126442,26,8
1,9,0.3076923076923077,0.5,79730574,13,4
0,2,0.0,0.0,64363264,2,0
0,15,0.0,0.0,67434780,15,0
1,5,0.2857142857142857,0.6666666666666666,69241816,7,2
1,2,0.3333333333333333,0.625,72439542,3,1
1,16,0.30434782608695654,0.855072463768116,80128850,23,7
1,6,0.4,0.5714285714285714,68163081,10,4
2,5,0.5833333333333334,0.9565217391304348,82060558,12,7
2,16,0.5897435897435898,0.8,68317921,39,23
0,6,0.25,0.3333333333333333,69390671,8,2
0,6,0.14285714285714285,0.23529411764705882,64202670,7,1
0,16,0.30434782608695654,0.4772727272727273,69469400,23,7
1,6,0.45454545454545453,0.5,72137835,11,5
2,2,0.5,0.8181818181818182,80133940,4,2
0,36,0.14285714285714285,0.15,70045192,42,6
2,0,1.0,1.0,80172951,3,3
2,1,0.75,0.0,62788684,4,3
2,0,1.0,1.0,68628882,1,1
2,7,0.7407407407407407,0.9523809523809523,80154216,27,20
1,8,0.3333333333333333,0.8095238095238095,70568183,12,4
2,2,0.5,0.8,72803262,4,2
0,5,0.0,0.0,70706041,5,0
1,15,0.375,0.85,68234705,24,9
0,4,0.0,0.0,70743603,4,0
0,1,0.0,0.0,67871454,1,0
2,6,0.7142857142857143,0.8125,82020073,21,15
2,3,0.8421052631578947,0.75,82060556,19,16
1,5,0.16666666666666666,0.6666666666666666,67840934,6,1
0,16,0.0,0.0,64048775,16,0
2,1,0.75,0.6666666666666666,78428245,4,3
1,5,0.2857142857142857,0.9375,70238441,7,2
2,6,0.75,0.9285714285714286,72315446,24,18
1,4,0.42857142857142855,0.8571428571428571,73801161,7,3
2,4,0.5555555555555556,0.9444444444444444,75149571,9,5
2,2,0.5,0.8888888888888888,65282350,4,2
2,1,0.9,0.6666666666666666,70925694,10,9
1,8,0.42857142857142855,0.85,71619275,14,6
0,9,0.0,0.0,68060461,9,0
2,8,0.7333333333333333,0.9777777777777777,72801351,30,22
2,3,0.7,0.8333333333333334,80176631,10,7
2,4,0.7647058823529411,0.75,80132917,17,13
0,3,0.0,0.0,80163695,3,0
1,18,0.25,0.6507936507936508,70042343,24,6
2,3,0.5714285714285714,0.8333333333333334,67053714,7,4
0,9,0.1,0.0,68400892,10,1
0,1,0.0,0.0,70676256,1,0
2,8,0.5294117647058824,0.7692307692307693,72469544,17,9
2,4,0.7894736842105263,0.7272727272727273,70762825,19,15
0,1,0.0,0.0,82013541,1,0
2,3,0.5,0.7142857142857143,68286750,6,3
0,18,0.1,0.22413793103448276,70699944,20,2
1,5,0.375,0.75,65008146,8,3
0,11,0.21428571428571427,0.41818181818181815,69510385,14,3
1,13,0.48,0.8979591836734694,70575162,25,12
1,4,0.3333333333333333,0.6666666666666666,80051524,6,2
2,0,1.0,1.0,75636071,7,7
2,4,0.6,0.8571428571428571,69562801,10,6
2,1,0.6666666666666666,0.6666666666666666,70821730,3,2
0,2,0.0,0.0,80172532,2,0
1,9,0.25,0.7037037037037037,80172588,12,3
0,6,0.0,0.0,80172650,6,0
0,2,0.0,0.0,82006177,2,0
0,30,0.14285714285714285,0.31213872832369943,66395224,35,5
2,3,0.7692307692307693,0.875,69058192,13,10
0,17,0.10526315789473684,0.4074074074074074,70917406,19,2
0,1,0.0,0.0,82006644,1,0
0,13,0.0,0.0,70069881,13,0
0,51,0.1206896551724138,0.10810810810810811,73634582,58,7
0,27,0.15625,0.17647058823529413,80053491,32,5
0,9,0.1,0.3333333333333333,80163380,10,1
0,4,0.0,0.0,80150534,4,0
1,17,0.22727272727272727,0.5818181818181818,70919583,22,5
1,5,0.16666666666666666,0.5,67509036,6,1
0,8,0.0,0.0,82102620,8,0
0,15,0.0,0.0,82102905,15,0
0,12,0.07692307692307693,0.25,82103897,13,1
0,2,0.0,0.0,65110850,2,0
0,25,0.038461538461538464,0.2,67888576,26,1
1,28,0.3170731707317073,0.8235294117647058,68158734,41,13
0,1,0.0,0.0,80171789,1,0
2,1,0.5,0.5,80171795,2,1
1,12,0.14285714285714285,0.5348837209302325,69407065,14,2
2,2,0.6,0.8888888888888888,70861896,5,3
0,2,0.0,0.0,80162864,2,0
1,7,0.125,0.5957446808510638,82006876,8,1
1,10,0.23076923076923078,0.7777777777777778,68213593,13,3
1,5,0.16666666666666666,0.6774193548387096,69407205,6,1
0,7,0.0,0.0,80150506,7,0
1,6,0.25,0.6666666666666666,74161283,8,2
1,4,0.2,0.5,80176302,5,1
1,2,0.3333333333333333,0.8,69188070,3,1
0,16,0.0,0.0,82118228,16,0
0,31,0.03125,0.10483870967741936,70468251,32,1
0,7,0.0,0.0,80150601,7,0
1,15,0.11764705882352941,0.5274725274725275,70173341,17,2
0,3,0.0,0.0,80131216,3,0
0,10,0.0,0.0,70908551,10,0
2,1,0.5,0.5,69736471,2,1
2,3,0.5714285714285714,0.9230769230769231,66354694,7,4
0,9,0.1,0.35294117647058826,80128462,10,1
0,10,0.09090909090909091,0.2,69149822,11,1
0,5,0.0,0.0,80086685,5,0
0,8,0.0,0.0,80150594,8,0
0,9,0.0,0.0,80150695,9,0
0,13,0.0,0.0,80150707,13,0
0,1,0.0,0.0,70629202,1,0
0,1,0.0,0.0,70698866,1,0
1,9,0.25,0.5675675675675675,69666674,12,3
0,8,0.1111111111111111,0.24,73701075,9,1
1,17,0.19047619047619047,0.5977011494252874,68498073,21,4
1,8,0.2727272727272727,0.6153846153846154,70508886,11,3
2,4,0.5,0.9166666666666666,71277591,8,4
2,6,0.5714285714285714,0.9411764705882353,80052714,14,8
0,30,0.0625,0.04395604395604396,67963133,32,2
1,11,0.45,0.92,70649292,20,9
2,1,0.75,0.6666666666666666,64124816,4,3
0,15,0.16666666666666666,0.3333333333333333,70910021,18,3
2,1,0.5,0.8571428571428571,68461533,2,1
1,13,0.43478260869565216,0.9696969696969697,80126965,23,10
2,2,0.6,0.8,70930944,5,3
2,4,0.5555555555555556,0.8571428571428571,273903,9,5
2,0,1.0,1.0,70422240,3,3
0,23,0.28125,0.4666666666666667,66378991,32,9
0,10,0.23076923076923078,0.3,72759484,13,3
1,30,0.2857142857142857,0.6593406593406593,68143810,42,12
2,0,1.0,1.0,82061217,5,5
0,9,0.1,0.4166666666666667,80124197,10,1
0,18,0.0,0.0,62841513,18,0
2,0,1.0,1.0,70037142,2,2
2,2,0.5,0.6666666666666666,69701065,4,2
0,32,0.15789473684210525,0.44329896907216493,66221806,38,6
1,20,0.3103448275862069,0.7659574468085106,82023706,29,9
1,4,0.3333333333333333,0.875,70037380,6,2
1,10,0.4117647058823529,0.9565217391304348,80128284,17,7
2,6,0.5,0.9090909090909091,69499451,12,6
0,13,0.23529411764705882,0.4583333333333333,67812325,17,4
0,6,0.14285714285714285,0.375,70706216,7,1
2,1,0.5,0.6666666666666666,70696311,2,1
1,9,0.25,0.75,70692566,12,3
0,5,0.16666666666666666,0.2222222222222222,79980131,6,1
2,9,0.6538461538461539,0.9772727272727273,66781155,26,17
1,4,0.42857142857142855,0.9375,70705705,7,3
2,1,0.9473684210526315,0.8,82054057,19,18
2,0,1.0,1.0,82038271,1,1
1,15,0.4,0.7352941176470589,70927080,25,10
0,2,0.0,0.0,65290904,2,0
1,18,0.3793103448275862,0.8043478260869565,82018795,29,11
0,2,0.0,0.0,69311536,2,0
0,7,0.125,0.4444444444444444,69723850,8,1
2,1,0.5,0.5,70742812,2,1
0,2,0.0,0.0,80145438,2,0
1,6,0.3333333333333333,0.723404255319149,80145885,9,3
1,3,0.25,0.5,62460335,4,1
0,18,0.1,0.25,82022524,20,2
2,0,1.0,1.0,82090156,3,3
2,2,0.7142857142857143,0.6666666666666666,63962535,7,5
0,2,0.3333333333333333,0.2,80156406,3,1
2,10,0.6428571428571429,0.8888888888888888,82096259,28,18
2,1,0.8571428571428571,0.5,82018722,7,6
0,7,0.0,0.0,70818272,7,0
0,3,0.0,0.0,82102771,3,0
0,3,0.0,0.0,82102778,3,0
1,4,0.2,0.7058823529411765,82102530,5,1
1,4,0.42857142857142855,0.8947368421052632,66403862,7,3
0,2,0.0,0.0,80128309,2,0
2,2,0.5,0.8333333333333334,82024371,4,2
0,7,0.125,0.034482758620689655,68359151,8,1
1,13,0.3157894736842105,0.8888888888888888,70489412,19,6
0,4,0.0,0.0,80067372,4,0
0,10,0.16666666666666666,0.41935483870967744,80134893,12,2
2,0,1.0,1.0,80159763,1,1
1,13,0.2777777777777778,0.9069767441860465,70233450,18,5
1,3,0.4,0.8333333333333334,74923940,5,2
0,9,0.0,0.0,67475814,9,0
1,6,0.25,0.5151515151515151,72844121,8,2
2,0,1.0,1.0,68240123,7,7
2,2,0.5,0.9230769230769231,69319481,4,2
2,27,0.5909090909090909,0.9848484848484849,69404832,66,39
0,20,0.047619047619047616,0.09615384615384616,61944946,21,1
0,13,0.13333333333333333,0.46,66933244,15,2
0,1,0.0,0.0,70705250,1,0
0,11,0.08333333333333333,0.3541666666666667,69007323,12,1
0,13,0.0,0.0,70699825,13,0
2,4,0.6923076923076923,0.9230769230769231,69065745,13,9
0,7,0.0,0.0,80149818,7,0
2,0,1.0,1.0,75295150,3,3
0,5,0.0,0.0,69977901,5,0
0,8,0.0,0.0,78507471,8,0
0,6,0.0,0.0,78507485,6,0
0,1,0.0,0.0,80145899,1,0
0,18,0.05263157894736842,0.16666666666666666,77577283,19,1
0,12,0.07692307692307693,0.058823529411764705,67775274,13,1
0,5,0.16666666666666666,0.2692307692307692,70759815,6,1
0,4,0.3333333333333333,0.14285714285714285,66237612,6,2
2,3,0.7,0.75,79792475,10,7
0,34,0.17073170731707318,0.3217391304347826,69545490,41,7
2,5,0.5833333333333334,0.9375,300650,12,7
1,2,0.3333333333333333,0.7777777777777778,67775162,3,1
1,6,0.4,0.8888888888888888,69331766,10,4
2,17,0.5277777777777778,0.84,74048702,36,19
1,15,0.3181818181818182,0.7872340425531915,78863631,22,7
1,4,0.42857142857142855,0.8571428571428571,69666870,7,3
2,4,0.5,0.6,67884236,8,4
0,10,0.0,0.0,72809184,10,0
1,5,0.16666666666666666,0.5454545454545454,60877614,6,1
0,5,0.16666666666666666,0.25,69596765,6,1
2,1,0.875,0.5,82023124,8,7
0,18,0.14285714285714285,0.2727272727272727,80052602,21,3
1,11,0.47619047619047616,0.8928571428571429,80052721,21,10
1,6,0.4,0.8,64968442,10,4
1,11,0.35294117647058826,0.9393939393939394,70854364,17,6
1,13,0.35,0.7419354838709677,65290232,20,7
1,9,0.3076923076923077,0.65,66802834,13,4
1,19,0.36666666666666664,0.8367346938775511,70395206,30,11
1,10,0.23076923076923078,0.6296296296296297,70070714,13,3
1,12,0.29411764705882354,0.6428571428571429,68530133,17,5
0,9,0.0,0.0,75148024,9,0
0,23,0.0,0.0,70639870,23,0
0,9,0.0,0.0,80150440,9,0
1,14,0.2222222222222222,0.5555555555555556,69681430,18,4
1,6,0.45454545454545453,0.9375,80165142,11,5
0,14,0.125,0.2558139534883721,67507993,16,2
1,4,0.3333333333333333,0.5,67423230,6,2
0,1,0.0,0.0,69187741,1,0
0,10,0.23076923076923078,0.46153846153846156,65286494,13,3
0,10,0.16666666666666666,0.21212121212121213,65286445,12,2
1,12,0.3333333333333333,0.5769230769230769,65289455,18,6
0,31,0.08823529411764706,0.34,68255236,34,3
1,4,0.3333333333333333,0.5,80018981,6,2
2,1,0.5,0.5,69170633,2,1
1,2,0.3333333333333333,0.8461538461538461,70699874,3,1
0,1,0.0,0.0,66187604,1,0
0,2,0.0,0.0,66956456,2,0
2,0,1.0,1.0,82201009,4,4
2,6,0.6,0.967741935483871,80176864,15,9
0,9,0.35714285714285715,0.4782608695652174,69482910,14,5
1,5,0.375,0.8571428571428571,66396274,8,3
2,1,0.5,0.6666666666666666,82007798,2,1
1,3,0.4,0.6,82019886,5,2
1,4,0.3333333333333333,0.625,70175532,6,2
2,0,1.0,1.0,82022193,1,1
1,10,0.3333333333333333,0.8333333333333334,80003196,15,5
2,2,0.6,0.875,69149332,5,3
2,21,0.5625,0.9880952380952381,69045704,48,27
0,13,0.13333333333333333,0.35555555555555557,69417565,15,2
2,4,0.6666666666666666,0.9090909090909091,80137607,12,8
0,3,0.0,0.0,72808981,3,0
1,28,0.40425531914893614,0.7073170731707317,79251893,47,19
2,0,1.0,1.0,82126596,7,7
2,0,1.0,1.0,69158901,2,2
2,3,0.7,0.8,73588956,10,7
0,9,0.18181818181818182,0.4090909090909091,69626214,11,2
0,3,0.0,0.0,69626221,3,0
2,6,0.7391304347826086,0.875,80127699,23,17
1,7,0.2222222222222222,0.7,80155212,9,2
2,1,0.5,0.5,82110448,2,1
2,0,1.0,1.0,80176468,2,2
2,1,0.75,0.8571428571428571,82096238,4,3
2,1,0.8,0.5,80149246,5,4
2,2,0.6,0.75,82038244,5,3
2,0,1.0,1.0,67258702,1,1
2,0,1.0,1.0,82041546,2,2
2,2,0.8181818181818182,0.8888888888888888,78621375,11,9
2,3,0.7272727272727273,0.9,77231602,11,8
1,4,0.3333333333333333,0.7692307692307693,67195492,6,2
2,0,1.0,1.0,82024289,1,1
2,0,1.0,1.0,80159748,17,17
2,0,1.0,1.0,82001095,3,3
1,7,0.36363636363636365,0.6,80155249,11,4
2,4,0.5,0.9,82110219,8,4
2,0,1.0,1.0,82038279,1,1
1,14,0.3333333333333333,0.6551724137931034,80134759,21,7
1,9,0.35714285714285715,0.525,80126968,14,5
2,1,0.8333333333333334,0.5,68747665,6,5
0,1,0.0,0.0,68748344,1,0
1,6,0.45454545454545453,0.9761904761904762,71434692,11,5
2,1,0.5,0.75,70758681,2,1
2,5,0.7058823529411765,0.7272727272727273,64998143,17,12
0,9,0.35714285714285715,0.2727272727272727,79718373,14,5
1,9,0.18181818181818182,0.5333333333333333,70676123,11,2
0,7,0.0,0.0,70678713,7,0
2,1,0.5,0.8,70743162,2,1
2,5,0.5,0.6,70815703,10,5
2,3,0.8695652173913043,0.8571428571428571,75662510,23,20
0,36,0.0,0.0,80124331,36,0
1,7,0.3,0.5625,80165148,10,3
0,27,0.1,0.4434782608695652,67467834,30,3
0,17,0.05555555555555555,0.28888888888888886,69525652,18,1
0,29,0.0,0.0,80150791,29,0
2,1,0.8571428571428571,0.6666666666666666,69404125,7,6
0,15,0.2857142857142857,0.48936170212765956,82019053,21,6
1,5,0.375,0.7692307692307693,72814546,8,3
0,21,0.045454545454545456,0.03571428571428571,80149939,22,1
1,5,0.2857142857142857,0.75,67754680,7,2
2,8,0.5,0.9545454545454546,69886404,16,8
0,4,0.0,0.0,69637701,4,0
0,16,0.2727272727272727,0.4864864864864865,70509082,22,6
0,9,0.0,0.0,72809100,9,0
1,4,0.3333333333333333,0.75,74086810,6,2
0,1,0.0,0.0,76326775,1,0
2,2,0.7142857142857143,0.9736842105263158,68477556,7,5
2,1,0.5,0.6666666666666666,66115476,2,1
2,1,0.5,0.9411764705882353,72768724,2,1
1,3,0.4,0.5,72472862,5,2
1,34,0.3584905660377358,0.7411764705882353,70509005,53,19
0,16,0.1111111111111111,0.35135135135135137,70679364,18,2
2,1,0.5,0.6,69164431,2,1
2,16,0.6444444444444445,0.94,72774702,45,29
2,2,0.6666666666666666,0.6666666666666666,70927052,6,4
0,7,0.0,0.0,70489181,7,0
0,45,0.021739130434782608,0.2923076923076923,70746655,46,1
0,16,0.0,0.0,70746732,16,0
0,4,0.0,0.0,70747782,4,0
0,4,0.0,0.0,65156882,4,0
2,0,1.0,1.0,79691654,1,1
0,8,0.0,0.0,70686266,8,0
2,3,0.8571428571428571,0.8,73979822,21,18
0,9,0.0,0.0,70703864,9,0
0,5,0.16666666666666666,0.4230769230769231,73295992,6,1
1,9,0.25,0.631578947368421,70036806,12,3
0,14,0.06666666666666667,0.0,68144041,15,1
2,4,0.6,0.8888888888888888,66354246,10,6
1,5,0.375,0.7222222222222222,69394374,8,3
0,4,0.3333333333333333,0.4,80135220,6,2
1,32,0.2,0.62,67049836,40,8
1,4,0.42857142857142855,0.9473684210526315,80150022,7,3
0,1,0.0,0.0,82121167,1,0
0,1,0.0,0.0,82121172,1,0
1,16,0.38461538461538464,0.5925925925925926,80028445,26,10
2,1,0.75,0.75,66379432,4,3
2,7,0.72,0.9090909090909091,80053575,25,18
1,4,0.3333333333333333,0.5,70591864,6,2
0,8,0.0,0.0,70051954,8,0
0,22,0.21428571428571427,0.358974358974359,69548332,28,6
2,7,0.6111111111111112,0.9230769230769231,74361826,18,11
1,5,0.4444444444444444,0.875,70694925,9,4
0,4,0.3333333333333333,0.4444444444444444,81989175,6,2
0,12,0.07692307692307693,0.4742268041237113,141855,13,1
1,28,0.125,0.6050955414012739,70239491,32,4
0,33,0.05714285714285714,0.28313253012048195,70508844,35,2
0,3,0.0,0.0,73489444,3,0
2,1,0.5,0.0,67754974,2,1
2,12,0.6756756756756757,0.4,62088733,37,25
0,10,0.23076923076923078,0.43478260869565216,69390706,13,3
0,3,0.0,0.0,81882139,3,0
0,11,0.15384615384615385,0.40540540540540543,80128072,13,2
2,2,0.6,0.8571428571428571,68545694,5,3
0,8,0.2,0.30434782608695654,67974725,10,2
2,0,1.0,1.0,82041336,9,9
2,4,0.5,0.7368421052631579,68499711,8,4
0,8,0.2,0.17142857142857143,68499760,10,2
0,6,0.14285714285714285,0.2962962962962963,68500033,7,1
2,1,0.5,0.6428571428571429,68631815,2,1
0,7,0.125,0.08695652173913043,70843591,8,1
2,14,0.5333333333333333,0.9318181818181818,66681706,30,16
0,2,0.3333333333333333,0.3333333333333333,69701492,3,1
1,16,0.2727272727272727,0.66,72135343,22,6
1,7,0.2222222222222222,0.5365853658536586,70685720,9,2
2,1,0.8571428571428571,0.9642857142857143,80181402,7,6
1,12,0.42857142857142855,0.9215686274509803,67994605,21,9
0,5,0.0,0.0,69003305,5,0
2,1,0.8333333333333334,0.5,67286653,6,5
1,11,0.45,0.896551724137931,80128715,20,9
0,16,0.0,0.0,81956351,16,0
2,1,0.9285714285714286,0.0,54880742,14,13
2,1,0.8571428571428571,0.5,67376421,7,6
2,1,0.9,0.5,73313905,10,9
2,1,0.5,0.6666666666666666,82250589,2,1
0,5,0.0,0.0,82250606,5,0
2,1,0.6666666666666666,0.8,82250607,3,2
0,3,0.0,0.0,82250609,3,0
0,11,0.08333333333333333,0.16666666666666666,70674954,12,1
1,11,0.3125,0.7,65890762,16,5
0,4,0.2,0.125,65977233,5,1
0,9,0.0,0.0,70597856,9,0
0,15,0.21052631578947367,0.425531914893617,70909160,19,4
1,2,0.3333333333333333,0.7894736842105263,70399133,3,1
0,61,0.1643835616438356,0.27692307692307694,80109652,73,12
0,2,0.0,0.0,82247796,2,0
0,8,0.0,0.0,66110422,8,0
0,4,0.2,0.2222222222222222,66110450,5,1
0,8,0.0,0.0,66110800,8,0
2,0,1.0,1.0,67042626,2,2
2,4,0.6,0.8947368421052632,72801610,10,6
2,0,1.0,1.0,70944755,1,1
1,16,0.2,0.6304347826086957,71619135,20,4
2,1,0.5,0.75,70779254,2,1
0,13,0.13333333333333333,0.3673469387755102,80131224,15,2
0,8,0.0,0.0,69240024,8,0
0,1,0.0,0.0,68742240,1,0
2,1,0.5,0.9,69044654,2,1
1,11,0.42105263157894735,0.8214285714285714,70494494,19,8
0,20,0.25925925925925924,0.3695652173913043,68401130,27,7
1,7,0.2222222222222222,0.6521739130434783,64561112,9,2
0,15,0.0,0.0,80069913,15,0
2,0,1.0,1.0,80159256,13,13
2,1,0.6666666666666666,0.6666666666666666,66077683,3,2
0,4,0.2,0.1111111111111111,70398174,5,1
1,5,0.16666666666666666,0.6153846153846154,80128153,6,1
1,7,0.36363636363636365,0.8048780487804879,68566295,11,4
0,3,0.25,0.3333333333333333,70820204,4,1
0,4,0.0,0.0,70820211,4,0
2,0,1.0,1.0,80179208,1,1
2,0,1.0,1.0,82013594,1,1
1,8,0.2,0.5454545454545454,80121201,10,2
1,8,0.3333333333333333,0.8,70687400,12,4
2,1,0.8,0.5,70718053,5,4
1,34,0.4603174603174603,0.8558558558558559,66903312,63,29
0,19,0.13636363636363635,0.46511627906976744,70675885,22,3
0,4,0.0,0.0,70684544,4,0
0,12,0.14285714285714285,0.25,67591321,14,2
1,5,0.16666666666666666,0.7894736842105263,62881462,6,1
2,0,1.0,1.0,80163678,4,4
1,15,0.2857142857142857,0.7321428571428571,78763181,21,6
1,7,0.36363636363636365,0.8181818181818182,80128821,11,4
1,17,0.2608695652173913,0.7586206896551724,68497072,23,6
1,4,0.3333333333333333,0.875,68497086,6,2
2,6,0.5,0.9523809523809523,82142695,12,6
1,2,0.3333333333333333,0.8620689655172413,80163454,3,1
2,7,0.5625,0.8333333333333334,70712152,16,9
2,18,0.5263157894736842,0.9565217391304348,67122580,38,20
2,3,0.5714285714285714,0.9166666666666666,74027814,7,4
0,11,0.08333333333333333,0.09090909090909091,80126972,12,1
0,2,0.0,0.0,80126975,2,0
1,8,0.3333333333333333,0.5625,69644743,12,4
0,13,0.1875,0.36538461538461536,80128820,16,3
2,0,1.0,1.0,70660730,3,3
2,5,0.5833333333333334,0.75,82096284,12,7
1,5,0.375,0.7,80162650,8,3
0,18,0.0,0.0,70607950,18,0
1,11,0.42105263157894735,0.9090909090909091,82041320,19,8
0,2,0.0,0.0,70685874,2,0
0,1,0.0,0.0,70707126,1,0
0,41,0.0,0.0,80150468,41,0
0,34,0.02857142857142857,0.2033898305084746,80150469,35,1
0,10,0.3333333333333333,0.375,65289903,15,5
0,24,0.14285714285714285,0.15151515151515152,65286375,28,4
0,5,0.2857142857142857,0.3333333333333333,65279725,7,2
0,9,0.0,0.0,70687603,9,0
2,1,0.5,0.0,80093433,2,1
2,1,0.5,0.0,80095330,2,1
2,3,0.625,0.9090909090909091,72803773,8,5
2,11,0.5,0.9736842105263158,68533052,22,11
0,19,0.17391304347826086,0.4393939393939394,73302376,23,4
0,1,0.0,0.0,68373613,1,0
0,2,0.0,0.0,68373711,2,0
0,3,0.0,0.0,68373816,3,0
1,36,0.25,0.5,64166382,48,12
0,19,0.05,0.09195402298850575,61983516,20,1
2,2,0.6666666666666666,0.75,69414982,6,4
0,10,0.16666666666666666,0.18518518518518517,69659835,12,2
1,26,0.2571428571428571,0.6986301369863014,67062086,35,9
1,16,0.4666666666666667,0.9523809523809523,68155696,30,14
1,25,0.2857142857142857,0.6707317073170732,70912730,35,10
2,4,0.5,0.9,70005880,8,4
1,2,0.3333333333333333,0.8,329042,3,1
0,4,0.2,0.25,65546222,5,1
1,4,0.3333333333333333,0.6923076923076923,73800720,6,2
2,1,0.6666666666666666,0.5,61392702,3,2
1,14,0.36363636363636365,0.775,64866242,22,8
0,1,0.0,0.0,69700050,1,0
0,1,0.0,0.0,69700554,1,0
2,1,0.6666666666666666,0.9615384615384616,80133892,3,2
1,5,0.2857142857142857,0.5,70843514,7,2
1,4,0.42857142857142855,0.7857142857142857,64948653,7,3
2,1,0.75,0.8,60968502,4,3
1,5,0.375,0.6666666666666666,75000331,8,3
2,0,1.0,1.0,69170696,1,1
1,9,0.3076923076923077,0.64,82052043,13,4
1,6,0.3333333333333333,0.6666666666666666,58879002,9,3
1,5,0.4444444444444444,0.75,66072384,9,4
2,0,1.0,1.0,67199146,4,4
1,18,0.3333333333333333,0.7567567567567568,72802835,27,9
2,1,0.5,0.8181818181818182,68498731,2,1
0,1,0.0,0.0,69479165,1,0
0,4,0.2,0.48,82018719,5,1
1,10,0.375,0.92,68785192,16,6
1,4,0.42857142857142855,0.8,82251160,7,3
2,4,0.5,0.8,67887372,8,4
0,10,0.16666666666666666,0.2571428571428571,70914403,12,2
2,1,0.875,0.6666666666666666,69033580,8,7
1,2,0.3333333333333333,0.7272727272727273,82090254,3,1
2,0,1.0,1.0,66235232,6,6
0,10,0.0,0.0,62836375,10,0
0,3,0.0,0.0,70697795,3,0
0,2,0.3333333333333333,0.0,82113195,3,1
2,1,0.6666666666666666,0.5,75858503,3,2
1,11,0.26666666666666666,0.6666666666666666,70683865,15,4
1,10,0.4444444444444444,0.9210526315789473,79648940,18,8
0,1,0.0,0.0,70698264,1,0
0,16,0.23809523809523808,0.16666666666666666,80168320,21,5
0,15,0.11764705882352941,0.3815789473684211,70674870,17,2
0,5,0.4444444444444444,0.0,70811580,9,4
1,16,0.38461538461538464,0.7674418604651163,80061030,26,10
2,0,1.0,1.0,67744362,4,4
2,12,0.5384615384615384,0.7058823529411765,76571831,26,14
0,4,0.0,0.0,70516131,4,0
1,8,0.38461538461538464,0.7083333333333334,80051650,13,5
0,26,0.13333333333333333,0.2,69693862,30,4
2,1,0.75,0.0,67830700,4,3
1,3,0.4,0.5,82096257,5,2
2,1,0.75,0.6666666666666666,82153543,4,3
0,9,0.3076923076923077,0.07142857142857142,65333275,13,4
0,2,0.0,0.0,14103775,2,0
1,42,0.3225806451612903,0.7633587786259542,66856146,62,20
1,5,0.4444444444444444,0.8,70216384,9,4
2,0,1.0,1.0,70037625,3,3
1,10,0.375,0.7878787878787878,70420490,16,6
1,5,0.375,0.7368421052631579,67208603,8,3
0,2,0.0,0.0,62703326,2,0
2,0,1.0,1.0,68478991,3,3
2,0,1.0,1.0,80134769,2,2
2,0,1.0,1.0,80118295,4,4
1,14,0.2631578947368421,0.7710843373493976,70606060,19,5
2,2,0.5,0.3333333333333333,70761670,4,2
0,56,0.06666666666666667,0.3891625615763547,67846443,60,4
2,3,0.7857142857142857,0.8333333333333334,80093566,14,11
0,2,0.0,0.0,70706314,2,0
0,5,0.0,0.0,70743624,5,0
1,6,0.4,0.8333333333333334,65282245,10,4
0,5,0.16666666666666666,0.2727272727272727,70527366,6,1
2,3,0.5,0.5,80165422,6,3
2,5,0.5,0.9166666666666666,67282390,10,5
0,4,0.0,0.0,80149986,4,0
0,1,0.0,0.0,80128317,1,0
0,13,0.13333333333333333,0.2653061224489796,80126765,15,2
2,0,1.0,1.0,53123693,1,1
1,13,0.23529411764705882,0.5,68773152,17,4
0,5,0.16666666666666666,0.3103448275862069,70703983,6,1
1,10,0.4117647058823529,0.9459459459459459,69031116,17,7
0,3,0.25,0.2,67118352,4,1
0,32,0.1111111111111111,0.29850746268656714,70675920,36,4
1,3,0.25,0.7142857142857143,70704473,4,1
0,10,0.0,0.0,70706363,10,0
1,23,0.3235294117647059,0.7358490566037735,66829672,34,11
0,14,0.06666666666666667,0.3333333333333333,80150438,15,1
0,4,0.0,0.0,70681744,4,0
1,2,0.3333333333333333,0.8888888888888888,70692860,3,1
0,6,0.0,0.0,70693021,6,0
0,3,0.0,0.0,70694071,3,0
1,3,0.25,0.8181818181818182,82019422,4,1
1,6,0.14285714285714285,0.6666666666666666,82090194,7,1
0,2,0.0,0.0,70702380,2,0
2,0,1.0,1.0,82018612,2,2
2,0,1.0,1.0,66237766,9,9
0,4,0.0,0.0,70681093,4,0
0,2,0.0,0.0,80126773,2,0
0,4,0.0,0.0,70675724,4,0
0,9,0.1,0.21052631578947367,70682591,10,1
2,0,1.0,1.0,80137621,3,3
1,9,0.3076923076923077,0.6388888888888888,66115546,13,4
1,19,0.3870967741935484,0.7777777777777778,68398526,31,12
0,4,0.0,0.0,69064366,4,0
2,1,0.6666666666666666,0.5,72964563,3,2
1,6,0.14285714285714285,0.7333333333333333,69188525,7,1
0,32,0.0,0.0,82134969,32,0
0,8,0.1111111111111111,0.058823529411764705,80118163,9,1
1,8,0.38461538461538464,0.8571428571428571,80118936,13,5
0,2,0.0,0.0,67900791,2,0
0,4,0.0,0.0,80150521,4,0
0,5,0.0,0.0,70918421,5,0
0,6,0.0,0.0,80162811,6,0
0,19,0.0,0.0,65882523,19,0
0,3,0.0,0.0,80165829,3,0
0,6,0.0,0.0,80165841,6,0
0,4,0.0,0.0,80165852,4,0
0,1,0.0,0.0,80165869,1,0
0,2,0.0,0.0,80172627,2,0
0,9,0.1,0.2857142857142857,80153579,10,1
0,16,0.058823529411764705,0.3333333333333333,70635194,17,1
0,3,0.0,0.0,82006735,3,0
0,4,0.0,0.0,82006736,4,0
1,3,0.25,0.5,82118281,4,1
0,17,0.05555555555555555,0.34234234234234234,70923153,18,1
0,11,0.15384615384615385,0.2222222222222222,82006493,13,2
2,1,0.5,0.8,82006708,2,1
0,15,0.0625,0.4810126582278481,68905571,16,1
0,2,0.0,0.0,82006240,2,0
0,4,0.0,0.0,82006671,4,0
1,12,0.2,0.5384615384615384,69538882,15,3
1,3,0.4,0.9761904761904762,80150552,5,2
2,1,0.75,0.75,68406044,4,3
0,4,0.0,0.0,82102482,4,0
1,7,0.4166666666666667,0.9333333333333333,70761243,12,5
0,8,0.1111111111111111,0.40625,70922894,9,1
1,12,0.29411764705882354,0.9074074074074074,70483301,17,5
0,2,0.0,0.0,82006614,2,0
1,8,0.1111111111111111,0.5106382978723404,82006689,9,1
0,20,0.09090909090909091,0.4788732394366197,67888660,22,2
2,8,0.5555555555555556,0.875,80135230,18,10
0,13,0.07142857142857142,0.2127659574468085,64027152,14,1
1,3,0.25,0.6,67917521,4,1
0,9,0.1,0.23529411764705882,71619373,10,1
0,5,0.0,0.0,70918351,5,0
0,2,0.0,0.0,71619506,2,0
2,0,1.0,1.0,80159556,25,25
1,2,0.3333333333333333,0.6666666666666666,82136694,3,1
2,3,0.5714285714285714,0.875,66766434,7,4
0,29,0.2564102564102564,0.49206349206349204,70587650,39,10
0,20,0.09090909090909091,0.30303030303030304,70746053,22,2
0,5,0.0,0.0,70747761,5,0
0,3,0.25,0.4,70721133,4,1
2,1,0.5,0.75,67509022,2,1
0,3,0.25,0.45,73801091,4,1
1,4,0.3333333333333333,0.6363636363636364,70866824,6,2
1,5,0.375,0.9285714285714286,82018900,8,3
0,6,0.14285714285714285,0.3125,79218881,7,1
0,9,0.25,0.4827586206896552,80118158,12,3
0,1,0.0,0.0,69640655,1,0
0,1,0.0,0.0,82022325,1,0
1,10,0.4444444444444444,0.75,80125547,18,8
2,2,0.5,0.6,68416943,4,2
0,5,0.16666666666666666,0.07142857142857142,69117111,6,1
1,3,0.4,0.8571428571428571,67600400,5,2
0,12,0.07692307692307693,0.0,68248796,13,1
1,11,0.3888888888888889,0.6666666666666666,82023511,18,7
1,6,0.25,0.5,69997865,8,2
2,9,0.64,0.9285714285714286,68402005,25,16
0,8,0.0,0.0,82090200,8,0
1,3,0.25,0.7142857142857143,70229740,4,1
2,1,0.75,0.5,82041311,4,3
1,15,0.25,0.6585365853658537,67775323,20,5
0,54,0.05263157894736842,0.18048780487804877,70658854,57,3
1,2,0.3333333333333333,0.75,69555570,3,1
2,30,0.5238095238095238,0.9142857142857143,71080373,63,33
0,7,0.0,0.0,65280320,7,0
2,0,1.0,1.0,82016255,1,1
2,1,0.75,0.5,67744705,4,3
1,9,0.47058823529411764,0.5384615384615384,74362071,17,8
0,4,0.2,0.23529411764705882,70683256,5,1
1,30,0.3617021276595745,0.759493670886076,68531421,47,17
1,2,0.3333333333333333,0.7142857142857143,65609131,3,1
2,6,0.5,0.9,69498352,12,6
1,15,0.2857142857142857,0.631578947368421,71081255,21,6
1,19,0.32142857142857145,0.72,69179656,28,9
2,0,1.0,1.0,70587874,1,1
2,0,1.0,1.0,80149513,1,1
1,7,0.4166666666666667,0.7368421052631579,73669064,12,5
0,4,0.2,0.36363636363636365,82022875,5,1
2,2,0.7142857142857143,0.8,67071802,7,5
2,9,0.5,0.9166666666666666,68401102,18,9
1,17,0.2608695652173913,0.5098039215686274,72390871,23,6
2,1,0.8888888888888888,0.5,70347893,9,8
0,2,0.0,0.0,70678300,2,0
2,1,0.9166666666666666,0.5,80126936,12,11
0,12,0.2,0.34615384615384615,68577824,15,3
0,6,0.14285714285714285,0.14285714285714285,69644652,7,1
2,8,0.6666666666666666,0.8333333333333334,80136918,24,16
2,7,0.5333333333333333,0.8,67410840,15,8
0,8,0.0,0.0,80124362,8,0
2,0,1.0,1.0,80134645,1,1
2,2,0.7142857142857143,0.6666666666666666,74088504,7,5
1,9,0.47058823529411764,0.9512195121951219,70811762,17,8
2,2,0.6,0.8571428571428571,69964482,5,3
2,0,1.0,1.0,68748232,1,1
2,5,0.8333333333333334,0.9444444444444444,80179031,30,25
1,11,0.35294117647058826,0.8333333333333334,66892553,17,6
0,4,0.0,0.0,82101247,4,0
1,17,0.32,0.896551724137931,80128122,25,8
0,10,0.09090909090909091,0.07142857142857142,67053854,11,1
2,5,0.5833333333333334,0.8333333333333334,80118285,12,7
0,8,0.1111111111111111,0.28125,70693420,9,1
1,6,0.45454545454545453,0.9375,68783302,11,5
1,5,0.4444444444444444,0.9285714285714286,73400635,9,4
2,0,1.0,1.0,80092516,2,2
0,2,0.0,0.0,69391084,2,0
1,7,0.46153846153846156,0.9545454545454546,80133803,13,6
0,4,0.0,0.0,69157676,4,0
1,18,0.47058823529411764,0.9333333333333333,68282970,34,16
1,4,0.3333333333333333,0.7333333333333333,74086782,6,2
1,8,0.2727272727272727,0.55,63993202,11,3
2,0,1.0,1.0,74442956,2,2
0,12,0.07692307692307693,0.2033898305084746,70695086,13,1
2,0,1.0,1.0,68474434,6,6
0,16,0.15789473684210525,0.23529411764705882,72529044,19,3
0,2,0.0,0.0,71081360,2,0
1,7,0.2222222222222222,0.6666666666666666,69895420,9,2
1,2,0.3333333333333333,0.6666666666666666,82047565,3,1
0,7,0.0,0.0,80029082,7,0
1,6,0.14285714285714285,0.68,65112824,7,1
0,6,0.0,0.0,69895210,6,0
2,1,0.5,0.9333333333333333,70700980,2,1
0,15,0.11764705882352941,0.4,69895336,17,2
0,10,0.09090909090909091,0.46808510638297873,61983544,11,1
1,9,0.18181818181818182,0.5862068965517241,66933272,11,2
0,10,0.16666666666666666,0.40625,82206205,12,2
2,9,0.5909090909090909,0.9047619047619048,68039993,22,13
1,2,0.3333333333333333,0.5,78479821,3,1
1,2,0.3333333333333333,0.8571428571428571,73632426,3,1
0,11,0.08333333333333333,0.0,70012943,12,1
0,4,0.0,0.0,82184452,4,0
2,2,0.5,0.8,82018945,4,2
0,11,0.0,0.0,70680743,11,0
2,2,0.6666666666666666,0.875,72803360,6,4
1,8,0.2727272727272727,0.5416666666666666,75149655,11,3
1,15,0.21052631578947367,0.7419354838709677,67435116,19,4
1,10,0.3333333333333333,0.8947368421052632,65351055,15,5
1,16,0.36,0.8260869565217391,69180370,25,9
2,0,1.0,1.0,80134218,2,2
0,11,0.08333333333333333,0.08,68499893,12,1
1,31,0.27906976744186046,0.5256410256410257,70052136,43,12
2,4,0.6666666666666666,0.9,80163679,12,8
0,9,0.0,0.0,82002408,9,0
1,7,0.2222222222222222,0.8809523809523809,82003707,9,2
0,2,0.0,0.0,82003754,2,0
0,1,0.0,0.0,82010314,1,0
2,4,0.5,0.8461538461538461,69538973,8,4
2,0,1.0,1.0,69958042,5,5
0,6,0.14285714285714285,0.16666666666666666,70059864,7,1
2,1,0.6666666666666666,0.75,65281524,3,2
2,7,0.5882352941176471,0.9545454545454546,72802562,17,10
1,15,0.25,0.6229508196721312,73171791,20,5
2,0,1.0,1.0,82163438,3,3
1,8,0.3333333333333333,0.7272727272727273,80128018,12,4
0,25,0.16666666666666666,0.24444444444444444,63955843,30,5
0,7,0.0,0.0,61117175,7,0
1,22,0.2413793103448276,0.6774193548387096,80135057,29,7
0,60,0.047619047619047616,0.2804878048780488,70914256,63,3
1,10,0.47368421052631576,0.8928571428571429,69285762,19,9
0,2,0.0,0.0,69034315,2,0
0,3,0.0,0.0,69055252,3,0
1,18,0.4,0.53125,80018806,30,12
2,0,1.0,1.0,66187583,1,1
2,6,0.76,0.9411764705882353,72048270,25,19
0,9,0.18181818181818182,0.0,68401214,11,2
0,14,0.06666666666666667,0.1702127659574468,69724424,15,1
2,10,0.6,0.9285714285714286,66063305,25,15
0,1,0.0,0.0,78479786,1,0
2,19,0.5,0.9791666666666666,65289490,38,19
0,7,0.2222222222222222,0.375,65288951,9,2
1,6,0.25,0.5833333333333334,70072485,8,2
0,1,0.0,0.0,69055343,1,0
0,8,0.2,0.45,69514424,10,2
1,3,0.4,0.875,69597493,5,2
0,2,0.0,0.0,80165733,2,0
0,3,0.0,0.0,69478885,3,0
0,4,0.0,0.0,69478955,4,0
2,1,0.5,0.5,69164501,2,1
2,0,1.0,1.0,82039789,3,3
1,4,0.2,0.5555555555555556,66225432,5,1
2,1,0.8571428571428571,0.6666666666666666,68689355,7,6
2,1,0.6666666666666666,0.5,82041895,3,2
1,12,0.29411764705882354,0.5555555555555556,63841596,17,5
2,1,0.5,0.5,80084130,2,1
1,18,0.4857142857142857,0.7368421052631579,80176087,35,17
1,16,0.2727272727272727,0.6833333333333333,69416060,22,6
1,6,0.3333333333333333,0.5454545454545454,80174906,9,3
2,1,0.8,0.5,73629983,5,4
0,6,0.25,0.47058823529411764,80176628,8,2
2,0,1.0,1.0,68364030,2,2
2,0,1.0,1.0,82102170,5,5
2,0,1.0,1.0,75362602,5,5
2,1,0.5,0.0,82093756,2,1
2,1,0.8571428571428571,0.8,82023757,7,6
2,11,0.5769230769230769,0.6666666666666666,82020385,26,15
2,0,1.0,1.0,80162125,3,3
2,8,0.6,0.6,82096283,20,12
2,4,0.7647058823529411,0.6,80159288,17,13
1,7,0.4166666666666667,0.8461538461538461,79792636,12,5
0,19,0.32142857142857145,0.4166666666666667,82060542,28,9
2,0,1.0,1.0,68385240,8,8
2,2,0.6666666666666666,0.75,80056676,6,4
1,13,0.4583333333333333,0.8611111111111112,73870412,24,11
2,5,0.6153846153846154,0.75,82009579,13,8
2,0,1.0,1.0,69867266,1,1
2,1,0.5,0.8,81882152,2,1
2,0,1.0,1.0,63064316,2,2
2,1,0.5,0.9,69633102,2,1
2,1,0.8333333333333334,0.5,69315855,6,5
1,10,0.23076923076923078,0.64,70115115,13,3
2,2,0.75,0.75,66257681,8,6
1,13,0.1875,0.5588235294117647,61566372,16,3
0,2,0.0,0.0,82152434,2,0
0,18,0.14285714285714285,0.28169014084507044,80097556,21,3
1,4,0.2,0.6363636363636364,67468072,5,1
0,18,0.0,0.0,69525715,18,0
0,24,0.07692307692307693,0.41134751773049644,80150794,26,2
0,5,0.0,0.0,67887841,5,0
1,27,0.2894736842105263,0.6779661016949152,70829710,38,11
1,7,0.46153846153846156,0.9130434782608695,80163147,13,6
0,5,0.0,0.0,64045821,5,0
1,5,0.2857142857142857,0.7692307692307693,64054865,7,2
0,7,0.0,0.0,66785656,7,0
0,3,0.0,0.0,66786426,3,0
2,8,0.5,0.8333333333333334,82009601,16,8
0,2,0.0,0.0,82006376,2,0
0,1,0.0,0.0,82006383,1,0
0,6,0.25,0.3333333333333333,62580735,8,2
0,23,0.14814814814814814,0.37333333333333335,63969024,27,4
1,28,0.125,0.588957055214724,69867903,32,4
0,1,0.0,0.0,64046094,1,0
0,9,0.3076923076923077,0.4375,82018804,13,4
1,16,0.2727272727272727,0.7413793103448276,70908383,22,6
1,4,0.2,0.6470588235294118,82006206,5,1
0,9,0.0,0.0,64338120,9,0
0,10,0.09090909090909091,0.05263157894736842,73399620,11,1
1,23,0.28125,0.7555555555555555,70251853,32,9
0,7,0.0,0.0,80165168,7,0
2,1,0.6666666666666666,0.5,64998122,3,2
2,1,0.5,0.6,68060825,2,1
0,3,0.0,0.0,82152773,3,0
1,15,0.34782608695652173,0.6595744680851063,80105151,23,8
1,18,0.4,0.9090909090909091,70780864,30,12
0,6,0.14285714285714285,0.0,82060541,7,1
1,12,0.3684210526315789,0.6086956521739131,68400850,19,7
0,8,0.0,0.0,60877726,8,0
1,9,0.25,0.5454545454545454,70568323,12,3
1,9,0.3076923076923077,0.5333333333333333,70842996,13,4
1,6,0.3333333333333333,0.6,67665535,9,3
0,7,0.3,0.47368421052631576,71458604,10,3
0,17,0.15,0.10714285714285714,69628832,20,3
2,1,0.6666666666666666,0.75,70000784,3,2
0,16,0.058823529411764705,0.09375,70705971,17,1
0,12,0.07692307692307693,0.19230769230769232,80126829,13,1
1,9,0.4,0.8666666666666667,82120539,15,6
2,0,1.0,1.0,80159173,7,7
1,5,0.2857142857142857,0.7058823529411765,82018920,7,2
2,4,0.5555555555555556,0.7142857142857143,61505136,9,5
1,14,0.3,0.7954545454545454,80046085,20,6
0,2,0.0,0.0,69640263,2,0
0,3,0.0,0.0,69640382,3,0
1,4,0.3333333333333333,0.5,70821660,6,2
0,5,0.0,0.0,70509614,5,0
0,8,0.0,0.0,70746473,8,0
2,2,0.6,0.6666666666666666,69895931,5,3
1,5,0.4444444444444444,0.8823529411764706,69638842,9,4
1,14,0.2631578947368421,0.6229508196721312,69558902,19,5
0,13,0.07142857142857142,0.16666666666666666,70080990,14,1
2,4,0.6363636363636364,0.9090909090909091,68923204,11,7
0,5,0.16666666666666666,0.0,80139732,6,1
0,10,0.23076923076923078,0.2830188679245283,69594462,13,3
0,1,0.0,0.0,69948494,1,0
0,2,0.0,0.0,69045711,2,0
2,2,0.5,0.8571428571428571,69997620,4,2
1,18,0.3793103448275862,0.8363636363636363,70568225,29,11
2,3,0.6666666666666666,0.9166666666666666,82024281,9,6
0,1,0.0,0.0,73064502,1,0
0,14,0.06666666666666667,0.1388888888888889,62529733,15,1
0,7,0.0,0.0,79816975,7,0
0,11,0.0,0.0,80128207,11,0
1,7,0.125,0.5555555555555556,68905585,8,1
0,13,0.07142857142857142,0.07692307692307693,70474901,14,1
0,1,0.0,0.0,70677145,1,0
1,20,0.16666666666666666,0.5970149253731343,69007274,24,4
1,5,0.16666666666666666,0.5,80122898,6,1
2,1,0.75,0.8571428571428571,70221396,4,3
0,3,0.25,0.3333333333333333,65614955,4,1
0,9,0.1,0.1935483870967742,70677432,10,1
0,6,0.0,0.0,70681023,6,0
1,3,0.25,0.6,62827345,4,1
1,6,0.25,0.6363636363636364,68813353,8,2
1,3,0.4,0.8636363636363636,69524504,5,2
1,18,0.4375,0.7435897435897436,81989145,32,14
1,17,0.32,0.6829268292682927,66892532,25,8
0,4,0.0,0.0,61986190,4,0
2,4,0.7333333333333333,0.9444444444444444,72469782,15,11
2,12,0.5,0.9090909090909091,68566883,24,12
2,1,0.8333333333333334,0.5,68241796,6,5
1,3,0.25,0.5,82251458,4,1
2,5,0.5,0.42857142857142855,68500950,10,5
2,0,1.0,1.0,80178440,3,3
2,2,0.7142857142857143,0.5,72376850,7,5
0,4,0.0,0.0,70684593,4,0
2,7,0.7083333333333334,0.967741935483871,72801470,24,17
2,2,0.5,0.75,70687631,4,2
0,4,0.2,0.14285714285714285,66166933,5,1
0,5,0.16666666666666666,0.47058823529411764,80131197,6,1
0,5,0.16666666666666666,0.4444444444444444,68769596,6,1
1,3,0.4,0.9090909090909091,69133512,5,2
2,1,0.6666666666666666,0.5,82247779,3,2
1,8,0.1111111111111111,0.575,75883122,9,1
2,12,0.5714285714285714,0.9090909090909091,80176274,28,16
0,39,0.025,0.09090909090909091,62840414,40,1
1,18,0.4857142857142857,0.9583333333333334,70654304,35,17
0,2,0.0,0.0,69638744,2,0
2,11,0.5416666666666666,0.9629629629629629,72802786,24,13
0,11,0.0,0.0,70567980,11,0
1,6,0.25,0.6363636363636364,80122891,8,2
0,3,0.4,0.0,68162990,5,2
1,5,0.2857142857142857,0.8695652173913043,69500221,7,2
0,2,0.0,0.0,81967947,2,0
2,0,1.0,1.0,67667075,1,1
2,6,0.625,0.9090909090909091,70399371,16,10
1,10,0.47368421052631576,0.9473684210526315,78266685,19,9
2,1,0.6666666666666666,0.5,66110863,3,2
0,11,0.08333333333333333,0.19230769230769232,70684901,12,1
0,31,0.08823529411764706,0.4180327868852459,80089611,34,3
0,17,0.15,0.08,80140102,20,3
0,26,0.1875,0.2,80141462,32,6
2,3,0.5,0.8,70252861,6,3
2,11,0.56,0.782608695652174,69944434,25,14
2,6,0.5384615384615384,0.9583333333333334,69489175,13,7
2,2,0.875,0.8333333333333334,82143784,16,14
0,4,0.0,0.0,71341844,4,0
0,1,0.0,0.0,70685146,1,0
0,3,0.0,0.0,64359554,3,0
1,2,0.3333333333333333,0.8571428571428571,82102533,3,1
0,29,0.12121212121212122,0.28,69559735,33,4
1,16,0.23809523809523808,0.5087719298245614,65288594,21,5
0,11,0.0,0.0,70677565,11,0
2,0,1.0,1.0,70062510,5,5
0,1,0.0,0.0,70829836,1,0
2,4,0.6,0.3333333333333333,69069154,10,6
0,7,0.125,0.3333333333333333,70707035,8,1
0,1,0.0,0.0,70706573,1,0
0,6,0.0,0.0,70706664,6,0
0,15,0.0,0.0,70174195,15,0
1,8,0.38461538461538464,0.8823529411764706,69997466,13,5
0,11,0.3125,0.1,71689590,16,5
2,2,0.6,0.8333333333333334,80128509,5,3
1,6,0.45454545454545453,0.8695652173913043,80126945,11,5
2,2,0.8461538461538461,0.6666666666666666,80053806,13,11
1,18,0.18181818181818182,0.6446280991735537,68241383,22,4
0,23,0.11538461538461539,0.08928571428571429,62901370,26,3
0,2,0.0,0.0,68356743,2,0
2,1,0.8333333333333334,0.9,82153816,6,5
1,8,0.3333333333333333,0.782608695652174,69634852,12,4
1,11,0.15384615384615385,0.5454545454545454,82158905,13,2
2,0,1.0,1.0,69483512,2,2
0,1,0.0,0.0,79989616,1,0
2,1,0.5,0.5,68402103,2,1
0,14,0.125,0.09523809523809523,67665395,16,2
2,1,0.9,0.75,82018813,10,9
1,4,0.42857142857142855,0.7857142857142857,70521542,7,3
2,4,0.6363636363636364,0.8888888888888888,72802660,11,7
0,1,0.0,0.0,80022054,1,0
1,8,0.3333333333333333,0.84,65279144,12,4
1,12,0.29411764705882354,0.6666666666666666,65280803,17,5
1,7,0.2222222222222222,0.5,65279760,9,2
2,9,0.5,0.9117647058823529,82023687,18,9
1,7,0.4166666666666667,0.9523809523809523,80135068,12,5
2,0,1.0,1.0,75295136,1,1
0,10,0.0,0.0,68499732,10,0
1,26,0.21212121212121213,0.5818181818181818,68499830,33,7
2,0,1.0,1.0,72803913,2,2
0,24,0.04,0.15384615384615385,77576730,25,1
0,30,0.0,0.0,77576765,30,0
0,25,0.07407407407407407,0.2777777777777778,77576786,27,2
1,2,0.3333333333333333,0.5,69311354,3,1
1,15,0.25,0.5555555555555556,70844053,20,5
0,1,0.0,0.0,80165471,1,0
2,1,0.5,0.5,70350595,2,1
1,9,0.25,0.6,70413483,12,3
1,4,0.42857142857142855,0.8125,66138226,7,3
0,14,0.06666666666666667,0.014492753623188406,80134996,15,1
0,29,0.03333333333333333,0.09259259259259259,69703151,30,1
1,5,0.375,0.9090909090909091,78863603,8,3
1,19,0.36666666666666664,0.8412698412698413,82053035,30,11
0,3,0.0,0.0,80145812,3,0
0,5,0.16666666666666666,0.44,80145826,6,1
1,2,0.3333333333333333,0.6666666666666666,70759472,3,1
0,8,0.2727272727272727,0.3333333333333333,82009522,11,3
0,2,0.0,0.0,69597094,2,0
2,4,0.6363636363636364,0.9166666666666666,70175441,11,7
1,20,0.16666666666666666,0.5161290322580645,75456640,24,4
2,1,0.5,0.7692307692307693,79953881,2,1
1,8,0.4666666666666667,0.9583333333333334,74924094,15,7
0,5,0.16666666666666666,0.4074074074074074,70703150,6,1
2,6,0.5,0.9464285714285714,82017800,12,6
0,6,0.14285714285714285,0.3142857142857143,69169443,7,1
2,1,0.8,0.5,80094931,5,4
0,8,0.1111111111111111,0.09433962264150944,66064894,9,1
2,2,0.6,0.75,66229275,5,3
0,6,0.0,0.0,67435060,6,0
0,1,0.0,0.0,63982506,1,0
1,10,0.23076923076923078,0.7096774193548387,67276251,13,3
1,22,0.2413793103448276,0.5263157894736842,82119691,29,7
2,1,0.9333333333333333,0.5,82134699,15,14
0,2,0.3333333333333333,0.3333333333333333,82013592,3,1
2,4,0.7777777777777778,0.8,80090164,18,14
0,7,0.0,0.0,80128479,7,0
0,5,0.375,0.42857142857142855,73871392,8,3
1,16,0.4482758620689655,0.86,69129431,29,13
2,0,1.0,1.0,82024396,3,3
2,2,0.6,0.6,82018777,5,3
2,2,0.9259259259259259,0.8571428571428571,80159831,27,25
0,3,0.0,0.0,68785101,3,0
0,1,0.0,0.0,68203646,1,0
0,4,0.0,0.0,72765994,4,0
0,11,0.08333333333333333,0.04,65292584,12,1
2,1,0.6666666666666666,0.5,80095190,3,2
2,1,0.6666666666666666,0.0,66227784,3,2
0,1,0.0,0.0,80156023,1,0
2,0,1.0,1.0,70251174,3,3
2,0,1.0,1.0,82052098,1,1
0,2,0.3333333333333333,0.0,70037492,3,1
0,5,0.16666666666666666,0.4782608695652174,82110027,6,1
0,2,0.0,0.0,82102936,2,0
1,7,0.46153846153846156,0.9444444444444444,69691951,13,6
0,3,0.0,0.0,64467753,3,0
0,33,0.05714285714285714,0.2206896551724138,80128211,35,2
0,10,0.09090909090909091,0.2558139534883721,80128163,11,1
2,4,0.5,0.9,69466593,8,4
0,9,0.0,0.0,68498836,9,0
0,4,0.0,0.0,70229271,4,0
0,8,0.0,0.0,70229971,8,0
1,7,0.125,0.6875,70230111,8,1
2,0,1.0,1.0,82137396,1,1
0,9,0.1,0.28888888888888886,72909816,10,1
2,1,0.75,0.5,69973400,4,3
2,1,0.6666666666666666,0.5,70036225,3,2
0,1,0.0,0.0,70660905,1,0
2,14,0.5625,0.9655172413793104,69129424,32,18
1,19,0.24,0.7105263157894737,70746375,25,6
2,5,0.5833333333333334,0.9230769230769231,66413732,12,7
1,7,0.2222222222222222,0.6216216216216216,70489146,9,2
0,5,0.16666666666666666,0.2916666666666667,80150327,6,1
1,7,0.3,0.782608695652174,68373823,10,3
1,6,0.4,0.875,81953879,10,4
1,15,0.375,0.8918918918918919,80135263,24,9
0,5,0.16666666666666666,0.2,80135261,6,1
0,10,0.16666666666666666,0.4716981132075472,70199794,12,2
0,1,0.0,0.0,82102861,1,0
0,2,0.0,0.0,69549606,2,0
1,8,0.2,0.6153846153846154,68432581,10,2
0,8,0.0,0.0,82118257,8,0
0,6,0.0,0.0,80162786,6,0
1,6,0.14285714285714285,0.5238095238095238,80162787,7,1
1,3,0.25,0.631578947368421,80163161,4,1
0,6,0.14285714285714285,0.3695652173913043,80172651,7,1
1,5,0.375,0.8181818181818182,81898493,8,3
1,6,0.14285714285714285,0.72,68384582,7,1
1,5,0.4444444444444444,0.6923076923076923,80056291,9,4
1,7,0.3,0.7647058823529411,69955564,10,3
1,5,0.2857142857142857,0.5555555555555556,80171747,7,2
1,13,0.23529411764705882,0.825,82103896,17,4
1,10,0.4444444444444444,0.96,69964384,18,8
1,23,0.3235294117647059,0.7640449438202247,82053052,34,11
0,4,0.0,0.0,82006547,4,0
0,12,0.07692307692307693,0.18,68769582,13,1
0,10,0.09090909090909091,0.38636363636363635,67900301,11,1
2,0,1.0,1.0,70061194,3,3
1,20,0.25925925925925924,0.8169014084507042,71619233,27,7
0,9,0.0,0.0,80165750,9,0
2,1,0.5,0.8333333333333334,80165756,2,1
0,6,0.14285714285714285,0.44,71619415,7,1
1,9,0.25,0.7777777777777778,80153549,12,3
2,6,0.5384615384615384,0.8620689655172413,63939820,13,7
0,10,0.09090909090909091,0.2894736842105263,65744861,11,1
0,10,0.09090909090909091,0.32608695652173914,70059451,11,1
0,10,0.09090909090909091,0.40816326530612246,82032908,11,1
1,6,0.4,0.8181818181818182,64474935,10,4
1,5,0.16666666666666666,0.5714285714285714,67122160,6,1
0,11,0.08333333333333333,0.2894736842105263,67122216,12,1
0,50,0.10714285714285714,0.42038216560509556,70483021,56,6
2,0,1.0,1.0,70467551,1,1
0,2,0.0,0.0,82006609,2,0
0,2,0.0,0.0,82006637,2,0
1,12,0.3684210526315789,0.9310344827586207,73634743,19,7
0,7,0.0,0.0,70916804,7,0
1,4,0.2,0.5,82150067,5,1
1,13,0.13333333333333333,0.5901639344262295,70343714,15,2
2,5,0.5,0.7619047619047619,70117075,10,5
2,5,0.6153846153846154,0.75,68285420,13,8
1,2,0.3333333333333333,0.6,81989169,3,1
0,6,0.0,0.0,70680470,6,0
1,12,0.14285714285714285,0.5662650602409639,75147961,14,2
2,5,0.5,0.9555555555555556,79816086,10,5
2,7,0.631578947368421,0.9583333333333334,82023703,19,12
2,8,0.6,0.9333333333333333,66367301,20,12
2,1,0.5,0.75,69463485,2,1
2,0,1.0,1.0,69729961,1,1
0,11,0.08333333333333333,0.2619047619047619,80126759,12,1
0,50,0.038461538461538464,0.023121387283236993,69416123,52,2
0,2,0.0,0.0,70070665,2,0
0,2,0.0,0.0,70070672,2,0
2,0,1.0,1.0,69193803,1,1
2,2,0.5,0.75,72801386,4,2
1,5,0.2857142857142857,0.6153846153846154,82070157,7,2
0,5,0.16666666666666666,0.0,67690756,6,1
0,1,0.0,0.0,69575422,1,0
2,0,1.0,1.0,74027702,1,1
0,1,0.0,0.0,69478990,1,0
0,39,0.13333333333333333,0.2376237623762376,80133446,45,6
0,5,0.16666666666666666,0.15384615384615385,69512303,6,1
0,8,0.0,0.0,70678832,8,0
2,2,0.5,0.8571428571428571,69638394,4,2
1,12,0.14285714285714285,0.6097560975609756,80149795,14,2
0,5,0.0,0.0,65157113,5,0
1,4,0.42857142857142855,0.8,73171784,7,3
1,15,0.375,0.5675675675675675,82052033,24,9
0,6,0.4,0.26666666666666666,65948344,10,4
1,8,0.38461538461538464,0.8333333333333334,66305071,13,5
0,8,0.1111111111111111,0.28125,79453220,9,1
1,9,0.1,0.5,82102552,10,1
2,1,0.5,0.5,70649194,2,1
0,7,0.0,0.0,67053861,7,0
2,6,0.5714285714285714,0.9375,80176656,14,8
0,2,0.0,0.0,82013549,2,0
2,3,0.5,0.75,72603916,6,3
0,2,0.0,0.0,70120064,2,0
2,1,0.5,0.5,67823574,2,1
0,16,0.0,0.0,66389190,16,0
2,0,1.0,1.0,82018815,5,5
1,3,0.25,0.5,66783542,4,1
0,36,0.1,0.3870967741935484,63992873,40,4
1,13,0.2777777777777778,0.7283950617283951,73713241,18,5
2,6,0.6470588235294118,0.875,70487284,17,11
1,7,0.4166666666666667,0.7857142857142857,70120820,12,5
1,8,0.2,0.684931506849315,71359484,10,2
0,23,0.08,0.3404255319148936,80124196,25,2
0,7,0.0,0.0,72946384,7,0
2,1,0.5,0.5,82019741,2,1
0,7,0.125,0.1,82062273,8,1
1,17,0.15,0.5142857142857142,69638170,20,3
0,59,0.1323529411764706,0.4606741573033708,63993041,68,9
1,8,0.1111111111111111,0.5818181818181818,68021695,9,1
0,8,0.0,0.0,68021744,8,0
0,32,0.08571428571428572,0.4666666666666667,67846310,35,3
1,20,0.23076923076923078,0.5217391304347826,73444875,26,6
1,11,0.21428571428571427,0.6785714285714286,66035851,14,3
1,3,0.4,0.5,71879563,5,2
0,10,0.09090909090909091,0.2,70843906,11,1
1,8,0.2727272727272727,0.5263157894736842,69996696,11,3
2,3,0.5714285714285714,0.6666666666666666,80118273,7,4
0,2,0.0,0.0,70677754,2,0
0,14,0.2631578947368421,0.42857142857142855,74386592,19,5
0,2,0.0,0.0,82143779,2,0
1,20,0.25925925925925924,0.75,69117153,27,7
2,0,1.0,1.0,68235951,1,1
0,1,0.0,0.0,67411085,1,0
2,0,1.0,1.0,67751341,1,1
2,1,0.5,0.6666666666666666,80172945,2,1
0,6,0.0,0.0,69616701,6,0
1,8,0.3333333333333333,0.6363636363636364,69735820,12,4
1,5,0.2857142857142857,0.75,70183764,7,2
1,6,0.25,0.7222222222222222,70184261,8,2
1,6,0.25,0.7058823529411765,68757262,8,2
1,14,0.17647058823529413,0.5357142857142857,64222445,17,3
0,9,0.4375,0.4,69617282,16,7
0,12,0.25,0.25,68401851,16,4
1,17,0.46875,0.9444444444444444,70341670,32,15
0,7,0.125,0.12121212121212122,69097791,8,1
0,1,0.0,0.0,80176038,1,0
2,0,1.0,1.0,67091374,2,2
0,10,0.16666666666666666,0.3793103448275862,70908572,12,2
0,5,0.0,0.0,71761753,5,0
2,1,0.8,0.5,80092110,5,4
1,5,0.4444444444444444,0.8888888888888888,68286596,9,4
2,1,0.5,0.6666666666666666,65286305,2,1
0,5,0.0,0.0,80128819,5,0
1,28,0.3333333333333333,0.7681159420289855,70854133,42,14
1,12,0.4,0.75,338940,20,8
2,0,1.0,1.0,70222033,3,3
0,3,0.0,0.0,80150366,3,0
1,38,0.36666666666666664,0.6436781609195402,75121081,60,22
1,11,0.26666666666666666,0.7058823529411765,68199194,15,4
0,2,0.0,0.0,68394004,2,0
0,6,0.0,0.0,73800825,6,0
0,6,0.25,0.3870967741935484,73801126,8,2
2,5,0.8275862068965517,0.95,70185682,29,24
0,1,0.0,0.0,69603086,1,0
0,1,0.0,0.0,79678725,1,0
0,18,0.18181818181818182,0.3484848484848485,68112555,22,4
1,3,0.4,0.875,70175833,5,2
2,0,1.0,1.0,82045551,2,2
2,1,0.5,0.5,64976282,2,1
2,0,1.0,1.0,69713623,12,12
0,13,0.07142857142857142,0.3333333333333333,80127852,14,1
2,7,0.631578947368421,0.8333333333333334,70343462,19,12
2,0,1.0,1.0,80137592,4,4
1,4,0.42857142857142855,0.6666666666666666,72366056,7,3
2,0,1.0,1.0,82041285,5,5
2,0,1.0,1.0,75577502,1,1
1,10,0.4444444444444444,0.75,80158229,18,8
2,0,1.0,1.0,82016261,2,2
2,5,0.6875,0.9,67300184,16,11
0,9,0.25,0.45454545454545453,80134742,12,3
1,13,0.3157894736842105,0.7586206896551724,67130973,19,6
2,0,1.0,1.0,70230083,1,1
2,0,1.0,1.0,80165273,10,10
2,0,1.0,1.0,82165070,1,1
2,0,1.0,1.0,82038284,3,3
2,0,1.0,1.0,70850633,19,19
0,1,0.0,0.0,73245494,1,0
2,2,0.875,0.5,68495455,16,14
2,7,0.5625,0.9375,80180337,16,9
2,0,1.0,1.0,65745316,13,13
2,0,1.0,1.0,79838535,6,6
2,1,0.5,0.5,62823495,2,1
1,3,0.4,0.75,70821044,5,2
1,15,0.34782608695652173,0.8214285714285714,70821065,23,8
0,2,0.0,0.0,70821093,2,0
2,0,1.0,1.0,80080210,3,3
1,3,0.25,0.8,80154108,4,1
2,6,0.6,0.9285714285714286,67997230,15,9
2,1,0.75,0.8,77563220,4,3
2,0,1.0,1.0,68380284,2,2
0,8,0.1111111111111111,0.0,63050953,9,1
0,17,0.10526315789473684,0.3488372093023256,80131229,19,2
2,3,0.5714285714285714,0.5,67823035,7,4
0,7,0.0,0.0,70701743,7,0
0,1,0.0,0.0,70702905,1,0
1,2,0.3333333333333333,0.7777777777777778,80176674,3,1
0,18,0.0,0.0,80150808,18,0
0,4,0.0,0.0,70704270,4,0
0,13,0.1875,0.4,80172596,16,3
1,31,0.3541666666666667,0.828125,70018256,48,17
1,5,0.375,0.6153846153846154,80153542,8,3
0,12,0.14285714285714285,0.4666666666666667,64041600,14,2
0,12,0.07692307692307693,0.4230769230769231,70908404,13,1
0,3,0.0,0.0,75663273,3,0
1,4,0.2,0.6111111111111112,70467670,5,1
2,1,0.5,0.75,66783283,2,1
1,4,0.3333333333333333,0.875,80118132,6,2
1,4,0.42857142857142855,0.8148148148148148,80118508,7,3
2,2,0.7142857142857143,0.3333333333333333,339003,7,5
2,3,0.7857142857142857,0.8333333333333334,70183813,14,11
1,27,0.4,0.9014084507042254,69168435,45,18
2,3,0.5,0.3333333333333333,80052651,6,3
2,1,0.875,0.6666666666666666,80054814,8,7
1,6,0.25,0.625,69575240,8,2
0,4,0.2,0.2857142857142857,82039194,5,1
0,4,0.0,0.0,82039195,4,0
2,0,1.0,1.0,66235876,2,2
0,9,0.18181818181818182,0.36,69416361,11,2
2,0,1.0,1.0,80052385,1,1
0,9,0.18181818181818182,0.1935483870967742,68999861,11,2
2,7,0.5625,0.95,80163136,16,9
0,16,0.058823529411764705,0.05454545454545454,75148255,17,1
0,3,0.0,0.0,68760174,3,0
0,21,0.045454545454545456,0.13846153846153847,80124170,22,1
0,30,0.16666666666666666,0.3472222222222222,69160511,36,6
2,5,0.75,0.8,72834251,20,15
2,1,0.5,0.875,80126443,2,1
2,1,0.5,0.8571428571428571,70238714,2,1
1,2,0.3333333333333333,0.7857142857142857,82202299,3,1
0,10,0.0,0.0,70705460,10,0
0,1,0.0,0.0,73295684,1,0
2,1,0.75,0.5,74363345,4,3
0,7,0.4166666666666667,0.3333333333333333,80178933,12,5
0,13,0.13333333333333333,0.18421052631578946,80137559,15,2
0,9,0.0,0.0,70693350,9,0
1,6,0.3333333333333333,0.5714285714285714,18066482,9,3
1,16,0.2727272727272727,0.6557377049180327,70207130,22,6
0,1,0.0,0.0,72175810,1,0
1,13,0.2777777777777778,0.7692307692307693,64048733,18,5
2,1,0.5,0.8,82121116,2,1
0,3,0.0,0.0,63279552,3,0
1,2,0.3333333333333333,0.6666666666666666,70405692,3,1
1,15,0.4642857142857143,0.8947368421052632,67456515,28,13
0,11,0.21428571428571427,0.3333333333333333,69167511,14,3
2,5,0.6153846153846154,0.9047619047619048,68357765,13,8
2,5,0.7222222222222222,0.8888888888888888,66228680,18,13
1,11,0.08333333333333333,0.7142857142857143,67715270,12,1
0,24,0.0,0.0,67715676,24,0
1,2,0.3333333333333333,0.8823529411764706,70198233,3,1
2,0,1.0,1.0,69499864,1,1
1,8,0.4666666666666667,0.75,67813753,15,7
1,13,0.43478260869565216,0.8571428571428571,80128518,23,10
1,13,0.2777777777777778,0.6842105263157895,70675871,18,5
2,8,0.5789473684210527,0.6666666666666666,75265071,19,11
2,3,0.75,0.8333333333333334,69691573,12,9
1,7,0.3,0.6428571428571429,80165889,10,3
0,3,0.25,0.2857142857142857,71689534,4,1
0,17,0.0,0.0,63239792,17,0
0,7,0.3,0.4583333333333333,82023573,10,3
1,18,0.4,0.7931034482758621,80153655,30,12
2,0,1.0,1.0,68393353,11,11
1,6,0.45454545454545453,0.8275862068965517,80145723,11,5
1,5,0.375,0.8421052631578947,69404594,8,3
2,0,1.0,1.0,66228540,2,2
1,10,0.4117647058823529,0.7391304347826086,72802800,17,7
2,1,0.6666666666666666,0.9,73161585,3,2
1,4,0.3333333333333333,0.7777777777777778,70705355,6,2
1,3,0.4,0.625,62046915,5,2
2,4,0.7142857142857143,0.9565217391304348,64935052,14,10
0,11,0.3125,0.4827586206896552,72846830,16,5
2,1,0.5,0.6666666666666666,69164284,2,1
1,16,0.36,0.85,70013223,25,9
0,11,0.3125,0.2608695652173913,69055630,16,5
0,4,0.0,0.0,70210455,4,0
2,5,0.5,0.4,69886530,10,5
2,3,0.8333333333333334,0.8571428571428571,80134734,18,15
2,9,0.5,0.9333333333333333,82264934,18,9
1,2,0.3333333333333333,0.8571428571428571,70230076,3,1
2,0,1.0,1.0,69469554,4,4
2,3,0.7272727272727273,0.8571428571428571,82126589,11,8
1,14,0.391304347826087,0.8913043478260869,80158077,23,9
1,24,0.3684210526315789,0.8032786885245902,68400822,38,14
0,7,0.0,0.0,80126974,7,0
0,17,0.05555555555555555,0.0,69667353,18,1
2,1,0.5,0.8,70711186,2,1
1,8,0.2,0.696969696969697,70629755,10,2
1,9,0.3076923076923077,0.6666666666666666,66064502,13,4
1,6,0.4,0.9230769230769231,68036220,10,4
1,9,0.25,0.5853658536585366,73421453,12,3
1,10,0.4444444444444444,0.9,69622455,18,8
0,8,0.2,0.39285714285714285,67401656,10,2
2,0,1.0,1.0,72804214,2,2
2,0,1.0,1.0,66238004,1,1
1,4,0.3333333333333333,0.7307692307692307,80132799,6,2
0,1,0.0,0.0,80118310,1,0
0,3,0.0,0.0,82019937,3,0
2,3,0.5714285714285714,0.75,80093342,7,4
2,13,0.5,0.5555555555555556,69025173,26,13
0,3,0.4,0.2,80145891,5,2
0,4,0.3333333333333333,0.38095238095238093,69489434,6,2
1,2,0.3333333333333333,0.5833333333333334,70470113,3,1
1,3,0.25,0.6,70223594,4,1
0,13,0.07142857142857142,0.05128205128205128,70224364,14,1
0,1,0.0,0.0,82024230,1,0
1,3,0.4,0.8571428571428571,69069896,5,2
2,11,0.5,0.7222222222222222,82109935,22,11
1,28,0.44,0.896,72801456,50,22
2,2,0.5,0.9,69681066,4,2
0,1,0.0,0.0,62958672,1,0
0,1,0.0,0.0,73624005,1,0
2,2,0.5,0.8571428571428571,80163443,4,2
0,12,0.0,0.0,70941640,12,0
0,6,0.3333333333333333,0.3,79354604,9,3
0,3,0.0,0.0,70676235,3,0
1,3,0.25,0.5,69485486,4,1
2,3,0.5714285714285714,0.8888888888888888,72417814,7,4
1,4,0.3333333333333333,0.6666666666666666,68416950,6,2
0,15,0.0,0.0,67049430,15,0
2,0,1.0,1.0,66460793,3,3
1,3,0.25,0.625,69693624,4,1
0,2,0.0,0.0,68784051,2,0
2,2,0.6666666666666666,0.6666666666666666,69153924,6,4
1,11,0.26666666666666666,0.5510204081632653,82126624,15,4
2,2,0.7142857142857143,0.8,66061282,7,5
1,5,0.16666666666666666,0.8333333333333334,80122850,6,1
0,4,0.0,0.0,80122892,4,0
0,1,0.0,0.0,80123395,1,0
2,6,0.5384615384615384,0.9285714285714286,80159830,13,7
2,4,0.5,0.5714285714285714,69172593,8,4
0,14,0.125,0.3103448275862069,67190060,16,2
2,6,0.5,0.9090909090909091,68401585,12,6
0,15,0.21052631578947367,0.16666666666666666,82095514,19,4
2,1,0.6666666666666666,0.6,80165361,3,2
2,1,0.5,0.5,68561605,2,1
1,7,0.2222222222222222,0.65,67435256,9,2
2,5,0.5454545454545454,0.95,72801400,11,6
2,1,0.75,0.8888888888888888,70325143,4,3
2,1,0.5,0.8333333333333334,70843780,2,1
2,2,0.6666666666666666,0.6666666666666666,63470050,6,4
0,14,0.17647058823529413,0.1951219512195122,69180412,17,3
2,0,1.0,1.0,80093426,1,1
2,3,0.75,0.8333333333333334,70573790,12,9
0,1,0.0,0.0,82003460,1,0
2,4,0.5,0.75,70844942,8,4
0,28,0.28205128205128205,0.4,82041834,39,11
2,0,1.0,1.0,69734070,2,2
2,4,0.8787878787878788,0.8181818181818182,70173971,33,29
2,6,0.6842105263157895,0.9166666666666666,80127528,19,13
2,0,1.0,1.0,70747264,1,1
0,5,0.0,0.0,66164455,5,0
0,12,0.29411764705882354,0.4838709677419355,79838815,17,5
0,25,0.21875,0.27906976744186046,70658434,32,7
2,0,1.0,1.0,69547912,1,1
1,13,0.35,0.76,70629111,20,7
1,5,0.16666666666666666,0.6538461538461539,71761746,6,1
2,9,0.5,0.5714285714285714,69573336,18,9
2,1,0.9090909090909091,0.6666666666666666,80159552,11,10
0,3,0.0,0.0,80150359,3,0
2,2,0.6,0.6,82018697,5,3
0,11,0.08333333333333333,0.038461538461538464,65546964,12,1
1,24,0.35135135135135137,0.7164179104477612,80125549,37,13
1,11,0.3888888888888889,0.6666666666666666,69579496,18,7
0,2,0.0,0.0,67824232,2,0
0,1,0.0,0.0,70408142,1,0
2,0,1.0,1.0,63632786,6,6
1,14,0.3333333333333333,0.8235294117647058,80139708,21,7
0,3,0.25,0.25,69543264,4,1
2,0,1.0,1.0,66236646,1,1
0,30,0.0625,0.1267605633802817,70209790,32,2
1,10,0.3333333333333333,0.7894736842105263,70751121,15,5
0,11,0.0,0.0,70675682,11,0
0,22,0.08333333333333333,0.313953488372093,80124268,24,2
0,10,0.0,0.0,80124288,10,0
0,6,0.0,0.0,80124359,6,0
2,0,1.0,1.0,66228694,2,2
0,1,0.0,0.0,69603744,1,0
1,2,0.3333333333333333,0.8,69693526,3,1
0,8,0.0,0.0,69700582,8,0
2,0,1.0,1.0,70347991,1,1
0,40,0.1111111111111111,0.358974358974359,70908740,45,5
1,3,0.25,0.8,70818335,4,1
1,24,0.1724137931034483,0.7435897435897436,80138907,29,5
1,21,0.3225806451612903,0.8295454545454546,73650654,31,10
0,4,0.2,0.41379310344827586,73650696,5,1
0,8,0.0,0.0,80150687,8,0
0,9,0.0,0.0,80150698,9,0
0,10,0.0,0.0,64389500,10,0
1,7,0.3,0.84,82118241,10,3
1,21,0.27586206896551724,0.8809523809523809,70059570,29,8
0,1,0.0,0.0,71619520,1,0
0,6,0.0,0.0,80167289,6,0
1,21,0.34375,0.6571428571428571,82001459,32,11
2,0,1.0,1.0,65176216,6,6
1,3,0.25,0.5,70037156,4,1
0,21,0.0,0.0,70467271,21,0
1,7,0.2222222222222222,0.7692307692307693,80089324,9,2
0,7,0.0,0.0,82102931,7,0
0,2,0.0,0.0,82046318,2,0
0,19,0.05,0.3333333333333333,66025281,20,1
1,2,0.3333333333333333,0.5714285714285714,70818265,3,1
1,5,0.375,0.8,66595361,8,3
1,2,0.3333333333333333,0.5714285714285714,67917500,3,1
1,9,0.35714285714285715,0.6388888888888888,69069910,14,5
2,1,0.5,0.75,70621740,2,1
0,42,0.023255813953488372,0.104,67051404,43,1
0,32,0.13513513513513514,0.4,71619212,37,5
0,4,0.2,0.42105263157894735,80135276,5,1
0,6,0.14285714285714285,0.3548387096774194,82102541,7,1
1,11,0.47619047619047616,0.9310344827586207,82053044,21,10
0,18,0.0,0.0,70463344,18,0
1,11,0.21428571428571427,0.7692307692307693,70343574,14,3
1,8,0.2,0.6896551724137931,80150848,10,2
0,8,0.1111111111111111,0.3333333333333333,82118259,9,1
0,37,0.02631578947368421,0.1,67122314,38,1
1,27,0.12903225806451613,0.5116279069767442,69912234,31,4
2,2,0.8181818181818182,0.6666666666666666,70855260,11,9
2,0,1.0,1.0,63767725,2,2
0,2,0.0,0.0,70748601,2,0
2,0,1.0,1.0,80162574,9,9
0,3,0.0,0.0,73296076,3,0
2,0,1.0,1.0,57167642,10,10
2,2,0.6,0.6666666666666666,76941634,5,3
1,4,0.2,0.6190476190476191,66813635,5,1
0,10,0.0,0.0,67703566,10,0
0,10,0.0,0.0,67703601,10,0
1,3,0.25,0.7272727272727273,69417124,4,1
1,6,0.25,0.7619047619047619,80053743,8,2
0,15,0.0,0.0,70686224,15,0
0,5,0.0,0.0,67690602,5,0
2,0,1.0,1.0,82038270,4,4
0,32,0.058823529411764705,0.037037037037037035,68784933,34,2
1,2,0.3333333333333333,0.7857142857142857,69909644,3,1
0,6,0.14285714285714285,0.18181818181818182,69061825,7,1
0,4,0.0,0.0,69946870,4,0
1,16,0.1111111111111111,0.5671641791044776,69965084,18,2
0,9,0.0,0.0,69965105,9,0
0,4,0.0,0.0,70746620,4,0
0,1,0.0,0.0,69575345,1,0
0,19,0.0,0.0,80122879,19,0
0,7,0.125,0.45454545454545453,70704382,8,1
0,6,0.0,0.0,72909872,6,0
2,0,1.0,1.0,82070170,1,1
0,6,0.0,0.0,69117223,6,0
2,2,0.5,0.7777777777777778,82139992,4,2
2,0,1.0,1.0,66379061,1,1
1,13,0.3157894736842105,0.6538461538461539,65279375,19,6
2,1,0.5,0.5,80114790,2,1
1,7,0.46153846153846156,0.84,80176687,13,6
2,2,0.5,0.875,69153931,4,2
0,4,0.0,0.0,82102674,4,0
0,3,0.0,0.0,82102768,3,0
1,3,0.25,0.7,82102787,4,1
0,9,0.0,0.0,65400762,9,0
0,6,0.0,0.0,70229411,6,0
1,20,0.42857142857142855,0.7818181818181819,82062258,35,15
0,3,0.0,0.0,68498290,3,0
0,11,0.0,0.0,68498451,11,0
1,22,0.21428571428571427,0.6904761904761905,78507422,28,6
0,1,0.0,0.0,67822804,1,0
1,17,0.32,0.6222222222222222,72759512,25,8
2,1,0.75,0.9375,82018704,4,3
0,31,0.03125,0.08461538461538462,69895553,32,1
0,5,0.0,0.0,78763083,5,0
1,11,0.3125,0.8064516129032258,64251901,16,5
1,3,0.25,0.6666666666666666,70183456,4,1
1,6,0.25,0.5128205128205128,82010287,8,2
1,5,0.375,0.8571428571428571,80125955,8,3
2,4,0.5,0.9230769230769231,69961073,8,4
0,5,0.16666666666666666,0.3,19489246,6,1
0,7,0.125,0.375,70678405,8,1
0,3,0.0,0.0,70705061,3,0
0,20,0.13043478260869565,0.15730337078651685,67553101,23,3
2,3,0.7,0.5,82045538,10,7
1,17,0.32,0.6341463414634146,69583010,25,8
2,2,0.5,0.6,70843710,4,2
0,16,0.1111111111111111,0.2,515515,18,2
0,10,0.0,0.0,70691614,10,0
0,5,0.0,0.0,70696773,5,0
2,0,1.0,1.0,68344633,1,1
2,5,0.8,0.6666666666666666,65430533,25,20
2,1,0.5,0.5,70488040,2,1
0,2,0.0,0.0,70676053,2,0
0,6,0.14285714285714285,0.32142857142857145,70677796,7,1
0,6,0.14285714285714285,0.3076923076923077,70174153,7,1
2,1,0.8,0.5,79816583,5,4
1,7,0.2222222222222222,0.6285714285714286,70704186,9,2
1,16,0.30434782608695654,0.5,80139714,23,7
0,6,0.0,0.0,70675003,6,0
1,6,0.3333333333333333,0.5333333333333333,82009371,9,3
1,8,0.2727272727272727,0.8181818181818182,73400586,11,3
0,6,0.0,0.0,82022544,6,0
1,7,0.4166666666666667,0.9285714285714286,69597661,12,5
0,5,0.0,0.0,68607014,5,0
0,1,0.0,0.0,69635104,1,0
2,1,0.6666666666666666,0.6666666666666666,73870342,3,2
1,6,0.45454545454545453,0.9090909090909091,66035193,11,5
1,2,0.3333333333333333,0.75,82024296,3,1
0,1,0.0,0.0,65941792,1,0
2,1,0.5,0.75,70565166,2,1
2,3,0.7,0.9090909090909091,69021645,10,7
1,5,0.375,0.5,69021715,8,3
0,2,0.0,0.0,75149466,2,0
0,1,0.0,0.0,80145785,1,0
2,3,0.7692307692307693,0.6666666666666666,62809103,13,10
2,9,0.55,0.96875,78013712,20,11
0,4,0.0,0.0,82164470,4,0
0,3,0.0,0.0,75813934,3,0
0,11,0.26666666666666666,0.4878048780487805,80105116,15,4
0,8,0.3333333333333333,0.4444444444444444,82142126,12,4
2,0,1.0,1.0,69027056,7,7
1,3,0.25,0.6875,69158152,4,1
1,3,0.25,0.625,70229600,4,1
0,8,0.2,0.3684210526315789,79218902,10,2
1,4,0.42857142857142855,0.8846153846153846,70746270,7,3
2,13,0.5517241379310345,0.8181818181818182,80118365,29,16
2,6,0.7692307692307693,0.9090909090909091,80149483,26,20
2,0,1.0,1.0,80177744,1,1
2,4,0.6923076923076923,0.95,80149515,13,9
2,0,1.0,1.0,82102164,2,2
2,1,0.5,0.0,67744355,2,1
2,0,1.0,1.0,82046085,1,1
2,0,1.0,1.0,62404132,4,4
1,6,0.4,0.6,67910360,10,4
2,0,1.0,1.0,68298860,9,9
2,0,1.0,1.0,70350581,7,7
1,7,0.2222222222222222,0.5,71510194,9,2
2,20,0.6363636363636364,0.8771929824561403,72433473,55,35
2,2,0.9130434782608695,0.75,80054646,23,21
1,6,0.3333333333333333,0.5652173913043478,19190892,9,3
2,0,1.0,1.0,80159672,9,9
2,1,0.75,0.5,70751170,4,3
2,5,0.7727272727272727,0.8571428571428571,82041322,22,17
2,1,0.8888888888888888,0.75,82062242,9,8
0,10,0.4444444444444444,0.46153846153846156,70583275,18,8
1,5,0.2857142857142857,0.8333333333333334,65826894,7,2
2,5,0.5,0.6666666666666666,68163102,10,5
2,3,0.625,0.6666666666666666,70687624,8,5
2,0,1.0,1.0,82095297,1,1
2,0,1.0,1.0,82038275,1,1
2,0,1.0,1.0,82154365,1,1
2,1,0.6666666666666666,0.5,80178954,3,2
2,2,0.5,0.9166666666666666,70320355,4,2
2,0,1.0,1.0,74316403,2,2
2,1,0.9583333333333334,0.5,80126586,24,23
2,0,1.0,1.0,68748015,1,1
2,0,1.0,1.0,74363373,12,12
2,0,1.0,1.0,82041292,5,5
0,11,0.08333333333333333,0.20930232558139536,70694652,12,1
0,2,0.0,0.0,70698033,2,0
0,26,0.10344827586206896,0.16666666666666666,61545043,29,3
2,3,0.6666666666666666,0.6666666666666666,66382281,9,6
0,15,0.16666666666666666,0.21212121212121213,64976205,18,3
0,15,0.16666666666666666,0.36065573770491804,69117265,18,3
0,8,0.2,0.4666666666666667,72293802,10,2
1,2,0.3333333333333333,0.6,69138601,3,1
0,2,0.0,0.0,69138615,2,0
0,1,0.0,0.0,69138636,1,0
2,2,0.5,0.6666666666666666,71230103,4,2
2,2,0.5,0.0,72410954,4,2
2,3,0.5,0.2,82041904,6,3
2,0,1.0,1.0,80137615,5,5
2,5,0.5,0.8181818181818182,80136775,10,5
0,18,0.05263157894736842,0.2571428571428571,70918176,19,1
0,11,0.21428571428571427,0.4827586206896552,63991494,14,3
2,3,0.625,0.9545454545454546,70908131,8,5
0,24,0.0,0.0,69525596,24,0
0,7,0.125,0.1111111111111111,70759906,8,1
1,27,0.37209302325581395,0.7066666666666667,64925735,43,16
2,0,1.0,1.0,70253750,1,1
0,2,0.0,0.0,82102940,2,0
1,45,0.34782608695652173,0.7582417582417582,80180588,69,24
2,1,0.6666666666666666,0.5,69213690,3,2
2,0,1.0,1.0,82019842,3,3
0,14,0.06666666666666667,0.2127659574468085,70677460,15,1
2,0,1.0,1.0,67812556,11,11
0,4,0.0,0.0,69997634,4,0
0,4,0.0,0.0,70677663,4,0
0,7,0.0,0.0,70238483,7,0
1,3,0.4,0.6904761904761905,69967184,5,2
1,28,0.28205128205128205,0.569620253164557,71458681,39,11
0,9,0.0,0.0,60877754,9,0
2,2,0.5,0.75,80118373,4,2
0,25,0.038461538461538464,0.14705882352941177,80124346,26,1
1,2,0.3333333333333333,0.8888888888888888,72801624,3,1
1,5,0.375,0.8571428571428571,73460002,8,3
2,1,0.5,0.5,64166270,2,1
1,21,0.25,0.6702127659574468,80132275,28,7
2,4,0.5555555555555556,0.6666666666666666,70713174,9,5
1,3,0.4,0.6666666666666666,69483946,5,2
0,1,0.0,0.0,65915185,1,0
1,20,0.3548387096774194,0.7536231884057971,80067274,31,11
2,0,1.0,1.0,80083486,8,8
1,4,0.2,0.5714285714285714,70467761,5,1
0,14,0.0,0.0,82134979,14,0
0,71,0.12345679012345678,0.44081632653061226,82103886,81,10
1,15,0.2857142857142857,0.8064516129032258,70661290,21,6
2,1,0.5,0.5,82102236,2,1
1,8,0.2727272727272727,0.5263157894736842,80122915,11,3
2,2,0.7142857142857143,0.6666666666666666,80118265,7,5
0,2,0.3333333333333333,0.25,64950305,3,1
2,4,0.5,0.8947368421052632,69591375,8,4
0,7,0.2222222222222222,0.2857142857142857,80163498,9,2
0,3,0.0,0.0,80165163,3,0
1,4,0.2,0.5384615384615384,70703703,5,1
1,9,0.3076923076923077,0.5757575757575758,80067554,13,4
0,5,0.16666666666666666,0.25,70598192,6,1
2,1,0.6666666666666666,0.6666666666666666,67620826,3,2
2,3,0.8,0.8333333333333334,82061198,15,12
2,1,0.5,0.5,67786040,2,1
0,1,0.0,0.0,67786341,1,0
0,13,0.23529411764705882,0.3888888888888889,82204385,17,4
0,5,0.16666666666666666,0.15384615384615385,74770836,6,1
1,8,0.3333333333333333,0.75,69997585,12,4
1,14,0.2222222222222222,0.7714285714285715,69693211,18,4
2,4,0.6923076923076923,0.9333333333333333,67910465,13,9
0,4,0.0,0.0,67434843,4,0
0,8,0.0,0.0,66031693,8,0
2,5,0.5,0.8888888888888888,82005343,10,5
2,0,1.0,1.0,80153699,1,1
1,6,0.14285714285714285,0.6333333333333333,69006553,7,1
0,7,0.0,0.0,69007106,7,0
0,6,0.14285714285714285,0.3888888888888889,70675696,7,1
2,3,0.5714285714285714,0.8888888888888888,69630064,7,4
1,8,0.2727272727272727,0.5666666666666667,68499795,11,3
0,20,0.09090909090909091,0.08,69726342,22,2
0,13,0.0,0.0,67846261,13,0
0,6,0.14285714285714285,0.45454545454545453,70516663,7,1
0,2,0.0,0.0,82070152,2,0
1,5,0.16666666666666666,0.5238095238095238,69479200,6,1
0,7,0.125,0.0,80132404,8,1
0,3,0.0,0.0,70843864,3,0
2,0,1.0,1.0,82185019,1,1
0,7,0.0,0.0,70251062,7,0
2,0,1.0,1.0,68199656,8,8
0,2,0.0,0.0,70742882,2,0
0,1,0.0,0.0,69390153,1,0
0,5,0.16666666666666666,0.36,69498646,6,1
1,3,0.4,0.6666666666666666,69212780,5,2
1,2,0.3333333333333333,0.5,70682010,3,1
2,3,0.625,0.8,73652173,8,5
2,1,0.6666666666666666,0.75,65758035,3,2
2,1,0.5,0.5,82105399,2,1
2,0,1.0,1.0,68189632,3,3
1,7,0.3,0.625,80159893,10,3
0,1,0.0,0.0,68373746,1,0
0,20,0.047619047619047616,0.13333333333333333,82022520,21,1
0,3,0.0,0.0,82024313,3,0
1,7,0.2222222222222222,0.6666666666666666,72546320,9,2
2,1,0.5,0.8,82024312,2,1
0,3,0.0,0.0,79791201,3,0
2,5,0.5833333333333334,0.0,82020079,12,7
2,2,0.7142857142857143,0.5,82020081,7,5
0,11,0.08333333333333333,0.25757575757575757,70568351,12,1
0,1,0.0,0.0,70848351,1,0
2,5,0.6875,0.8888888888888888,70926373,16,11
0,6,0.0,0.0,80083444,6,0
2,0,1.0,1.0,82013588,4,4
2,2,0.875,0.6666666666666666,62589800,16,14
1,2,0.3333333333333333,0.7777777777777778,65939482,3,1
0,14,0.06666666666666667,0.3064516129032258,70704214,15,1
1,11,0.3888888888888889,0.76,67130945,18,7
2,4,0.5555555555555556,0.6,69315862,9,5
1,9,0.3076923076923077,0.5769230769230769,81965681,13,4
0,16,0.1111111111111111,0.034482758620689655,65286123,18,2
1,19,0.17391304347826086,0.5,70629895,23,4
2,1,0.8333333333333334,0.6666666666666666,73161452,6,5
2,0,1.0,1.0,70745122,2,2
1,8,0.2727272727272727,0.8771929824561403,71341774,11,3
0,10,0.09090909090909091,0.3076923076923077,72808575,11,1
2,2,0.6,0.9230769230769231,80141328,5,3
2,4,0.6,0.8,68402054,10,6
0,2,0.0,0.0,69478514,2,0
0,4,0.0,0.0,69478584,4,0
1,4,0.2,0.6842105263157895,75147520,5,1
1,25,0.2647058823529412,0.8181818181818182,80149458,34,9
2,5,0.5833333333333334,0.875,68119625,12,7
1,4,0.42857142857142855,0.9333333333333333,82201359,7,3
0,17,0.22727272727272727,0.2702702702702703,80062395,22,5
1,20,0.4117647058823529,0.8679245283018868,80175642,34,14
2,3,0.625,0.9090909090909091,69483421,8,5
2,3,0.75,0.8571428571428571,82167955,12,9
1,3,0.4,0.9230769230769231,80150242,5,2
0,2,0.0,0.0,79783725,2,0
1,4,0.42857142857142855,0.8947368421052632,72801792,7,3
0,6,0.0,0.0,80150336,6,0
0,8,0.1111111111111111,0.1,66539816,9,1
0,7,0.0,0.0,69977915,7,0
0,2,0.0,0.0,78507492,2,0
2,13,0.5,0.8823529411764706,65281293,26,13
1,4,0.3333333333333333,0.5,67993702,6,2
0,13,0.0,0.0,69417544,13,0
0,5,0.16666666666666666,0.1,80145440,6,1
0,4,0.0,0.0,70675962,4,0
0,14,0.0,0.0,70694106,14,0
0,6,0.0,0.0,70699321,6,0
2,2,0.8666666666666667,0.25,69666863,15,13
2,3,0.625,0.8571428571428571,66904236,8,5
0,2,0.0,0.0,68757192,2,0
2,0,1.0,1.0,70595854,1,1
0,10,0.0,0.0,70941472,10,0
1,13,0.13333333333333333,0.5357142857142857,67094545,15,2
0,5,0.0,0.0,68522062,5,0
0,3,0.0,0.0,69967681,3,0
0,7,0.2222222222222222,0.3783783783783784,80133804,9,2
0,2,0.0,0.0,82019308,2,0
1,20,0.13043478260869565,0.5185185185185185,74924185,23,3
1,16,0.15789473684210525,0.5428571428571428,74924423,19,3
0,4,0.0,0.0,69726335,4,0
0,6,0.0,0.0,70199640,6,0
1,3,0.25,0.5357142857142857,69163206,4,1
2,1,0.9090909090909091,0.5,82021570,11,10
1,7,0.36363636363636365,0.9230769230769231,82126786,11,4
2,1,0.8333333333333334,0.5,61786025,6,5
0,1,0.0,0.0,72332162,1,0
0,1,0.0,0.0,72356900,1,0
0,3,0.0,0.0,69639794,3,0
0,7,0.125,0.0,69596800,8,1
0,10,0.23076923076923078,0.3,80118309,13,3
2,0,1.0,1.0,72802086,3,3
2,2,0.8333333333333334,0.8888888888888888,66257912,12,10
0,5,0.0,0.0,82024278,5,0
0,11,0.0,0.0,67379732,11,0
1,6,0.25,0.6666666666666666,67844504,8,2
1,10,0.4117647058823529,0.9,69693442,17,7
2,3,0.5714285714285714,0.6,80125956,7,4
0,3,0.0,0.0,67836384,3,0
1,9,0.4,0.8333333333333334,82096286,15,6
0,5,0.2857142857142857,0.4166666666666667,67993604,7,2
0,1,0.0,0.0,82182758,1,0
2,0,1.0,1.0,82039341,2,2
2,1,0.875,0.75,67042843,8,7
0,4,0.0,0.0,82050078,4,0
1,2,0.3333333333333333,0.5,67818352,3,1
1,3,0.25,0.75,70703556,4,1
0,8,0.1111111111111111,0.2903225806451613,68908175,9,1
1,3,0.25,0.6521739130434783,69020910,4,1
0,5,0.0,0.0,70238322,5,0
0,8,0.1111111111111111,0.4426229508196721,70238434,9,1
0,4,0.3333333333333333,0.4,80118283,6,2
2,5,0.6153846153846154,0.9,70045710,13,8
2,0,1.0,1.0,73103135,1,1
2,10,0.7435897435897436,0.9696969696969697,80128778,39,29
1,2,0.3333333333333333,0.6666666666666666,69701051,3,1
0,5,0.0,0.0,69701324,5,0
0,1,0.0,0.0,69701863,1,0
0,11,0.26666666666666666,0.45454545454545453,82172728,15,4
2,0,1.0,1.0,54412421,4,4
1,6,0.45454545454545453,0.9565217391304348,68273394,11,5
0,15,0.11764705882352941,0.1724137931034483,72809156,17,2
1,3,0.25,0.6,80134730,4,1
2,1,0.75,0.5,80176264,4,3
0,2,0.0,0.0,82024269,2,0
0,3,0.0,0.0,80177530,3,0
2,0,1.0,1.0,82036937,2,2
0,16,0.2,0.2978723404255319,65278864,20,4
0,2,0.0,0.0,70679301,2,0
0,8,0.1111111111111111,0.36,82102587,9,1
0,4,0.0,0.0,82102942,4,0
0,5,0.0,0.0,82102943,5,0
1,4,0.2,0.5,82102799,5,1
0,5,0.0,0.0,82110029,5,0
0,37,0.17777777777777778,0.35625,68190311,45,8
0,4,0.0,0.0,62841716,4,0
0,4,0.0,0.0,80019142,4,0
1,6,0.14285714285714285,0.6111111111111112,82019473,7,1
0,4,0.0,0.0,82022534,4,0
0,2,0.0,0.0,70706293,2,0
0,2,0.0,0.0,68192502,2,0
2,0,1.0,1.0,69212710,1,1
0,1,0.0,0.0,70514164,1,0
1,3,0.25,0.6,70459326,4,1
2,4,0.6666666666666666,0.9230769230769231,70821023,12,8
2,0,1.0,1.0,82041538,3,3
2,4,0.5,0.9722222222222222,80164930,8,4
1,10,0.3333333333333333,0.5737704918032787,75974150,15,5
0,1,0.0,0.0,80084004,1,0
0,4,0.2,0.35294117647058826,69549585,5,1
2,4,0.6666666666666666,0.875,80176256,12,8
0,1,0.0,0.0,71764224,1,0
2,1,0.6666666666666666,0.75,72364761,3,2
1,11,0.26666666666666666,0.7605633802816901,71277626,15,4
0,8,0.2,0.36363636363636365,70801710,10,2
0,27,0.12903225806451613,0.16176470588235295,68047546,31,4
0,15,0.16666666666666666,0.047619047619047616,65280033,18,3
0,12,0.07692307692307693,0.0,68350590,13,1
1,8,0.1111111111111111,0.6301369863013698,80150694,9,1
0,12,0.0,0.0,70635523,12,0
0,3,0.0,0.0,80163399,3,0
0,6,0.0,0.0,80165827,6,0
2,1,0.5,0.5,82118270,2,1
2,0,1.0,1.0,70821695,3,3
0,21,0.08695652173913043,0.20224719101123595,70922691,23,2
1,5,0.2857142857142857,0.8181818181818182,80153594,7,2
0,12,0.14285714285714285,0.18181818181818182,74882500,14,2
1,4,0.3333333333333333,0.6363636363636364,70758611,6,2
0,17,0.0,0.0,70629951,17,0
0,10,0.16666666666666666,0.38461538461538464,82018985,12,2
1,5,0.16666666666666666,0.7419354838709677,70917672,6,1
0,2,0.0,0.0,78763153,2,0
1,25,0.21875,0.75,70916986,32,7
0,5,0.0,0.0,80089170,5,0
1,4,0.3333333333333333,0.9666666666666667,80135180,6,2
1,16,0.1111111111111111,0.6229508196721312,70343840,18,2
0,16,0.1111111111111111,0.44329896907216493,70481915,18,2
0,1,0.0,0.0,66804003,1,0
0,8,0.0,0.0,80168240,8,0
1,2,0.3333333333333333,0.8823529411764706,67917325,3,1
0,3,0.0,0.0,66146192,3,0
0,2,0.0,0.0,68607084,2,0
1,4,0.3333333333333333,0.5,80130721,6,2
2,4,0.6,0.8666666666666667,68401284,10,6
0,1,0.0,0.0,70575064,1,0
2,1,0.5,0.5,70575106,2,1
2,0,1.0,1.0,80136690,2,2
0,1,0.0,0.0,66041150,1,0
0,6,0.0,0.0,69034175,6,0
2,0,1.0,1.0,75636064,14,14
0,4,0.2,0.125,65282441,5,1
2,4,0.6,0.9,72874403,10,6
0,5,0.2857142857142857,0.4827586206896552,80132954,7,2
0,4,0.3333333333333333,0.3333333333333333,73800741,6,2
1,3,0.25,0.8,70678342,4,1
1,4,0.42857142857142855,0.6666666666666666,66048500,7,3
0,1,0.0,0.0,66207155,1,0
0,13,0.1875,0.28,65279844,16,3
1,3,0.4,0.75,69621580,5,2
0,2,0.0,0.0,69718544,2,0
0,14,0.17647058823529413,0.2653061224489796,67300072,17,3
0,10,0.0,0.0,69910512,10,0
0,1,0.0,0.0,67982180,1,0
0,1,0.0,0.0,82020007,1,0
2,0,1.0,1.0,74043543,9,9
2,4,0.6,0.8571428571428571,70915341,10,6
0,6,0.14285714285714285,0.25,80124204,7,1
2,1,0.5,0.5,82022360,2,1
2,4,0.6363636363636364,0.9,62744633,11,7
0,12,0.0,0.0,82018930,12,0
0,11,0.0,0.0,82018932,11,0
2,0,1.0,1.0,80165461,1,1
1,6,0.14285714285714285,0.6428571428571429,82090181,7,1
2,3,0.5714285714285714,0.75,61712574,7,4
0,2,0.0,0.0,70933765,2,0
1,7,0.2222222222222222,0.5357142857142857,72392824,9,2
0,5,0.0,0.0,70674730,5,0
0,1,0.0,0.0,70684180,1,0
1,2,0.3333333333333333,0.8181818181818182,82010243,3,1
0,7,0.125,0.045454545454545456,80156013,8,1
0,4,0.0,0.0,76081145,4,0
2,3,0.5714285714285714,0.6666666666666666,70585732,7,4
1,9,0.3076923076923077,0.5263157894736842,68015451,13,4
1,23,0.25806451612903225,0.5303030303030303,69499332,31,8
0,4,0.2,0.15384615384615385,71588216,5,1
1,2,0.3333333333333333,0.8333333333333334,70743540,3,1
2,0,1.0,1.0,67751383,9,9
2,2,0.6666666666666666,0.3333333333333333,66227861,6,4
0,4,0.3333333333333333,0.25,70113561,6,2
2,2,0.6666666666666666,0.8,80117575,6,4
1,8,0.42857142857142855,0.8205128205128205,80117717,14,6
0,2,0.0,0.0,66785831,2,0
2,0,1.0,1.0,66469732,2,2
0,10,0.09090909090909091,0.09090909090909091,67475842,11,1
1,11,0.3888888888888889,0.8529411764705882,82008932,18,7
0,11,0.0,0.0,67846401,11,0
2,0,1.0,1.0,78763706,2,2
1,27,0.2702702702702703,0.734375,73444861,37,10
0,13,0.07142857142857142,0.2413793103448276,63993132,14,1
2,5,0.5,0.9375,80166903,10,5
2,3,0.7,0.8,67823280,10,7
0,30,0.0625,0.029411764705882353,80018435,32,2
1,5,0.4444444444444444,0.6470588235294118,70719124,9,4
1,2,0.3333333333333333,0.9090909090909091,80176805,3,1
1,8,0.1111111111111111,0.5,70675115,9,1
0,13,0.13333333333333333,0.358974358974359,70678013,15,2
2,4,0.5,0.7777777777777778,70493640,8,4
0,8,0.2,0.0,70493780,10,2
2,0,1.0,1.0,82021573,7,7
2,8,0.5555555555555556,0.9615384615384616,69712202,18,10
2,2,0.5,0.5,67070465,4,2
2,5,0.5454545454545454,0.8333333333333334,70078323,11,6
0,9,0.1,0.21428571428571427,82019817,10,1
0,3,0.0,0.0,82019921,3,0
0,3,0.0,0.0,82020033,3,0
2,1,0.5,0.75,63279573,2,1
1,24,0.4,0.9178082191780822,69183541,40,16
0,4,0.0,0.0,69633214,4,0
0,17,0.05555555555555555,0.2823529411764706,80124218,18,1
1,4,0.42857142857142855,0.7692307692307693,66930241,7,3
0,9,0.18181818181818182,0.40625,70854021,11,2
2,0,1.0,1.0,67862494,1,1
2,3,0.5714285714285714,0.75,73508806,7,4
2,0,1.0,1.0,80019485,2,2
2,2,0.7777777777777778,0.0,80181544,9,7
0,16,0.1111111111111111,0.07547169811320754,65282616,18,2
2,1,0.8571428571428571,0.5,66875774,7,6
0,8,0.1111111111111111,0.07692307692307693,82219366,9,1
0,1,0.0,0.0,68211423,1,0
0,10,0.2857142857142857,0.17647058823529413,82165064,14,4
0,6,0.25,0.4444444444444444,70253701,8,2
2,2,0.6666666666666666,0.5,63177611,6,4
0,5,0.2857142857142857,0.25,80118311,7,2
1,13,0.35,0.8,80124772,20,7
0,1,0.0,0.0,82009528,1,0
0,1,0.0,0.0,82009544,1,0
2,3,0.6666666666666666,0.8,68402026,9,6
1,19,0.42424242424242425,0.8648648648648649,66404422,33,14
0,5,0.0,0.0,79854180,5,0
2,4,0.5,0.9333333333333333,80124630,8,4
2,3,0.7,0.5,80137919,10,7
2,0,1.0,1.0,80150409,2,2
1,3,0.25,0.8181818181818182,69603835,4,1
0,5,0.0,0.0,67775246,5,0
2,0,1.0,1.0,80165221,3,3
2,1,0.8,0.5,80055024,5,4
2,5,0.6153846153846154,0.75,82112146,13,8
2,2,0.7142857142857143,0.0,80080161,7,5
2,0,1.0,1.0,80134733,3,3
2,4,0.8095238095238095,0.75,69068944,21,17
2,5,0.5,0.9444444444444444,82032904,10,5
2,2,0.6666666666666666,0.6666666666666666,82051748,6,4
2,0,1.0,1.0,80118126,1,1
1,10,0.2857142857142857,0.6,80180478,14,4
0,1,0.0,0.0,82095214,1,0
0,2,0.0,0.0,82095217,2,0
0,2,0.0,0.0,82095219,2,0
2,1,0.5,0.75,82095299,2,1
0,13,0.23529411764705882,0.3333333333333333,81900763,17,4
2,0,1.0,1.0,80141537,5,5
2,0,1.0,1.0,69229545,3,3
2,1,0.5,0.5,70343882,2,1
2,0,1.0,1.0,70747390,2,2
2,1,0.5,0.5,69976032,2,1
2,0,1.0,1.0,70511665,6,6
2,0,1.0,1.0,70586586,5,5
2,1,0.9,0.5,82054007,10,9
1,8,0.3333333333333333,0.6875,72804655,12,4
1,19,0.4722222222222222,0.9545454545454546,63259392,36,17
0,39,0.1875,0.49295774647887325,70568715,48,9
1,6,0.25,0.6521739130434783,70174720,8,2
0,10,0.23076923076923078,0.21428571428571427,69667745,13,3
0,25,0.0,0.0,69554233,25,0
0,17,0.05555555555555555,0.07317073170731707,70605661,18,1
2,1,0.75,0.6666666666666666,66871553,4,3
2,0,1.0,1.0,66229373,2,2
0,18,0.1,0.02127659574468085,69179740,20,2
0,3,0.0,0.0,69972973,3,0
0,5,0.16666666666666666,0.38461538461538464,69973176,6,1
0,4,0.0,0.0,70199570,4,0
0,15,0.0,0.0,69525561,15,0
0,44,0.15384615384615385,0.39893617021276595,82008942,52,8
1,11,0.26666666666666666,0.5714285714285714,77677033,15,4
0,20,0.047619047619047616,0.192,64240771,21,1
0,20,0.0,0.0,69525533,20,0
0,10,0.09090909090909091,0.1724137931034483,65348612,11,1
2,3,0.625,0.9411764705882353,82059798,8,5
0,5,0.0,0.0,67899510,5,0
0,21,0.19230769230769232,0.3333333333333333,70828471,26,5
0,5,0.2857142857142857,0.0,70925106,7,2
2,5,0.5,0.5,70925120,10,5
2,1,0.5,0.8571428571428571,80153539,2,1
1,11,0.3888888888888889,0.7,69185466,18,7
0,8,0.0,0.0,66782513,8,0
1,5,0.16666666666666666,0.5882352941176471,66787000,6,1
2,5,0.6153846153846154,0.9565217391304348,70966343,13,8
0,1,0.0,0.0,61986225,1,0
0,4,0.2,0.1,73977911,5,1
0,1,0.0,0.0,70718984,1,0
2,5,0.5,0.631578947368421,73870244,10,5
1,15,0.4642857142857143,0.9137931034482759,69191675,28,13
0,1,0.0,0.0,66228981,1,0
2,1,0.5,0.5,66229296,2,1
0,1,0.0,0.0,66229450,1,0
2,1,0.6666666666666666,0.75,66229723,3,2
0,10,0.09090909090909091,0.11764705882352941,60305196,11,1
0,5,0.16666666666666666,0.09090909090909091,67521174,6,1
1,20,0.16666666666666666,0.7058823529411765,70109606,24,4
0,22,0.043478260869565216,0.1,70678286,23,1
0,12,0.2,0.4897959183673469,80126780,15,3
0,1,0.0,0.0,82105401,1,0
2,2,0.6666666666666666,0.2,70408205,6,4
0,5,0.16666666666666666,0.0,80178132,6,1
2,0,1.0,1.0,70716744,2,2
2,3,0.625,0.75,66337845,8,5
0,2,0.0,0.0,70674821,2,0
0,1,0.0,0.0,80122866,1,0
0,1,0.0,0.0,80122916,1,0
2,0,1.0,1.0,80178219,3,3
0,25,0.16666666666666666,0.40963855421686746,64002190,30,5
2,0,1.0,1.0,68649280,1,1
2,2,0.5,0.5,71938615,4,2
2,8,0.5294117647058824,0.9655172413793104,69735470,17,9
1,11,0.35294117647058826,0.6,79879093,17,6
2,4,0.5,0.8,80053610,8,4
0,5,0.16666666666666666,0.14285714285714285,80160445,6,1
0,9,0.0,0.0,80163484,9,0
0,7,0.0,0.0,69416263,7,0
1,8,0.2727272727272727,0.6428571428571429,72546341,11,3
2,7,0.72,0.9166666666666666,80126557,25,18
2,2,0.6,0.5,80091865,5,3
2,2,0.6,0.5,70494354,5,3
2,1,0.8333333333333334,0.6666666666666666,80133901,6,5
1,15,0.4444444444444444,0.8275862068965517,67127753,27,12
2,0,1.0,1.0,77602441,4,4
2,2,0.6,0.9333333333333333,70491036,5,3
1,31,0.1388888888888889,0.5605095541401274,65348906,36,5
0,20,0.09090909090909091,0.21212121212121213,80149814,22,2
1,7,0.2222222222222222,0.7,79787981,9,2
1,6,0.45454545454545453,0.5454545454545454,66228526,11,5
0,1,0.0,0.0,69478934,1,0
1,3,0.4,0.8571428571428571,70633192,5,2
2,1,0.8,0.5,70182945,5,4
2,1,0.75,0.6666666666666666,70250796,4,3
0,3,0.0,0.0,70679315,3,0
2,4,0.6666666666666666,0.5714285714285714,69406750,12,8
2,6,0.625,0.8461538461538461,82154405,16,10
0,17,0.0,0.0,67703636,17,0
1,12,0.14285714285714285,0.782608695652174,67703664,14,2
0,9,0.0,0.0,67703734,9,0
1,9,0.1,0.5652173913043478,67703776,10,1
0,8,0.0,0.0,67703804,8,0
0,10,0.0,0.0,67703895,10,0
0,16,0.0,0.0,67893112,16,0
0,2,0.0,0.0,68255684,2,0
2,4,0.6,0.9,70713650,10,6
0,8,0.2,0.4074074074074074,72775584,10,2
2,1,0.6666666666666666,0.6666666666666666,69061832,3,2
0,1,0.0,0.0,70184065,1,0
0,15,0.0625,0.11940298507462686,69640851,16,1
1,24,0.4666666666666667,0.9178082191780822,80132323,45,21
0,4,0.2,0.0,80145774,5,1
0,2,0.0,0.0,69997676,2,0
2,1,0.5,0.75,69997515,2,1
0,14,0.0,0.0,70684950,14,0
0,1,0.0,0.0,82247814,1,0
1,5,0.375,0.875,69183576,8,3
0,12,0.25,0.4838709677419355,68509553,16,4
0,11,0.0,0.0,72546334,11,0
2,14,0.5,0.9375,80176604,28,14
1,8,0.42857142857142855,0.875,73801280,14,6
1,9,0.35714285714285715,0.5945945945945946,73801294,14,5
2,0,1.0,1.0,69483456,1,1
1,15,0.34782608695652173,0.8448275862068966,80128255,23,8
1,13,0.43478260869565216,0.8431372549019608,80180223,23,10
2,2,0.6666666666666666,0.6666666666666666,78482523,6,4
2,5,0.7222222222222222,0.9090909090909091,79792664,18,13
2,6,0.6842105263157895,0.9090909090909091,66235883,19,13
1,6,0.3333333333333333,0.8823529411764706,70633101,9,3
2,7,0.6666666666666666,0.9565217391304348,71458653,21,14
1,4,0.42857142857142855,0.5,82013504,7,3
1,8,0.3333333333333333,0.5,79146025,12,4
0,16,0.058823529411764705,0.23076923076923078,67889283,17,1
0,12,0.14285714285714285,0.45161290322580644,79453213,14,2
1,2,0.3333333333333333,0.6,57175104,3,1
0,2,0.0,0.0,70677355,2,0
0,13,0.07142857142857142,0.057692307692307696,62653661,14,1
0,5,0.0,0.0,70704795,5,0
0,10,0.23076923076923078,0.25,69621986,13,3
0,10,0.2857142857142857,0.4166666666666667,66604013,14,4
2,0,1.0,1.0,82019874,2,2
0,7,0.0,0.0,69169464,7,0
1,12,0.14285714285714285,0.5915492957746479,66025974,14,2
0,2,0.3333333333333333,0.3333333333333333,65008160,3,1
2,2,0.5,0.9,68785185,4,2
1,10,0.4117647058823529,0.9629629629629629,66892784,17,7
0,6,0.25,0.25,80172934,8,2
2,0,1.0,1.0,82102225,1,1
2,5,0.6428571428571429,0.5,66257646,14,9
2,3,0.625,0.875,80052686,8,5
1,10,0.3333333333333333,0.75,65282756,15,5
1,12,0.4,0.8518518518518519,65281223,20,8
2,0,1.0,1.0,70405993,1,1
2,1,0.6666666666666666,0.5,70189931,3,2
2,2,0.75,0.6666666666666666,70408163,8,6
0,3,0.25,0.46153846153846156,76807451,4,1
2,2,0.9,0.3333333333333333,67699590,20,18
0,2,0.0,0.0,80177435,2,0
0,5,0.16666666666666666,0.3448275862068966,72910040,6,1
2,2,0.5,0.3333333333333333,80128558,4,2
2,1,0.5,0.0,80128856,2,1
2,2,0.8,0.75,79462600,10,8
1,11,0.21428571428571427,0.7931034482758621,60514202,14,3
0,10,0.09090909090909091,0.2727272727272727,70680673,11,1
0,5,0.0,0.0,70691684,5,0
0,11,0.0,0.0,62529761,11,0
0,12,0.2,0.38461538461538464,80135071,15,3
0,24,0.14285714285714285,0.14035087719298245,82053038,28,4
2,9,0.5714285714285714,0.9411764705882353,80175661,21,12
0,7,0.3,0.23529411764705882,80158313,10,3
0,9,0.1,0.25,70679224,10,1
0,2,0.3333333333333333,0.3333333333333333,80094413,3,1
2,1,0.6666666666666666,0.5,73850742,3,2
2,0,1.0,1.0,70648102,8,8
0,6,0.0,0.0,70758646,6,0
0,12,0.0,0.0,82008040,12,0
2,7,0.65,0.7777777777777778,80128555,20,13
0,6,0.0,0.0,70693980,6,0
0,1,0.0,0.0,70701841,1,0
0,3,0.25,0.3333333333333333,70705446,4,1
2,1,0.6666666666666666,0.8571428571428571,80132900,3,2
0,14,0.125,0.17567567567567569,66225180,16,2
1,6,0.4,0.8571428571428571,65812306,10,4
1,6,0.25,0.6666666666666666,78166025,8,2
1,6,0.3333333333333333,0.7647058823529411,82120530,9,3
2,0,1.0,1.0,65860193,4,4
0,13,0.07142857142857142,0.2413793103448276,82022541,14,1
0,6,0.14285714285714285,0.26666666666666666,80069976,7,1
0,1,0.0,0.0,62837782,1,0
0,1,0.0,0.0,69572713,1,0
0,1,0.0,0.0,70197750,1,0
2,6,0.6842105263157895,0.8461538461538461,69575751,19,13
2,0,1.0,1.0,69530972,1,1
1,6,0.45454545454545453,0.7368421052631579,72425591,11,5
2,0,1.0,1.0,65714313,1,1
0,1,0.0,0.0,67821866,1,0
2,1,0.8,0.5,67822111,5,4
0,2,0.0,0.0,65100196,2,0
0,4,0.0,0.0,70829101,4,0
0,12,0.0,0.0,80124365,12,0
0,4,0.0,0.0,63227101,4,0
1,15,0.2857142857142857,0.896551724137931,68399226,21,6
1,7,0.3,0.5714285714285714,70240961,10,3
2,4,0.5,0.8666666666666667,80134738,8,4
2,5,0.5454545454545454,0.9,66856811,11,6
1,7,0.2222222222222222,0.5714285714285714,67922701,9,2
0,1,0.0,0.0,67669063,1,0
0,6,0.0,0.0,82126660,6,0
1,18,0.21739130434782608,0.6470588235294118,71618792,23,5
0,8,0.0,0.0,80128216,8,0
0,10,0.0,0.0,82102585,10,0
2,11,0.5925925925925926,0.8823529411764706,70608986,27,16
0,7,0.0,0.0,73295474,7,0
0,24,0.25,0.4666666666666667,79989504,32,8
2,0,1.0,1.0,69950090,3,3
2,0,1.0,1.0,80093251,1,1
1,3,0.4,0.9411764705882353,70701204,5,2
0,11,0.08333333333333333,0.23529411764705882,80123382,12,1
2,2,0.7142857142857143,0.8,72801414,7,5
0,24,0.0,0.0,68356456,24,0
2,1,0.5,0.8333333333333334,69008450,2,1
2,4,0.8709677419354839,0.9090909090909091,74484102,31,27
0,9,0.18181818181818182,0.2857142857142857,70509523,11,2
1,22,0.42105263157894735,0.660377358490566,65899246,38,16
2,0,1.0,1.0,80159674,4,4
2,0,1.0,1.0,80004365,1,1
2,2,0.6,0.8,69063995,5,3
2,0,1.0,1.0,70522382,1,1
0,10,0.23076923076923078,0.4444444444444444,69724200,13,3
0,7,0.0,0.0,80150576,7,0
0,19,0.05,0.3063063063063063,67887834,20,1
0,2,0.0,0.0,68669041,2,0
2,2,0.6,0.9285714285714286,67084556,5,3
0,5,0.0,0.0,80172543,5,0
0,2,0.0,0.0,82006583,2,0
1,7,0.46153846153846156,0.9545454545454546,80171743,13,6
0,1,0.0,0.0,67917150,1,0
0,13,0.0,0.0,80150507,13,0
2,7,0.631578947368421,0.9333333333333333,80171746,19,12
1,12,0.14285714285714285,0.6716417910447762,69407023,14,2
1,6,0.14285714285714285,0.7317073170731707,78166004,7,1
0,2,0.0,0.0,67917675,2,0
0,19,0.09523809523809523,0.12698412698412698,80153527,21,2
1,9,0.18181818181818182,0.6829268292682927,80153543,11,2
0,13,0.0,0.0,70918330,13,0
0,10,0.0,0.0,70918393,10,0
0,3,0.0,0.0,80162862,3,0
1,2,0.3333333333333333,0.7058823529411765,80162895,3,1
1,5,0.16666666666666666,0.7,82054068,6,1
0,12,0.0,0.0,82118248,12,0
1,4,0.2,0.7407407407407407,70635775,5,1
0,3,0.0,0.0,80131217,3,0
0,1,0.0,0.0,82102496,1,0
2,1,0.5,0.8333333333333334,72801526,2,1
2,1,0.8,0.5,66243142,5,4
0,10,0.09090909090909091,0.4230769230769231,70683403,11,1
0,14,0.06666666666666667,0.038461538461538464,70866733,15,1
2,0,1.0,1.0,80150245,2,2
1,3,0.4,0.7,72555014,5,2
1,7,0.4166666666666667,0.8636363636363636,65290421,12,5
2,1,0.6666666666666666,0.8,65977352,3,2
2,2,0.7777777777777778,0.8888888888888888,80162767,9,7
1,9,0.4,0.6666666666666666,80140257,15,6
0,13,0.13333333333333333,0.4722222222222222,70568582,15,2
0,8,0.1111111111111111,0.05555555555555555,69466320,9,1
1,6,0.45454545454545453,0.972972972972973,82023704,11,5
1,11,0.35294117647058826,0.75,70331373,17,6
2,0,1.0,1.0,80139891,2,2
1,3,0.25,0.8,82096501,4,1
0,2,0.0,0.0,73623480,2,0
0,4,0.0,0.0,70223741,4,0
0,3,0.0,0.0,70223783,3,0
1,3,0.25,0.5555555555555556,74632320,4,1
2,2,0.6,0.8888888888888888,80125460,5,3
0,4,0.0,0.0,67376470,4,0
0,62,0.08823529411764706,0.09195402298850575,67472713,68,6
2,1,0.6666666666666666,0.9166666666666666,69310052,3,2
2,0,1.0,1.0,72802730,11,11
0,11,0.08333333333333333,0.05263157894736842,68784163,12,1
1,13,0.23529411764705882,0.6060606060606061,68785003,17,4
0,11,0.08333333333333333,0.1794871794871795,68497996,12,1
1,5,0.2857142857142857,0.7666666666666667,68785353,7,2
2,1,0.5,0.5,69639773,2,1
2,2,0.5,0.8571428571428571,70681422,4,2
1,3,0.25,0.7272727272727273,80126808,4,1
0,5,0.16666666666666666,0.0,80145442,6,1
0,2,0.0,0.0,70704410,2,0
2,6,0.8,0.9230769230769231,70719712,30,24
0,8,0.0,0.0,80095113,8,0
0,7,0.3,0.4666666666666667,82071321,10,3
0,2,0.0,0.0,70685104,2,0
0,8,0.1111111111111111,0.14285714285714285,69726461,9,1
0,7,0.0,0.0,69726475,7,0
2,1,0.6666666666666666,0.8888888888888888,68060636,3,2
2,2,0.7142857142857143,0.9411764705882353,72411206,7,5
1,3,0.25,0.5714285714285714,74770815,4,1
0,6,0.14285714285714285,0.16666666666666666,70343434,7,1
1,2,0.3333333333333333,0.5,64032283,3,1
0,3,0.0,0.0,82047594,3,0
0,7,0.125,0.325,70489370,8,1
0,1,0.0,0.0,66222380,1,0
1,2,0.3333333333333333,0.7,67985666,3,1
2,1,0.75,0.5,80134735,4,3
2,5,0.5454545454545454,0.9148936170212766,71537585,11,6
2,5,0.5,0.7857142857142857,61440372,10,5
2,1,0.8333333333333334,0.75,80052742,6,5
0,3,0.0,0.0,69163255,3,0
0,19,0.05,0.045454545454545456,67872812,20,1
1,8,0.38461538461538464,0.6428571428571429,70343455,13,5
2,0,1.0,1.0,82049146,1,1
1,10,0.4444444444444444,0.9230769230769231,66855782,18,8
0,1,0.0,0.0,65279886,1,0
2,1,0.5,0.8333333333333334,65579724,2,1
2,10,0.7619047619047619,0.85,80062283,42,32
2,0,1.0,1.0,82024301,2,2
0,1,0.0,0.0,67658395,1,0
1,5,0.375,0.9523809523809523,68784016,8,3
0,4,0.0,0.0,70509173,4,0
0,10,0.0,0.0,70698621,10,0
0,1,0.0,0.0,70702443,1,0
0,10,0.0,0.0,70703843,10,0
2,1,0.5,0.6666666666666666,80137599,2,1
2,3,0.6666666666666666,0.8571428571428571,72393195,9,6
0,11,0.15384615384615385,0.2727272727272727,70184051,13,2
2,1,0.75,0.5,72803311,4,3
0,1,0.0,0.0,72808666,1,0
0,15,0.0,0.0,80124295,15,0
2,3,0.5,0.9,80124366,6,3
2,3,0.5714285714285714,0.5,68405855,7,4
1,19,0.42424242424242425,0.958904109589041,80132303,33,14
2,1,0.6666666666666666,0.8333333333333334,66286605,3,2
2,1,0.8,0.5,82126597,5,4
1,17,0.32,0.6216216216216216,80161487,25,8
0,6,0.14285714285714285,0.13333333333333333,67775295,7,1
1,13,0.35,0.6774193548387096,65007495,20,7
0,5,0.0,0.0,78226204,5,0
2,3,0.625,0.75,69705545,8,5
1,4,0.3333333333333333,0.7692307692307693,72844135,6,2
1,16,0.3333333333333333,0.55,65967895,24,8
0,5,0.2857142857142857,0.391304347826087,80145904,7,2
2,0,1.0,1.0,73551422,5,5
2,1,0.875,0.8,67558911,8,7
1,5,0.375,0.8666666666666667,80163418,8,3
0,5,0.16666666666666666,0.36363636363636365,70921375,6,1
2,12,0.5555555555555556,0.9545454545454546,70854035,27,15
1,5,0.4444444444444444,0.8461538461538461,80163436,9,4
2,0,1.0,1.0,70605794,3,3
2,0,1.0,1.0,80056473,4,4
2,3,0.5,0.8181818181818182,69539106,6,3
0,3,0.0,0.0,69603765,3,0
2,0,1.0,1.0,68084625,1,1
2,0,1.0,1.0,73102372,3,3
2,4,0.6363636363636364,0.9166666666666666,72510291,11,7
1,17,0.32,0.8032786885245902,66892735,25,8
0,2,0.3333333333333333,0.3333333333333333,62375586,3,1
0,15,0.0625,0.0,70812840,16,1
2,3,0.5,0.6666666666666666,73635016,6,3
1,5,0.2857142857142857,0.5625,69514382,7,2
0,8,0.3333333333333333,0.4444444444444444,82052564,12,4
0,5,0.0,0.0,70175301,5,0
2,4,0.5555555555555556,0.875,69064464,9,5
2,3,0.7272727272727273,0.9,80124631,11,8
2,0,1.0,1.0,82042090,2,2
2,2,0.92,0.6666666666666666,82037162,25,23
2,0,1.0,1.0,82037551,3,3
2,1,0.9444444444444444,0.5,75636246,18,17
2,0,1.0,1.0,80159741,3,3
2,0,1.0,1.0,70720881,2,2
2,0,1.0,1.0,69158810,1,1
2,0,1.0,1.0,82052083,1,1
2,0,1.0,1.0,70537551,3,3
2,0,1.0,1.0,80155977,4,4
2,0,1.0,1.0,80162164,2,2
2,9,0.8125,0.2,80126592,48,39
2,3,0.7692307692307693,0.6666666666666666,75347461,13,10
2,0,1.0,1.0,82042088,1,1
2,0,1.0,1.0,82055434,8,8
1,8,0.42857142857142855,0.8181818181818182,65330615,14,6
2,0,1.0,1.0,67248552,1,1
2,5,0.5,0.7692307692307693,79792524,10,5
2,0,1.0,1.0,80159671,1,1
2,0,1.0,1.0,82125494,1,1
2,6,0.6666666666666666,0.95,77909314,18,12
2,5,0.6153846153846154,0.7777777777777778,69394283,13,8
2,1,0.8571428571428571,0.0,82052081,7,6
2,1,0.8571428571428571,0.5,82037165,7,6
2,0,1.0,1.0,82053817,1,1
1,4,0.42857142857142855,0.8235294117647058,66110275,7,3
2,0,1.0,1.0,80090941,6,6
2,0,1.0,1.0,80175657,1,1
2,1,0.5,0.5,80132937,2,1
0,1,0.0,0.0,69110783,1,0
2,1,0.75,0.6666666666666666,65950381,4,3
1,7,0.4166666666666667,0.8809523809523809,70843430,12,5
2,3,0.5714285714285714,0.8571428571428571,80133621,7,4
0,21,0.0,0.0,80150813,21,0
0,2,0.0,0.0,80149846,2,0
0,2,0.0,0.0,67900574,2,0
0,1,0.0,0.0,80119154,1,0
0,15,0.0625,0.36619718309859156,69525624,16,1
2,0,1.0,1.0,74442900,1,1
0,1,0.0,0.0,70248010,1,0
0,2,0.0,0.0,70248052,2,0
1,4,0.2,0.6666666666666666,70610785,5,1
0,17,0.05555555555555555,0.0,80135268,18,1
0,8,0.0,0.0,70199626,8,0
0,4,0.0,0.0,69637792,4,0
0,2,0.0,0.0,69638345,2,0
0,10,0.09090909090909091,0.19230769230769232,69886621,11,1
0,2,0.0,0.0,65974160,2,0
1,7,0.125,0.5454545454545454,64045996,8,1
0,17,0.05555555555555555,0.0,66603992,18,1
2,0,1.0,1.0,70747082,3,3
1,7,0.4166666666666667,0.875,77769573,12,5
0,2,0.0,0.0,81903749,2,0
1,2,0.3333333333333333,0.7333333333333333,80128461,3,1
1,22,0.3333333333333333,0.6440677966101694,82055990,33,11
1,15,0.25,0.5375,72803444,20,5
2,2,0.5,0.8,82137406,4,2
2,0,1.0,1.0,68287352,2,2
1,9,0.47058823529411764,0.5,69170535,17,8
1,4,0.2,0.5,60877621,5,1
0,8,0.0,0.0,69633256,8,0
2,3,0.5,0.8571428571428571,70855792,6,3
1,9,0.35714285714285715,0.8985507246376812,71277563,14,5
2,0,1.0,1.0,63154630,1,1
0,1,0.0,0.0,75338242,1,0
2,2,0.5,0.9090909090909091,82206151,4,2
1,2,0.3333333333333333,0.8,68154842,3,1
0,4,0.0,0.0,70488901,4,0
0,14,0.2222222222222222,0.4722222222222222,68402740,18,4
0,13,0.13333333333333333,0.3557692307692308,70844025,15,2
2,2,0.6,0.75,82018998,5,3
0,14,0.06666666666666667,0.07142857142857142,501151,15,1
1,10,0.3333333333333333,0.9259259259259259,65290015,15,5
1,17,0.19047619047619047,0.7532467532467533,69151964,21,4
2,4,0.6,0.8181818181818182,67598783,10,6
0,2,0.0,0.0,78735510,2,0
0,1,0.0,0.0,69954626,1,0
0,1,0.0,0.0,70332311,1,0
0,1,0.0,0.0,70332325,1,0
0,1,0.0,0.0,70332381,1,0
0,1,0.0,0.0,70332416,1,0
0,1,0.0,0.0,70332423,1,0
0,1,0.0,0.0,70332451,1,0
0,1,0.0,0.0,70332612,1,0
0,1,0.0,0.0,70332654,1,0
0,1,0.0,0.0,70332696,1,0
0,1,0.0,0.0,70332724,1,0
0,1,0.0,0.0,70332766,1,0
0,1,0.0,0.0,70332773,1,0
0,1,0.0,0.0,70332864,1,0
0,1,0.0,0.0,70332906,1,0
0,1,0.0,0.0,70332962,1,0
0,1,0.0,0.0,70333011,1,0
0,1,0.0,0.0,70333032,1,0
0,1,0.0,0.0,70333102,1,0
0,1,0.0,0.0,70333144,1,0
0,1,0.0,0.0,70333165,1,0
0,1,0.0,0.0,70333200,1,0
0,1,0.0,0.0,70333221,1,0
0,1,0.0,0.0,70333242,1,0
0,1,0.0,0.0,70333263,1,0
0,1,0.0,0.0,70333333,1,0
0,1,0.0,0.0,70333340,1,0
0,1,0.0,0.0,70333375,1,0
0,1,0.0,0.0,70333382,1,0
0,1,0.0,0.0,70333480,1,0
0,1,0.0,0.0,70333494,1,0
0,1,0.0,0.0,70333690,1,0
0,1,0.0,0.0,70333725,1,0
0,1,0.0,0.0,70333802,1,0
2,18,0.7313432835820896,0.9791666666666666,73415916,67,49
0,2,0.3333333333333333,0.0,72802464,3,1
2,2,0.5,0.8,82002294,4,2
2,0,1.0,1.0,68393010,4,4
2,2,0.5,0.8571428571428571,70675402,4,2
0,4,0.0,0.0,80163435,4,0
2,2,0.7777777777777778,0.6666666666666666,70593376,9,7
0,11,0.15384615384615385,0.2702702702702703,74635155,13,2
0,10,0.2857142857142857,0.46153846153846156,74635183,14,4
2,4,0.7333333333333333,0.8571428571428571,72803325,15,11
2,1,0.8,0.5,590905,5,4
1,4,0.3333333333333333,0.5,77576975,6,2
1,6,0.25,0.5714285714285714,69954003,8,2
0,9,0.3076923076923077,0.42105263157894735,80135012,13,4
0,7,0.2222222222222222,0.3,69152524,9,2
2,0,1.0,1.0,82052079,4,4
0,10,0.09090909090909091,0.05555555555555555,70677166,11,1
0,14,0.125,0.39344262295081966,80126767,16,2
0,4,0.2,0.14285714285714285,72523143,5,1
2,2,0.5,0.6666666666666666,64705921,4,2
0,2,0.0,0.0,69634411,2,0
0,8,0.0,0.0,78763202,8,0
1,10,0.4117647058823529,0.8,66064495,17,7
0,1,0.0,0.0,80128173,1,0
0,3,0.0,0.0,69701401,3,0
0,12,0.14285714285714285,0.08,66857896,14,2
2,1,0.6666666666666666,0.5,72377354,3,2
1,15,0.21052631578947367,0.7083333333333334,67285680,19,4
1,4,0.42857142857142855,0.9259259259259259,80165895,7,3
1,17,0.22727272727272727,0.6,80155204,22,5
0,3,0.0,0.0,72900212,3,0
0,3,0.25,0.375,75816580,4,1
2,1,0.5,0.3333333333333333,80168490,2,1
0,4,0.0,0.0,72809352,4,0
0,1,0.0,0.0,66110324,1,0
1,15,0.3181818181818182,0.8135593220338984,67555474,22,7
0,6,0.0,0.0,54468414,6,0
0,7,0.125,0.4444444444444444,82137504,8,1
1,3,0.4,0.875,66761702,5,2
1,4,0.42857142857142855,0.9230769230769231,71081794,7,3
1,7,0.2222222222222222,0.7058823529411765,79453241,9,2
2,7,0.5,0.9411764705882353,70253813,14,7
1,7,0.4166666666666667,0.9714285714285714,70236523,12,5
2,0,1.0,1.0,68747630,1,1
1,13,0.2777777777777778,0.5384615384615384,69498534,18,5
1,12,0.14285714285714285,0.5526315789473685,70746613,14,2
1,5,0.375,0.6,82126755,8,3
2,1,0.6666666666666666,0.875,70842891,3,2
2,0,1.0,1.0,70399245,1,1
0,19,0.17391304347826086,0.3717948717948718,67438686,23,4
0,6,0.3333333333333333,0.375,69840036,9,3
0,2,0.0,0.0,68747861,2,0
1,9,0.18181818181818182,0.5714285714285714,70691782,11,2
0,6,0.0,0.0,70700112,6,0
0,11,0.15384615384615385,0.3055555555555556,70692706,13,2
0,7,0.125,0.4642857142857143,70703892,8,1
1,7,0.2222222222222222,0.6285714285714286,80126747,9,2
2,0,1.0,1.0,68285735,9,9
2,0,1.0,1.0,67335534,1,1
2,1,0.5,0.8,69149325,2,1
0,5,0.0,0.0,70792610,5,0
1,4,0.3333333333333333,0.6666666666666666,70822311,6,2
0,1,0.0,0.0,67335723,1,0
0,8,0.0,0.0,81968413,8,0
0,8,0.0,0.0,82164461,8,0
1,8,0.2727272727272727,0.6470588235294118,65278843,11,3
1,10,0.375,0.8,65290281,16,6
0,9,0.18181818181818182,0.08333333333333333,65352651,11,2
2,2,0.5,0.6666666666666666,82002280,4,2
0,2,0.0,0.0,67285554,2,0
2,3,0.5714285714285714,0.75,80132909,7,4
0,2,0.0,0.0,66876502,2,0
0,2,0.3333333333333333,0.0,76807465,3,1
2,2,0.8333333333333334,0.3333333333333333,65094953,12,10
0,8,0.1111111111111111,0.2222222222222222,67276461,9,1
0,3,0.0,0.0,69597360,3,0
2,5,0.6153846153846154,0.9545454545454546,75000345,13,8
2,3,0.5714285714285714,0.9090909090909091,58878981,7,4
0,3,0.25,0.3333333333333333,68400773,4,1
0,3,0.0,0.0,62653654,3,0
1,4,0.3333333333333333,0.5,70463862,6,2
2,0,1.0,1.0,80159206,5,5
0,1,0.0,0.0,67297601,1,0
0,2,0.0,0.0,67297860,2,0
2,0,1.0,1.0,82135120,2,2
2,1,0.9166666666666666,0.6666666666666666,82021572,12,11
1,5,0.375,0.95,80133896,8,3
2,3,0.7272727272727273,0.8888888888888888,70051926,11,8
0,28,0.034482758620689655,0.14285714285714285,67315031,29,1
0,5,0.0,0.0,73489556,5,0
0,1,0.0,0.0,70685692,1,0
2,1,0.5,0.75,70692370,2,1
0,2,0.0,0.0,70693686,2,0
1,12,0.14285714285714285,0.5294117647058824,72773232,14,2
1,3,0.4,0.9,82119991,5,2
2,1,0.5,0.9090909090909091,71588272,2,1
0,5,0.0,0.0,80069871,5,0
1,4,0.3333333333333333,0.5,73102470,6,2
0,12,0.2,0.4666666666666667,69508873,15,3
2,0,1.0,1.0,72803276,3,3
2,0,1.0,1.0,70718046,6,6
2,8,0.5,0.9444444444444444,69390601,16,8
2,8,0.6,0.8888888888888888,79076060,20,12
1,2,0.3333333333333333,0.5,69874434,3,1
0,5,0.2857142857142857,0.0,80125897,7,2
1,17,0.34615384615384615,0.90625,80135182,26,9
1,12,0.3684210526315789,0.8163265306122449,72803465,19,7
0,18,0.1,0.2972972972972973,71080982,20,2
2,0,1.0,1.0,80149485,1,1
2,6,0.7692307692307693,0.8,71847846,26,20
2,3,0.625,0.9166666666666666,69030976,8,5
0,4,0.0,0.0,70820225,4,0
2,2,0.6666666666666666,0.8333333333333334,75272652,6,4
2,3,0.5714285714285714,0.8,69588162,7,4
2,0,1.0,1.0,82013580,1,1
0,7,0.0,0.0,82096337,7,0
0,15,0.0,0.0,80124233,15,0
1,7,0.4166666666666667,0.8125,71458583,12,5
2,1,0.9,0.5,65888802,10,9
2,0,1.0,1.0,80165427,2,2
0,10,0.2857142857142857,0.3684210526315789,80153668,14,4
0,12,0.14285714285714285,0.13636363636363635,68637786,14,2
0,3,0.0,0.0,80172626,3,0
0,4,0.2,0.4375,70759535,5,1
1,9,0.1,0.5217391304347826,82032907,10,1
0,8,0.0,0.0,70629594,8,0
0,15,0.0,0.0,82102562,15,0
0,2,0.0,0.0,82118236,2,0
0,18,0.0,0.0,72816660,18,0
0,2,0.3333333333333333,0.3333333333333333,80162805,3,1
0,2,0.0,0.0,80055983,2,0
0,3,0.0,0.0,82006681,3,0
1,11,0.26666666666666666,0.7073170731707317,80135281,15,4
1,4,0.2,0.631578947368421,82102565,5,1
1,21,0.16,0.6764705882352942,68905550,25,4
0,2,0.0,0.0,82006556,2,0
1,7,0.3,0.9523809523809523,64235591,10,3
1,6,0.25,0.8,67511171,8,2
0,3,0.0,0.0,70635446,3,0
0,9,0.1,0.425,80163393,10,1
1,2,0.3333333333333333,0.6666666666666666,65713522,3,1
0,22,0.08333333333333333,0.3983050847457627,69527843,24,2
1,2,0.3333333333333333,0.6666666666666666,70675710,3,1
2,3,0.5,0.9375,82062274,6,3
2,0,1.0,1.0,80010784,8,8
2,2,0.6666666666666666,0.875,82008298,6,4
0,14,0.2222222222222222,0.4583333333333333,73634946,18,4
0,1,0.0,0.0,69607622,1,0
2,1,0.5,0.7272727272727273,82008047,2,1
1,3,0.4,0.9375,72802870,5,2
1,2,0.3333333333333333,0.6666666666666666,67528006,3,1
2,1,0.5,0.5,70037023,2,1
2,2,0.7142857142857143,0.8,80175660,7,5
2,13,0.5185185185185185,0.9487179487179487,74303313,27,14
0,2,0.0,0.0,69700981,2,0
0,11,0.15384615384615385,0.23333333333333334,73801574,13,2
1,19,0.2692307692307692,0.5833333333333334,82023692,26,7
2,1,0.8333333333333334,0.9230769230769231,75272666,6,5
0,11,0.21428571428571427,0.22727272727272727,74389546,14,3
0,4,0.3333333333333333,0.4444444444444444,80156407,6,2
0,6,0.14285714285714285,0.38095238095238093,65279676,7,1
1,10,0.4117647058823529,0.875,64468873,17,7
2,3,0.8695652173913043,0.8333333333333334,67596410,23,20
0,3,0.0,0.0,80176804,3,0
2,14,0.5333333333333333,0.9487179487179487,82145174,30,16
0,6,0.0,0.0,80165153,6,0
0,5,0.0,0.0,69319334,5,0
0,3,0.0,0.0,78506960,3,0
0,17,0.19047619047619047,0.3488372093023256,74086565,21,4
1,9,0.25,0.8888888888888888,82102875,12,3
1,14,0.391304347826087,0.8070175438596491,19191935,23,9
0,2,0.0,0.0,69064303,2,0
2,2,0.8333333333333334,0.9523809523809523,80126529,12,10
1,10,0.2857142857142857,0.782608695652174,64343664,14,4
0,14,0.0,0.0,70684215,14,0
2,0,1.0,1.0,12162570,13,13
0,5,0.0,0.0,74510800,5,0
0,8,0.0,0.0,74510814,8,0
1,11,0.15384615384615385,0.6470588235294118,80029012,13,2
1,9,0.4375,0.9444444444444444,74086656,16,7
1,20,0.2,0.5128205128205128,69724396,25,5
0,8,0.1111111111111111,0.0,70175483,9,1
2,3,0.5,0.8571428571428571,80104955,6,3
2,1,0.5,0.9230769230769231,80067540,2,1
1,5,0.16666666666666666,0.75,70820141,6,1
0,1,0.0,0.0,70820155,1,0
2,2,0.6666666666666666,0.8,80118893,6,4
1,8,0.2727272727272727,0.5454545454545454,72392852,11,3
0,6,0.3333333333333333,0.4166666666666667,82088770,9,3
2,1,0.5,0.6666666666666666,70687771,2,1
0,10,0.0,0.0,80132295,10,0
2,9,0.5,0.6666666666666666,67237870,18,9
2,1,0.6666666666666666,0.5,72801981,3,2
0,4,0.2,0.16666666666666666,80135005,5,1
1,6,0.4,0.9310344827586207,70183526,10,4
2,0,1.0,1.0,70493745,1,1
2,6,0.625,0.9090909090909091,80019205,16,10
0,2,0.3333333333333333,0.0,74718224,3,1
0,5,0.0,0.0,70701540,5,0
0,6,0.0,0.0,70701911,6,0
2,0,1.0,1.0,63960932,1,1
2,0,1.0,1.0,80093783,2,2
1,19,0.32142857142857145,0.5714285714285714,68400920,28,9
2,0,1.0,1.0,67567703,1,1
2,3,0.5714285714285714,0.875,69071415,7,4
2,1,0.75,0.5,65286410,4,3
0,16,0.15789473684210525,0.15625,65280362,19,3
0,16,0.15789473684210525,0.16,65554293,19,3
0,9,0.18181818181818182,0.0,82116611,11,2
2,1,0.75,0.5,82070188,4,3
2,2,0.8666666666666667,0.75,72801484,15,13
2,0,1.0,1.0,69578523,1,1
0,12,0.07692307692307693,0.3220338983050847,69965091,13,1
0,13,0.0,0.0,70746256,13,0
2,6,0.5714285714285714,0.9402985074626866,79989980,14,8
1,3,0.25,0.5,69597353,4,1
2,2,0.7142857142857143,0.75,70720160,7,5
2,0,1.0,1.0,82042078,2,2
2,0,1.0,1.0,75362203,3,3
2,0,1.0,1.0,80159665,6,6
2,4,0.5,0.8666666666666667,280196,8,4
2,0,1.0,1.0,65257122,7,7
2,0,1.0,1.0,82038886,1,1
2,0,1.0,1.0,82023108,1,1
1,18,0.1,0.5,80124370,20,2
2,1,0.5,0.6666666666666666,82037583,2,1
2,0,1.0,1.0,82018096,1,1
0,3,0.25,0.4,79788471,4,1
1,9,0.3076923076923077,0.8,62382383,13,4
1,4,0.3333333333333333,0.85,73444833,6,2
2,0,1.0,1.0,82038296,2,2
2,1,0.6666666666666666,0.0,82039338,3,2
2,0,1.0,1.0,80159723,2,2
2,0,1.0,1.0,82039397,1,1
2,0,1.0,1.0,69205171,9,9
2,0,1.0,1.0,80159744,21,21
2,3,0.5714285714285714,0.25,70543746,7,4
2,0,1.0,1.0,80162578,8,8
2,0,1.0,1.0,82145111,2,2
0,2,0.0,0.0,82042106,2,0
2,0,1.0,1.0,82102169,3,3
0,16,0.1111111111111111,0.42105263157894735,72918692,18,2
1,18,0.18181818181818182,0.7027027027027027,72918706,22,4
0,4,0.0,0.0,72909914,4,0
0,31,0.06060606060606061,0.19548872180451127,70823074,33,2
1,29,0.3695652173913043,0.72,80176701,46,17
2,0,1.0,1.0,80139961,1,1
2,2,0.6666666666666666,0.8333333333333334,80128026,6,4
2,2,0.5,0.9090909090909091,80153544,4,2
1,3,0.4,0.75,80128553,5,2
0,7,0.125,0.08333333333333333,80172599,8,1
2,0,1.0,1.0,80156167,1,1
2,2,0.6,0.75,70562436,5,3
1,4,0.3333333333333333,0.5,76571516,6,2
2,1,0.5,0.5,82127534,2,1
0,3,0.0,0.0,82127550,3,0
0,5,0.0,0.0,68039986,5,0
0,25,0.16666666666666666,0.3787878787878788,69240185,30,5
1,8,0.42857142857142855,0.8695652173913043,79410051,14,6
2,2,0.6666666666666666,0.6666666666666666,68342491,6,4
1,10,0.375,0.75,82251174,16,6
0,4,0.0,0.0,80122868,4,0
2,1,0.6666666666666666,0.6666666666666666,82037879,3,2
0,17,0.10526315789473684,0.45,70693161,19,2
0,11,0.08333333333333333,0.41379310344827586,70695191,12,1
0,15,0.0625,0.16923076923076924,80126830,16,1
0,2,0.3333333333333333,0.25,69482994,3,1
0,10,0.23076923076923078,0.48,70706454,13,3
0,27,0.12903225806451613,0.15315315315315314,67775204,31,4
1,10,0.16666666666666666,0.6097560975609756,70216720,12,2
1,4,0.3333333333333333,0.7,71618701,6,2
2,2,0.8333333333333334,0.9230769230769231,80181664,12,10
0,15,0.11764705882352941,0.4222222222222222,80128489,17,2
0,9,0.18181818181818182,0.08333333333333333,80145896,11,2
2,4,0.5555555555555556,0.8461538461538461,70649712,9,5
2,0,1.0,1.0,80051293,3,3
2,11,0.5,0.875,82053098,22,11
0,6,0.14285714285714285,0.4583333333333333,73800916,7,1
1,4,0.3333333333333333,0.7142857142857143,69416382,6,2
0,6,0.0,0.0,62841590,6,0
0,3,0.0,0.0,79787953,3,0
2,0,1.0,1.0,80162583,2,2
0,3,0.0,0.0,70488880,3,0
0,12,0.0,0.0,70489230,12,0
0,2,0.0,0.0,73489486,2,0
0,4,0.0,0.0,74517702,4,0
2,9,0.6896551724137931,0.9642857142857143,80158306,29,20
2,12,0.5384615384615384,0.9166666666666666,80158336,26,14
0,6,0.14285714285714285,0.1111111111111111,65279865,7,1
0,5,0.16666666666666666,0.25,80105060,6,1
0,8,0.0,0.0,65543002,8,0
1,32,0.1111111111111111,0.5306122448979592,82103945,36,4
0,1,0.0,0.0,69106156,1,0
1,15,0.4642857142857143,0.9041095890410958,68480055,28,13
0,4,0.0,0.0,67128530,4,0
0,19,0.0,0.0,82173341,19,0
0,19,0.0,0.0,82173342,19,0
0,14,0.125,0.2153846153846154,64999410,16,2
0,5,0.0,0.0,70682276,5,0
2,0,1.0,1.0,82090159,20,20
2,0,1.0,1.0,80159269,1,1
0,2,0.0,0.0,69500270,2,0
0,2,0.0,0.0,69319362,2,0
0,3,0.0,0.0,82250612,3,0
2,3,0.5714285714285714,0.8,82251467,7,4
2,0,1.0,1.0,70869372,7,7
0,4,0.3333333333333333,0.14285714285714285,69169982,6,2
0,8,0.1111111111111111,0.25,69611220,9,1
0,8,0.1111111111111111,0.07142857142857142,69611311,9,1
0,14,0.2631578947368421,0.4411764705882353,80127353,19,5
0,1,0.0,0.0,71458520,1,0
1,18,0.41935483870967744,0.813953488372093,80019366,31,13
2,1,0.5,0.5,68060706,2,1
0,3,0.25,0.0,68060741,4,1
2,2,0.5,0.25,69958966,4,2
1,6,0.3333333333333333,0.5555555555555556,69998131,9,3
1,2,0.3333333333333333,0.5,69633074,3,1
0,3,0.25,0.2857142857142857,82247813,4,1
0,6,0.25,0.46153846153846156,62143522,8,2
2,2,0.6666666666666666,0.8,80134716,6,4
2,2,0.6,0.3333333333333333,80134746,5,3
2,0,1.0,1.0,80162565,5,5
1,16,0.23809523809523808,0.5833333333333334,80121202,21,5
2,2,0.6666666666666666,0.8333333333333334,69840022,6,4
1,5,0.375,0.5,68401795,8,3
1,15,0.4827586206896552,0.90625,74646593,29,14
1,4,0.3333333333333333,0.7777777777777778,68164516,6,2
2,2,0.5,0.6666666666666666,81967948,4,2
2,3,0.5714285714285714,0.0,80137674,7,4
1,13,0.1875,0.52,73535336,16,3
2,4,0.6666666666666666,0.8888888888888888,64399664,12,8
2,2,0.7142857142857143,0.8333333333333334,75124280,7,5
1,16,0.42857142857142855,0.8333333333333334,70071351,28,12
2,0,1.0,1.0,68413240,4,4
2,9,0.5714285714285714,0.9473684210526315,69626340,21,12
0,5,0.16666666666666666,0.3333333333333333,69626291,6,1
0,1,0.0,0.0,70749350,1,0
2,1,0.6666666666666666,0.5,60547774,3,2
1,55,0.27631578947368424,0.7972972972972973,66010756,76,21
0,7,0.125,0.42857142857142855,82102600,8,1
2,0,1.0,1.0,69206823,6,6
0,8,0.2,0.38461538461538464,70843605,10,2
2,0,1.0,1.0,80136725,1,1
2,0,1.0,1.0,74032476,3,3
1,3,0.25,0.5384615384615384,70801556,4,1
2,1,0.5,0.5,80118286,2,1
0,17,0.0,0.0,80124190,17,0
0,4,0.2,0.375,73863853,5,1
2,1,0.6666666666666666,0.6666666666666666,65281370,3,2
0,9,0.1,0.07692307692307693,65281076,10,1
1,3,0.4,0.6,65280124,5,2
2,1,0.9473684210526315,0.5,82061898,19,18
2,1,0.8,0.5,70406154,5,4
2,2,0.5,0.8333333333333334,70415604,4,2
0,7,0.125,0.14285714285714285,82145533,8,1
2,0,1.0,1.0,82182772,1,1
1,3,0.25,0.6666666666666666,70691992,4,1
0,3,0.0,0.0,80165456,3,0
1,15,0.3181818181818182,0.7068965517241379,80161489,22,7
0,4,0.0,0.0,66473505,4,0
0,22,0.043478260869565216,0.06097560975609756,82126669,23,1
0,4,0.0,0.0,68361370,4,0
1,2,0.3333333333333333,0.7272727272727273,68784772,3,1
1,33,0.35294117647058826,0.8670212765957447,68616772,51,18
0,1,0.0,0.0,65806482,1,0
0,9,0.18181818181818182,0.07692307692307693,80176679,11,2
1,8,0.42857142857142855,0.8823529411764706,67506495,14,6
0,6,0.3333333333333333,0.0,82120647,9,3
2,11,0.5769230769230769,0.92,70633556,26,15
1,12,0.4,0.9538461538461539,80176800,20,8
2,0,1.0,1.0,70399343,3,3
0,5,0.0,0.0,69640774,5,0
0,8,0.2,0.48,70906745,10,2
0,5,0.375,0.42857142857142855,80134795,8,3
1,6,0.4,0.9230769230769231,80118746,10,4
1,4,0.3333333333333333,0.7692307692307693,70683305,6,2
0,4,0.0,0.0,70702940,4,0
0,1,0.0,0.0,70706993,1,0
2,3,0.5,0.967741935483871,71434804,6,3
2,2,0.7777777777777778,0.5,82019047,9,7
1,2,0.3333333333333333,0.75,68236840,3,1
0,2,0.0,0.0,69597311,2,0
1,6,0.3333333333333333,0.5,82205635,9,3
0,5,0.16666666666666666,0.0,82205636,6,1
2,1,0.5,0.8,70703031,2,1
1,8,0.42857142857142855,0.8333333333333334,80165360,14,6
0,8,0.1111111111111111,0.22727272727272727,70675563,9,1
1,3,0.25,0.55,80104836,4,1
1,13,0.38095238095238093,0.9054054054054054,70828513,21,8
0,8,0.2,0.42424242424242425,82032897,10,2
0,17,0.0,0.0,80128195,17,0
0,27,0.18181818181818182,0.2289156626506024,67187204,33,6
1,4,0.3333333333333333,0.9354838709677419,70239274,6,2
2,3,0.5714285714285714,0.8,69483533,7,4
0,11,0.0,0.0,69958973,11,0
0,2,0.0,0.0,82019735,2,0
1,2,0.3333333333333333,0.75,80094161,3,1
2,3,0.8125,0.9166666666666666,70760186,16,13
0,4,0.0,0.0,74510506,4,0
0,1,0.0,0.0,62839574,1,0
2,4,0.5555555555555556,0.8,67580366,9,5
0,12,0.2,0.41935483870967744,74923933,15,3
0,8,0.0,0.0,68905536,8,0
0,14,0.17647058823529413,0.3333333333333333,65716623,17,3
0,1,0.0,0.0,70482643,1,0
0,9,0.1,0.3235294117647059,67978281,10,1
0,5,0.0,0.0,67722221,5,0
0,9,0.0,0.0,69549550,9,0
0,2,0.0,0.0,69549592,2,0
2,1,0.5,0.8,80167298,2,1
0,14,0.0,0.0,80150501,14,0
0,4,0.0,0.0,80150529,4,0
1,4,0.2,0.5454545454545454,82103843,5,1
2,4,0.6,0.96,80180255,10,6
1,7,0.3,0.9259259259259259,68467623,10,3
0,4,0.0,0.0,70862512,4,0
0,14,0.0,0.0,82150128,14,0
1,6,0.14285714285714285,0.6206896551724138,70918841,7,1
1,6,0.14285714285714285,0.6333333333333333,80163400,7,1
0,2,0.0,0.0,80169900,2,0
0,6,0.0,0.0,82006676,6,0
0,3,0.0,0.0,82006679,3,0
0,14,0.125,0.2619047619047619,69867252,16,2
0,9,0.0,0.0,74924024,9,0
0,9,0.0,0.0,80128457,9,0
0,4,0.0,0.0,70634844,4,0
0,4,0.0,0.0,80170977,4,0
2,0,1.0,1.0,82006683,1,1
1,9,0.47058823529411764,0.9354838709677419,80134775,17,8
1,15,0.16666666666666666,0.5844155844155844,67900280,18,3
0,39,0.07142857142857142,0.1450381679389313,69134345,42,3
1,3,0.4,0.9375,70843556,5,2
0,4,0.0,0.0,80145441,4,0
2,1,0.5,0.5,72813965,2,1
0,13,0.07142857142857142,0.28125,70746025,14,1
1,4,0.3333333333333333,0.9285714285714286,67226131,6,2
2,0,1.0,1.0,70809235,3,3
2,0,1.0,1.0,66235813,2,2
2,0,1.0,1.0,68486950,3,3
1,2,0.3333333333333333,0.75,64469566,3,1
2,4,0.5,0.9166666666666666,80159041,8,4
0,5,0.0,0.0,69184486,5,0
2,1,0.6666666666666666,0.6666666666666666,70674590,3,2
1,3,0.25,0.6428571428571429,70675612,4,1
1,4,0.2,0.75,70691915,5,1
0,6,0.25,0.375,68499935,8,2
0,19,0.13636363636363635,0.12195121951219512,70679294,22,3
0,9,0.0,0.0,70692881,9,0
0,25,0.16666666666666666,0.3924050632911392,67706016,30,5
1,2,0.3333333333333333,0.625,69523524,3,1
1,2,0.3333333333333333,0.8571428571428571,82056733,3,1
0,2,0.0,0.0,68254872,2,0
0,2,0.0,0.0,70820134,2,0
2,2,0.6,0.8205128205128205,69970985,5,3
1,13,0.38095238095238093,0.8333333333333334,68533066,21,8
1,7,0.2222222222222222,0.7142857142857143,70674485,9,2
0,4,0.0,0.0,82102518,4,0
1,6,0.14285714285714285,0.6071428571428571,80128263,7,1
0,6,0.0,0.0,82102808,6,0
1,11,0.15384615384615385,0.6153846153846154,82102899,13,2
0,14,0.0,0.0,80128305,14,0
0,4,0.2,0.38095238095238093,80105081,5,1
1,7,0.3,0.7142857142857143,82021845,10,3
0,39,0.025,0.072,70801661,40,1
0,21,0.125,0.2948717948717949,70224322,24,3
0,21,0.125,0.30434782608695654,80123381,24,3
2,4,0.75,0.7142857142857143,74123770,16,12
0,4,0.0,0.0,67993695,4,0
0,4,0.2,0.4444444444444444,69499402,5,1
0,9,0.1,0.38095238095238093,82150066,10,1
2,0,1.0,1.0,67314205,1,1
0,21,0.08695652173913043,0.19047619047619047,82041833,23,2
2,0,1.0,1.0,80165316,2,2
2,1,0.5,0.6666666666666666,82024331,2,1
1,3,0.25,0.5384615384615384,73459680,4,1
0,2,0.0,0.0,66783164,2,0
0,3,0.0,0.0,66786825,3,0
0,3,0.0,0.0,67754512,3,0
0,6,0.0,0.0,67475562,6,0
0,9,0.18181818181818182,0.25,74513831,11,2
1,9,0.25,0.5,80180111,12,3
0,10,0.0,0.0,70069965,10,0
2,1,0.875,0.5,54880763,8,7
0,13,0.23529411764705882,0.4358974358974359,80019226,17,4
0,4,0.0,0.0,69558510,4,0
0,1,0.0,0.0,64240295,1,0
0,1,0.0,0.0,67183585,1,0
0,6,0.3333333333333333,0.23076923076923078,67540921,9,3
0,3,0.0,0.0,69693925,3,0
0,4,0.0,0.0,67815272,4,0
1,2,0.3333333333333333,0.7,68366312,3,1
2,8,0.5,0.875,82047569,16,8
1,15,0.25,0.6451612903225806,68956265,20,5
0,22,0.15384615384615385,0.4264705882352941,66226993,26,4
0,7,0.125,0.13333333333333333,70183750,8,1
2,2,0.5,0.75,77676340,4,2
0,14,0.17647058823529413,0.32,64982435,17,3
0,5,0.16666666666666666,0.25,82041892,6,1
2,3,0.75,0.8333333333333334,80133891,12,9
2,7,0.5882352941176471,0.9411764705882353,80180258,17,10
0,2,0.0,0.0,70681471,2,0
2,1,0.75,0.8,70418166,4,3
2,3,0.5,0.8571428571428571,70718312,6,3
0,5,0.16666666666666666,0.16666666666666666,80054555,6,1
1,10,0.4117647058823529,0.9333333333333333,62771093,17,7
0,6,0.25,0.25,65289994,8,2
2,3,0.7,0.9473684210526315,65286774,10,7
2,1,0.8888888888888888,0.6666666666666666,82039834,9,8
2,1,0.5,0.5,66648470,2,1
2,0,1.0,1.0,70314384,4,4
0,12,0.14285714285714285,0.2222222222222222,72104522,14,2
2,0,1.0,1.0,63737814,6,6
0,20,0.13043478260869565,0.4166666666666667,69007190,23,3
0,1,0.0,0.0,80156763,1,0
0,1,0.0,0.0,68805513,1,0
0,4,0.2,0.23076923076923078,70175714,5,1
0,11,0.08333333333333333,0.2,70850675,12,1
2,0,1.0,1.0,82135113,4,4
2,6,0.5384615384615384,0.8888888888888888,69666632,13,7
1,2,0.3333333333333333,0.75,82022896,3,1
0,11,0.08333333333333333,0.0,69611290,12,1
2,2,0.75,0.75,82043179,8,6
2,5,0.6153846153846154,0.7142857142857143,82062240,13,8
2,0,1.0,1.0,68500362,1,1
2,4,0.7333333333333333,0.8333333333333334,69170556,15,11
2,0,1.0,1.0,80169301,1,1
2,3,0.7,0.875,68733343,10,7
2,1,0.6666666666666666,0.3333333333333333,80141332,3,2
2,1,0.8333333333333334,0.9090909090909091,66738196,6,5
2,0,1.0,1.0,80136603,9,9
2,0,1.0,1.0,80159152,2,2
2,0,1.0,1.0,82154363,3,3
2,1,0.9,0.5,80137912,10,9
2,0,1.0,1.0,66975104,1,1
2,0,1.0,1.0,82039403,2,2
2,0,1.0,1.0,82102201,5,5
0,12,0.2,0.25,70193312,15,3
2,0,1.0,1.0,82039200,1,1
2,0,1.0,1.0,80159710,2,2
2,0,1.0,1.0,80158238,3,3
2,2,0.7777777777777778,0.6666666666666666,80126503,9,7
2,2,0.6666666666666666,0.5,80130482,6,4
1,4,0.3333333333333333,0.5,74982712,6,2
2,0,1.0,1.0,80159156,5,5
2,1,0.8,0.75,75636113,5,4
1,16,0.1111111111111111,0.5652173913043478,70198142,18,2
2,0,1.0,1.0,80159262,3,3
2,0,1.0,1.0,80169821,6,6
2,0,1.0,1.0,82025182,1,1
2,0,1.0,1.0,80174100,6,6
0,6,0.0,0.0,70059801,6,0
1,10,0.23076923076923078,0.5714285714285714,70059892,13,3
0,1,0.0,0.0,67530176,1,0
1,7,0.4166666666666667,0.8333333333333334,70751856,12,5
0,14,0.0,0.0,69554261,14,0
1,5,0.2857142857142857,0.5714285714285714,82002266,7,2
1,5,0.16666666666666666,0.7619047619047619,67466721,6,1
1,11,0.45,0.72,80176710,20,9
0,4,0.2,0.42105263157894735,67467813,5,1
2,0,1.0,1.0,75347412,1,1
2,0,1.0,1.0,80165476,1,1
0,3,0.0,0.0,70566650,3,0
2,2,0.5,0.9523809523809523,82017793,4,2
2,10,0.5,0.9636363636363636,70600383,20,10
0,7,0.0,0.0,82050075,7,0
0,7,0.0,0.0,80162893,7,0
2,0,1.0,1.0,80153540,1,1
2,2,0.6666666666666666,0.8571428571428571,69464094,6,4
0,1,0.0,0.0,80163199,1,0
0,7,0.125,0.2631578947368421,80172598,8,1
2,2,0.5,0.875,65092300,4,2
1,3,0.25,0.8333333333333334,82103921,4,1
2,0,1.0,1.0,70760102,2,2
2,4,0.5,0.96,69416193,8,4
2,0,1.0,1.0,80092733,1,1
0,3,0.4,0.0,74389504,5,2
1,10,0.23076923076923078,0.5217391304347826,74086733,13,3
0,7,0.125,0.1,80141491,8,1
2,0,1.0,1.0,69946415,1,1
0,24,0.1724137931034483,0.43636363636363634,69724312,29,5
2,2,0.6666666666666666,0.9,80137603,6,4
2,0,1.0,1.0,943635,3,3
2,1,0.5,0.8888888888888888,80177418,2,1
2,2,0.8461538461538461,0.6666666666666666,69039285,13,11
1,11,0.35294117647058826,0.84,80105004,17,6
0,7,0.2222222222222222,0.2857142857142857,70060354,9,2
0,6,0.14285714285714285,0.20833333333333334,70214284,7,1
0,1,0.0,0.0,70705404,1,0
1,4,0.3333333333333333,0.8947368421052632,70411033,6,2
0,2,0.3333333333333333,0.42857142857142855,80127036,3,1
0,3,0.0,0.0,80127037,3,0
2,0,1.0,1.0,70780402,2,2
2,0,1.0,1.0,70192563,1,1
2,1,0.9230769230769231,0.8,67514531,13,12
1,7,0.2222222222222222,0.6666666666666666,67053833,9,2
2,2,0.5,0.8333333333333334,73632405,4,2
2,5,0.5833333333333334,0.9,68595653,12,7
0,9,0.1,0.16666666666666666,69981555,10,1
0,15,0.11764705882352941,0.37037037037037035,65713046,17,2
1,4,0.2,0.5294117647058824,80121034,5,1
0,30,0.09090909090909091,0.34074074074074073,80149904,33,3
1,10,0.2857142857142857,0.625,70463932,14,4
1,11,0.3125,0.7931034482758621,70463946,16,5
1,2,0.3333333333333333,0.8181818181818182,80116764,3,1
2,2,0.6,0.9166666666666666,68060713,5,3
2,1,0.5,0.5,70892654,2,1
2,1,0.5,0.6666666666666666,80150338,2,1
2,1,0.5,0.9230769230769231,80150281,2,1
2,2,0.5,0.9,82023971,4,2
1,8,0.3333333333333333,0.8076923076923077,69596170,12,4
2,2,0.6666666666666666,0.5,73102295,6,4
0,3,0.25,0.0,73102813,4,1
0,2,0.0,0.0,82019746,2,0
0,3,0.0,0.0,82020035,3,0
0,1,0.0,0.0,69735841,1,0
0,5,0.16666666666666666,0.15384615384615385,82024358,6,1
0,6,0.4,0.0,82140138,10,4
2,2,0.5,0.5,66069626,4,2
0,5,0.0,0.0,68211276,5,0
0,10,0.23076923076923078,0.43478260869565216,68821746,13,3
1,7,0.46153846153846156,0.9565217391304348,68258421,13,6
1,4,0.3333333333333333,0.9565217391304348,63781970,6,2
2,4,0.6363636363636364,0.7777777777777778,70077882,11,7
1,5,0.4444444444444444,0.7857142857142857,70585095,9,4
0,9,0.0,0.0,80028942,9,0
2,0,1.0,1.0,82012784,1,1
2,1,0.5,0.6666666666666666,70685083,2,1
1,15,0.34782608695652173,0.5806451612903226,68400556,23,8
0,1,0.0,0.0,80163123,1,0
1,9,0.4375,0.7272727272727273,69944420,16,7
1,4,0.42857142857142855,0.5,67410980,7,3
1,3,0.25,0.7272727272727273,70695030,4,1
0,2,0.0,0.0,70743400,2,0
1,4,0.2,0.6666666666666666,70744331,5,1
2,0,1.0,1.0,68746475,1,1
2,0,1.0,1.0,70509271,1,1
2,0,1.0,1.0,69993455,1,1
0,14,0.3,0.3939393939393939,65507981,20,6
0,3,0.0,0.0,65655352,3,0
1,2,0.3333333333333333,0.7142857142857143,71536542,3,1
0,6,0.0,0.0,69416655,6,0
0,2,0.3333333333333333,0.25,67985393,3,1
0,2,0.0,0.0,70474831,2,0
0,10,0.23076923076923078,0.4666666666666667,70864430,13,3
0,10,0.0,0.0,62841534,10,0
0,4,0.0,0.0,64248632,4,0
0,24,0.22580645161290322,0.34285714285714286,69179663,31,7
0,9,0.18181818181818182,0.34615384615384615,70525805,11,2
0,2,0.0,0.0,70684320,2,0
0,7,0.125,0.21739130434782608,80123454,8,1
0,3,0.0,0.0,70629552,3,0
0,6,0.0,0.0,78863610,6,0
0,1,0.0,0.0,69695402,1,0
0,10,0.09090909090909091,0.0,79218874,11,1
2,1,0.6666666666666666,0.6666666666666666,66337761,3,2
0,9,0.18181818181818182,0.17391304347826086,63766871,11,2
2,2,0.75,0.8,79854152,8,6
2,9,0.5714285714285714,0.9411764705882353,68040490,21,12
2,3,0.7,0.6666666666666666,80158064,10,7
0,6,0.0,0.0,75149592,6,0
0,1,0.0,0.0,75346971,1,0
1,2,0.3333333333333333,0.75,82070173,3,1
2,6,0.5714285714285714,0.9523809523809523,82052111,14,8
2,4,0.6363636363636364,0.8333333333333334,70031493,11,7
0,6,0.14285714285714285,0.23809523809523808,60081756,7,1
2,2,0.5,0.75,63980105,4,2
0,27,0.03571428571428571,0.058823529411764705,72808841,28,1
0,13,0.23529411764705882,0.4634146341463415,63051100,17,4
0,3,0.0,0.0,82110442,3,0
0,6,0.0,0.0,82110459,6,0
1,4,0.3333333333333333,0.7333333333333333,61356421,6,2
2,1,0.8333333333333334,0.5,82060535,6,5
2,2,0.6,0.0,82061199,5,3
0,3,0.0,0.0,70743085,3,0
0,2,0.0,0.0,70678272,2,0
0,11,0.21428571428571427,0.4,65281335,14,3
0,1,0.0,0.0,70406070,1,0
2,1,0.6666666666666666,0.5,70406175,3,2
1,13,0.38095238095238093,0.6333333333333333,67846555,21,8
0,2,0.3333333333333333,0.25,63737821,3,1
0,8,0.1111111111111111,0.07317073170731707,76606061,9,1
1,6,0.45454545454545453,0.8125,67525381,11,5
0,8,0.0,0.0,68038992,8,0
0,6,0.14285714285714285,0.2777777777777778,61566393,7,1
0,21,0.16,0.2916666666666667,73801371,25,4
0,1,0.0,0.0,64356824,1,0
2,8,0.5294117647058824,0.967741935483871,57206730,17,9
0,1,0.0,0.0,70758632,1,0
1,6,0.45454545454545453,0.8461538461538461,75109741,11,5
2,0,1.0,1.0,73403561,4,4
2,0,1.0,1.0,70036715,1,1
0,24,0.04,0.07017543859649122,70679532,25,1
1,3,0.25,0.7741935483870968,73536764,4,1
1,5,0.2857142857142857,0.5238095238095238,80105242,7,2
1,22,0.37142857142857144,0.7906976744186046,72802702,35,13
0,12,0.14285714285714285,0.25,73295551,14,2
0,4,0.0,0.0,71761732,4,0
2,2,0.5,0.9565217391304348,76551790,4,2
2,1,0.5,0.5,70494543,2,1
2,2,0.5,0.8571428571428571,68546625,4,2
2,2,0.7142857142857143,0.8571428571428571,80172943,7,5
2,2,0.5,0.9523809523809523,67066510,4,2
0,7,0.36363636363636365,0.46153846153846156,70343504,11,4
0,5,0.0,0.0,70699272,5,0
1,2,0.3333333333333333,0.7142857142857143,70706720,3,1
0,11,0.15384615384615385,0.3,80003742,13,2
0,3,0.0,0.0,70742826,3,0
0,3,0.0,0.0,70743183,3,0
0,7,0.0,0.0,82090213,7,0
0,3,0.0,0.0,82090214,3,0
0,5,0.0,0.0,82090215,5,0
0,6,0.0,0.0,82090216,6,0
0,5,0.0,0.0,82090217,5,0
2,0,1.0,1.0,68613881,8,8
0,3,0.25,0.18181818181818182,69596345,4,1
0,1,0.0,0.0,70747936,1,0
2,11,0.5769230769230769,0.8666666666666667,80155229,26,15
2,3,0.6666666666666666,0.6,80172883,9,6
2,2,0.6,0.6666666666666666,80145839,5,3
1,3,0.25,0.5454545454545454,80129154,4,1
2,0,1.0,1.0,80176667,1,1
0,40,0.16666666666666666,0.2923076923076923,70615685,48,8
2,0,1.0,1.0,67128670,6,6
2,4,0.6,0.8636363636363636,76941655,10,6
1,8,0.38461538461538464,0.8695652173913043,64473430,13,5
0,5,0.0,0.0,70684621,5,0
1,4,0.3333333333333333,0.7586206896551724,70691306,6,2
0,3,0.25,0.4444444444444444,69544594,4,1
2,0,1.0,1.0,68747700,3,3
2,0,1.0,1.0,70822486,11,11
2,0,1.0,1.0,67626902,4,4
2,0,1.0,1.0,80117628,2,2
0,9,0.18181818181818182,0.43137254901960786,69008485,11,2
2,3,0.5,0.9,62564404,6,3
2,0,1.0,1.0,70537516,3,3
2,1,0.5,0.5,67521181,2,1
1,9,0.4375,0.9574468085106383,81971189,16,7
0,13,0.0,0.0,80149973,13,0
1,13,0.2777777777777778,0.8947368421052632,67000115,18,5
1,2,0.3333333333333333,0.5454545454545454,80135062,3,1
0,7,0.0,0.0,82006220,7,0
0,4,0.0,0.0,82006254,4,0
0,1,0.0,0.0,82006255,1,0
0,2,0.0,0.0,80162775,2,0
0,6,0.0,0.0,80172593,6,0
0,9,0.0,0.0,67975691,9,0
0,2,0.0,0.0,80086776,2,0
1,14,0.2631578947368421,0.7631578947368421,65769004,19,5
0,6,0.0,0.0,80150520,6,0
0,4,0.0,0.0,80150627,4,0
1,12,0.4,0.8709677419354839,65048151,20,8
0,2,0.0,0.0,70629195,2,0
0,6,0.14285714285714285,0.3888888888888889,82006527,7,1
0,1,0.0,0.0,80162851,1,0
1,3,0.25,0.6153846153846154,70821814,4,1
2,1,0.75,0.3333333333333333,68294695,4,3
0,16,0.0,0.0,82118251,16,0
0,1,0.0,0.0,82140369,1,0
0,26,0.10344827586206896,0.17647058823529413,78165990,29,3
0,3,0.0,0.0,80135225,3,0
0,5,0.0,0.0,80150505,5,0
0,9,0.0,0.0,80150706,9,0
0,5,0.0,0.0,80150476,5,0
1,5,0.2857142857142857,0.6666666666666666,82062268,7,2
2,4,0.7333333333333333,0.75,70250271,15,11
1,5,0.16666666666666666,0.8571428571428571,82038355,6,1
0,5,0.0,0.0,82038357,5,0
0,9,0.1,0.2857142857142857,80128851,10,1
0,1,0.0,0.0,70681870,1,0
2,0,1.0,1.0,80133893,4,4
0,14,0.06666666666666667,0.20754716981132076,69478395,15,1
2,4,0.6666666666666666,0.9259259259259259,79953825,12,8
2,0,1.0,1.0,70283073,1,1
1,7,0.36363636363636365,0.7307692307692307,70283374,11,4
0,3,0.0,0.0,69549256,3,0
1,4,0.2,0.5714285714285714,80162906,5,1
2,0,1.0,1.0,82175566,4,4
0,11,0.21428571428571427,0.07407407407407407,68400542,14,3
0,4,0.0,0.0,80132363,4,0
0,9,0.1,0.16666666666666666,70744933,10,1
0,1,0.0,0.0,82008304,1,0
0,1,0.0,0.0,82008307,1,0
0,1,0.0,0.0,82008309,1,0
1,4,0.3333333333333333,0.5,80176642,6,2
0,8,0.0,0.0,80067253,8,0
0,1,0.0,0.0,82010306,1,0
0,4,0.2,0.46153846153846156,82101566,5,1
2,1,0.5,0.5,66243170,2,1
1,6,0.25,0.5882352941176471,70685972,8,2
2,1,0.6666666666666666,0.6666666666666666,70843976,3,2
1,3,0.4,0.75,69922055,5,2
0,8,0.2,0.4,70527534,10,2
0,1,0.0,0.0,66379334,1,0
2,0,1.0,1.0,80159673,5,5
1,11,0.45,0.9696969696969697,73701110,20,9
2,0,1.0,1.0,73337152,1,1
2,0,1.0,1.0,68498143,2,2
0,18,0.0,0.0,67475373,18,0
0,12,0.2,0.45,63164066,15,3
0,12,0.07692307692307693,0.16666666666666666,82150117,13,1
2,1,0.5,0.8461538461538461,82018731,2,1
0,8,0.1111111111111111,0.32,66782296,9,1
1,7,0.4166666666666667,0.8214285714285714,64248072,12,5
2,6,0.6842105263157895,0.9375,68543580,19,13
2,5,0.6428571428571429,0.875,62613383,14,9
0,1,0.0,0.0,80141402,1,0
2,1,0.5,0.5,80141408,2,1
2,0,1.0,1.0,68629225,4,4
2,1,0.75,0.8571428571428571,80128511,4,3
0,4,0.0,0.0,70697494,4,0
0,2,0.3333333333333333,0.0,80135740,3,1
2,0,1.0,1.0,67071823,3,3
1,2,0.3333333333333333,0.5,68519941,3,1
1,7,0.3,0.631578947368421,69215496,10,3
2,5,0.5,0.8,70420483,10,5
2,0,1.0,1.0,82039869,1,1
2,1,0.5,0.5,69831636,2,1
0,1,0.0,0.0,69860035,1,0
0,21,0.045454545454545456,0.06521739130434782,72808554,22,1
0,7,0.0,0.0,68130776,7,0
0,5,0.16666666666666666,0.13636363636363635,70175210,6,1
1,2,0.3333333333333333,0.6666666666666666,70463820,3,1
0,9,0.25,0.4230769230769231,70463876,12,3
2,0,1.0,1.0,67744404,3,3
0,1,0.0,0.0,80178764,1,0
2,0,1.0,1.0,70568176,1,1
0,14,0.2222222222222222,0.4722222222222222,69611171,18,4
0,13,0.0,0.0,70238343,13,0
0,4,0.0,0.0,70238826,4,0
2,2,0.5,0.8333333333333334,70202685,4,2
2,9,0.5263157894736842,0.96875,70600355,19,10
2,11,0.5,0.9354838709677419,66892742,22,11
0,16,0.23809523809523808,0.425,65719612,21,5
1,10,0.4444444444444444,0.975609756097561,65966684,18,8
1,23,0.3235294117647059,0.7115384615384616,69691216,34,11
0,9,0.0,0.0,82019468,9,0
0,1,0.0,0.0,15012221,1,0
1,6,0.3333333333333333,0.9,81989187,9,3
2,4,0.6,0.9615384615384616,82010262,10,6
2,2,0.5,0.3333333333333333,66379474,4,2
1,9,0.25,0.6470588235294118,65286550,12,3
1,9,0.25,0.5263157894736842,80156739,12,3
2,1,0.75,0.8,70070910,4,3
2,0,1.0,1.0,70524461,1,1
0,12,0.0,0.0,67822174,12,0
0,2,0.0,0.0,67822286,2,0
0,6,0.14285714285714285,0.35,70677950,7,1
2,1,0.8,0.5,80092565,5,4
1,13,0.2777777777777778,0.5161290322580645,77676893,18,5
0,8,0.1111111111111111,0.16666666666666666,65812222,9,1
0,14,0.06666666666666667,0.18840579710144928,70676242,15,1
0,48,0.058823529411764705,0.12949640287769784,70678265,51,3
0,8,0.0,0.0,70694876,8,0
2,0,1.0,1.0,73425261,4,4
0,8,0.0,0.0,70237951,8,0
0,2,0.0,0.0,75147632,2,0
0,7,0.0,0.0,70746326,7,0
0,2,0.0,0.0,73255630,2,0
0,2,0.0,0.0,80133453,2,0
2,0,1.0,1.0,80136600,1,1
2,0,1.0,1.0,80136689,7,7
1,7,0.4166666666666667,0.5555555555555556,73412843,12,5
2,0,1.0,1.0,80136594,2,2
2,1,0.9375,0.5,70314321,16,15
1,9,0.47058823529411764,0.7954545454545454,80158269,17,8
2,2,0.6666666666666666,0.6,75636232,6,4
2,4,0.5555555555555556,0.8333333333333334,72749264,9,5
1,7,0.4166666666666667,0.8620689655172413,75120983,12,5
2,0,1.0,1.0,80136534,3,3
2,0,1.0,1.0,80165232,3,3
2,0,1.0,1.0,82126290,2,2
2,0,1.0,1.0,70851102,7,7
2,1,0.8333333333333334,0.6666666666666666,74165273,6,5
2,5,0.7222222222222222,0.8571428571428571,80175664,18,13
2,0,1.0,1.0,80159697,1,1
2,1,0.75,0.9,70057064,4,3
1,14,0.3,0.6486486486486487,82088792,20,6
2,4,0.5,0.8571428571428571,82046917,8,4
2,0,1.0,1.0,82042184,1,1
0,2,0.0,0.0,82018778,2,0
2,2,0.7777777777777778,0.875,67787790,9,7
2,1,0.875,0.5,67833395,8,7
2,0,1.0,1.0,19487923,2,2
1,7,0.46153846153846156,0.9375,73245886,13,6
0,3,0.0,0.0,77563920,3,0
2,0,1.0,1.0,66240244,1,1
2,0,1.0,1.0,82020269,5,5
2,4,0.5555555555555556,0.95,69589303,9,5
1,5,0.4444444444444444,0.875,72802905,9,4
0,7,0.0,0.0,72808925,7,0
0,5,0.0,0.0,62839672,5,0
0,6,0.0,0.0,80150798,6,0
2,1,0.6666666666666666,0.75,82010245,3,2
2,4,0.6666666666666666,0.9,69887223,12,8
1,3,0.25,0.5833333333333334,70703052,4,1
0,7,0.0,0.0,72909655,7,0
0,6,0.14285714285714285,0.35714285714285715,80126804,7,1
1,4,0.3333333333333333,0.7058823529411765,80162641,6,2
0,5,0.0,0.0,70405741,5,0
1,6,0.3333333333333333,0.782608695652174,82002293,9,3
0,6,0.0,0.0,75048120,6,0
0,19,0.05,0.14457831325301204,63969052,20,1
1,4,0.3333333333333333,0.76,66783465,6,2
2,7,0.6956521739130435,0.9444444444444444,82018980,23,16
1,3,0.25,0.7272727272727273,66784760,4,1
0,9,0.0,0.0,66786881,9,0
0,5,0.16666666666666666,0.4375,66783262,6,1
0,6,0.0,0.0,66782121,6,0
0,4,0.0,0.0,66782135,4,0
0,7,0.0,0.0,62840015,7,0
0,5,0.0,0.0,66787182,5,0
0,5,0.0,0.0,67895982,5,0
1,4,0.2,0.7692307692307693,66785971,5,1
2,1,0.9411764705882353,0.6666666666666666,74043480,17,16
1,5,0.2857142857142857,0.5384615384615384,74086845,7,2
1,20,0.3103448275862069,0.6883116883116883,62148254,29,9
0,6,0.14285714285714285,0.14285714285714285,69538952,7,1
2,4,0.7333333333333333,0.9,73549854,15,11
0,2,0.0,0.0,72474535,2,0
2,1,0.5,0.5,72475193,2,1
2,0,1.0,1.0,80117627,1,1
0,4,0.2,0.21428571428571427,67335744,5,1
0,1,0.0,0.0,58873661,1,0
1,2,0.3333333333333333,0.5,82010308,3,1
2,1,0.6666666666666666,0.5,70751100,3,2
2,3,0.5714285714285714,0.8571428571428571,69031256,7,4
2,0,1.0,1.0,64068970,1,1
1,7,0.125,0.7377049180327869,71341753,8,1
2,0,1.0,1.0,68774293,4,4
2,0,1.0,1.0,82020087,4,4
2,0,1.0,1.0,68498654,1,1
2,6,0.5,0.8125,69587735,12,6
2,1,0.5,0.8571428571428571,66842146,2,1
2,8,0.6363636363636364,0.9375,74316396,22,14
2,2,0.5,0.9333333333333333,68469702,4,2
2,3,0.7692307692307693,0.8,72802821,13,10
2,2,0.6,0.8571428571428571,70695100,5,3
0,1,0.0,0.0,70080451,1,0
0,11,0.0,0.0,515592,11,0
1,17,0.32,0.6818181818181818,66062381,25,8
0,17,0.10526315789473684,0.025,81965577,19,2
2,2,0.7777777777777778,0.75,82037359,9,7
1,8,0.42857142857142855,0.7714285714285715,70120253,14,6
1,10,0.2857142857142857,0.6153846153846154,80145874,14,4
2,0,1.0,1.0,73403323,2,2
2,1,0.5,0.0,66228246,2,1
1,10,0.2857142857142857,0.6875,65529275,14,4
1,2,0.3333333333333333,0.5,69980246,3,1
2,1,0.5,0.6666666666666666,63692174,2,1
1,8,0.2,0.7555555555555555,71537536,10,2
0,7,0.2222222222222222,0.23076923076923078,65293515,9,2
2,0,1.0,1.0,68340790,1,1
2,1,0.8888888888888888,0.5,71219820,9,8
0,1,0.0,0.0,70706370,1,0
0,3,0.0,0.0,73295824,3,0
2,1,0.5,0.5,69975724,2,1
1,2,0.3333333333333333,0.5,66917641,3,1
2,2,0.5,0.0,70670901,4,2
0,10,0.0,0.0,69089692,10,0
0,9,0.3076923076923077,0.25,71230131,13,4
2,4,0.5,0.8888888888888888,80180269,8,4
0,2,0.0,0.0,69896582,2,0
0,5,0.0,0.0,69575331,5,0
0,1,0.0,0.0,69575436,1,0
2,2,0.8461538461538461,0.9,79838584,13,11
0,8,0.2,0.43243243243243246,66110415,10,2
0,9,0.0,0.0,70691355,9,0
1,3,0.25,0.6875,70692664,4,1
1,3,0.4,0.8484848484848485,70699713,5,2
2,1,0.6666666666666666,0.5,68167890,3,2
2,6,0.6666666666666666,0.7272727272727273,80128773,18,12
1,2,0.3333333333333333,0.6363636363636364,82126590,3,1
1,19,0.13636363636363635,0.7363636363636363,80137531,22,3
2,0,1.0,1.0,80178163,2,2
2,11,0.65625,0.9830508474576272,82016416,32,21
2,0,1.0,1.0,82038895,1,1
0,3,0.25,0.46153846153846156,69997781,4,1
0,6,0.0,0.0,82022535,6,0
1,3,0.25,0.6,66423133,4,1
0,1,0.0,0.0,70076244,1,0
0,11,0.21428571428571427,0.44680851063829785,70843346,14,3
1,14,0.3,0.8666666666666667,67887785,20,6
0,4,0.0,0.0,72809261,4,0
0,2,0.0,0.0,70675346,2,0
0,17,0.15,0.39759036144578314,68633173,20,3
2,0,1.0,1.0,70459431,4,4
1,2,0.3333333333333333,0.5,68022262,3,1
0,1,0.0,0.0,69701205,1,0
0,1,0.0,0.0,69701765,1,0
2,8,0.5555555555555556,0.9473684210526315,63278796,18,10
1,4,0.42857142857142855,0.8,81965673,7,3
1,13,0.38095238095238093,0.8311688311688312,69974961,21,8
2,3,0.5714285714285714,0.5,80019282,7,4
0,2,0.0,0.0,70685454,2,0
0,5,0.0,0.0,80126751,5,0
0,8,0.0,0.0,70684845,8,0
1,10,0.23076923076923078,0.5365853658536586,65280831,13,3
2,5,0.6875,0.9,80137595,16,11
0,5,0.16666666666666666,0.3333333333333333,70583373,6,1
2,1,0.8,0.8,82018710,5,4
2,0,1.0,1.0,80134066,23,23
1,6,0.3333333333333333,0.6333333333333333,82024373,9,3
2,1,0.75,0.6666666666666666,70408093,4,3
2,0,1.0,1.0,82159943,18,18
1,7,0.36363636363636365,0.6071428571428571,82013608,11,4
0,12,0.07692307692307693,0.0684931506849315,82096296,13,1
0,3,0.0,0.0,63692195,3,0
2,6,0.5,0.6842105263157895,70413413,12,6
0,3,0.0,0.0,68522146,3,0
0,5,0.0,0.0,70941521,5,0
0,15,0.16666666666666666,0.2765957446808511,70908481,18,3
0,20,0.047619047619047616,0.11363636363636363,82103883,21,1
0,3,0.0,0.0,66405094,3,0
0,4,0.2,0.2,80126842,5,1
2,7,0.5882352941176471,0.9375,61737676,17,10
0,2,0.0,0.0,69139336,2,0
1,4,0.3333333333333333,0.8636363636363636,69577522,6,2
0,7,0.2222222222222222,0.38095238095238093,681912,9,2
2,1,0.75,0.6666666666666666,69579321,4,3
2,0,1.0,1.0,75636043,5,5
2,2,0.6,0.6,70109991,5,3
1,4,0.42857142857142855,0.8333333333333334,65108106,7,3
0,4,0.0,0.0,80153648,4,0
2,2,0.5,0.9285714285714286,70867174,4,2
0,1,0.0,0.0,65937102,1,0
0,12,0.2,0.3870967741935484,67657821,15,3
1,3,0.4,0.8333333333333334,72803626,5,2
1,7,0.4166666666666667,0.75,72844044,12,5
0,4,0.0,0.0,69424236,4,0
0,4,0.2,0.3548387096774194,80105123,5,1
1,17,0.19047619047619047,0.6896551724137931,61946325,21,4
0,8,0.1111111111111111,0.21052631578947367,60513593,9,1
2,2,0.6,0.9444444444444444,66379131,5,3
2,3,0.625,0.6,70460271,8,5
0,2,0.0,0.0,69701436,2,0
0,2,0.0,0.0,69701576,2,0
0,2,0.0,0.0,80117831,2,0
1,14,0.3,0.7551020408163265,62850263,20,6
1,3,0.25,0.8,69735855,4,1
0,21,0.045454545454545456,0.19101123595505617,67376463,22,1
0,7,0.125,0.0,69596625,8,1
0,31,0.1388888888888889,0.1717171717171717,80139726,36,5
0,21,0.045454545454545456,0.1694915254237288,80124319,22,1
0,1,0.0,0.0,67659466,1,0
1,7,0.2222222222222222,0.5789473684210527,75121074,9,2
1,4,0.3333333333333333,0.6363636363636364,70406294,6,2
0,2,0.3333333333333333,0.25,70406336,3,1
1,3,0.4,0.5,80118263,5,2
0,15,0.11764705882352941,0.34,71619345,17,2
0,15,0.0,0.0,70685153,15,0
2,1,0.6666666666666666,0.5,79816562,3,2
1,5,0.2857142857142857,0.6153846153846154,66324405,7,2
0,6,0.0,0.0,62711691,6,0
2,1,0.75,0.5,69213354,4,3
2,1,0.6666666666666666,0.5,69630225,3,2
2,0,1.0,1.0,80093685,1,1
0,6,0.14285714285714285,0.07692307692307693,70601314,7,1
2,1,0.6666666666666666,0.9166666666666666,70676102,3,2
2,2,0.5,0.5,80176665,4,2
1,13,0.1875,0.6666666666666666,80141493,16,3
1,9,0.35714285714285715,0.7391304347826086,61021961,14,5
1,3,0.25,0.8,66441991,4,1
2,0,1.0,1.0,67290265,1,1
2,5,0.5,0.7142857142857143,69189225,10,5
0,1,0.0,0.0,75347013,1,0
1,9,0.3076923076923077,0.6923076923076923,69092366,13,4
1,11,0.35294117647058826,0.7560975609756098,80028571,17,6
0,7,0.125,0.2,82022529,8,1
2,5,0.6666666666666666,0.96,68604081,15,10
0,21,0.19230769230769232,0.36363636363636365,73293892,26,5
2,0,1.0,1.0,69912080,1,1
0,3,0.0,0.0,82103925,3,0
1,7,0.125,0.6136363636363636,82032909,8,1
0,15,0.0625,0.26229508196721313,67435235,16,1
0,5,0.0,0.0,69867812,5,0
0,1,0.0,0.0,67242231,1,0
0,4,0.0,0.0,80172542,4,0
0,4,0.0,0.0,65713501,4,0
0,24,0.04,0.11627906976744186,80162890,25,1
0,14,0.125,0.325,15765295,16,2
0,1,0.0,0.0,82006672,1,0
0,1,0.0,0.0,80128349,1,0
0,2,0.0,0.0,80128416,2,0
0,8,0.1111111111111111,0.36363636363636365,82102627,9,1
0,5,0.0,0.0,82006569,5,0
0,10,0.0,0.0,82102637,10,0
1,3,0.25,0.6666666666666666,75883101,4,1
0,4,0.0,0.0,76551881,4,0
0,5,0.0,0.0,64063622,5,0
0,9,0.0,0.0,66059721,9,0
0,22,0.21428571428571427,0.48214285714285715,74924003,28,6
0,2,0.0,0.0,82018971,2,0
1,4,0.42857142857142855,0.6428571428571429,69042540,7,3
0,6,0.14285714285714285,0.4418604651162791,70759374,7,1
0,14,0.0,0.0,82102641,14,0
1,16,0.1111111111111111,0.6162790697674418,70467222,18,2
0,7,0.0,0.0,82206118,7,0
0,2,0.0,0.0,80150621,2,0
1,10,0.2857142857142857,0.7884615384615384,70759031,14,4
0,2,0.0,0.0,82102575,2,0
0,1,0.0,0.0,69519891,1,0
0,9,0.0,0.0,80167324,9,0
0,6,0.0,0.0,80176289,6,0
1,5,0.16666666666666666,0.7142857142857143,80176292,6,1
0,3,0.0,0.0,70675745,3,0
1,10,0.23076923076923078,0.5,70678174,13,3
1,3,0.25,0.6666666666666666,70693833,4,1
0,3,0.0,0.0,80130734,3,0
1,7,0.3,0.75,79990211,10,3
1,5,0.2857142857142857,0.5454545454545454,69316912,7,2
0,2,0.0,0.0,69653451,2,0
0,8,0.2,0.34285714285714286,69102880,10,2
1,12,0.25,0.6097560975609756,80019114,16,4
0,10,0.16666666666666666,0.1111111111111111,68401816,12,2
0,8,0.1111111111111111,0.46938775510204084,68497716,9,1
0,1,0.0,0.0,69006686,1,0
0,7,0.0,0.0,69006861,7,0
2,1,0.6666666666666666,0.9166666666666666,70230461,3,2
0,1,0.0,0.0,80176173,1,0
2,0,1.0,1.0,69979623,2,2
2,3,0.625,0.8888888888888888,70494060,8,5
0,5,0.0,0.0,70238161,5,0
0,6,0.0,0.0,70238406,6,0
0,8,0.1111111111111111,0.42857142857142855,70238420,9,1
0,9,0.0,0.0,70239155,9,0
1,14,0.125,0.5308641975308642,70239232,16,2
0,15,0.0625,0.16176470588235295,82152203,16,1
2,4,0.5555555555555556,0.9523809523809523,69604206,9,5
1,19,0.42424242424242425,0.8095238095238095,80134788,33,14
1,13,0.1875,0.5961538461538461,70908614,16,3
0,2,0.0,0.0,80150300,2,0
1,5,0.16666666666666666,0.5,68467756,6,1
0,23,0.11538461538461539,0.3821138211382114,80128229,26,3
0,2,0.0,0.0,66010686,2,0
0,2,0.0,0.0,70678965,2,0
0,9,0.0,0.0,70694484,9,0
0,6,0.3333333333333333,0.4444444444444444,78150296,9,3
0,3,0.0,0.0,82003713,3,0
2,0,1.0,1.0,66211845,2,2
2,0,1.0,1.0,68385653,2,2
0,4,0.0,0.0,70677705,4,0
0,9,0.0,0.0,66783143,9,0
0,8,0.0,0.0,66784354,8,0
0,7,0.0,0.0,66787084,7,0
0,36,0.07692307692307693,0.2616822429906542,67475716,39,3
2,1,0.6666666666666666,0.25,68167960,3,2
0,23,0.0,0.0,82164882,23,0
0,3,0.0,0.0,66786454,3,0
0,5,0.0,0.0,66783304,5,0
1,4,0.2,0.6875,66784102,5,1
2,2,0.5,0.6666666666666666,70059220,4,2
2,1,0.75,0.5,67365564,4,3
1,2,0.3333333333333333,0.9230769230769231,70696332,3,1
2,1,0.6666666666666666,0.5,70189560,3,2
0,8,0.2727272727272727,0.48,65017841,11,3
2,4,0.5555555555555556,0.8333333333333334,82023094,9,5
1,8,0.2727272727272727,0.7777777777777778,61500390,11,3
0,2,0.0,0.0,66379103,2,0
1,12,0.3684210526315789,0.5263157894736842,68400661,19,7
1,7,0.2222222222222222,0.6739130434782609,67066503,9,2
2,4,0.5,0.8823529411764706,69483806,8,4
2,1,0.875,0.5,80092726,8,7
0,1,0.0,0.0,69027105,1,0
0,1,0.0,0.0,69027126,1,0
0,2,0.0,0.0,82010284,2,0
0,2,0.0,0.0,73151281,2,0
0,11,0.21428571428571427,0.47058823529411764,69538630,14,3
0,1,0.0,0.0,57209733,1,0
0,14,0.06666666666666667,0.2127659574468085,70417242,15,1
0,1,0.0,0.0,70747754,1,0
2,1,0.6666666666666666,0.75,66901233,3,2
2,2,0.5,0.875,69031312,4,2
1,7,0.46153846153846156,0.7857142857142857,70718746,13,6
1,5,0.4444444444444444,0.6666666666666666,70718935,9,4
1,8,0.3333333333333333,0.631578947368421,70051940,12,4
2,2,0.6,0.5,70051996,5,3
1,3,0.4,0.6666666666666666,65289322,5,2
1,9,0.4,0.9375,65281580,15,6
0,19,0.09523809523809523,0.21428571428571427,73245592,21,2
1,5,0.375,0.9523809523809523,71852704,8,3
2,0,1.0,1.0,74320792,5,5
0,8,0.0,0.0,70081452,8,0
1,8,0.3333333333333333,0.6451612903225806,70843752,12,4
0,7,0.0,0.0,67731923,7,0
2,1,0.5,0.8333333333333334,67485845,2,1
0,2,0.0,0.0,73082513,2,0
2,0,1.0,1.0,67199202,2,2
2,7,0.5882352941176471,0.9761904761904762,82023702,17,10
1,4,0.3333333333333333,0.9090909090909091,70702163,6,2
2,5,0.5454545454545454,0.9473684210526315,82023682,11,6
0,18,0.14285714285714285,0.2987012987012987,82116865,21,3
1,14,0.36363636363636365,0.7428571428571429,68533045,22,8
1,14,0.391304347826087,0.8292682926829268,68383560,23,9
0,2,0.3333333333333333,0.25,70395521,3,1
0,6,0.0,0.0,72808582,6,0
2,0,1.0,1.0,69738396,2,2
2,0,1.0,1.0,82102151,5,5
2,1,0.8333333333333334,0.5,65532033,6,5
2,0,1.0,1.0,82153817,1,1
2,0,1.0,1.0,73551401,2,2
2,0,1.0,1.0,65619365,2,2
2,0,1.0,1.0,80159755,1,1
0,1,0.0,0.0,82041890,1,0
0,2,0.0,0.0,82126268,2,0
2,0,1.0,1.0,82102200,4,4
2,2,0.8181818181818182,0.8,80178969,11,9
2,0,1.0,1.0,82138701,2,2
2,12,0.5862068965517241,0.9090909090909091,62580693,29,17
2,0,1.0,1.0,19806003,1,1
0,3,0.4,0.3333333333333333,70609021,5,2
2,2,0.8333333333333334,0.75,82020374,12,10
2,0,1.0,1.0,67066783,1,1
2,0,1.0,1.0,80162127,7,7
2,2,0.5,0.8,80051846,4,2
2,3,0.7,0.6,79792720,10,7
0,7,0.46153846153846156,0.0,80159736,13,6
2,3,0.5714285714285714,0.9333333333333333,72803472,7,4
2,0,1.0,1.0,82110441,1,1
2,0,1.0,1.0,82036974,3,3
2,0,1.0,1.0,82038248,9,9
2,0,1.0,1.0,80126998,1,1
0,3,0.0,0.0,67286282,3,0
0,2,0.0,0.0,67286310,2,0
2,1,0.8,0.8333333333333334,82052032,5,4
0,1,0.0,0.0,69157872,1,0
2,2,0.7142857142857143,0.75,67823490,7,5
2,0,1.0,1.0,66144456,2,2
1,10,0.4117647058823529,0.9622641509433962,71434825,17,7
0,10,0.2857142857142857,0.28,68401543,14,4
1,7,0.2222222222222222,0.6,80074456,9,2
0,15,0.0,0.0,68600833,15,0
0,4,0.0,0.0,70743330,4,0
0,1,0.0,0.0,64955163,1,0
0,1,0.0,0.0,64955170,1,0
0,16,0.058823529411764705,0.16393442622950818,80128103,17,1
1,2,0.3333333333333333,0.8064516129032258,79994432,3,1
1,17,0.22727272727272727,0.5555555555555556,61578713,22,5
2,0,1.0,1.0,71080401,1,1
2,3,0.7,0.9,82042614,10,7
0,7,0.0,0.0,80105221,7,0
2,0,1.0,1.0,69974674,2,2
0,1,0.0,0.0,70843640,1,0
2,2,0.5,0.9285714285714286,70635341,4,2
1,15,0.21052631578947367,0.5581395348837209,70018326,19,4
1,4,0.2,0.7333333333333333,66781925,5,1
2,7,0.5,0.8461538461538461,65159325,14,7
0,5,0.16666666666666666,0.09090909090909091,70759493,6,1
0,5,0.0,0.0,66783500,5,0
0,5,0.0,0.0,67754442,5,0
1,6,0.25,0.6,70661514,8,2
0,3,0.0,0.0,82006238,3,0
2,0,1.0,1.0,70891023,1,1
0,5,0.16666666666666666,0.3333333333333333,64041824,6,1
1,4,0.2,0.5714285714285714,66787161,5,1
1,5,0.16666666666666666,0.5294117647058824,67754372,6,1
2,1,0.875,0.75,8010513,8,7
0,7,0.125,0.0,82108145,8,1
0,10,0.09090909090909091,0.06451612903225806,80139713,11,1
1,8,0.42857142857142855,0.85,73508820,14,6
1,4,0.2,0.8,70683725,5,1
2,5,0.5,0.85,82023137,10,5
1,2,0.3333333333333333,0.7142857142857143,70692202,3,1
2,3,0.5,0.9166666666666666,71588090,6,3
0,6,0.14285714285714285,0.3333333333333333,70680785,7,1
2,11,0.5769230769230769,0.9629629629629629,61501300,26,15
2,0,1.0,1.0,80136555,3,3
0,4,0.0,0.0,82052031,4,0
0,10,0.0,0.0,80159297,10,0
1,8,0.4666666666666667,0.5555555555555556,66280830,15,7
2,2,0.6666666666666666,0.6666666666666666,70811601,6,4
2,6,0.6,0.9444444444444444,82007549,15,9
1,20,0.2857142857142857,0.6883116883116883,80137523,28,8
2,2,0.6,0.6,70282506,5,3
0,1,0.0,0.0,70238476,1,0
1,4,0.2,0.64,70746585,5,1
1,7,0.2222222222222222,0.8787878787878788,79990015,9,2
1,7,0.2222222222222222,0.85,70192500,9,2
0,4,0.0,0.0,70685566,4,0
1,7,0.4166666666666667,0.9230769230769231,82002324,12,5
0,1,0.0,0.0,67202310,1,0
0,2,0.3333333333333333,0.3,80141331,3,1
1,3,0.4,0.9333333333333333,54298370,5,2
1,4,0.3333333333333333,0.8,80122844,6,2
0,1,0.0,0.0,80123392,1,0
2,2,0.5,0.75,69867336,4,2
2,1,0.6666666666666666,0.5,70543711,3,2
0,2,0.0,0.0,70672021,2,0
0,4,0.0,0.0,72775136,4,0
0,9,0.1,0.10526315789473684,78858815,10,1
1,6,0.25,0.5714285714285714,80145822,8,2
2,1,0.5,0.875,80145758,2,1
0,2,0.0,0.0,70706342,2,0
2,7,0.5333333333333333,0.6666666666666666,80018953,15,8
1,10,0.4444444444444444,0.8076923076923077,68499963,18,8
1,3,0.25,0.5,70684166,4,1
2,1,0.75,0.6666666666666666,80141398,4,3
0,4,0.0,0.0,64127301,4,0
0,2,0.0,0.0,82251459,2,0
0,1,0.0,0.0,82250587,1,0
0,2,0.0,0.0,68234306,2,0
0,2,0.0,0.0,68234376,2,0
2,1,0.8888888888888888,0.75,70712446,9,8
1,5,0.4444444444444444,0.6153846153846154,80158260,9,4
0,2,0.0,0.0,70685804,2,0
1,14,0.3,0.8064516129032258,70645603,20,6
0,12,0.14285714285714285,0.19148936170212766,67669021,14,2
0,13,0.07142857142857142,0.3384615384615385,64249045,14,1
0,4,0.2,0.16666666666666666,70417515,5,1
2,3,0.5,0.2,82154383,6,3
2,0,1.0,1.0,80118186,3,3
2,2,0.7142857142857143,0.8333333333333334,70781571,7,5
0,3,0.25,0.4,69241781,4,1
2,1,0.5,0.5,67822433,2,1
1,29,0.17142857142857143,0.5981308411214953,80128307,35,6
0,38,0.19148936170212766,0.38064516129032255,80069941,47,9
1,4,0.3333333333333333,0.8181818181818182,70693091,6,2
0,11,0.0,0.0,65282644,11,0
2,1,0.5,0.6666666666666666,66379341,2,1
2,0,1.0,1.0,65325911,1,1
2,4,0.6363636363636364,0.9230769230769231,66194520,11,7
0,2,0.0,0.0,66228176,2,0
2,0,1.0,1.0,80126497,15,15
2,1,0.75,0.5,80093762,4,3
0,6,0.0,0.0,70238070,6,0
0,6,0.25,0.23809523809523808,80177686,8,2
0,1,0.0,0.0,69964286,1,0
1,6,0.3333333333333333,0.6666666666666666,70813274,9,3
0,23,0.25806451612903225,0.46236559139784944,70843115,31,8
0,4,0.2,0.14285714285714285,82041720,5,1
0,25,0.13793103448275862,0.2558139534883721,73801364,29,4
2,8,0.5294117647058824,0.9411764705882353,75121186,17,9
2,1,0.8,0.5,80128568,5,4
0,7,0.125,0.42857142857142855,69204786,8,1
0,7,0.2222222222222222,0.4,80013423,9,2
2,2,0.6,0.9166666666666666,62748623,5,3
2,1,0.6666666666666666,0.9285714285714286,68656273,3,2
0,7,0.0,0.0,70692916,7,0
0,6,0.14285714285714285,0.375,70694386,7,1
0,4,0.2,0.0,66228414,5,1
1,8,0.2,0.7272727272727273,67822454,10,2
2,0,1.0,1.0,60738881,2,2
2,1,0.75,0.5,70406021,4,3
2,1,0.75,0.5,82022884,4,3
0,21,0.045454545454545456,0.02702702702702703,82009765,22,1
0,5,0.0,0.0,80083402,5,0
0,6,0.14285714285714285,0.43333333333333335,82019461,7,1
2,1,0.5,0.5,82152077,2,1
0,1,0.0,0.0,69967674,1,0
0,2,0.0,0.0,70682955,2,0
0,1,0.0,0.0,70683116,1,0
0,10,0.0,0.0,67094370,10,0
2,2,0.6,0.8571428571428571,81963735,5,3
2,3,0.625,0.875,82145137,8,5
0,1,0.0,0.0,68338662,1,0
0,4,0.3333333333333333,0.4,80158322,6,2
0,2,0.0,0.0,70744870,2,0
1,14,0.391304347826087,0.8367346938775511,80141350,23,9
2,6,0.5384615384615384,0.6666666666666666,82041282,13,7
0,1,0.0,0.0,66917613,1,0
2,1,0.5,0.75,74887323,2,1
0,3,0.0,0.0,79648933,3,0
0,4,0.0,0.0,70843724,4,0
1,6,0.45454545454545453,0.875,67656883,11,5
0,5,0.16666666666666666,0.2916666666666667,73801133,6,1
0,4,0.2,0.3076923076923077,74632334,5,1
0,20,0.09090909090909091,0.30303030303030304,82018908,22,2
0,2,0.0,0.0,70120995,2,0
2,3,0.5714285714285714,0.8333333333333334,69973302,7,4
2,1,0.5,0.0,80091760,2,1
2,3,0.6666666666666666,0.7,69956012,9,6
0,1,0.0,0.0,82163423,1,0
2,0,1.0,1.0,69164151,1,1
1,4,0.2,0.6363636363636364,74095756,5,1
2,4,0.5,0.9166666666666666,80163130,8,4
2,0,1.0,1.0,67365802,1,1
0,2,0.0,0.0,66441984,2,0
0,5,0.0,0.0,65279774,5,0
2,1,0.5,0.5,62734301,2,1
2,1,0.75,0.6666666666666666,68167771,4,3
2,0,1.0,1.0,66237633,1,1
2,3,0.5714285714285714,0.9,69979791,7,4
2,4,0.5555555555555556,0.8333333333333334,70632226,9,5
0,3,0.25,0.125,66256925,4,1
0,11,0.08333333333333333,0.14285714285714285,73918523,12,1
0,2,0.0,0.0,69091505,2,0
0,13,0.13333333333333333,0.23076923076923078,69508880,15,2
0,2,0.3333333333333333,0.2,82172734,3,1
2,15,0.5588235294117647,0.9761904761904762,80051720,34,19
0,7,0.36363636363636365,0.125,70544250,11,4
0,23,0.17857142857142858,0.14814814814814814,67815776,28,5
2,3,0.5,0.8636363636363636,70712222,6,3
0,1,0.0,0.0,70348614,1,0
1,2,0.3333333333333333,0.6,66973165,3,1
1,5,0.2857142857142857,0.8,66041612,7,2
0,4,0.0,0.0,80126853,4,0
0,1,0.0,0.0,80162557,1,0
0,1,0.0,0.0,80162589,1,0
0,1,0.0,0.0,64197063,1,0
1,8,0.2727272727272727,0.5,69092681,11,3
2,0,1.0,1.0,69036051,1,1
0,6,0.0,0.0,72809303,6,0
2,1,0.9,0.6666666666666666,75264301,10,9
0,3,0.0,0.0,80105312,3,0
0,1,0.0,0.0,65425283,1,0
2,1,0.5,0.5,82010242,2,1
0,8,0.1111111111111111,0.045454545454545456,65289595,9,1
1,5,0.2857142857142857,0.6666666666666666,65281426,7,2
2,9,0.7567567567567568,0.9545454545454546,70648123,37,28
0,1,0.0,0.0,80128414,1,0
0,13,0.13333333333333333,0.3333333333333333,80163194,15,2
0,7,0.2222222222222222,0.22580645161290322,82062260,9,2
1,6,0.3333333333333333,0.7058823529411765,80167327,9,3
0,2,0.0,0.0,70629916,2,0
0,28,0.0,0.0,80150863,28,0
0,1,0.0,0.0,80167233,1,0
0,4,0.0,0.0,82102616,4,0
0,11,0.0,0.0,82102888,11,0
0,2,0.0,0.0,80131188,2,0
0,3,0.0,0.0,80131192,3,0
0,4,0.2,0.2,80162869,5,1
0,9,0.0,0.0,82118276,9,0
0,13,0.0,0.0,80150497,13,0
0,11,0.0,0.0,80150718,11,0
0,7,0.0,0.0,80150721,7,0
2,2,0.75,0.9285714285714286,70821716,8,6
0,3,0.0,0.0,82006285,3,0
0,4,0.0,0.0,70630063,4,0
0,3,0.0,0.0,82006574,3,0
1,8,0.1111111111111111,0.55,82006597,9,1
0,12,0.0,0.0,74924416,12,0
0,8,0.0,0.0,82003708,8,0
2,7,0.5,0.8947368421052632,68400654,14,7
0,4,0.0,0.0,67568690,4,0
1,9,0.35714285714285715,0.8620689655172413,70240842,14,5
0,29,0.12121212121212122,0.24285714285714285,70045612,33,4
1,12,0.25,0.5416666666666666,82120001,16,4
0,4,0.0,0.0,82163425,4,0
2,3,0.7692307692307693,0.9375,70752773,13,10
0,1,0.0,0.0,70527401,1,0
0,1,0.0,0.0,70683480,1,0
0,1,0.0,0.0,70684852,1,0
1,4,0.3333333333333333,0.7142857142857143,69912521,6,2
1,2,0.3333333333333333,0.75,65176496,3,1
1,9,0.4375,0.813953488372093,72198322,16,7
2,5,0.5833333333333334,0.9459459459459459,80163452,12,7
0,2,0.0,0.0,79795100,2,0
0,8,0.1111111111111111,0.4576271186440678,82010263,9,1
2,1,0.75,0.5,69998033,4,3
2,2,0.5,0.9545454545454546,67895065,4,2
1,15,0.21052631578947367,0.5283018867924528,82050493,19,4
1,2,0.3333333333333333,0.7,67226110,3,1
2,1,0.75,0.96,72802415,4,3
0,2,0.3333333333333333,0.25,80165402,3,1
2,1,0.9655172413793104,0.5,61758746,29,28
0,1,0.0,0.0,80165325,1,0
0,8,0.1111111111111111,0.13793103448275862,69319474,9,1
1,2,0.3333333333333333,0.6428571428571429,70842954,3,1
0,3,0.0,0.0,70070686,3,0
0,4,0.0,0.0,70684572,4,0
2,1,0.5,0.8571428571428571,67066545,2,1
0,2,0.0,0.0,69895651,2,0
0,19,0.09523809523809523,0.26153846153846155,63992922,21,2
0,7,0.0,0.0,63993146,7,0
1,8,0.42857142857142855,0.9117647058823529,64287720,14,6
2,0,1.0,1.0,61493866,1,1
2,3,0.5,0.8,67422754,6,3
2,4,0.5,0.9259259259259259,82017799,8,4
1,9,0.18181818181818182,0.5882352941176471,80176815,11,2
1,7,0.2222222222222222,0.6,68530161,9,2
1,10,0.3333333333333333,0.8333333333333334,80121197,15,5
0,17,0.19047619047619047,0.3541666666666667,67775190,21,4
2,2,0.5,0.6666666666666666,73629976,4,2
2,3,0.5714285714285714,0.3333333333333333,66337831,7,4
1,2,0.3333333333333333,0.5,70217133,3,1
2,0,1.0,1.0,80132869,2,2
1,12,0.29411764705882354,0.574468085106383,75121130,17,5
0,1,0.0,0.0,70238574,1,0
2,0,1.0,1.0,65964003,3,3
2,5,0.6666666666666666,0.9411764705882353,81882154,15,10
2,5,0.5833333333333334,0.9411764705882353,73300031,12,7
0,2,0.3333333333333333,0.42857142857142855,65292675,3,1
0,1,0.0,0.0,70562065,1,0
0,5,0.16666666666666666,0.43478260869565216,72522786,6,1
2,5,0.6428571428571429,0.6666666666666666,80092425,14,9
2,1,0.75,0.9375,68372745,4,3
2,3,0.5714285714285714,0.5,80165729,7,4
0,15,0.0,0.0,70803075,15,0
0,4,0.0,0.0,62841366,4,0
0,2,0.3333333333333333,0.0,82008045,3,1
0,6,0.14285714285714285,0.08333333333333333,69691342,7,1
1,19,0.2962962962962963,0.6985294117647058,82137927,27,8
0,10,0.2857142857142857,0.2727272727272727,69666912,14,4
1,3,0.25,0.5833333333333334,80104976,4,1
1,9,0.3076923076923077,0.7,67159974,13,4
2,1,0.5,0.8,70780101,2,1
0,4,0.0,0.0,70239134,4,0
2,0,1.0,1.0,80178184,2,2
2,1,0.6666666666666666,0.9285714285714286,408562,3,2
2,1,0.6666666666666666,0.0,80158280,3,2
2,1,0.6666666666666666,0.0,80158301,3,2
2,0,1.0,1.0,82095245,2,2
2,5,0.6153846153846154,0.9629629629629629,75338795,13,8
2,0,1.0,1.0,67067462,1,1
2,0,1.0,1.0,65826873,1,1
2,2,0.5,0.6666666666666666,80126533,4,2
0,5,0.16666666666666666,0.3,82024252,6,1
1,8,0.4666666666666667,0.868421052631579,82120706,15,7
2,1,0.875,0.5,80158329,8,7
2,1,0.8,0.5,69031151,5,4
2,0,1.0,1.0,80149255,4,4
2,0,1.0,1.0,80054940,2,2
2,7,0.7307692307692307,0.9375,80176878,26,19
0,5,0.16666666666666666,0.25,82047556,6,1
0,3,0.25,0.42857142857142855,80165432,4,1
0,1,0.0,0.0,80165437,1,0
2,1,0.6666666666666666,0.8,80165445,3,2
0,1,0.0,0.0,80165475,1,0
2,1,0.5,0.6,80165487,2,1
2,0,1.0,1.0,72446052,4,4
2,0,1.0,1.0,69205780,6,6
2,1,0.6666666666666666,0.6666666666666666,80145895,3,2
2,0,1.0,1.0,82018785,4,4
2,1,0.8,0.0,80178976,5,4
2,0,1.0,1.0,80117574,3,3
2,0,1.0,1.0,80159219,1,1
2,2,0.5,0.75,12762301,4,2
2,0,1.0,1.0,82018105,1,1
0,3,0.0,0.0,70706006,3,0
0,1,0.0,0.0,67286240,1,0
2,2,0.6666666666666666,0.875,65087743,6,4
1,2,0.3333333333333333,0.9411764705882353,70013615,3,1
2,1,0.5,0.5,70718354,2,1
0,2,0.0,0.0,70229712,2,0
1,7,0.125,0.5333333333333333,70697984,8,1
0,2,0.3333333333333333,0.42857142857142855,70002541,3,1
0,8,0.1111111111111111,0.4222222222222222,80150814,9,1
2,2,0.75,0.6666666666666666,69124895,8,6
0,4,0.0,0.0,69525540,4,0
0,6,0.0,0.0,80149914,6,0
1,10,0.23076923076923078,0.5,69726524,13,3
0,5,0.0,0.0,66782940,5,0
0,1,0.0,0.0,66783780,1,0
2,1,0.6666666666666666,0.5,67478005,3,2
0,7,0.0,0.0,61228741,7,0
0,4,0.0,0.0,82206136,4,0
1,3,0.4,0.7,71619205,5,2
0,4,0.0,0.0,66784781,4,0
0,3,0.0,0.0,80178154,3,0
2,9,0.6666666666666666,0.85,66111976,27,18
0,7,0.125,0.14285714285714285,69509111,8,1
1,12,0.45454545454545453,0.9583333333333334,69581624,22,10
0,6,0.0,0.0,54468386,6,0
1,8,0.2,0.5789473684210527,65255400,10,2
2,4,0.5,0.9090909090909091,82102327,8,4
1,10,0.23076923076923078,0.574468085106383,82052054,13,3
0,2,0.0,0.0,70679854,2,0
2,1,0.5,0.75,69596373,2,1
0,13,0.0,0.0,67405002,13,0
0,6,0.0,0.0,67897312,6,0
2,3,0.85,0.75,68744781,20,17
0,13,0.38095238095238093,0.42857142857142855,82039847,21,8
1,7,0.125,0.5357142857142857,73459953,8,1
0,7,0.2222222222222222,0.2222222222222222,72808743,9,2
1,6,0.3333333333333333,0.85,74709026,9,3
1,3,0.25,0.6,80046162,4,1
2,4,0.5,0.8125,70282443,8,4
2,0,1.0,1.0,80134830,1,1
1,11,0.26666666666666666,0.8979591836734694,69857893,15,4
0,8,0.1111111111111111,0.3125,66035935,9,1
0,5,0.16666666666666666,0.4,68467861,6,1
2,0,1.0,1.0,61486684,7,7
0,4,0.2,0.16666666666666666,69946401,5,1
1,10,0.3333333333333333,0.7142857142857143,82023701,15,5
1,5,0.2857142857142857,0.6666666666666666,70697914,7,2
1,4,0.3333333333333333,0.6,70639912,6,2
0,10,0.09090909090909091,0.33783783783783783,70706713,11,1
0,6,0.0,0.0,80177437,6,0
2,2,0.6666666666666666,0.5,72474724,6,4
1,5,0.375,0.84375,80167083,8,3
2,0,1.0,1.0,82090147,3,3
1,6,0.45454545454545453,0.625,80083311,11,5
0,2,0.3333333333333333,0.0,80153701,3,1
2,0,1.0,1.0,82033528,15,15
0,2,0.0,0.0,69467041,2,0
0,1,0.0,0.0,80061471,1,0
1,5,0.4444444444444444,0.9090909090909091,69183184,9,4
1,6,0.4,0.7368421052631579,82045530,10,4
1,6,0.14285714285714285,0.5555555555555556,70746382,7,1
2,1,0.5,0.5,70960022,2,1
0,6,0.0,0.0,82250593,6,0
0,12,0.0,0.0,70691873,12,0
1,3,0.4,0.9090909090909091,70702303,5,2
2,3,0.5714285714285714,0.6,66402455,7,4
0,40,0.09090909090909091,0.21164021164021163,82050499,44,4
2,0,1.0,1.0,80053715,1,1
0,6,0.0,0.0,82039889,6,0
0,14,0.17647058823529413,0.35294117647058826,82022539,17,3
2,2,0.5,0.875,65595873,4,2
1,5,0.2857142857142857,0.6363636363636364,69660584,7,2
0,5,0.0,0.0,68192481,5,0
1,6,0.14285714285714285,0.75,80145559,7,1
0,15,0.0625,0.0,82124918,16,1
2,1,0.5,0.9090909090909091,70238651,2,1
1,3,0.4,0.85,81989786,5,2
2,1,0.8571428571428571,0.75,80084823,7,6
0,1,0.0,0.0,68248845,1,0
2,0,1.0,1.0,82102223,2,2
0,2,0.3333333333333333,0.0,82145158,3,1
0,5,0.0,0.0,67199734,5,0
2,2,0.7142857142857143,0.9375,72801554,7,5
0,9,0.25,0.4339622641509434,70183183,12,3
2,0,1.0,1.0,80150284,1,1
2,1,0.8571428571428571,0.75,80003686,7,6
0,3,0.0,0.0,70678195,3,0
2,1,0.5,0.9,70470085,2,1
0,4,0.0,0.0,69549424,4,0
0,4,0.0,0.0,69550110,4,0
2,2,0.6666666666666666,0.8888888888888888,80175671,6,4
0,2,0.0,0.0,70490294,2,0
2,2,0.8333333333333334,0.8888888888888888,74047785,12,10
1,11,0.47619047619047616,0.8235294117647058,68401963,21,10
2,3,0.5714285714285714,0.8,69704243,7,4
2,4,0.5,0.7272727272727273,77711081,8,4
2,0,1.0,1.0,80136524,1,1
1,13,0.3157894736842105,0.6333333333333333,65279711,19,6
0,1,0.0,0.0,62957923,1,0
2,0,1.0,1.0,64197070,1,1
2,3,0.75,0.75,73935785,12,9
0,3,0.25,0.4827586206896552,73296062,4,1
1,3,0.25,0.8260869565217391,68607126,4,1
1,17,0.2916666666666667,0.8333333333333334,82145534,24,7
2,2,0.6,0.75,82145521,5,3
1,2,0.3333333333333333,0.6666666666666666,82013544,3,1
1,17,0.41379310344827586,0.7962962962962963,66102582,29,12
1,7,0.3,0.7575757575757576,82002240,10,3
2,2,0.8666666666666667,0.75,69882890,15,13
0,8,0.0,0.0,70682542,8,0
1,4,0.42857142857142855,0.875,69638702,7,3
1,4,0.3333333333333333,0.9411764705882353,80074491,6,2
0,3,0.0,0.0,70210441,3,0
0,9,0.0,0.0,69596415,9,0
1,8,0.2,0.7619047619047619,70198156,10,2
0,17,0.0,0.0,70198226,17,0
0,25,0.07407407407407407,0.48,70198275,27,2
0,25,0.0,0.0,70198296,25,0
0,1,0.0,0.0,82202364,1,0
0,9,0.0,0.0,70759255,9,0
1,7,0.3,0.6111111111111112,82001870,10,3
1,2,0.3333333333333333,0.8,69024585,3,1
2,3,0.625,0.8888888888888888,82251159,8,5
1,3,0.25,0.875,67403742,4,1
2,7,0.5882352941176471,0.9,82039843,17,10
0,2,0.0,0.0,65713473,2,0
0,4,0.2,0.2857142857142857,62752046,5,1
2,4,0.5,0.6666666666666666,66228582,8,4
2,0,1.0,1.0,64871891,1,1
2,1,0.6666666666666666,0.8888888888888888,76574141,3,2
0,7,0.3,0.42857142857142855,74989621,10,3
1,3,0.4,0.8333333333333334,70573811,5,2
0,18,0.18181818181818182,0.4032258064516129,786324,22,4
2,5,0.5,0.8333333333333334,82022396,10,5
1,16,0.36,0.7358490566037735,82109937,25,9
2,1,0.5,0.6666666666666666,68563446,2,1
1,7,0.4166666666666667,0.7272727272727273,67182332,12,5
2,0,1.0,1.0,82097535,3,3
0,2,0.0,0.0,82102784,2,0
1,4,0.2,0.6808510638297872,70229306,5,1
0,2,0.3333333333333333,0.3333333333333333,70608846,3,1
0,7,0.125,0.14285714285714285,70706734,8,1
2,1,0.8333333333333334,0.75,80118528,6,5
2,1,0.5,0.0,80127359,2,1
0,14,0.125,0.2857142857142857,69611213,16,2
0,2,0.0,0.0,70686084,2,0
0,8,0.0,0.0,65286655,8,0
2,13,0.5806451612903226,0.5238095238095238,66280753,31,18
2,3,0.5,0.7857142857142857,80054730,6,3
0,23,0.11538461538461539,0.4805194805194805,70463281,26,3
0,7,0.0,0.0,80150889,7,0
0,1,0.0,0.0,70117194,1,0
0,2,0.0,0.0,82102762,2,0
0,15,0.11764705882352941,0.4,80163181,17,2
0,2,0.0,0.0,82102796,2,0
1,2,0.3333333333333333,0.8181818181818182,80167279,3,1
0,3,0.0,0.0,80167294,3,0
1,14,0.17647058823529413,0.631578947368421,68440673,17,3
0,7,0.125,0.42105263157894735,80135300,8,1
0,6,0.14285714285714285,0.25,82050503,7,1
0,1,0.0,0.0,71081290,1,0
0,2,0.0,0.0,82006164,2,0
0,1,0.0,0.0,82006216,1,0
0,27,0.0,0.0,67045720,27,0
1,5,0.16666666666666666,0.7272727272727273,82006612,6,1
0,12,0.07692307692307693,0.28378378378378377,82102914,13,1
1,6,0.4,0.8461538461538461,69886320,10,4
2,0,1.0,1.0,70927822,1,1
0,21,0.045454545454545456,0.20192307692307693,67454842,22,1
1,8,0.1111111111111111,0.5686274509803921,82102871,9,1
0,9,0.0,0.0,82102901,9,0
1,11,0.21428571428571427,0.7796610169491526,67917661,14,3
0,5,0.0,0.0,80169894,5,0
0,5,0.0,0.0,67917416,5,0
0,1,0.0,0.0,65559550,1,0
0,6,0.0,0.0,80029096,6,0
0,6,0.25,0.42857142857142855,69895840,8,2
2,1,0.5,0.6666666666666666,70280623,2,1
0,6,0.14285714285714285,0.42857142857142855,70921452,7,1
2,0,1.0,1.0,67311783,1,1
0,1,0.0,0.0,80150771,1,0
0,11,0.08333333333333333,0.0,74513845,12,1
0,3,0.0,0.0,70746165,3,0
0,29,0.0,0.0,80124195,29,0
0,1,0.0,0.0,69596772,1,0
0,23,0.14814814814814814,0.17142857142857143,80180221,27,4
1,11,0.35294117647058826,0.7894736842105263,80156405,17,6
2,1,0.5,0.5,63953715,2,1
2,0,1.0,1.0,80161941,2,2
0,11,0.0,0.0,70567994,11,0
2,1,0.875,0.0,80136563,8,7
1,4,0.42857142857142855,0.8,80094266,7,3
0,5,0.375,0.3333333333333333,80095064,8,3
2,0,1.0,1.0,80126847,1,1
1,2,0.3333333333333333,0.8823529411764706,70801465,3,1
1,7,0.3,0.8148148148148148,79453262,10,3
1,3,0.25,0.875,69634523,4,1
2,5,0.5833333333333334,0.9166666666666666,69466621,12,7
2,0,1.0,1.0,72801764,1,1
2,1,0.6666666666666666,0.0,67547543,3,2
0,50,0.09090909090909091,0.16363636363636364,72920904,55,5
2,0,1.0,1.0,66237934,1,1
2,0,1.0,1.0,70071715,3,3
0,5,0.0,0.0,63993090,5,0
2,1,0.5,0.7142857142857143,82041714,2,1
0,5,0.16666666666666666,0.14285714285714285,69895602,6,1
1,11,0.35294117647058826,0.8571428571428571,69841212,17,6
2,4,0.6363636363636364,0.8888888888888888,67981865,11,7
2,0,1.0,1.0,66235050,1,1
0,2,0.0,0.0,69924813,2,0
0,1,0.0,0.0,70701414,1,0
0,1,0.0,0.0,72910054,1,0
0,2,0.0,0.0,70509740,2,0
1,4,0.3333333333333333,0.5714285714285714,69047496,6,2
0,7,0.2222222222222222,0.16666666666666666,80162118,9,2
0,4,0.0,0.0,70037345,4,0
2,2,0.5,0.8,73623746,4,2
2,1,0.6666666666666666,0.8333333333333334,70063812,3,2
2,2,0.5,0.3333333333333333,80176646,4,2
2,0,1.0,1.0,82041544,1,1
0,4,0.0,0.0,69596450,4,0
0,5,0.16666666666666666,0.35294117647058826,70699790,6,1
0,1,0.0,0.0,70704536,1,0
1,3,0.4,0.6666666666666666,72910103,5,2
1,3,0.25,0.5714285714285714,70327264,4,1
1,3,0.4,0.7727272727272727,71434832,5,2
2,0,1.0,1.0,67830875,1,1
2,1,0.9523809523809523,0.5,80118217,21,20
2,6,0.625,0.6,80112935,16,10
0,2,0.0,0.0,69006644,2,0
0,2,0.0,0.0,69006805,2,0
1,6,0.25,0.8620689655172413,70801444,8,2
2,1,0.6666666666666666,0.5,69536873,3,2
2,0,1.0,1.0,67464152,1,1
0,9,0.18181818181818182,0.41935483870967744,65290400,11,2
0,29,0.06451612903225806,0.248,80149876,31,2
0,6,0.25,0.4444444444444444,65812271,8,2
1,7,0.3,0.7954545454545454,66620113,10,3
1,3,0.4,0.8333333333333334,80119099,5,2
0,1,0.0,0.0,82018768,1,0
1,3,0.4,0.8888888888888888,82018769,5,2
0,2,0.0,0.0,79651313,2,0
2,0,1.0,1.0,69738494,3,3
2,1,0.8333333333333334,0.5,80172926,6,5
2,5,0.7727272727272727,0.8888888888888888,69207383,22,17
2,0,1.0,1.0,75636085,7,7
2,0,1.0,1.0,80003910,3,3
2,0,1.0,1.0,82020836,2,2
2,0,1.0,1.0,80137591,2,2
2,6,0.6666666666666666,0.8461538461538461,82171878,18,12
2,0,1.0,1.0,80162580,13,13
2,4,0.6363636363636364,0.75,80158328,11,7
2,0,1.0,1.0,82000479,3,3
2,0,1.0,1.0,80162122,3,3
2,0,1.0,1.0,80141538,6,6
2,0,1.0,1.0,80159699,4,4
0,4,0.2,0.1111111111111111,69640025,5,1
2,2,0.8,0.75,75662720,10,8
2,0,1.0,1.0,80093692,1,1
2,0,1.0,1.0,82012001,19,19
2,0,1.0,1.0,68285875,7,7
2,0,1.0,1.0,68385471,4,4
2,0,1.0,1.0,82024293,1,1
2,1,0.8571428571428571,0.5,80161998,7,6
1,2,0.3333333333333333,0.5,80128383,3,1
1,10,0.16666666666666666,0.6557377049180327,70238210,12,2
0,1,0.0,0.0,68569424,1,0
2,2,0.6,0.5,69065444,5,3
0,1,0.0,0.0,73255672,1,0
0,1,0.0,0.0,681744,1,0
1,3,0.25,0.631578947368421,69092793,4,1
0,7,0.125,0.36,63981785,8,1
2,1,0.6666666666666666,0.5,63737884,3,2
2,1,0.75,0.6666666666666666,80139943,4,3
0,15,0.0625,0.39705882352941174,69525925,16,1
2,0,1.0,1.0,75362945,4,4
1,4,0.3333333333333333,0.8823529411764706,68115250,6,2
0,8,0.0,0.0,68572343,8,0
0,1,0.0,0.0,70930776,1,0
2,1,0.6666666666666666,0.5,70468202,3,2
1,5,0.2857142857142857,0.7333333333333333,66782786,7,2
0,10,0.09090909090909091,0.44680851063829785,66782156,11,1
2,3,0.7272727272727273,0.5,68420835,11,8
2,1,0.6666666666666666,0.0,80126550,3,2
2,2,0.8333333333333334,0.6666666666666666,82040688,12,10
1,2,0.3333333333333333,0.6666666666666666,67831204,3,1
0,4,0.0,0.0,67831330,4,0
0,6,0.0,0.0,70680491,6,0
1,4,0.3333333333333333,0.7272727272727273,70546350,6,2
2,2,0.6666666666666666,0.6,69507473,6,4
0,15,0.16666666666666666,0.4125,70703066,18,3
2,0,1.0,1.0,69660472,4,4
1,8,0.4666666666666667,0.8125,82096245,15,7
0,3,0.25,0.375,70481481,4,1
0,4,0.0,0.0,68756884,4,0
0,2,0.0,0.0,69160812,2,0
0,8,0.1111111111111111,0.2692307692307692,63267281,9,1
2,2,0.6666666666666666,0.8,80135231,6,4
0,3,0.0,0.0,82205926,3,0
0,2,0.0,0.0,66110730,2,0
0,14,0.0,0.0,70063063,14,0
0,3,0.0,0.0,80177696,3,0
1,10,0.4117647058823529,0.7692307692307693,61871691,17,7
1,8,0.42857142857142855,0.9285714285714286,70674023,14,6
2,0,1.0,1.0,63501844,3,3
0,5,0.0,0.0,73295845,5,0
1,7,0.46153846153846156,0.75,69170101,13,6
0,15,0.0,0.0,72809163,15,0
2,0,1.0,1.0,80126499,7,7
1,5,0.375,0.9047619047619048,67053826,8,3
0,1,0.0,0.0,69484023,1,0
0,1,0.0,0.0,69484373,1,0
2,0,1.0,1.0,82038250,8,8
1,3,0.25,0.6428571428571429,70693945,4,1
0,3,0.0,0.0,70694253,3,0
1,5,0.4444444444444444,0.9615384615384616,82052045,9,4
2,0,1.0,1.0,82140300,3,3
1,2,0.3333333333333333,0.7142857142857143,70694400,3,1
0,9,0.0,0.0,78763034,9,0
0,4,0.2,0.3333333333333333,70868161,5,1
2,4,0.5,0.6666666666666666,69489203,8,4
2,2,0.5,0.5,62143662,4,2
2,2,0.5,0.3333333333333333,70768313,4,2
2,1,0.6666666666666666,0.8,69180482,3,2
2,0,1.0,1.0,82033541,3,3
0,4,0.2,0.2,82143662,5,1
1,6,0.3333333333333333,0.7368421052631579,80128220,9,3
1,7,0.2222222222222222,0.6956521739130435,82135617,9,2
2,0,1.0,1.0,64197952,2,2
2,0,1.0,1.0,67822090,1,1
2,2,0.5,0.5,67822825,4,2
0,3,0.0,0.0,69701583,3,0
2,3,0.7272727272727273,0.9642857142857143,82017806,11,8
0,2,0.0,0.0,70175742,2,0
0,1,0.0,0.0,69002283,1,0
1,6,0.45454545454545453,0.9629629629629629,72803213,11,5
0,1,0.0,0.0,67831575,1,0
0,1,0.0,0.0,61356351,1,0
2,0,1.0,1.0,61684294,3,3
2,2,0.5,0.3333333333333333,68960220,4,2
2,0,1.0,1.0,80161951,2,2
0,1,0.0,0.0,69319355,1,0
0,1,0.0,0.0,82010252,1,0
1,6,0.3333333333333333,0.9333333333333333,70608293,9,3
2,4,0.6666666666666666,0.5555555555555556,80180397,12,8
1,5,0.16666666666666666,0.5945945945945946,78735475,6,1
0,9,0.0,0.0,80053946,9,0
1,13,0.2777777777777778,0.6052631578947368,65290323,18,5
0,13,0.0,0.0,70675311,13,0
0,4,0.0,0.0,70679693,4,0
2,3,0.6666666666666666,0.5,72803794,9,6
0,7,0.125,0.045454545454545456,66267243,8,1
0,2,0.0,0.0,70494263,2,0
0,2,0.0,0.0,68497590,2,0
1,7,0.125,0.5,68499585,8,1
0,4,0.0,0.0,70801591,4,0
0,8,0.1111111111111111,0.18181818181818182,66257352,9,1
0,6,0.14285714285714285,0.47619047619047616,69400534,7,1
0,11,0.15384615384615385,0.09523809523809523,68907433,13,2
0,4,0.0,0.0,82145537,4,0
0,2,0.3333333333333333,0.0,69734084,3,1
1,2,0.3333333333333333,0.75,69416032,3,1
0,16,0.0,0.0,63239785,16,0
2,1,0.6666666666666666,0.75,79792454,3,2
0,6,0.14285714285714285,0.3333333333333333,69204191,7,1
0,6,0.0,0.0,70674744,6,0
0,5,0.0,0.0,70680316,5,0
0,18,0.14285714285714285,0.36470588235294116,80126811,21,3
0,4,0.0,0.0,65884896,4,0
2,2,0.6666666666666666,0.6,67199132,6,4
1,4,0.2,0.5,80124511,5,1
0,3,0.25,0.2857142857142857,70223321,4,1
1,8,0.4666666666666667,0.7368421052631579,62143550,15,7
2,1,0.75,0.5,82018860,4,3
2,1,0.8,0.5,80092103,5,4
2,2,0.7777777777777778,0.6,75346390,9,7
2,1,0.5,0.4,80165340,2,1
2,0,1.0,1.0,82046066,1,1
2,0,1.0,1.0,72814532,2,2
1,34,0.20930232558139536,0.5058823529411764,67627252,43,9
0,5,0.16666666666666666,0.0,80153619,6,1
0,1,0.0,0.0,70398790,1,0
1,14,0.125,0.6290322580645161,70488936,16,2
2,0,1.0,1.0,80135033,2,2
0,5,0.16666666666666666,0.4444444444444444,60232494,6,1
2,2,0.5,0.75,73102820,4,2
2,3,0.6666666666666666,0.6666666666666666,70690970,9,6
1,2,0.3333333333333333,0.6,80118352,3,1
2,0,1.0,1.0,67652900,1,1
0,3,0.0,0.0,82102591,3,0
1,4,0.3333333333333333,0.8888888888888888,69736443,6,2
2,0,1.0,1.0,80019310,3,3
2,1,0.5,0.5,74089323,2,1
0,12,0.25,0.3125,80123734,16,4
2,0,1.0,1.0,67822426,1,1
0,2,0.0,0.0,67831295,2,0
0,11,0.0,0.0,70198163,11,0
1,12,0.07692307692307693,0.5384615384615384,70198184,13,1
0,6,0.0,0.0,70703773,6,0
0,9,0.0,0.0,72909620,9,0
1,6,0.14285714285714285,0.65,64129905,7,1
2,0,1.0,1.0,82118256,3,3
0,5,0.16666666666666666,0.4666666666666667,69640732,6,1
0,3,0.0,0.0,67467540,3,0
1,7,0.125,0.6285714285714286,80150556,8,1
0,3,0.0,0.0,82118284,3,0
0,9,0.1,0.32142857142857145,80163182,10,1
1,10,0.16666666666666666,0.6551724137931034,67976125,12,2
0,4,0.0,0.0,80165872,4,0
0,3,0.0,0.0,80163159,3,0
0,5,0.0,0.0,80163166,5,0
2,6,0.5,0.9285714285714286,82118286,12,6
2,1,0.5,0.5,69973113,2,1
0,6,0.0,0.0,80163160,6,0
0,11,0.15384615384615385,0.48484848484848486,80163190,13,2
1,22,0.12,0.515625,65716574,25,3
2,1,0.5,0.8,74027842,2,1
1,3,0.25,0.7777777777777778,80165843,4,1
0,2,0.0,0.0,80169906,2,0
0,7,0.0,0.0,64235073,7,0
0,6,0.14285714285714285,0.375,80172522,7,1
0,7,0.0,0.0,82006633,7,0
0,4,0.0,0.0,80150647,4,0
2,3,0.5,0.8571428571428571,65335760,6,3
0,7,0.0,0.0,80150688,7,0
2,2,0.5,0.8,70917014,4,2
2,2,0.8461538461538461,0.6666666666666666,64469076,13,11
0,24,0.1111111111111111,0.16470588235294117,67344683,27,3
1,7,0.125,0.5,70917105,8,1
0,3,0.0,0.0,67706135,3,0
2,1,0.5,0.7142857142857143,69974513,2,1
0,12,0.0,0.0,82137502,12,0
0,11,0.0,0.0,82137503,11,0
0,10,0.0,0.0,82138814,10,0
0,4,0.0,0.0,67620581,4,0
0,11,0.15384615384615385,0.1875,69622154,13,2
1,6,0.25,0.5294117647058824,65279403,8,2
1,3,0.4,0.8571428571428571,65279480,5,2
0,5,0.0,0.0,64976135,5,0
0,7,0.0,0.0,64409912,7,0
1,7,0.36363636363636365,0.5581395348837209,82133036,11,4
2,1,0.6666666666666666,0.9,82143663,3,2
2,0,1.0,1.0,66159625,2,2
1,6,0.4,0.8421052631578947,65716924,10,4
0,9,0.1,0.24390243902439024,67053805,10,1
0,10,0.0,0.0,70474516,10,0
0,7,0.0,0.0,82102536,7,0
0,7,0.0,0.0,82102622,7,0
2,3,0.625,0.8333333333333334,74048723,8,5
0,1,0.0,0.0,65292682,1,0
1,7,0.4166666666666667,0.8333333333333334,80153667,12,5
0,1,0.0,0.0,70684873,1,0
0,11,0.08333333333333333,0.09523809523809523,70626486,12,1
2,0,1.0,1.0,68258610,4,4
2,0,1.0,1.0,12200846,2,2
0,25,0.10714285714285714,0.31,67475282,28,3
1,3,0.25,0.8148148148148148,67754722,4,1
0,7,0.0,0.0,70229145,7,0
0,6,0.0,0.0,70229915,6,0
0,11,0.0,0.0,70801430,11,0
0,10,0.0,0.0,70801542,10,0
2,0,1.0,1.0,82033523,13,13
0,4,0.0,0.0,70508501,4,0
0,1,0.0,0.0,70317926,1,0
1,3,0.25,0.7,65135105,4,1
0,6,0.0,0.0,70694246,6,0
0,13,0.23529411764705882,0.3448275862068966,69630050,17,4
1,8,0.42857142857142855,0.9565217391304348,74708732,14,6
2,2,0.6666666666666666,0.8333333333333334,82038363,6,4
1,16,0.15789473684210525,0.5362318840579711,70746151,19,3
1,4,0.3333333333333333,0.5,80118289,6,2
1,12,0.4,0.9452054794520548,70600404,20,8
2,4,0.5,0.8888888888888888,68273702,8,4
2,0,1.0,1.0,82020749,1,1
0,1,0.0,0.0,67220650,1,0
0,4,0.2,0.3333333333333333,80163417,5,1
0,3,0.0,0.0,80163419,3,0
1,6,0.4,0.9285714285714286,80177709,10,4
0,7,0.125,0.09090909090909091,66802813,8,1
0,15,0.16666666666666666,0.328125,67793593,18,3
2,6,0.7692307692307693,0.8461538461538461,80117711,26,20
0,1,0.0,0.0,70493220,1,0
2,3,0.5,0.6666666666666666,80118255,6,3
2,1,0.8,0.5,80137920,5,4
1,10,0.2857142857142857,0.5909090909090909,73266305,14,4
0,6,0.14285714285714285,0.2631578947368421,70175770,7,1
0,3,0.0,0.0,70175455,3,0
0,7,0.0,0.0,67516575,7,0
2,3,0.7857142857142857,0.5,82037164,14,11
2,8,0.6,0.96,80165892,20,12
2,0,1.0,1.0,70183981,1,1
2,4,0.6666666666666666,0.8333333333333334,82062193,12,8
1,2,0.3333333333333333,0.625,80180267,3,1
0,2,0.0,0.0,73078803,2,0
1,2,0.3333333333333333,0.5,73079146,3,1
2,3,0.6666666666666666,0.8333333333333334,80118583,9,6
2,0,1.0,1.0,82054709,1,1
2,0,1.0,1.0,82008296,3,3
2,3,0.8421052631578947,0.75,70255864,19,16
1,5,0.16666666666666666,0.6363636363636364,82022518,6,1
2,0,1.0,1.0,80162577,2,2
2,0,1.0,1.0,70185052,2,2
1,4,0.3333333333333333,0.5,73137162,6,2
2,1,0.6666666666666666,0.6666666666666666,68805555,3,2
2,0,1.0,1.0,82033546,1,1
1,3,0.4,0.5,80150341,5,2
0,6,0.0,0.0,70850843,6,0
1,2,0.3333333333333333,0.9,67286135,3,1
2,0,1.0,1.0,80140253,4,4
2,1,0.5,0.8571428571428571,590863,2,1
2,0,1.0,1.0,75346495,4,4
2,1,0.8333333333333334,0.75,69315820,6,5
1,2,0.3333333333333333,0.6,70059773,3,1
1,7,0.36363636363636365,0.7241379310344828,80128520,11,4
0,5,0.0,0.0,67467890,5,0
2,0,1.0,1.0,82020369,1,1
1,2,0.3333333333333333,0.5,80139944,3,1
2,0,1.0,1.0,80165326,3,3
2,3,0.5,0.8571428571428571,82010266,6,3
2,4,0.5555555555555556,0.8571428571428571,74051712,9,5
2,0,1.0,1.0,82006288,1,1
0,7,0.125,0.07407407407407407,82018977,8,1
0,15,0.11764705882352941,0.29310344827586204,82103922,17,2
2,0,1.0,1.0,64457505,1,1
0,8,0.2,0.4090909090909091,70766416,10,2
2,0,1.0,1.0,64459115,3,3
1,10,0.4444444444444444,0.9354838709677419,70494606,18,8
0,2,0.0,0.0,72474626,2,0
0,20,0.09090909090909091,0.18518518518518517,81900753,22,2
0,1,0.0,0.0,70681310,1,0
0,11,0.08333333333333333,0.09090909090909091,77677026,12,1
2,1,0.75,0.75,72803661,4,3
1,14,0.391304347826087,0.9302325581395349,62003851,23,9
2,5,0.6153846153846154,0.5,70892423,13,8
1,4,0.42857142857142855,0.75,69116971,7,3
1,2,0.3333333333333333,0.7,78858570,3,1
2,0,1.0,1.0,70238665,1,1
1,3,0.25,0.8484848484848485,80166914,4,1
1,2,0.3333333333333333,0.6666666666666666,72802303,3,1
2,4,0.6363636363636364,0.8888888888888888,68519976,11,7
1,19,0.40625,0.9333333333333333,66857714,32,13
1,9,0.3076923076923077,0.7407407407407407,64069845,13,4
1,4,0.3333333333333333,0.7368421052631579,73295635,6,2
2,0,1.0,1.0,63447496,3,3
2,0,1.0,1.0,67508231,3,3
2,3,0.5,0.8333333333333334,69964440,6,3
2,5,0.5454545454545454,0.8571428571428571,80155228,11,6
1,8,0.38461538461538464,0.7894736842105263,62219493,13,5
0,28,0.06666666666666667,0.2441860465116279,74924402,30,2
0,10,0.0,0.0,70705943,10,0
0,19,0.05,0.06756756756756757,64129982,20,1
1,10,0.23076923076923078,0.52,70921354,13,3
0,7,0.0,0.0,82102628,7,0
0,2,0.0,0.0,82102903,2,0
0,4,0.2,0.38461538461538464,82010271,5,1
0,4,0.2,0.0,69604122,5,1
0,11,0.15384615384615385,0.3684210526315789,60242623,13,2
0,4,0.0,0.0,68607154,4,0
1,11,0.26666666666666666,0.6923076923076923,80149270,15,4
0,2,0.3333333333333333,0.0,80130732,3,1
0,1,0.0,0.0,70317835,1,0
1,3,0.4,0.8636363636363636,70914221,5,2
0,12,0.07692307692307693,0.2222222222222222,66547460,13,1
0,3,0.0,0.0,69153980,3,0
2,3,0.6666666666666666,0.8571428571428571,80165171,9,6
0,2,0.0,0.0,72909886,2,0
2,5,0.5833333333333334,0.6666666666666666,76571824,12,7
2,0,1.0,1.0,69918156,2,2
1,8,0.2727272727272727,0.6666666666666666,70677544,11,3
1,16,0.15789473684210525,0.5423728813559322,70675535,19,3
0,2,0.0,0.0,70109865,2,0
0,3,0.0,0.0,70109935,3,0
2,0,1.0,1.0,80159695,2,2
0,1,0.0,0.0,70706335,1,0
1,4,0.42857142857142855,0.6666666666666666,70121226,7,3
0,5,0.0,0.0,69633263,5,0
2,4,0.6,0.8947368421052632,80155301,10,6
2,1,0.5,0.8571428571428571,82070201,2,1
1,8,0.4666666666666667,0.9285714285714286,76081201,15,7
2,2,0.75,0.6666666666666666,72823394,8,6
0,4,0.0,0.0,70680820,4,0
0,6,0.0,0.0,70843843,6,0
0,1,0.0,0.0,70682976,1,0
2,2,0.5,0.9375,68766873,4,2
1,4,0.3333333333333333,0.9166666666666666,70676284,6,2
0,1,0.0,0.0,65926392,1,0
0,4,0.0,0.0,78763734,4,0
0,1,0.0,0.0,68675005,1,0
0,1,0.0,0.0,68675082,1,0
2,9,0.5909090909090909,0.8846153846153846,80180601,22,13
2,0,1.0,1.0,71021713,4,4
2,1,0.6666666666666666,0.5,82051897,3,2
2,0,1.0,1.0,82039418,5,5
1,19,0.17391304347826086,0.5211267605633803,70060445,23,4
1,22,0.3125,0.7647058823529411,73983364,32,10
2,2,0.6,0.75,70240184,5,3
0,7,0.36363636363636365,0.36363636363636365,63242984,11,4
0,7,0.0,0.0,70684453,7,0
0,2,0.3333333333333333,0.0,75277153,3,1
2,0,1.0,1.0,66395553,10,10
0,3,0.0,0.0,70705964,3,0
2,0,1.0,1.0,67257820,1,1
1,6,0.25,0.5454545454545454,70758695,8,2
1,4,0.42857142857142855,0.9375,68383721,7,3
2,0,1.0,1.0,70761642,3,3
2,0,1.0,1.0,82051751,3,3
2,1,0.6666666666666666,0.6666666666666666,69950104,3,2
0,6,0.0,0.0,80126770,6,0
0,10,0.09090909090909091,0.03571428571428571,65451456,11,1
2,10,0.6,0.9459459459459459,82010235,25,15
2,1,0.6666666666666666,0.5,70037233,3,2
1,2,0.3333333333333333,0.8461538461538461,69093675,3,1
0,8,0.1111111111111111,0.037037037037037035,74708683,9,1
2,1,0.5,0.7777777777777778,69458452,2,1
0,3,0.0,0.0,67081336,3,0
2,2,0.6666666666666666,0.5,66212006,6,4
0,1,0.0,0.0,82095057,1,0
2,0,1.0,1.0,82018775,1,1
2,4,0.8095238095238095,0.875,82095119,21,17
2,4,0.5555555555555556,0.6666666666666666,80136921,9,5
0,5,0.16666666666666666,0.2857142857142857,67656890,6,1
0,9,0.0,0.0,62835115,9,0
1,6,0.3333333333333333,0.5,80165355,9,3
2,0,1.0,1.0,70348593,1,1
1,6,0.25,0.7096774193548387,74789806,8,2
0,9,0.0,0.0,74510492,9,0
1,3,0.25,0.6538461538461539,75149662,4,1
2,1,0.8,0.5,82165059,5,4
1,2,0.3333333333333333,0.8571428571428571,80069892,3,1
0,1,0.0,0.0,70686056,1,0
2,0,1.0,1.0,69027000,1,1
2,0,1.0,1.0,80178170,2,2
0,4,0.2,0.39285714285714285,70675185,5,1
2,2,0.6,0.8888888888888888,70770504,5,3
2,1,0.5,0.5,66235666,2,1
0,5,0.0,0.0,65279074,5,0
0,4,0.3333333333333333,0.42857142857142855,65293172,6,2
2,0,1.0,1.0,65635066,1,1
2,9,0.5,0.9642857142857143,65280481,18,9
0,7,0.0,0.0,82102885,7,0
0,19,0.20833333333333334,0.4318181818181818,74086593,24,5
1,5,0.2857142857142857,0.8,74086831,7,2
2,4,0.5555555555555556,0.7142857142857143,69207061,9,5
1,10,0.375,0.6923076923076923,68475512,16,6
1,10,0.23076923076923078,0.8125,70417256,13,3
0,1,0.0,0.0,67910283,1,0
0,4,0.0,0.0,69092331,4,0
2,1,0.5,0.5,67404512,2,1
0,4,0.0,0.0,69870213,4,0
2,1,0.5,0.5,72802240,2,1
1,7,0.36363636363636365,0.8260869565217391,68546702,11,4
1,11,0.26666666666666666,0.7536231884057971,69868120,15,4
0,1,0.0,0.0,64473045,1,0
2,2,0.5,0.9375,69549655,4,2
2,1,0.75,0.75,80118137,4,3
0,7,0.0,0.0,69386513,7,0
0,8,0.0,0.0,82206140,8,0
0,9,0.1,0.4074074074074074,74161262,10,1
0,8,0.0,0.0,78763146,8,0
0,2,0.0,0.0,74161136,2,0
1,10,0.16666666666666666,0.5789473684210527,80163180,12,2
0,3,0.25,0.3333333333333333,67970931,4,1
1,12,0.14285714285714285,0.5588235294117647,69528004,14,2
1,5,0.2857142857142857,0.7058823529411765,82006871,7,2
1,8,0.38461538461538464,0.9722222222222222,70482664,13,5
1,4,0.2,0.75,80150723,5,1
0,9,0.0,0.0,70635292,9,0
0,4,0.0,0.0,80162894,4,0
0,3,0.0,0.0,80172529,3,0
0,2,0.0,0.0,82006864,2,0
0,7,0.0,0.0,70463211,7,0
0,10,0.09090909090909091,0.49056603773584906,63984452,11,1
0,3,0.0,0.0,80162888,3,0
0,9,0.0,0.0,80150724,9,0
1,13,0.1875,0.5846153846153846,68598586,16,3
0,2,0.0,0.0,74161122,2,0
0,17,0.0,0.0,67051320,17,0
1,6,0.25,0.8275862068965517,80165837,8,2
2,1,0.6666666666666666,0.5,69736436,3,2
0,9,0.18181818181818182,0.3939393939393939,82050500,11,2
1,6,0.14285714285714285,0.65625,80172545,7,1
0,7,0.3,0.25,80061114,10,3
1,3,0.4,0.5,67824134,5,2
0,7,0.2222222222222222,0.47368421052631576,80136471,9,2
2,0,1.0,1.0,69069413,2,2
2,1,0.8888888888888888,0.8,82135111,9,8
0,5,0.0,0.0,65977324,5,0
2,5,0.5,0.9166666666666666,68009431,10,5
0,10,0.09090909090909091,0.2857142857142857,69463373,11,1
2,1,0.5,0.6666666666666666,82022403,2,1
0,9,0.1,0.0,70543662,10,1
0,2,0.0,0.0,68144083,2,0
2,1,0.5,0.0,70190421,2,1
0,2,0.3333333333333333,0.0,75048022,3,1
2,4,0.6363636363636364,0.9166666666666666,68034414,11,7
1,5,0.4444444444444444,0.9444444444444444,80162881,9,4
1,6,0.25,0.6363636363636364,69193775,8,2
2,4,0.6,0.5454545454545454,69956033,10,6
0,1,0.0,0.0,68157292,1,0
0,21,0.0,0.0,82003746,21,0
0,13,0.0,0.0,80128286,13,0
2,1,0.8,0.6666666666666666,82070155,5,4
2,1,0.5,0.8333333333333334,80128186,2,1
0,4,0.0,0.0,82102531,4,0
2,0,1.0,1.0,69544272,1,1
1,13,0.1875,0.6493506493506493,82050489,16,3
1,4,0.3333333333333333,0.6666666666666666,80018792,6,2
2,2,0.7142857142857143,0.6666666666666666,72471742,7,5
0,1,0.0,0.0,69841394,1,0
0,3,0.0,0.0,80164927,3,0
0,17,0.0,0.0,66111031,17,0
0,1,0.0,0.0,70720041,1,0
0,15,0.0,0.0,73489906,15,0
0,3,0.0,0.0,65544164,3,0
1,5,0.2857142857142857,0.7272727272727273,66955476,7,2
0,15,0.0,0.0,67475772,15,0
0,9,0.0,0.0,67475660,9,0
0,19,0.05,0.04838709677419355,80131230,20,1
0,24,0.1111111111111111,0.2111111111111111,69318151,27,3
2,1,0.8333333333333334,0.6666666666666666,80132334,6,5
0,4,0.3333333333333333,0.4444444444444444,71879556,6,2
1,10,0.2857142857142857,0.7727272727272727,70674275,14,4
1,4,0.2,0.7619047619047619,70747831,5,1
0,10,0.09090909090909091,0.08823529411764706,67285533,11,1
0,5,0.16666666666666666,0.2777777777777778,80141338,6,1
0,1,0.0,0.0,68394060,1,0
2,0,1.0,1.0,80132802,3,3
0,5,0.0,0.0,73635331,5,0
2,1,0.875,0.5,68163046,8,7
1,3,0.25,0.8421052631578947,68164110,4,1
0,1,0.0,0.0,65360904,1,0
2,0,1.0,1.0,70854245,1,1
2,1,0.5,0.0,82022376,2,1
2,5,0.6153846153846154,0.8888888888888888,69424502,13,8
0,1,0.0,0.0,74986233,1,0
1,2,0.3333333333333333,0.625,70923965,3,1
1,12,0.29411764705882354,0.58,73623326,17,5
0,2,0.0,0.0,70704893,2,0
0,2,0.0,0.0,70707175,2,0
1,16,0.30434782608695654,0.717391304347826,262871,23,7
2,0,1.0,1.0,69949803,1,1
2,0,1.0,1.0,66414936,1,1
1,4,0.42857142857142855,0.875,80150360,7,3
2,11,0.5217391304347826,0.9166666666666666,74324096,23,12
2,0,1.0,1.0,80079643,11,11
1,2,0.3333333333333333,0.75,67779642,3,1
2,0,1.0,1.0,80178438,2,2
2,0,1.0,1.0,70344946,3,3
0,6,0.25,0.0,75033175,8,2
2,1,0.8,0.5,80131101,5,4
2,0,1.0,1.0,70229782,1,1
2,0,1.0,1.0,80145844,1,1
2,5,0.5833333333333334,0.7777777777777778,68060622,12,7
1,2,0.3333333333333333,0.6666666666666666,66473526,3,1
0,4,0.2,0.2,66473533,5,1
2,1,0.8,0.5,82039358,5,4
1,9,0.25,0.5555555555555556,82119385,12,3
2,4,0.5,0.85,69479095,8,4
2,0,1.0,1.0,82054732,1,1
2,2,0.7777777777777778,0.6666666666666666,78252965,9,7
2,0,1.0,1.0,80159667,2,2
2,2,0.5,0.8888888888888888,68402033,4,2
1,12,0.25,0.6721311475409836,70675472,16,4
0,3,0.4,0.42857142857142855,82041721,5,2
0,9,0.1,0.15384615384615385,69525855,10,1
1,5,0.4444444444444444,0.75,80176689,9,4
0,5,0.16666666666666666,0.2222222222222222,78763643,6,1
0,49,0.0392156862745098,0.13432835820895522,67467645,51,2
0,17,0.0,0.0,67468723,17,0
0,3,0.0,0.0,66787091,3,0
1,3,0.4,0.875,65909564,5,2
0,4,0.2,0.4666666666666667,64145571,5,1
2,1,0.6666666666666666,0.5,82039402,3,2
1,5,0.4444444444444444,0.9333333333333333,82046933,9,4
0,2,0.0,0.0,72804200,2,0
1,9,0.18181818181818182,0.5384615384615384,70676186,11,2
2,1,0.6666666666666666,0.5,67672696,3,2
1,4,0.3333333333333333,0.6363636363636364,69072381,6,2
0,2,0.0,0.0,69404734,2,0
0,3,0.0,0.0,70681254,3,0
0,1,0.0,0.0,70697515,1,0
0,15,0.11764705882352941,0.3181818181818182,72808750,17,2
1,6,0.4,0.7692307692307693,70748244,10,4
2,0,1.0,1.0,80125200,7,7
0,2,0.3333333333333333,0.3333333333333333,80012681,3,1
0,4,0.0,0.0,82018987,4,0
2,3,0.5714285714285714,0.75,70216643,7,4
2,2,0.8947368421052632,0.8571428571428571,65255904,19,17
2,0,1.0,1.0,82041718,1,1
2,0,1.0,1.0,80117577,1,1
2,0,1.0,1.0,82145121,5,5
0,5,0.0,0.0,73072412,5,0
0,1,0.0,0.0,70238882,1,0
2,0,1.0,1.0,69212682,3,3
2,0,1.0,1.0,68285896,3,3
0,10,0.0,0.0,69639115,10,0
1,4,0.42857142857142855,0.75,65290092,7,3
0,1,0.0,0.0,82102499,1,0
0,6,0.0,0.0,82126776,6,0
2,2,0.5,0.75,69547835,4,2
0,20,0.09090909090909091,0.0,65812341,22,2
2,0,1.0,1.0,70037282,1,1
0,1,0.0,0.0,82145338,1,0
2,6,0.5,0.5,82140137,12,6
0,14,0.125,0.36923076923076925,68560576,16,2
0,6,0.14285714285714285,0.26666666666666666,63802704,7,1
0,5,0.0,0.0,70706405,5,0
1,9,0.18181818181818182,0.5263157894736842,72909865,11,2
0,6,0.0,0.0,80126760,6,0
1,9,0.35714285714285715,0.8666666666666667,73800986,14,5
1,4,0.3333333333333333,0.7,72803584,6,2
0,8,0.1111111111111111,0.3333333333333333,67054806,9,1
0,7,0.0,0.0,67054813,7,0
2,2,0.6,0.75,681996,5,3
0,2,0.0,0.0,82250575,2,0
0,6,0.0,0.0,65279550,6,0
2,1,0.75,0.5,80165279,4,3
0,9,0.35714285714285715,0.2222222222222222,80168336,14,5
0,3,0.0,0.0,69133890,3,0
0,2,0.0,0.0,61579112,2,0
2,0,1.0,1.0,82247777,2,2
2,1,0.75,0.5,73313464,4,3
2,1,0.5,0.6666666666666666,80176051,2,1
0,13,0.0,0.0,80128293,13,0
0,4,0.0,0.0,82043126,4,0
0,4,0.0,0.0,82152072,4,0
1,11,0.45,0.86,82023700,20,9
0,1,0.0,0.0,70675752,1,0
0,6,0.0,0.0,70680036,6,0
0,2,0.0,0.0,70692776,2,0
1,5,0.16666666666666666,0.6363636363636364,70568771,6,1
2,2,0.5,0.3333333333333333,82012242,4,2
2,0,1.0,1.0,65730042,4,4
2,1,0.75,0.5,69069336,4,3
0,11,0.08333333333333333,0.1875,80128905,12,1
0,5,0.16666666666666666,0.4074074074074074,66224382,6,1
0,5,0.16666666666666666,0.4666666666666667,82102803,6,1
0,15,0.11764705882352941,0.25,82036405,17,2
0,5,0.0,0.0,67189003,5,0
1,6,0.14285714285714285,0.5652173913043478,70238301,7,1
0,6,0.0,0.0,70746795,6,0
2,2,0.5,0.5,80025155,4,2
1,2,0.3333333333333333,0.6666666666666666,70702625,3,1
0,4,0.0,0.0,73295873,4,0
2,1,0.5,0.6666666666666666,67365816,2,1
2,0,1.0,1.0,68545015,1,1
2,0,1.0,1.0,66235134,1,1
1,4,0.2,0.5882352941176471,80116806,5,1
1,4,0.42857142857142855,0.9333333333333333,80171955,7,3
0,1,0.0,0.0,69045683,1,0
2,0,1.0,1.0,82009521,3,3
2,4,0.5555555555555556,0.8888888888888888,74028164,9,5
0,7,0.2222222222222222,0.4444444444444444,60735080,9,2
1,7,0.46153846153846156,0.9545454545454546,65281013,13,6
2,2,0.6666666666666666,0.8,82018857,6,4
0,2,0.0,0.0,82018751,2,0
2,7,0.5,0.9375,73862453,14,7
0,5,0.16666666666666666,0.19047619047619047,69479641,6,1
0,26,0.037037037037037035,0.1797752808988764,69007225,27,1
0,6,0.0,0.0,70759486,6,0
0,7,0.125,0.4583333333333333,82116862,8,1
2,1,0.75,0.8333333333333334,72804186,4,3
0,1,0.0,0.0,67899412,1,0
0,1,0.0,0.0,70677845,1,0
2,0,1.0,1.0,82033548,2,2
0,13,0.13333333333333333,0.06666666666666667,70532910,15,2
2,0,1.0,1.0,69738263,11,11
1,8,0.2727272727272727,0.5135135135135135,70707105,11,3
2,0,1.0,1.0,67799480,1,1
0,6,0.0,0.0,80122881,6,0
0,4,0.0,0.0,68497324,4,0
1,12,0.25,0.6274509803921569,67053735,16,4
0,6,0.0,0.0,69867280,6,0
0,2,0.0,0.0,82024353,2,0
2,0,1.0,1.0,70843213,1,1
2,4,0.6923076923076923,0.96,72803745,13,9
0,3,0.0,0.0,81989201,3,0
2,0,1.0,1.0,60331600,1,1
0,8,0.0,0.0,54468372,8,0
2,0,1.0,1.0,69164522,2,2
2,1,0.8333333333333334,0.6666666666666666,75347405,6,5
1,4,0.2,0.5,80153683,5,1
1,3,0.25,0.64,82022895,4,1
0,1,0.0,0.0,70697235,1,0
0,2,0.0,0.0,80132896,2,0
1,4,0.3333333333333333,0.7142857142857143,66379572,6,2
1,2,0.3333333333333333,0.9090909090909091,82102625,3,1
1,39,0.13333333333333333,0.5916230366492147,62881252,45,6
1,3,0.25,0.5555555555555556,67551260,4,1
0,1,0.0,0.0,80128200,1,0
0,3,0.0,0.0,82102640,3,0
0,3,0.0,0.0,82102651,3,0
0,16,0.0,0.0,82102911,16,0
0,12,0.0,0.0,54468393,12,0
1,19,0.4722222222222222,0.8775510204081632,80158330,36,17
0,9,0.18181818181818182,0.36,80155964,11,2
1,22,0.40540540540540543,0.825,80126967,37,15
1,8,0.2,0.6521739130434783,67159960,10,2
2,0,1.0,1.0,80094126,3,3
2,1,0.6666666666666666,0.5,75346376,3,2
0,15,0.0625,0.058823529411764705,66499090,16,1
0,4,0.0,0.0,66227161,4,0
0,1,0.0,0.0,66227882,1,0
0,4,0.0,0.0,69549340,4,0
2,1,0.5,0.5,65976750,2,1
0,11,0.0,0.0,80150696,11,0
0,8,0.0,0.0,82102866,8,0
1,7,0.125,0.7073170731707317,67975754,8,1
2,2,0.6666666666666666,0.75,74619734,6,4
0,8,0.1111111111111111,0.4186046511627907,82102919,9,1
2,0,1.0,1.0,71619723,1,1
0,2,0.0,0.0,80162840,2,0
0,1,0.0,0.0,69528060,1,0
0,13,0.13333333333333333,0.22916666666666666,74923863,15,2
0,18,0.05263157894736842,0.3333333333333333,62841401,19,1
2,3,0.625,0.8571428571428571,70821471,8,5
0,19,0.05,0.23076923076923078,70467656,20,1
0,17,0.0,0.0,67051306,17,0
2,2,0.5,0.875,82006529,4,2
1,2,0.3333333333333333,0.5555555555555556,67917276,3,1
2,0,1.0,1.0,82006768,1,1
0,1,0.0,0.0,68115313,1,0
1,5,0.2857142857142857,0.8125,70908502,7,2
0,9,0.1,0.16216216216216217,70908705,10,1
0,2,0.0,0.0,80165842,2,0
0,4,0.0,0.0,82102648,4,0
0,4,0.2,0.42857142857142855,68273590,5,1
2,0,1.0,1.0,80172956,1,1
0,7,0.0,0.0,68499410,7,0
0,5,0.2857142857142857,0.16666666666666666,80095225,7,2
1,2,0.3333333333333333,0.75,82019713,3,1
1,4,0.3333333333333333,0.6,70179655,6,2
0,3,0.25,0.3,68311621,4,1
1,5,0.375,0.75,67786985,8,3
0,7,0.125,0.0,70036792,8,1
0,3,0.0,0.0,69117083,3,0
1,2,0.3333333333333333,0.7857142857142857,68579616,3,1
0,12,0.07692307692307693,0.08333333333333333,73256666,13,1
0,4,0.0,0.0,70525406,4,0
0,10,0.16666666666666666,0.46875,70629741,12,2
1,2,0.3333333333333333,0.5,65884945,3,1
2,1,0.5,0.0,69548976,2,1
0,4,0.0,0.0,66041633,4,0
0,2,0.0,0.0,68805856,2,0
0,1,0.0,0.0,69474874,1,0
0,5,0.0,0.0,61264175,5,0
1,4,0.3333333333333333,0.7142857142857143,70568295,6,2
0,5,0.0,0.0,80122875,5,0
0,6,0.0,0.0,70489223,6,0
0,1,0.0,0.0,70489405,1,0
1,5,0.16666666666666666,0.7727272727272727,70746851,6,1
1,5,0.4444444444444444,0.9210526315789473,80166915,9,4
0,9,0.18181818181818182,0.047619047619047616,80176714,11,2
2,3,0.7,0.9,80176650,10,7
0,8,0.0,0.0,70691460,8,0
0,6,0.14285714285714285,0.4230769230769231,72910306,7,1
0,6,0.0,0.0,70109844,6,0
0,10,0.09090909090909091,0.22916666666666666,70474670,11,1
0,10,0.0,0.0,80149957,10,0
0,2,0.3333333333333333,0.3333333333333333,69034154,3,1
0,4,0.0,0.0,82102763,4,0
0,12,0.0,0.0,82102906,12,0
2,1,0.5,0.75,65293235,2,1
2,1,0.6666666666666666,0.75,69185494,3,2
1,11,0.35294117647058826,0.7142857142857143,66792530,17,6
0,4,0.0,0.0,70692006,4,0
1,4,0.2,0.75,70239526,5,1
0,9,0.18181818181818182,0.3888888888888889,68150544,11,2
2,1,0.8,0.9629629629629629,82002237,5,4
2,0,1.0,1.0,82201011,1,1
1,14,0.3,0.6829268292682927,80134776,20,6
0,16,0.0,0.0,63781536,16,0
0,14,0.0,0.0,63781900,14,0
1,10,0.16666666666666666,0.6097560975609756,67475632,12,2
0,5,0.16666666666666666,0.08333333333333333,82041889,6,1
0,3,0.0,0.0,66784522,3,0
0,4,0.0,0.0,69895693,4,0
2,4,0.5,0.9090909090909091,63992684,8,4
1,8,0.42857142857142855,0.975609756097561,63993223,14,6
0,3,0.0,0.0,70629566,3,0
0,1,0.0,0.0,68279372,1,0
2,1,0.6666666666666666,0.5,69691944,3,2
2,5,0.6153846153846154,0.9090909090909091,82001456,13,8
2,1,0.9,0.5,67822783,10,9
2,1,0.8333333333333334,0.8,69997564,6,5
0,2,0.0,0.0,70237944,2,0
2,1,0.75,0.75,69983382,4,3
2,1,0.6666666666666666,0.8,80163121,3,2
2,1,0.8333333333333334,0.6666666666666666,70350126,6,5
2,1,0.8333333333333334,0.8333333333333334,68629323,6,5
2,0,1.0,1.0,80092502,1,1
2,2,0.6666666666666666,0.8,75479922,6,4
1,9,0.25,0.65,66264170,12,3
2,1,0.5,0.7857142857142857,73537051,2,1
0,1,0.0,0.0,80145562,1,0
1,4,0.42857142857142855,0.7272727272727273,70717934,7,3
2,7,0.65,0.9523809523809523,67159645,20,13
0,9,0.1,0.05,74789834,10,1
0,3,0.0,0.0,72802184,3,0
1,10,0.3333333333333333,0.52,80130379,15,5
0,2,0.0,0.0,63154623,2,0
2,2,0.5,0.9230769230769231,80056340,4,2
0,5,0.0,0.0,73632356,5,0
1,5,0.4444444444444444,0.75,72803696,9,4
0,12,0.0,0.0,69093696,12,0
2,4,0.5555555555555556,0.8095238095238095,69983011,9,5
0,1,0.0,0.0,70542892,1,0
0,1,0.0,0.0,80018785,1,0
0,3,0.25,0.3333333333333333,69187916,4,1
2,5,0.6428571428571429,0.9166666666666666,80024266,14,9
2,1,0.5,0.8947368421052632,69970453,2,1
0,6,0.0,0.0,65963702,6,0
0,6,0.14285714285714285,0.08695652173913043,73801413,7,1
2,9,0.5714285714285714,0.7,82041308,21,12
2,1,0.9,0.5,80162165,10,9
2,0,1.0,1.0,82037202,11,11
2,0,1.0,1.0,82052080,3,3
2,2,0.5,0.6,82041859,4,2
2,0,1.0,1.0,80176421,1,1
2,0,1.0,1.0,80181929,1,1
2,0,1.0,1.0,80136566,4,4
2,3,0.5714285714285714,0.5,80162550,7,4
2,3,0.625,0.8,75662503,8,5
2,0,1.0,1.0,70344624,1,1
2,1,0.8333333333333334,0.5,82062247,6,5
2,0,1.0,1.0,77114044,1,1
2,0,1.0,1.0,956905,9,9
1,6,0.4,0.65,80158319,10,4
0,2,0.3333333333333333,0.2857142857142857,74362491,3,1
2,8,0.5555555555555556,0.9285714285714286,74363303,18,10
2,0,1.0,1.0,82052086,3,3
2,0,1.0,1.0,82054033,1,1
2,0,1.0,1.0,82145503,1,1
2,0,1.0,1.0,69979770,2,2
2,1,0.6666666666666666,0.8571428571428571,82042617,3,2
2,0,1.0,1.0,19432931,4,4
1,10,0.4444444444444444,0.9230769230769231,80141470,18,8
0,5,0.16666666666666666,0.1875,75377015,6,1
2,4,0.5,0.9411764705882353,82002319,8,4
2,8,0.5,0.8888888888888888,82112145,16,8
2,0,1.0,1.0,68344591,1,1
0,2,0.0,0.0,70680596,2,0
0,4,0.2,0.4642857142857143,70692993,5,1
0,2,0.0,0.0,70744891,2,0
2,2,0.5,0.9090909090909091,67715683,4,2
0,6,0.14285714285714285,0.375,68239584,7,1
0,1,0.0,0.0,69464486,1,0
0,14,0.0,0.0,69525582,14,0
0,2,0.0,0.0,70677810,2,0
1,2,0.3333333333333333,0.7272727272727273,69691930,3,1
0,12,0.07692307692307693,0.23214285714285715,80126750,13,1
0,2,0.0,0.0,80133925,2,0
0,1,0.0,0.0,82019717,1,0
1,14,0.2631578947368421,0.9038461538461539,79990071,19,5
0,2,0.0,0.0,82102902,2,0
0,3,0.0,0.0,82006226,3,0
0,2,0.0,0.0,82006251,2,0
2,0,1.0,1.0,67246235,2,2
2,1,0.6666666666666666,0.5,82006317,3,2
0,9,0.35714285714285715,0.25,69876443,14,5
0,2,0.0,0.0,82158909,2,0
2,1,0.6666666666666666,0.6666666666666666,80094014,3,2
0,2,0.0,0.0,82022189,2,0
2,0,1.0,1.0,69039054,1,1
2,1,0.6666666666666666,0.5,80135011,3,2
2,2,0.7142857142857143,0.875,82251170,7,5
2,1,0.6666666666666666,0.875,69149304,3,2
1,15,0.375,0.90625,71618813,24,9
2,2,0.6,0.8571428571428571,65282812,5,3
0,1,0.0,0.0,76598830,1,0
2,2,0.8461538461538461,0.9375,82163420,13,11
1,4,0.3333333333333333,0.6666666666666666,69856423,6,2
1,11,0.3125,0.7906976744186046,76600944,16,5
0,2,0.0,0.0,69500025,2,0
0,2,0.3333333333333333,0.25,68798240,3,1
0,1,0.0,0.0,63168924,1,0
0,2,0.0,0.0,82021483,2,0
0,1,0.0,0.0,80132291,1,0
1,20,0.09090909090909091,0.5294117647058824,67796512,22,2
1,3,0.4,0.9333333333333333,67846240,5,2
2,1,0.6666666666666666,0.8571428571428571,70669480,3,2
2,4,0.5555555555555556,0.9523809523809523,69840806,9,5
2,1,0.5,0.5,82019869,2,1
2,0,1.0,1.0,70700742,17,17
0,7,0.125,0.38461538461538464,70681905,8,1
2,0,1.0,1.0,66256904,1,1
2,3,0.625,0.9285714285714286,79791320,8,5
0,2,0.0,0.0,70682066,2,0
0,4,0.2,0.058823529411764705,67053784,5,1
0,9,0.0,0.0,69737430,9,0
0,8,0.0,0.0,76081306,8,0
0,14,0.0,0.0,67094930,14,0
0,2,0.0,0.0,69985664,2,0
1,17,0.2916666666666667,0.7142857142857143,72546264,24,7
2,1,0.6666666666666666,0.5,69100682,3,2
0,17,0.0,0.0,72808946,17,0
0,2,0.0,0.0,67796036,2,0
1,4,0.3333333333333333,0.6666666666666666,80141471,6,2
2,0,1.0,1.0,73651144,1,1
0,3,0.0,0.0,70702422,3,0
0,9,0.0,0.0,70703171,9,0
0,9,0.0,0.0,70704683,9,0
0,6,0.0,0.0,70705985,6,0
0,4,0.0,0.0,70706951,4,0
2,3,0.5,0.9629629629629629,80150330,6,3
2,1,0.9230769230769231,0.5,69098085,13,12
0,8,0.1111111111111111,0.27586206896551724,66224753,9,1
0,4,0.2,0.42857142857142855,66622654,5,1
2,0,1.0,1.0,80180009,2,2
2,2,0.8,0.8333333333333334,75663056,10,8
2,2,0.6,0.6,82019055,5,3
2,2,0.5,0.8333333333333334,69064002,4,2
0,3,0.25,0.4117647058823529,70040824,4,1
2,3,0.8235294117647058,0.8823529411764706,63154861,17,14
2,2,0.7142857142857143,0.75,71910930,7,5
1,7,0.4166666666666667,0.9333333333333333,69997641,12,5
2,1,0.6666666666666666,0.5,67725112,3,2
0,3,0.25,0.3333333333333333,82206218,4,1
0,6,0.3333333333333333,0.45,64866235,9,3
0,9,0.0,0.0,70692846,9,0
2,2,0.5,0.8666666666666667,79816072,4,2
2,0,1.0,1.0,82020832,2,2
1,6,0.3333333333333333,0.8181818181818182,69626270,9,3
1,3,0.25,0.8636363636363636,61356393,4,1
0,1,0.0,0.0,66571456,1,0
0,2,0.0,0.0,68130783,2,0
2,1,0.5,0.5,80176850,2,1
0,10,0.16666666666666666,0.17142857142857143,65279494,12,2
0,1,0.0,0.0,70744786,1,0
2,1,0.6666666666666666,0.5,82113194,3,2
1,2,0.3333333333333333,0.5,69862555,3,1
0,29,0.19444444444444445,0.47761194029850745,79651026,36,7
0,8,0.1111111111111111,0.22727272727272727,82152764,9,1
1,18,0.47058823529411764,0.9705882352941176,69173594,34,16
0,4,0.0,0.0,67404505,4,0
0,4,0.0,0.0,66110856,4,0
1,4,0.42857142857142855,0.875,82002253,7,3
2,1,0.6666666666666666,0.5,69667752,3,2
1,10,0.375,0.7608695652173914,81989184,16,6
0,3,0.0,0.0,80124313,3,0
2,0,1.0,1.0,80125390,4,4
0,9,0.18181818181818182,0.2608695652173913,70063784,11,2
2,2,0.6666666666666666,0.8333333333333334,80122621,6,4
0,1,0.0,0.0,69464556,1,0
0,6,0.0,0.0,70745962,6,0
2,0,1.0,1.0,80178952,2,2
0,3,0.0,0.0,67627084,3,0
0,1,0.0,0.0,80145843,1,0
0,1,0.0,0.0,80181395,1,0
2,4,0.6,0.9375,63706461,10,6
2,2,0.6666666666666666,0.8,69172635,6,4
0,3,0.4,0.3333333333333333,68167876,5,2
0,2,0.3333333333333333,0.0,68167883,3,1
0,7,0.0,0.0,69633025,7,0
1,4,0.42857142857142855,0.6666666666666666,80123589,7,3
2,0,1.0,1.0,74511591,1,1
0,1,0.0,0.0,69164613,1,0
0,2,0.0,0.0,66009993,2,0
0,2,0.3333333333333333,0.375,70678083,3,1
2,2,0.6,0.9411764705882353,70692412,5,3
2,4,0.5,0.8571428571428571,72803766,8,4
0,3,0.4,0.25,66233055,5,2
2,5,0.5,0.3333333333333333,69562822,10,5
0,14,0.06666666666666667,0.25,70681513,15,1
0,39,0.0,0.0,82126668,39,0
2,6,0.5,0.8571428571428571,67844462,12,6
1,5,0.2857142857142857,0.9523809523809523,71619072,7,2
0,6,0.14285714285714285,0.20833333333333334,80163149,7,1
2,1,0.6666666666666666,0.75,70713314,3,2
0,10,0.2857142857142857,0.40625,80145782,14,4
2,4,0.5,0.3333333333333333,73411912,8,4
2,0,1.0,1.0,69701835,1,1
0,3,0.0,0.0,67753511,3,0
2,0,1.0,1.0,82018829,3,3
0,5,0.16666666666666666,0.0,69997942,6,1
1,8,0.42857142857142855,0.9032258064516129,70821562,14,6
0,6,0.0,0.0,80163187,6,0
0,3,0.0,0.0,69640326,3,0
1,4,0.2,0.5,69973351,5,1
1,5,0.16666666666666666,0.5555555555555556,68905522,6,1
0,9,0.0,0.0,67978316,9,0
1,8,0.4666666666666667,0.9393939393939394,70630112,15,7
0,21,0.045454545454545456,0.3382352941176471,67051383,22,1
0,5,0.0,0.0,80162865,5,0
0,2,0.0,0.0,68384435,2,0
0,5,0.16666666666666666,0.45,64027124,6,1
0,5,0.2857142857142857,0.36363636363636365,74027821,7,2
0,2,0.0,0.0,82006475,2,0
0,6,0.14285714285714285,0.3076923076923077,70629881,7,1
0,3,0.0,0.0,82102750,3,0
2,0,1.0,1.0,66534874,1,1
0,3,0.0,0.0,80176287,3,0
2,1,0.5,0.0,66238564,2,1
0,3,0.0,0.0,68666780,3,0
0,3,0.25,0.25,69924820,4,1
1,3,0.25,0.6666666666666666,82020106,4,1
0,4,0.0,0.0,69463352,4,0
2,0,1.0,1.0,80092474,2,2
2,1,0.875,0.5,82140298,8,7
2,4,0.6,0.25,82140299,10,6
2,1,0.5,0.75,68358591,2,1
0,2,0.0,0.0,69551272,2,0
2,4,0.5,0.9696969696969697,70649691,8,4
0,3,0.0,0.0,70672413,3,0
2,5,0.5454545454545454,0.9375,80104871,11,6
1,3,0.25,0.6666666666666666,70705264,4,1
0,1,0.0,0.0,70861301,1,0
0,6,0.0,0.0,70682535,6,0
2,3,0.5,0.9166666666666666,80135213,6,3
1,7,0.3,0.5909090909090909,69597290,10,3
2,0,1.0,1.0,82039388,2,2
2,2,0.5,0.7777777777777778,70780563,4,2
0,2,0.0,0.0,69006623,2,0
0,10,0.0,0.0,75148010,10,0
0,2,0.0,0.0,66423686,2,0
0,8,0.0,0.0,62837012,8,0
2,3,0.6666666666666666,0.75,60600281,9,6
2,0,1.0,1.0,78858584,1,1
0,4,0.0,0.0,75264574,4,0
2,1,0.8333333333333334,0.0,65094932,6,5
1,5,0.2857142857142857,0.5135135135135135,80113460,7,2
0,5,0.16666666666666666,0.25,80163500,6,1
0,8,0.1111111111111111,0.13043478260869565,73400551,9,1
0,5,0.0,0.0,70706020,5,0
2,0,1.0,1.0,80136602,23,23
1,3,0.25,0.7142857142857143,70202720,4,1
1,5,0.375,0.9523809523809523,60081721,8,3
0,6,0.0,0.0,64344644,6,0
0,1,0.0,0.0,64345113,1,0
0,5,0.0,0.0,72918734,5,0
0,9,0.1,0.25,69895434,10,1
0,9,0.0,0.0,69895490,9,0
0,4,0.0,0.0,67475674,4,0
0,5,0.0,0.0,69895756,5,0
0,1,0.0,0.0,70677362,1,0
0,6,0.14285714285714285,0.11764705882352941,82032898,7,1
0,15,0.16666666666666666,0.425,66201422,18,3
2,1,0.8,0.6666666666666666,70911442,5,4
0,4,0.0,0.0,71212281,4,0
0,5,0.16666666666666666,0.18181818181818182,80133807,6,1
0,2,0.0,0.0,69158936,2,0
1,10,0.2857142857142857,0.6896551724137931,80052595,14,4
2,0,1.0,1.0,80159286,1,1
2,5,0.5,0.8181818181818182,80136919,10,5
0,5,0.0,0.0,70184282,5,0
0,2,0.0,0.0,68805471,2,0
2,7,0.5625,0.9615384615384616,80145763,16,9
2,1,0.875,0.6666666666666666,82047590,8,7
2,1,0.6666666666666666,0.5,82041705,3,2
0,8,0.2,0.1111111111111111,65991625,10,2
0,1,0.0,0.0,65977030,1,0
1,4,0.3333333333333333,0.7142857142857143,69041084,6,2
0,5,0.16666666666666666,0.30434782608695654,65292563,6,1
1,8,0.38461538461538464,0.9074074074074074,80176606,13,5
2,7,0.6111111111111112,0.8333333333333334,79816492,18,11
2,1,0.75,0.5,80093461,4,3
0,9,0.18181818181818182,0.23076923076923078,69623750,11,2
0,5,0.0,0.0,70702352,5,0
2,1,0.5,0.5,69550404,2,1
2,0,1.0,1.0,66224816,1,1
2,2,0.5,0.9230769230769231,62735582,4,2
1,6,0.3333333333333333,0.5625,69129872,9,3
2,0,1.0,1.0,66848061,1,1
2,1,0.8888888888888888,0.8,80052665,9,8
2,1,0.5,0.5,82120707,2,1
0,3,0.0,0.0,73800902,3,0
0,5,0.16666666666666666,0.0,80105032,6,1
2,2,0.6666666666666666,0.8333333333333334,67195506,6,4
2,2,0.7142857142857143,0.8888888888888888,82042621,7,5
2,0,1.0,1.0,82046246,2,2
2,1,0.875,0.6666666666666666,65001146,8,7
2,0,1.0,1.0,80165231,3,3
2,2,0.8461538461538461,0.8333333333333334,67181723,13,11
2,0,1.0,1.0,70314202,4,4
2,1,0.95,0.5,69954073,20,19
2,1,0.6666666666666666,0.6666666666666666,70699741,3,2
2,1,0.5,0.5,70743022,2,1
2,0,1.0,1.0,82039860,4,4
2,0,1.0,1.0,80158236,3,3
0,4,0.42857142857142855,0.38461538461538464,80018491,7,3
2,1,0.8571428571428571,0.5,82039323,7,6
2,0,1.0,1.0,74051621,3,3
2,1,0.75,0.6666666666666666,80067463,4,3
1,13,0.3157894736842105,0.7619047619047619,66364466,19,6
1,4,0.42857142857142855,0.8888888888888888,70229026,7,3
1,3,0.25,0.5555555555555556,69644785,4,1
0,5,0.16666666666666666,0.35714285714285715,69644792,6,1
0,1,0.0,0.0,70677915,1,0
0,4,0.0,0.0,80135354,4,0
0,3,0.0,0.0,64505,3,0
0,8,0.0,0.0,69525792,8,0
0,6,0.0,0.0,70680022,6,0
0,8,0.0,0.0,70691572,8,0
0,8,0.2,0.0,75576522,10,2
0,3,0.4,0.25,70070721,5,2
2,2,0.5,0.9285714285714286,64458121,4,2
0,3,0.0,0.0,67339713,3,0
1,2,0.3333333333333333,0.8,66782821,3,1
0,1,0.0,0.0,69638044,1,0
1,4,0.2,0.8461538461538461,80149905,5,1
2,5,0.5454545454545454,0.5714285714285714,52164763,11,6
2,2,0.5,0.9,70405650,4,2
2,1,0.6666666666666666,0.6666666666666666,79854145,3,2
2,0,1.0,1.0,66379264,1,1
2,4,0.5,0.8333333333333334,72802856,8,4
2,2,0.6666666666666666,0.6666666666666666,80019212,6,4
2,4,0.6363636363636364,0.875,82096237,11,7
0,5,0.0,0.0,70801584,5,0
2,1,0.8,0.6666666666666666,66237500,5,4
2,0,1.0,1.0,67797695,3,3
2,1,0.5,0.3333333333333333,69209280,2,1
0,21,0.16,0.3854166666666667,70823081,25,4
0,4,0.0,0.0,70693462,4,0
0,5,0.0,0.0,70694372,5,0
0,4,0.0,0.0,70701750,4,0
0,7,0.0,0.0,73295971,7,0
0,5,0.0,0.0,82206114,5,0
1,3,0.25,0.6470588235294118,80126807,4,1
0,4,0.0,0.0,15781330,4,0
2,0,1.0,1.0,69479466,2,2
1,5,0.16666666666666666,0.5,67378465,6,1
0,1,0.0,0.0,82024368,1,0
2,1,0.875,0.5,70567315,8,7
0,21,0.0,0.0,70706202,21,0
0,12,0.07692307692307693,0.22077922077922077,70707161,13,1
0,4,0.2,0.4375,70707273,5,1
0,1,0.0,0.0,82039788,1,0
2,2,0.6,0.7142857142857143,69893733,5,3
2,3,0.5,0.8666666666666667,68039930,6,3
2,3,0.5,0.7142857142857143,72031155,6,3
1,3,0.25,0.5,70702695,4,1
0,9,0.18181818181818182,0.3076923076923077,68273772,11,2
2,1,0.5,0.6666666666666666,67311762,2,1
1,3,0.4,0.75,69997711,5,2
0,3,0.25,0.45454545454545453,69954605,4,1
0,4,0.0,0.0,80138892,4,0
0,1,0.0,0.0,69188665,1,0
1,13,0.23529411764705882,0.6444444444444445,70229852,17,4
0,6,0.14285714285714285,0.25,69315561,7,1
2,3,0.7272727272727273,0.8571428571428571,80118947,11,8
1,14,0.2631578947368421,0.8734177215189873,70761145,19,5
2,6,0.6666666666666666,0.9,73651872,18,12
2,1,0.6666666666666666,0.5,69499122,3,2
0,4,0.2,0.25,82251468,5,1
1,3,0.4,0.8333333333333334,82002313,5,2
2,2,0.5,0.9166666666666666,80028956,4,2
0,1,0.0,0.0,70705915,1,0
0,2,0.0,0.0,66147543,2,0
2,0,1.0,1.0,70223286,1,1
2,1,0.6666666666666666,0.8571428571428571,82017805,3,2
0,6,0.0,0.0,66554733,6,0
1,8,0.38461538461538464,0.7619047619047619,70609966,13,5
2,1,0.8333333333333334,0.5,80159076,6,5
2,2,0.7142857142857143,0.9523809523809523,80150334,7,5
0,8,0.0,0.0,69611241,8,0
2,0,1.0,1.0,67645053,1,1
1,6,0.3333333333333333,0.5909090909090909,80167231,9,3
0,1,0.0,0.0,70229264,1,0
2,2,0.8181818181818182,0.8,66364340,11,9
0,7,0.2222222222222222,0.42857142857142855,68492214,9,2
2,0,1.0,1.0,67291805,3,3
2,1,0.75,0.3333333333333333,79457455,4,3
2,3,0.5714285714285714,0.625,82009549,7,4
1,5,0.2857142857142857,0.75,72775206,7,2
0,4,0.0,0.0,67437335,4,0
2,0,1.0,1.0,80159163,13,13
0,19,0.20833333333333334,0.19230769230769232,67131071,24,5
2,2,0.75,0.9,68294170,8,6
0,4,0.0,0.0,81965674,4,0
0,11,0.15384615384615385,0.36,81965680,13,2
2,0,1.0,1.0,70229194,1,1
0,7,0.0,0.0,68393416,7,0
0,1,0.0,0.0,80151000,1,0
0,1,0.0,0.0,69635342,1,0
0,6,0.14285714285714285,0.3,82089994,7,1
2,0,1.0,1.0,82097536,3,3
2,0,1.0,1.0,80094532,1,1
2,0,1.0,1.0,82025205,7,7
0,2,0.0,0.0,82152776,2,0
0,3,0.0,0.0,82152780,3,0
2,1,0.8,0.9,72198336,5,4
2,0,1.0,1.0,74027912,3,3
0,10,0.09090909090909091,0.2857142857142857,68607063,11,1
0,1,0.0,0.0,68607091,1,0
0,5,0.0,0.0,68607161,5,0
1,4,0.3333333333333333,0.8333333333333334,68338676,6,2
0,3,0.0,0.0,80124354,3,0
2,0,1.0,1.0,80178432,2,2
2,3,0.7272727272727273,0.9,80155226,11,8
0,9,0.1,0.21052631578947367,72809373,10,1
0,10,0.09090909090909091,0.3157894736842105,72809380,11,1
2,2,0.75,0.6666666666666666,80053603,8,6
0,5,0.16666666666666666,0.2222222222222222,68546765,6,1
2,1,0.5,0.875,68032090,2,1
2,0,1.0,1.0,82019681,6,6
1,12,0.29411764705882354,0.6451612903225806,69180552,17,5
1,9,0.4375,0.7058823529411765,80181565,16,7
2,2,0.5,0.6666666666666666,70349566,4,2
1,7,0.3,0.5789473684210527,70013216,10,3
1,6,0.14285714285714285,0.7843137254901961,80167082,7,1
2,0,1.0,1.0,70459515,2,2
0,3,0.0,0.0,70223664,3,0
2,3,0.5714285714285714,0.8571428571428571,65400825,7,4
0,2,0.0,0.0,78506995,2,0
0,1,0.0,0.0,67132884,1,0
0,4,0.2,0.1875,80153653,5,1
2,1,0.5,0.8,70614453,2,1
0,2,0.0,0.0,305200,2,0
1,8,0.4666666666666667,0.9333333333333333,69543271,15,7
0,10,0.23076923076923078,0.4153846153846154,70694603,13,3
0,7,0.125,0.4090909090909091,70680526,8,1
2,0,1.0,1.0,82012783,1,1
2,0,1.0,1.0,82023116,1,1
0,21,0.045454545454545456,0.19801980198019803,68497744,22,1
1,2,0.3333333333333333,0.8648648648648649,70747712,3,1
2,1,0.6666666666666666,0.75,76023423,3,2
2,3,0.5,0.6,69483932,6,3
2,0,1.0,1.0,80095211,1,1
1,7,0.46153846153846156,0.8421052631578947,82010257,13,6
0,3,0.0,0.0,74086712,3,0
1,5,0.4444444444444444,0.8181818181818182,80162791,9,4
2,1,0.5,0.9523809523809523,82143734,2,1
0,8,0.42857142857142855,0.3333333333333333,80118303,14,6
2,0,1.0,1.0,82012798,1,1
2,0,1.0,1.0,68631633,4,4
0,2,0.0,0.0,63279566,2,0
0,7,0.125,0.15384615384615385,73801175,8,1
2,1,0.5,0.8,82002312,2,1
2,2,0.5,0.6666666666666666,70417095,4,2
1,6,0.45454545454545453,0.9285714285714286,66133382,11,5
0,4,0.2,0.10526315789473684,69059396,5,1
0,6,0.14285714285714285,0.3103448275862069,69637134,7,1
0,20,0.047619047619047616,0.415929203539823,70216762,21,1
0,3,0.25,0.3333333333333333,69689935,4,1
0,3,0.0,0.0,80170931,3,0
2,0,1.0,1.0,67359705,2,2
0,12,0.0,0.0,80150851,12,0
1,14,0.125,0.6888888888888889,82102546,16,2
0,4,0.2,0.26666666666666666,80135283,5,1
0,4,0.0,0.0,80162885,4,0
0,8,0.1111111111111111,0.32608695652173914,82009395,9,1
0,5,0.0,0.0,80150557,5,0
0,2,0.0,0.0,80172628,2,0
0,6,0.0,0.0,80162892,6,0
0,1,0.0,0.0,82006740,1,0
0,2,0.0,0.0,69867861,2,0
0,8,0.0,0.0,71619016,8,0
0,3,0.0,0.0,80172616,3,0
2,0,1.0,1.0,70654423,1,1
2,3,0.75,0.8333333333333334,82145117,12,9
2,0,1.0,1.0,80089394,1,1
2,1,0.75,0.6666666666666666,70767333,4,3
0,2,0.0,0.0,74595906,2,0
0,3,0.0,0.0,74595913,3,0
1,3,0.25,0.6470588235294118,61440596,4,1
0,3,0.0,0.0,65286312,3,0
1,2,0.3333333333333333,0.6666666666666666,68596073,3,1
1,5,0.2857142857142857,0.5294117647058824,70059780,7,2
1,6,0.45454545454545453,0.8928571428571429,65598323,11,5
0,10,0.09090909090909091,0.0,80127356,11,1
1,14,0.3,0.6825396825396826,73701103,20,6
1,2,0.3333333333333333,0.6923076923076923,69500851,3,1
1,12,0.45454545454545453,0.9,68784331,22,10
1,8,0.2,0.5555555555555556,68036206,10,2
2,2,0.6,0.9166666666666666,80149931,5,3
0,1,0.0,0.0,70683592,1,0
0,4,0.2,0.2222222222222222,80163144,5,1
0,6,0.0,0.0,70696696,6,0
2,3,0.625,0.9090909090909091,66257282,8,5
1,14,0.4166666666666667,0.9047619047619048,67159491,24,10
2,0,1.0,1.0,70190015,1,1
1,3,0.25,0.75,67740211,4,1
1,16,0.36,0.6470588235294118,73870174,25,9
1,4,0.2,0.5333333333333333,82102854,5,1
2,2,0.6,0.9,69482511,5,3
2,2,0.5,0.75,70868483,4,2
2,0,1.0,1.0,78286894,1,1
1,9,0.3076923076923077,0.8157894736842105,69637890,13,4
0,2,0.0,0.0,70693231,2,0
0,9,0.1,0.3235294117647059,69895322,10,1
1,4,0.2,0.6923076923076923,80029103,5,1
0,5,0.16666666666666666,0.28,74086775,6,1
0,7,0.0,0.0,66787070,7,0
2,1,0.8571428571428571,0.8333333333333334,82022872,7,6
1,7,0.125,0.5238095238095238,81968373,8,1
0,10,0.09090909090909091,0.3548387096774194,81968402,11,1
0,2,0.0,0.0,82024307,2,0
2,3,0.7692307692307693,0.9285714285714286,65598771,13,10
2,0,1.0,1.0,82037360,10,10
1,11,0.3125,0.6486486486486487,67806116,16,5
2,0,1.0,1.0,69152405,1,1
2,0,1.0,1.0,74029452,1,1
0,16,0.15789473684210525,0.125,82060543,19,3
2,3,0.5,0.6666666666666666,74635134,6,3
1,4,0.2,0.6666666666666666,67220475,5,1
2,2,0.7142857142857143,0.75,82018812,7,5
1,5,0.2857142857142857,0.5,68273695,7,2
0,2,0.0,0.0,66055122,2,0
0,1,0.0,0.0,70520835,1,0
1,5,0.4444444444444444,0.5,70718543,9,4
2,5,0.5833333333333334,0.6666666666666666,77318983,12,7
0,1,0.0,0.0,79788394,1,0
0,5,0.16666666666666666,0.0625,67601590,6,1
1,8,0.2727272727272727,0.5666666666666667,72775262,11,3
0,1,0.0,0.0,81989189,1,0
2,7,0.6111111111111112,0.9545454545454546,65289756,18,11
1,12,0.3333333333333333,0.7666666666666667,65279753,18,6
2,3,0.7272727272727273,0.8571428571428571,69733104,11,8
2,0,1.0,1.0,70598346,6,6
2,2,0.5,0.7142857142857143,69489154,4,2
2,1,0.875,0.5,66364354,8,7
2,1,0.5,0.6666666666666666,65981811,2,1
2,0,1.0,1.0,72801652,1,1
2,4,0.5,0.5,80137363,8,4
2,2,0.8888888888888888,0.75,81867497,18,16
0,1,0.0,0.0,82024391,1,0
2,0,1.0,1.0,82020382,9,9
1,7,0.36363636363636365,0.8125,72426480,11,4
2,0,1.0,1.0,70747005,2,2
2,0,1.0,1.0,80159760,2,2
2,1,0.8333333333333334,0.8,80158258,6,5
2,0,1.0,1.0,80175992,12,12
2,1,0.8333333333333334,0.6666666666666666,67199083,6,5
2,0,1.0,1.0,82039175,4,4
0,8,0.38461538461538464,0.4,75545946,13,5
2,0,1.0,1.0,82064862,1,1
2,1,0.5,0.5,16717071,2,1
2,0,1.0,1.0,80159677,1,1
2,0,1.0,1.0,70851263,6,6
2,0,1.0,1.0,80079755,1,1
2,0,1.0,1.0,70712306,1,1
2,2,0.6,0.6666666666666666,82047596,5,3
0,3,0.25,0.0,69703970,4,1
0,7,0.2222222222222222,0.42857142857142855,68625823,9,2
0,15,0.2857142857142857,0.43333333333333335,62734182,21,6
0,1,0.0,0.0,70705733,1,0
2,2,0.7142857142857143,0.6666666666666666,69065423,7,5
0,11,0.08333333333333333,0.06666666666666667,80018904,12,1
0,8,0.0,0.0,70927766,8,0
0,1,0.0,0.0,82143741,1,0
0,10,0.09090909090909091,0.16666666666666666,70677453,11,1
0,14,0.0,0.0,69664161,14,0
0,3,0.0,0.0,66785292,3,0
0,5,0.0,0.0,66784431,5,0
2,2,0.7142857142857143,0.6666666666666666,69617310,7,5
2,0,1.0,1.0,77602651,1,1
1,10,0.4444444444444444,0.9534883720930233,80175674,18,8
0,2,0.0,0.0,65156826,2,0
1,2,0.3333333333333333,0.875,65156854,3,1
1,5,0.2857142857142857,0.8333333333333334,65157351,7,2
1,3,0.4,0.6923076923076923,65972543,5,2
2,1,0.5,0.0,66229310,2,1
0,3,0.0,0.0,70674240,3,0
2,2,0.7142857142857143,0.9333333333333333,67066552,7,5
2,0,1.0,1.0,82020833,2,2
1,16,0.42857142857142855,0.8611111111111112,68401256,28,12
2,0,1.0,1.0,82018708,1,1
2,0,1.0,1.0,66830015,4,4
0,5,0.0,0.0,70467880,5,0
0,13,0.0,0.0,70917322,13,0
2,6,0.5384615384615384,0.8666666666666667,75120941,13,7
0,1,0.0,0.0,71588251,1,0
2,5,0.5833333333333334,0.75,8018962,12,7
2,2,0.6,0.8571428571428571,70225064,5,3
1,5,0.16666666666666666,0.5428571428571428,70683802,6,1
2,4,0.5,0.4,70720552,8,4
2,11,0.5217391304347826,0.9285714285714286,61717523,23,12
1,3,0.4,0.7142857142857143,70005901,5,2
1,5,0.2857142857142857,0.7692307692307693,65280306,7,2
1,9,0.1,0.5384615384615384,67434724,10,1
2,6,0.5384615384615384,0.8888888888888888,80145877,13,7
1,5,0.4444444444444444,0.8709677419354839,72803535,9,4
0,2,0.0,0.0,72808904,2,0
0,4,0.0,0.0,65282833,4,0
0,3,0.25,0.0,70494305,4,1
0,8,0.1111111111111111,0.0,70646835,9,1
0,19,0.24,0.24444444444444444,70646842,25,6
2,1,0.5,0.75,69604192,2,1
2,0,1.0,1.0,72930963,1,1
0,2,0.0,0.0,69634110,2,0
0,4,0.2,0.45454545454545453,82152201,5,1
2,1,0.5,0.5,80092950,2,1
2,2,0.875,0.6666666666666666,80176261,16,14
0,5,0.0,0.0,72808645,5,0
2,4,0.6666666666666666,0.8571428571428571,80152806,12,8
2,1,0.5,0.5,66228624,2,1
1,2,0.3333333333333333,0.8666666666666667,69950055,3,1
1,6,0.14285714285714285,0.5833333333333334,75148696,7,1
2,3,0.5,0.6666666666666666,70459501,6,3
2,1,0.6666666666666666,0.5,74045321,3,2
2,2,0.6666666666666666,0.75,82103839,6,4
0,1,0.0,0.0,79795240,1,0
2,0,1.0,1.0,82012768,2,2
1,3,0.25,0.8,66379040,4,1
0,2,0.0,0.0,63273532,2,0
2,1,0.5,0.6666666666666666,70927416,2,1
0,8,0.0,0.0,72785930,8,0
2,1,0.6666666666666666,0.6666666666666666,82023107,3,2
0,7,0.125,0.3333333333333333,70843500,8,1
2,0,1.0,1.0,70843612,1,1
0,5,0.0,0.0,80067491,5,0
2,0,1.0,1.0,77112441,2,2
0,1,0.0,0.0,70683886,1,0
0,1,0.0,0.0,73645320,1,0
2,1,0.6666666666666666,0.5,82041331,3,2
0,2,0.0,0.0,80155959,2,0
2,1,0.6666666666666666,0.8571428571428571,80159202,3,2
2,2,0.75,0.6666666666666666,75346341,8,6
0,5,0.0,0.0,67094321,5,0
0,11,0.0,0.0,78506946,11,0
0,6,0.0,0.0,78506974,6,0
1,6,0.25,0.6538461538461539,80116890,8,2
2,0,1.0,1.0,65094974,1,1
0,1,0.0,0.0,76905395,1,0
2,5,0.5454545454545454,0.8235294117647058,74097751,11,6
0,11,0.08333333333333333,0.09523809523809523,81956352,12,1
0,2,0.0,0.0,70677425,2,0
2,1,0.6666666666666666,0.75,70693651,3,2
0,1,0.0,0.0,82252621,1,0
2,1,0.8571428571428571,0.5,70862085,7,6
2,0,1.0,1.0,80152992,2,2
0,6,0.0,0.0,69417390,6,0
0,3,0.0,0.0,68234341,3,0
2,2,0.5,0.8571428571428571,80163152,4,2
2,1,0.5,0.8,72801771,2,1
1,10,0.23076923076923078,0.5609756097560976,70692601,13,3
2,0,1.0,1.0,68401725,2,2
1,5,0.4444444444444444,0.9032258064516129,82126598,9,4
0,10,0.09090909090909091,0.4482758620689655,80124695,11,1
0,4,0.0,0.0,62711530,4,0
0,3,0.0,0.0,70744401,3,0
2,1,0.8333333333333334,0.5,82019731,6,5
2,1,0.8333333333333334,0.6666666666666666,82018741,6,5
0,8,0.1111111111111111,0.24242424242424243,80126806,9,1
0,1,0.0,0.0,63141155,1,0
1,10,0.3333333333333333,0.75,65279221,15,5
0,9,0.1,0.027777777777777776,70331513,10,1
0,3,0.0,0.0,70684915,3,0
0,4,0.0,0.0,70694022,4,0
1,10,0.375,0.8461538461538461,70638043,16,6
1,11,0.35294117647058826,0.8148148148148148,81976885,17,6
2,7,0.5,0.6153846153846154,60167506,14,7
2,0,1.0,1.0,82061205,1,1
2,0,1.0,1.0,80159236,6,6
1,7,0.2222222222222222,0.5,69482882,9,2
0,2,0.0,0.0,67154535,2,0
0,1,0.0,0.0,82070168,1,0
1,3,0.4,0.8571428571428571,73459981,5,2
1,5,0.16666666666666666,0.7333333333333333,80150605,6,1
0,2,0.0,0.0,71619541,2,0
0,1,0.0,0.0,82006539,1,0
0,6,0.0,0.0,82006557,6,0
2,1,0.5,0.8571428571428571,66646545,2,1
0,1,0.0,0.0,80089240,1,0
0,4,0.0,0.0,80150573,4,0
0,22,0.12,0.37333333333333335,71081325,25,3
0,1,0.0,0.0,80172625,1,0
0,12,0.07692307692307693,0.45,70918323,13,1
1,13,0.23529411764705882,0.8181818181818182,70483434,17,4
0,6,0.0,0.0,69133932,6,0
1,2,0.3333333333333333,0.5,67970882,3,1
0,4,0.0,0.0,80150679,4,0
0,1,0.0,0.0,69735421,1,0
1,11,0.08333333333333333,0.6666666666666666,80089205,12,1
1,2,0.3333333333333333,0.7692307692307693,82102767,3,1
0,2,0.0,0.0,82150105,2,0
0,10,0.0,0.0,69407135,10,0
0,1,0.0,0.0,82006621,1,0
1,11,0.15384615384615385,0.7288135593220338,70468370,13,2
0,1,0.0,0.0,73533341,1,0
0,6,0.14285714285714285,0.3333333333333333,69703921,7,1
1,13,0.3157894736842105,0.5555555555555556,70202776,19,6
0,2,0.0,0.0,70469875,2,0
0,4,0.0,0.0,80029173,4,0
2,2,0.6,0.875,80135226,5,3
0,5,0.0,0.0,82019430,5,0
0,10,0.0,0.0,82019470,10,0
2,0,1.0,1.0,73390065,5,5
0,1,0.0,0.0,69831720,1,0
2,4,0.5,0.9047619047619048,80163439,8,4
0,1,0.0,0.0,68538435,1,0
0,3,0.0,0.0,69415871,3,0
0,1,0.0,0.0,80145818,1,0
1,2,0.3333333333333333,0.6666666666666666,80145832,3,1
2,1,0.8,0.5,80175672,5,4
1,12,0.29411764705882354,0.7741935483870968,69911954,17,5
1,5,0.4444444444444444,0.8888888888888888,66923920,9,4
2,2,0.6666666666666666,0.8,62449534,6,4
1,5,0.16666666666666666,0.5,62449625,6,1
2,0,1.0,1.0,82096236,2,2
0,6,0.0,0.0,54468365,6,0
0,4,0.2,0.25,70081466,5,1
2,2,0.6,0.6666666666666666,65887066,5,3
2,1,0.5,0.5,80094693,2,1
0,1,0.0,0.0,80126866,1,0
1,5,0.4444444444444444,0.8,82096278,9,4
2,1,0.5,0.5,67154514,2,1
0,10,0.0,0.0,82102769,10,0
0,5,0.0,0.0,82102631,5,0
0,6,0.14285714285714285,0.3,82102913,7,1
0,3,0.0,0.0,65290204,3,0
2,1,0.5,0.5,82070196,2,1
2,0,1.0,1.0,67824295,4,4
0,9,0.0,0.0,80029110,9,0
2,3,0.5,0.7272727272727273,69799646,6,3
2,4,0.5,0.42857142857142855,67779831,8,4
0,5,0.16666666666666666,0.3333333333333333,70679273,6,1
1,3,0.25,0.5714285714285714,70692895,4,1
2,0,1.0,1.0,82020361,1,1
2,1,0.9090909090909091,0.5,70822535,11,10
0,2,0.0,0.0,62087823,2,0
0,8,0.1111111111111111,0.37142857142857144,63993125,9,1
1,3,0.4,0.9523809523809523,69163493,5,2
1,5,0.2857142857142857,0.6538461538461539,73295894,7,2
1,7,0.3,0.6857142857142857,70175602,10,3
2,0,1.0,1.0,66232425,1,1
0,4,0.0,0.0,70677131,4,0
1,4,0.3333333333333333,0.7142857142857143,80136726,6,2
1,5,0.4444444444444444,0.625,69483015,9,4
2,1,0.6666666666666666,0.875,80150319,3,2
2,1,0.75,0.5,80092306,4,3
0,12,0.14285714285714285,0.04,69954206,14,2
2,0,1.0,1.0,82053163,2,2
2,2,0.6,0.6666666666666666,81989158,5,3
0,1,0.0,0.0,69596555,1,0
0,2,0.0,0.0,69596856,2,0
2,2,0.6666666666666666,0.75,71458891,6,4
1,7,0.3,0.9285714285714286,69886964,10,3
0,6,0.14285714285714285,0.3103448275862069,70748594,7,1
0,5,0.0,0.0,70679084,5,0
2,1,0.6666666666666666,0.0,80126603,3,2
0,3,0.0,0.0,65981902,3,0
2,1,0.8,0.75,70567945,5,4
1,6,0.25,0.5555555555555556,70654535,8,2
1,3,0.25,0.5,67822440,4,1
1,2,0.3333333333333333,0.7777777777777778,69034084,3,1
1,11,0.3888888888888889,0.84,65279802,18,7
2,0,1.0,1.0,69153196,1,1
2,1,0.75,0.5,63737800,4,3
2,0,1.0,1.0,73632412,1,1
0,21,0.16,0.11764705882352941,82163482,25,4
2,3,0.8,0.9090909090909091,67843272,15,12
2,2,0.8181818181818182,0.0,80162132,11,9
2,1,0.75,0.6666666666666666,82179478,4,3
2,0,1.0,1.0,74443544,1,1
2,1,0.8,0.6666666666666666,82020090,5,4
2,0,1.0,1.0,82054072,3,3
0,3,0.25,0.0,80125219,4,1
2,1,0.6666666666666666,0.5,82016285,3,2
2,0,1.0,1.0,80172947,3,3
2,0,1.0,1.0,80003882,3,3
2,0,1.0,1.0,68487125,6,6
2,4,0.6,0.6666666666666666,82047592,10,6
0,10,0.09090909090909091,0.25,72868194,11,1
2,0,1.0,1.0,80176055,1,1
2,1,0.5,0.0,80125198,2,1
2,0,1.0,1.0,65839515,1,1
2,1,0.5,0.0,82022168,2,1
2,5,0.6428571428571429,0.9411764705882353,69666800,14,9
2,1,0.6666666666666666,0.75,80158276,3,2
2,1,0.6666666666666666,0.75,70037163,3,2
0,2,0.0,0.0,82041725,2,0
0,4,0.2,0.4375,80163437,5,1
0,3,0.0,0.0,80123455,3,0
0,1,0.0,0.0,67786705,1,0
1,6,0.4,0.8333333333333334,69159594,10,4
2,14,0.6216216216216216,0.92,80126940,37,23
2,1,0.5,0.7692307692307693,80141326,2,1
1,3,0.25,0.8666666666666667,70674373,4,1
1,6,0.14285714285714285,0.5675675675675675,66227154,7,1
0,4,0.2,0.45454545454545453,75346383,5,1
1,6,0.14285714285714285,0.6666666666666666,70674800,7,1
0,3,0.0,0.0,80135299,3,0
2,5,0.5454545454545454,0.8888888888888888,65598743,11,6
0,5,0.16666666666666666,0.22727272727272727,70842961,6,1
0,4,0.2,0.0,73257086,5,1
2,0,1.0,1.0,69861526,1,1
0,3,0.0,0.0,80105095,3,0
1,2,0.3333333333333333,0.7857142857142857,65282546,3,1
0,3,0.0,0.0,65283015,3,0
0,4,0.0,0.0,69311494,4,0
0,7,0.0,0.0,69315554,7,0
0,2,0.0,0.0,69723976,2,0
0,14,0.06666666666666667,0.1111111111111111,70680435,15,1
1,9,0.3076923076923077,0.64,80135728,13,4
1,5,0.2857142857142857,0.7272727272727273,68241411,7,2
1,2,0.3333333333333333,0.8181818181818182,70692762,3,1
0,18,0.05263157894736842,0.12903225806451613,70078274,19,1
0,3,0.25,0.42857142857142855,69630092,4,1
0,6,0.14285714285714285,0.30434782608695654,64068732,7,1
1,12,0.3333333333333333,0.8823529411764706,65709833,18,6
1,4,0.2,0.6923076923076923,80149983,5,1
1,4,0.3333333333333333,0.8125,69857760,6,2
2,0,1.0,1.0,70509502,2,2
0,2,0.3333333333333333,0.375,70760473,3,1
2,1,0.5,0.6666666666666666,66816862,2,1
0,19,0.0,0.0,78540721,19,0
2,0,1.0,1.0,69071401,4,4
2,1,0.5,0.6666666666666666,69484093,2,1
1,7,0.3,0.675,80105046,10,3
2,2,0.6666666666666666,0.9090909090909091,82023093,6,4
0,4,0.0,0.0,73295915,4,0
0,9,0.0,0.0,68498255,9,0
0,9,0.0,0.0,68498332,9,0
0,12,0.0,0.0,68498416,12,0
2,3,0.5,0.8888888888888888,79990134,6,3
2,2,0.5,0.7777777777777778,70646436,4,2
0,20,0.23076923076923078,0.4883720930232558,66855845,26,6
0,20,0.047619047619047616,0.18604651162790697,68497702,21,1
2,2,0.5,0.8,72376311,4,2
0,4,0.0,0.0,82154381,4,0
0,3,0.25,0.0,70608881,4,1
0,2,0.0,0.0,69689921,2,0
2,0,1.0,1.0,82019973,1,1
1,6,0.3333333333333333,0.7692307692307693,60909093,9,3
0,1,0.0,0.0,82250578,1,0
0,1,0.0,0.0,82250619,1,0
2,0,1.0,1.0,66211593,3,3
0,17,0.05555555555555555,0.21428571428571427,70237832,18,1
2,0,1.0,1.0,68654726,4,4
2,1,0.5,0.8571428571428571,65976736,2,1
0,2,0.0,0.0,65758042,2,0
2,4,0.875,0.75,64939735,32,28
0,1,0.0,0.0,82020305,1,0
2,1,0.5,0.6666666666666666,67786824,2,1
0,2,0.0,0.0,70422275,2,0
0,3,0.25,0.25,67672850,4,1
0,1,0.0,0.0,70693630,1,0
1,5,0.2857142857142857,0.6896551724137931,70693770,7,2
0,14,0.3,0.37037037037037035,82096279,20,6
1,7,0.3,0.75,72157050,10,3
1,7,0.36363636363636365,0.5625,82113199,11,4
2,0,1.0,1.0,67843230,3,3
0,4,0.0,0.0,68017782,4,0
0,1,0.0,0.0,70692363,1,0
1,2,0.3333333333333333,0.8333333333333334,68167806,3,1
2,2,0.5,0.25,66228610,4,2
0,1,0.0,0.0,67993611,1,0
0,8,0.1111111111111111,0.3333333333333333,69391182,9,1
2,1,0.5,0.5,80135030,2,1
1,3,0.25,0.6923076923076923,65286781,4,1
0,11,0.15384615384615385,0.1935483870967742,65286816,13,2
2,1,0.8333333333333334,0.6666666666666666,69863353,6,5
0,9,0.18181818181818182,0.3888888888888889,69596723,11,2
0,5,0.2857142857142857,0.2,71374786,7,2
0,1,0.0,0.0,67657632,1,0
0,6,0.0,0.0,70063252,6,0
0,1,0.0,0.0,68763751,1,0
1,2,0.3333333333333333,0.5714285714285714,82013631,3,1
2,0,1.0,1.0,80165336,2,2
0,6,0.0,0.0,70682633,6,0
0,1,0.0,0.0,70682654,1,0
0,1,0.0,0.0,70696381,1,0
1,5,0.4444444444444444,0.9375,69021372,9,4
1,14,0.2631578947368421,0.5517241379310345,70632170,19,5
2,9,0.5909090909090909,0.9545454545454546,81989153,22,13
0,8,0.2,0.4523809523809524,68273786,10,2
1,6,0.4,0.8333333333333334,72803003,10,4
2,1,0.5,0.0,68631640,2,1
0,1,0.0,0.0,82019745,1,0
0,1,0.0,0.0,70013594,1,0
0,3,0.25,0.42857142857142855,80133809,4,1
1,4,0.42857142857142855,0.6666666666666666,75149501,7,3
2,4,0.7333333333333333,0.8571428571428571,70851431,15,11
1,6,0.25,0.5806451612903226,70843990,8,2
2,2,0.7142857142857143,0.6666666666666666,67540585,7,5
2,8,0.5,0.9166666666666666,69666590,16,8
2,0,1.0,1.0,74452560,6,6
0,5,0.0,0.0,80153681,5,0
2,1,0.5,0.5,73871406,2,1
1,6,0.4,0.8095238095238095,68545673,10,4
0,5,0.375,0.23076923076923078,77540904,8,3
2,0,1.0,1.0,67485775,2,2
0,16,0.1111111111111111,0.0,65279193,18,2
2,0,1.0,1.0,63959322,1,1
2,1,0.6666666666666666,0.5,68531092,3,2
2,1,0.5,0.9,70679672,2,1
1,3,0.4,0.8947368421052632,82002285,5,2
0,2,0.0,0.0,72809044,2,0
2,0,1.0,1.0,69681402,9,9
0,6,0.0,0.0,74029032,6,0
0,9,0.18181818181818182,0.4782608695652174,70121072,11,2
1,3,0.25,0.7,76081285,4,1
0,2,0.0,0.0,70697711,2,0
0,9,0.1,0.4117647058823529,70693805,10,1
0,16,0.0,0.0,78507443,16,0
2,1,0.5,0.5,70189651,2,1
2,1,0.5,0.5,70190211,2,1
1,11,0.42105263157894735,0.9,70669445,19,8
0,2,0.0,0.0,70699153,2,0
1,5,0.375,0.5,79788562,8,3
0,3,0.25,0.4444444444444444,67666991,4,1
1,3,0.25,0.8863636363636364,80089142,4,1
1,6,0.3333333333333333,0.8421052631578947,80167300,9,3
1,7,0.4166666666666667,0.972972972972973,80128490,12,5
0,1,0.0,0.0,69868043,1,0
0,1,0.0,0.0,80150550,1,0
0,9,0.1,0.37142857142857144,64233946,10,1
1,3,0.25,0.75,82006282,4,1
0,9,0.25,0.42105263157894735,72906792,12,3
0,3,0.0,0.0,80131211,3,0
2,0,1.0,1.0,80159295,1,1
1,6,0.4,0.5,62147162,10,4
0,1,0.0,0.0,70512085,1,0
1,6,0.3333333333333333,0.8055555555555556,66939026,9,3
1,9,0.35714285714285715,0.9285714285714286,69836116,14,5
1,3,0.25,0.7142857142857143,75148003,4,1
0,1,0.0,0.0,69057940,1,0
0,1,0.0,0.0,78266706,1,0
0,4,0.0,0.0,70706251,4,0
0,4,0.2,0.2727272727272727,67925445,5,1
0,5,0.0,0.0,73801056,5,0
0,4,0.0,0.0,69693743,4,0
2,2,0.5,0.8571428571428571,69635825,4,2
0,2,0.0,0.0,82206122,2,0
2,1,0.6666666666666666,0.5,69908986,3,2
2,1,0.5,0.5,70678454,2,1
0,1,0.0,0.0,69034231,1,0
2,0,1.0,1.0,80153968,3,3
1,4,0.42857142857142855,0.7777777777777778,66228435,7,3
2,0,1.0,1.0,68133996,1,1
0,4,0.0,0.0,70259385,4,0
0,4,0.2,0.35714285714285715,70063763,5,1
2,0,1.0,1.0,67841256,2,2
2,4,0.6666666666666666,0.9090909090909091,80176652,12,8
1,3,0.4,0.75,73295726,5,2
2,0,1.0,1.0,82018674,1,1
2,1,0.5,0.8571428571428571,69633942,2,1
2,0,1.0,1.0,67428634,3,3
2,4,0.7647058823529411,0.9230769230769231,82051998,17,13
0,3,0.0,0.0,70679994,3,0
1,7,0.3,0.5,81989149,10,3
0,8,0.42857142857142855,0.4444444444444444,70809536,14,6
0,1,0.0,0.0,69026503,1,0
0,1,0.0,0.0,69499290,1,0
2,1,0.8571428571428571,0.5,78621361,7,6
2,2,0.6666666666666666,0.9090909090909091,80069815,6,4
0,5,0.16666666666666666,0.3684210526315789,69100955,6,1
2,0,1.0,1.0,70645463,1,1
0,4,0.0,0.0,70179263,4,0
2,1,0.5,0.9166666666666666,80056053,2,1
1,3,0.4,0.8333333333333334,68756590,5,2
2,1,0.5,0.6666666666666666,82145136,2,1
2,1,0.875,0.5,79792594,8,7
0,6,0.14285714285714285,0.2,74539304,7,1
2,7,0.5,0.9166666666666666,68402166,14,7
0,1,0.0,0.0,63283584,1,0
2,1,0.5,0.6666666666666666,69603604,2,1
0,11,0.08333333333333333,0.0,79976491,12,1
2,4,0.6363636363636364,0.9444444444444444,70854336,11,7
1,8,0.42857142857142855,0.95,65280425,14,6
0,2,0.0,0.0,70674772,2,0
0,1,0.0,0.0,70686091,1,0
2,2,0.5,0.8,62142605,4,2
2,3,0.7272727272727273,0.9333333333333333,72803080,11,8
0,1,0.0,0.0,70601286,1,0
0,3,0.25,0.3333333333333333,54298363,4,1
1,7,0.4166666666666667,0.6666666666666666,80118307,12,5
0,1,0.0,0.0,66304861,1,0
2,1,0.6666666666666666,0.6666666666666666,73800734,3,2
2,1,0.6666666666666666,0.5,82143781,3,2
2,0,1.0,1.0,82022174,3,3
2,0,1.0,1.0,70851312,2,2
1,6,0.4,0.7666666666666667,75048190,10,4
2,2,0.6,0.8,82041295,5,3
2,0,1.0,1.0,68883626,4,4
2,0,1.0,1.0,79838654,7,7
2,1,0.875,0.5,80181787,8,7
2,0,1.0,1.0,80159732,2,2
2,0,1.0,1.0,70747173,3,3
0,2,0.0,0.0,82126264,2,0
2,0,1.0,1.0,80138913,2,2
2,0,1.0,1.0,73651081,2,2
2,7,0.65,0.9375,70648130,20,13
2,2,0.7142857142857143,0.9090909090909091,81900847,7,5
2,2,0.6,0.6666666666666666,80126997,5,3
2,1,0.5,0.5,80150249,2,1
2,1,0.5,0.5,80128329,2,1
2,0,1.0,1.0,68276775,1,1
0,3,0.25,0.45454545454545453,66539823,4,1
0,8,0.2,0.42857142857142855,70693154,10,2
0,7,0.0,0.0,70697935,7,0
0,4,0.0,0.0,73296083,4,0
2,0,1.0,1.0,70071505,1,1
1,5,0.4444444444444444,0.7333333333333333,890715,9,4
1,3,0.25,0.7777777777777778,69164333,4,1
0,2,0.0,0.0,80170928,2,0
1,2,0.3333333333333333,0.6666666666666666,70633241,3,1
0,8,0.0,0.0,66503430,8,0
2,0,1.0,1.0,80128364,1,1
0,12,0.0,0.0,80124395,12,0
0,4,0.2,0.3333333333333333,64458016,5,1
0,1,0.0,0.0,66203802,1,0
0,2,0.0,0.0,70621684,2,0
1,4,0.42857142857142855,0.7142857142857143,72801393,7,3
0,8,0.1111111111111111,0.35294117647058826,69469470,9,1
2,0,1.0,1.0,71879654,3,3
0,5,0.0,0.0,69186964,5,0
1,5,0.4444444444444444,0.9,73783570,9,4
0,1,0.0,0.0,73801490,1,0
0,5,0.2857142857142857,0.47368421052631576,73295453,7,2
1,8,0.42857142857142855,0.8461538461538461,80128508,14,6
0,9,0.1,0.14285714285714285,70700035,10,1
1,3,0.25,0.5862068965517241,70703024,4,1
0,8,0.2,0.14285714285714285,67905243,10,2
0,6,0.0,0.0,66227196,6,0
1,6,0.14285714285714285,0.6363636363636364,66227203,7,1
1,5,0.2857142857142857,0.5862068965517241,66227210,7,2
1,4,0.2,0.7666666666666667,68668425,5,1
2,2,0.6,0.9583333333333334,82143728,5,3
0,10,0.0,0.0,67995746,10,0
1,6,0.14285714285714285,0.5263157894736842,80176300,7,1
0,1,0.0,0.0,73632531,1,0
0,3,0.0,0.0,80123388,3,0
0,11,0.21428571428571427,0.46875,70685356,14,3
0,8,0.2,0.30952380952380953,69498856,10,2
2,2,0.6666666666666666,0.6666666666666666,66111990,6,4
2,2,0.6666666666666666,0.875,80074421,6,4
1,2,0.3333333333333333,0.8125,82143740,3,1
2,1,0.5,0.5,82022315,2,1
2,0,1.0,1.0,82009390,4,4
0,6,0.14285714285714285,0.2727272727272727,70680701,7,1
0,2,0.0,0.0,82154406,2,0
0,16,0.15789473684210525,0.2903225806451613,70230090,19,3
1,5,0.375,0.5384615384615384,70418201,8,3
0,3,0.0,0.0,82051777,3,0
2,1,0.8,0.5,80168328,5,4
2,0,1.0,1.0,65286424,4,4
1,8,0.3333333333333333,0.6666666666666666,68234292,12,4
2,4,0.5,0.9333333333333333,79616166,8,4
0,5,0.16666666666666666,0.0,68805933,6,1
2,1,0.8333333333333334,0.9230769230769231,82020154,6,5
2,0,1.0,1.0,72801631,1,1
1,7,0.36363636363636365,0.86,80164932,11,4
2,0,1.0,1.0,69954276,1,1
1,6,0.4,0.7647058823529411,70120225,10,4
0,8,0.0,0.0,515473,8,0
2,2,0.8666666666666667,0.6666666666666666,69406785,15,13
2,0,1.0,1.0,80128564,3,3
0,12,0.07692307692307693,0.16393442622950818,70680981,13,1
0,6,0.0,0.0,70683445,6,0
0,15,0.16666666666666666,0.45454545454545453,82010268,18,3
2,2,0.5,0.5,70322546,4,2
0,13,0.1875,0.39285714285714285,70682164,16,3
2,3,0.5,0.9230769230769231,70692160,6,3
2,4,0.5,0.9523809523809523,65909550,8,4
2,4,0.5,0.75,70113582,8,4
0,1,0.0,0.0,64976296,1,0
2,0,1.0,1.0,75362273,5,5
0,2,0.0,0.0,69124804,2,0
0,7,0.125,0.125,82201358,8,1
0,1,0.0,0.0,82201362,1,0
2,1,0.5,0.8571428571428571,82016280,2,1
1,5,0.4444444444444444,0.7777777777777778,80165175,9,4
0,5,0.0,0.0,70005005,5,0
2,0,1.0,1.0,69604003,2,2
1,6,0.14285714285714285,0.5132743362831859,82137497,7,1
0,1,0.0,0.0,70706510,1,0
2,0,1.0,1.0,70120085,2,2
0,14,0.0,0.0,68161513,14,0
0,10,0.16666666666666666,0.41379310344827586,70680603,12,2
0,3,0.0,0.0,82022881,3,0
0,9,0.25,0.26666666666666666,80124762,12,3
0,6,0.0,0.0,54252051,6,0
2,2,0.6,0.75,66228673,5,3
0,11,0.21428571428571427,0.38095238095238093,82145527,14,3
0,7,0.0,0.0,70941542,7,0
1,9,0.25,0.74,82103917,12,3
2,0,1.0,1.0,82052095,5,5
1,3,0.4,0.875,80134128,5,2
1,4,0.42857142857142855,0.8823529411764706,66353910,7,3
2,1,0.5,0.75,64235465,2,1
2,0,1.0,1.0,79843974,1,1
2,0,1.0,1.0,75264294,1,1
1,3,0.25,0.6666666666666666,70843402,4,1
2,2,0.5,0.8333333333333334,69575555,4,2
2,0,1.0,1.0,66761786,4,4
2,0,1.0,1.0,80174189,2,2
0,20,0.16666666666666666,0.34210526315789475,72906750,24,4
2,0,1.0,1.0,82201010,2,2
0,7,0.4166666666666667,0.2222222222222222,67872385,12,5
2,6,0.5384615384615384,0.8461538461538461,80180265,13,7
0,3,0.25,0.25,70658665,4,1
2,0,1.0,1.0,80153622,2,2
2,3,0.5714285714285714,0.0,70762832,7,4
0,1,0.0,0.0,65595992,1,0
2,1,0.8,0.5,80128570,5,4
2,0,1.0,1.0,82143624,6,6
2,0,1.0,1.0,80139966,1,1
2,0,1.0,1.0,68765501,4,4
1,11,0.35294117647058826,0.625,80163135,17,6
2,3,0.8235294117647058,0.8333333333333334,76973925,17,14
0,4,0.0,0.0,69395445,4,0
0,4,0.0,0.0,70818230,4,0
0,8,0.1111111111111111,0.46153846153846156,69139126,9,1
1,16,0.1111111111111111,0.5063291139240507,69634446,18,2
0,10,0.16666666666666666,0.375,68812380,12,2
1,2,0.3333333333333333,0.6,68812394,3,1
2,2,0.7142857142857143,0.9230769230769231,70238595,7,5
2,3,0.5,0.8333333333333334,80145905,6,3
0,2,0.0,0.0,66864140,2,0
0,1,0.0,0.0,67335856,1,0
0,2,0.0,0.0,69117125,2,0
2,2,0.6666666666666666,0.0,66227735,6,4
2,2,0.6,0.6666666666666666,80176662,5,3
2,0,1.0,1.0,75295192,1,1
2,0,1.0,1.0,63180173,3,3
2,1,0.5,0.9230769230769231,79953930,2,1
1,15,0.2857142857142857,0.6046511627906976,19430453,21,6
2,1,0.5,0.5,68999854,2,1
0,2,0.3333333333333333,0.3333333333333333,68058340,3,1
0,3,0.0,0.0,69596674,3,0
0,1,0.0,0.0,80162794,1,0
0,3,0.0,0.0,82006752,3,0
0,2,0.0,0.0,82006754,2,0
1,17,0.15,0.6703296703296703,67435130,20,3
0,15,0.0625,0.27710843373493976,68905634,16,1
2,0,1.0,1.0,68518205,2,2
0,2,0.0,0.0,82006225,2,0
1,5,0.16666666666666666,0.72,70059556,6,1
0,7,0.0,0.0,82102867,7,0
2,0,1.0,1.0,64470371,7,7
1,2,0.3333333333333333,0.85,66423966,3,1
1,7,0.46153846153846156,0.8333333333333334,65609313,13,6
2,0,1.0,1.0,80162886,1,1
1,9,0.18181818181818182,0.5454545454545454,69911044,11,2
0,5,0.0,0.0,70916391,5,0
1,7,0.2222222222222222,0.7037037037037037,74924276,9,2
0,4,0.0,0.0,82150069,4,0
0,6,0.0,0.0,80131210,6,0
0,16,0.0,0.0,67467610,16,0
2,2,0.6666666666666666,0.8,80162798,6,4
0,9,0.0,0.0,80150699,9,0
0,8,0.0,0.0,80150714,8,0
0,22,0.15384615384615385,0.49411764705882355,68227313,26,4
2,3,0.5714285714285714,0.6666666666666666,66232453,7,4
1,7,0.2222222222222222,0.7410714285714286,82137505,9,2
1,2,0.3333333333333333,0.75,69547800,3,1
2,6,0.7931034482758621,0.9333333333333333,67650226,29,23
0,2,0.0,0.0,82018742,2,0
0,6,0.3333333333333333,0.4444444444444444,70609014,9,3
2,5,0.6428571428571429,0.8571428571428571,65282420,14,9
1,7,0.36363636363636365,0.7241379310344828,68045936,11,4
0,3,0.0,0.0,69997452,3,0
0,9,0.1,0.08333333333333333,69997760,10,1
0,4,0.0,0.0,65279984,4,0
2,3,0.5714285714285714,0.9655172413793104,72697905,7,4
2,1,0.5,0.5,69630113,2,1
2,1,0.6666666666666666,0.9230769230769231,70747663,3,2
0,13,0.13333333333333333,0.0625,80130317,15,2
2,1,0.6666666666666666,0.8571428571428571,82070187,3,2
0,6,0.0,0.0,61871733,6,0
2,0,1.0,1.0,66175011,1,1
2,1,0.5,0.5,70071484,2,1
2,3,0.5,0.9411764705882353,69596814,6,3
0,1,0.0,0.0,69596933,1,0
2,2,0.7142857142857143,0.875,82037220,7,5
1,12,0.29411764705882354,0.6818181818181818,80159895,17,5
0,2,0.0,0.0,69603751,2,0
1,3,0.25,0.875,69603821,4,1
0,12,0.07692307692307693,0.35185185185185186,82102523,13,1
0,11,0.0,0.0,67053812,11,0
2,3,0.5,0.9,65667140,6,3
2,1,0.6666666666666666,0.75,70407554,3,2
2,1,0.6666666666666666,0.5,68402180,3,2
0,6,0.14285714285714285,0.36363636363636365,70702786,7,1
2,0,1.0,1.0,82051773,1,1
2,2,0.7142857142857143,0.8,69638296,7,5
0,3,0.0,0.0,71081724,3,0
0,2,0.0,0.0,66782653,2,0
0,3,0.0,0.0,70395626,3,0
2,1,0.5,0.8571428571428571,70175364,2,1
0,10,0.0,0.0,70691971,10,0
1,5,0.4444444444444444,0.8387096774193549,80163126,9,4
2,1,0.6666666666666666,0.5,69168701,3,2
0,4,0.2,0.38461538461538464,72539915,5,1
0,1,0.0,0.0,72540230,1,0
0,1,0.0,0.0,72952593,1,0
2,0,1.0,1.0,82145129,2,2
1,16,0.3333333333333333,0.75,66508820,24,8
2,2,0.6666666666666666,0.875,72801932,6,4
2,2,0.6,0.8571428571428571,69660696,5,3
2,2,0.5,0.75,79792216,4,2
0,2,0.0,0.0,80105361,2,0
0,7,0.125,0.09090909090909091,80172880,8,1
1,9,0.3076923076923077,0.7837837837837838,80131186,13,4
2,1,0.6666666666666666,0.875,79758294,3,2
2,0,1.0,1.0,80176056,2,2
1,3,0.4,0.75,69041140,5,2
0,16,0.2,0.1702127659574468,82116866,20,4
0,6,0.14285714285714285,0.3333333333333333,66802806,7,1
2,1,0.5,0.6666666666666666,80127926,2,1
2,2,0.6,0.6666666666666666,80054996,5,3
1,7,0.3,0.8461538461538461,69417446,10,3
2,1,0.5,0.5,78266636,2,1
0,2,0.3333333333333333,0.25,82034385,3,1
2,0,1.0,1.0,80165242,1,1
0,5,0.0,0.0,78735496,5,0
0,3,0.0,0.0,80150472,3,0
0,2,0.0,0.0,68401753,2,0
2,0,1.0,1.0,80161947,1,1
2,0,1.0,1.0,69964685,1,1
0,2,0.3333333333333333,0.3333333333333333,69976053,3,1
0,1,0.0,0.0,69976151,1,0
2,1,0.6666666666666666,0.5,80118876,3,2
2,0,1.0,1.0,82009822,2,2
1,3,0.25,0.6,72365846,4,1
2,0,1.0,1.0,80136598,6,6
2,0,1.0,1.0,82059902,3,3
2,0,1.0,1.0,80159737,4,4
2,0,1.0,1.0,82145572,2,2
2,0,1.0,1.0,82095279,2,2
2,0,1.0,1.0,70586705,3,3
2,1,0.75,0.5,68500425,4,3
2,0,1.0,1.0,82039376,5,5
0,5,0.0,0.0,71510145,5,0
2,0,1.0,1.0,80159705,6,6
2,0,1.0,1.0,69511043,1,1
0,2,0.0,0.0,70063721,2,0
2,1,0.5,0.8571428571428571,72803703,2,1
2,0,1.0,1.0,82041724,1,1
2,0,1.0,1.0,80159276,1,1
2,0,1.0,1.0,70572761,4,4
0,1,0.0,0.0,69575142,1,0
0,12,0.0,0.0,80150805,12,0
0,7,0.125,0.4090909090909091,71619443,8,1
2,1,0.5,0.5,73460016,2,1
0,6,0.0,0.0,73295495,6,0
2,1,0.6666666666666666,0.5,80054982,3,2
2,4,0.7142857142857143,0.8,72417912,14,10
2,3,0.625,0.5,70818902,8,5
1,7,0.2222222222222222,0.5333333333333333,69638303,9,2
0,7,0.0,0.0,66785964,7,0
0,8,0.1111111111111111,0.11475409836065574,80131221,9,1
0,1,0.0,0.0,69724165,1,0
0,2,0.0,0.0,80104983,2,0
0,4,0.2,0.21428571428571427,70474215,5,1
2,1,0.5,0.6666666666666666,70704963,2,1
2,4,0.5,0.16666666666666666,67347721,8,4
0,3,0.0,0.0,66378823,3,0
0,10,0.16666666666666666,0.3939393939393939,66378942,12,2
2,0,1.0,1.0,63963704,1,1
1,4,0.3333333333333333,0.7,72802093,6,2
0,3,0.0,0.0,82095122,3,0
2,0,1.0,1.0,76805120,2,2
2,1,0.5,0.3333333333333333,72474710,2,1
0,2,0.0,0.0,72474780,2,0
2,4,0.5,0.4,72475214,8,4
2,3,0.5,0.875,80145420,6,3
0,5,0.0,0.0,80145443,5,0
2,0,1.0,1.0,82163439,1,1
1,6,0.3333333333333333,0.7692307692307693,68380382,9,3
2,0,1.0,1.0,70344904,3,3
2,4,0.5555555555555556,0.5,70687666,9,5
1,5,0.2857142857142857,0.5,80128854,7,2
0,3,0.0,0.0,70674835,3,0
0,1,0.0,0.0,70677943,1,0
0,2,0.0,0.0,80126805,2,0
1,2,0.3333333333333333,0.8,80084053,3,1
0,6,0.25,0.32,69484436,8,2
2,1,0.6666666666666666,0.5,80061534,3,2
0,4,0.0,0.0,66225250,4,0
0,1,0.0,0.0,69861841,1,0
0,2,0.3333333333333333,0.3333333333333333,66257975,3,1
0,3,0.0,0.0,67965590,3,0
0,7,0.125,0.0,67053742,8,1
2,2,0.6666666666666666,0.8,70255892,6,4
2,1,0.75,0.5,68545680,4,3
0,5,0.16666666666666666,0.42857142857142855,72104536,6,1
2,2,0.7142857142857143,0.5,73829903,7,5
1,4,0.42857142857142855,0.8333333333333334,73635030,7,3
2,0,1.0,1.0,80132961,3,3
2,5,0.5454545454545454,0.9836065573770492,69949523,11,6
0,2,0.0,0.0,80145560,2,0
1,5,0.2857142857142857,0.6666666666666666,69622441,7,2
0,4,0.0,0.0,70908684,4,0
0,14,0.0,0.0,80124332,14,0
2,1,0.5,0.6666666666666666,82247786,2,1
0,1,0.0,0.0,80178630,1,0
2,0,1.0,1.0,80165224,4,4
0,14,0.125,0.3225806451612903,70679966,16,2
0,2,0.3333333333333333,0.4,70691250,3,1
0,1,0.0,0.0,70699034,1,0
0,10,0.0,0.0,70680302,10,0
2,3,0.7272727272727273,0.6666666666666666,66371872,11,8
0,19,0.05,0.018518518518518517,66378872,20,1
1,17,0.22727272727272727,0.5882352941176471,66378914,22,5
2,3,0.7,0.75,69585740,10,7
2,1,0.8,0.8,67780972,5,4
1,4,0.2,0.5625,80126752,5,1
0,11,0.15384615384615385,0.1111111111111111,70646303,13,2
1,15,0.3181818181818182,0.6341463414634146,65286354,22,7
2,1,0.5,0.6,80165799,2,1
2,2,0.5,0.8571428571428571,69998040,4,2
2,2,0.5,0.75,70691432,4,2
2,0,1.0,1.0,80105354,1,1
2,0,1.0,1.0,67821663,3,3
2,0,1.0,1.0,80159160,2,2
1,5,0.16666666666666666,0.5,69169401,6,1
2,0,1.0,1.0,69038102,1,1
0,8,0.2,0.4883720930232558,69633053,10,2
2,2,0.6,0.75,63883211,5,3
2,4,0.5,0.9411764705882353,68287331,8,4
2,0,1.0,1.0,82182778,1,1
2,0,1.0,1.0,72376332,1,1
0,5,0.2857142857142857,0.16666666666666666,69090196,7,2
1,3,0.25,0.6363636363636364,80150260,4,1
0,5,0.16666666666666666,0.0,65288776,6,1
0,16,0.2,0.32727272727272727,65288965,20,4
2,0,1.0,1.0,82018898,6,6
0,1,0.0,0.0,66212741,1,0
0,3,0.25,0.2,67282173,4,1
0,4,0.2,0.35714285714285715,70318010,5,1
2,2,0.7142857142857143,0.5,367234,7,5
1,4,0.3333333333333333,0.625,69597101,6,2
0,1,0.0,0.0,68625690,1,0
2,1,0.5,0.0,68249356,2,1
0,14,0.0,0.0,72546271,14,0
0,3,0.0,0.0,69596541,3,0
0,3,0.0,0.0,80163442,3,0
1,8,0.2727272727272727,0.6923076923076923,80126771,11,3
0,1,0.0,0.0,68373620,1,0
2,3,0.5714285714285714,0.8,69604073,7,4
0,44,0.13725490196078433,0.13157894736842105,80140090,51,7
2,1,0.5,0.0,67787636,2,1
0,3,0.25,0.4,70347942,4,1
2,1,0.75,0.5,67832632,4,3
2,2,0.6,0.75,67271316,5,3
1,6,0.45454545454545453,0.6666666666666666,80128019,11,5
0,4,0.2,0.23529411764705882,70175735,5,1
1,3,0.4,0.6,66476102,5,2
0,6,0.25,0.06666666666666667,82113198,8,2
0,1,0.0,0.0,68556376,1,0
0,18,0.05263157894736842,0.13253012048192772,70684726,19,1
1,4,0.42857142857142855,0.8571428571428571,75149536,7,3
0,10,0.23076923076923078,0.3333333333333333,69185312,13,3
2,4,0.8,0.9333333333333333,80056515,20,16
2,2,0.5,0.6666666666666666,74089330,4,2
0,4,0.0,0.0,80029075,4,0
0,4,0.0,0.0,70703402,4,0
2,1,0.5,0.8333333333333334,70694414,2,1
2,2,0.6,0.75,79792461,5,3
2,0,1.0,1.0,74619741,7,7
0,1,0.0,0.0,70813162,1,0
2,12,0.5,0.46153846153846156,65994586,24,12
2,2,0.5,0.9047619047619048,66861704,4,2
2,0,1.0,1.0,68060692,3,3
1,8,0.38461538461538464,0.875,80125964,13,5
0,5,0.0,0.0,69499311,5,0
2,1,0.6666666666666666,0.6666666666666666,70493661,3,2
2,0,1.0,1.0,82020754,2,2
2,0,1.0,1.0,82018783,3,3
0,5,0.16666666666666666,0.3,70707392,6,1
0,14,0.06666666666666667,0.4,70238084,15,1
1,8,0.1111111111111111,0.64,81875438,9,1
2,9,0.64,0.9565217391304348,70933674,25,16
0,4,0.0,0.0,69484331,4,0
0,2,0.3333333333333333,0.38461538461538464,69484471,3,1
0,3,0.0,0.0,80172652,3,0
1,4,0.3333333333333333,0.6086956521739131,68226970,6,2
0,3,0.0,0.0,80172574,3,0
1,3,0.25,0.5238095238095238,63321524,4,1
0,3,0.0,0.0,78762663,3,0
1,5,0.16666666666666666,0.5,80167278,6,1
1,3,0.25,0.6666666666666666,64474900,4,1
0,7,0.0,0.0,82102529,7,0
1,3,0.25,0.75,82102550,4,1
0,2,0.0,0.0,80150662,2,0
0,4,0.0,0.0,80089254,4,0
1,12,0.25,0.8723404255319149,69890450,16,4
2,2,0.6666666666666666,0.75,64474991,6,4
0,6,0.0,0.0,80150655,6,0
2,6,0.5384615384615384,0.7857142857142857,68115236,13,7
0,1,0.0,0.0,69164165,1,0
0,3,0.25,0.4,69240983,4,1
2,1,0.8333333333333334,0.5,80054933,6,5
1,6,0.3333333333333333,0.8571428571428571,80155196,9,3
0,1,0.0,0.0,80057040,1,0
0,1,0.0,0.0,80057271,1,0
1,8,0.3333333333333333,0.7,80105263,12,4
2,6,0.5,0.9230769230769231,69509083,12,6
0,2,0.0,0.0,70014665,2,0
2,0,1.0,1.0,82105400,1,1
2,0,1.0,1.0,82012810,2,2
0,3,0.0,0.0,70628684,3,0
0,6,0.0,0.0,82096335,6,0
1,3,0.4,0.9166666666666666,69193796,5,2
0,7,0.125,0.2619047619047619,70702660,8,1
0,16,0.0,0.0,80124320,16,0
0,1,0.0,0.0,68520662,1,0
2,1,0.5,0.8888888888888888,70238224,2,1
0,1,0.0,0.0,82013561,1,0
2,2,0.5,0.8,66239460,4,2
0,1,0.0,0.0,75327203,1,0
1,10,0.3333333333333333,0.7368421052631579,66035263,15,5
0,7,0.0,0.0,82102649,7,0
0,2,0.0,0.0,70591773,2,0
0,9,0.1,0.28205128205128205,69895532,10,1
0,3,0.0,0.0,69653115,3,0
0,8,0.1111111111111111,0.35135135135135137,69895644,9,1
2,0,1.0,1.0,80163686,1,1
0,5,0.0,0.0,82145532,5,0
1,4,0.3333333333333333,0.5714285714285714,69163451,6,2
2,0,1.0,1.0,69958462,4,4
0,1,0.0,0.0,75140261,1,0
1,4,0.42857142857142855,0.5714285714285714,80118463,7,3
0,6,0.0,0.0,80124296,6,0
0,6,0.0,0.0,80124396,6,0
0,5,0.0,0.0,82018909,5,0
2,1,0.5,0.6666666666666666,63159845,2,1
0,3,0.25,0.3076923076923077,69135024,4,1
1,3,0.25,0.6,80126973,4,1
0,3,0.4,0.3333333333333333,66237465,5,2
1,4,0.3333333333333333,0.7142857142857143,65281475,6,2
2,5,0.6153846153846154,0.9473684210526315,79758301,13,8
0,5,0.0,0.0,79789395,5,0
2,0,1.0,1.0,73609970,3,3
0,16,0.15789473684210525,0.21052631578947367,70494585,19,3
0,4,0.2,0.2,73870265,5,1
1,4,0.3333333333333333,0.6818181818181818,82018693,6,2
2,0,1.0,1.0,80159162,2,2
0,4,0.0,0.0,65279893,4,0
1,6,0.4,0.8125,65279634,10,4
1,4,0.3333333333333333,0.6111111111111112,66379516,6,2
2,1,0.5,0.75,70677635,2,1
2,1,0.5,0.8,69003270,2,1
1,4,0.42857142857142855,0.6923076923076923,68042023,7,3
1,35,0.2553191489361702,0.52,69622392,47,12
0,8,0.1111111111111111,0.0,68273380,9,1
0,7,0.125,0.18181818181818182,70415583,8,1
2,1,0.9333333333333333,0.5,70314524,15,14
2,0,1.0,1.0,69976263,1,1
2,0,1.0,1.0,82020627,4,4
2,0,1.0,1.0,82125477,1,1
2,0,1.0,1.0,75277174,4,4
2,0,1.0,1.0,82052100,4,4
2,0,1.0,1.0,80003833,2,2
1,17,0.34615384615384615,0.6031746031746031,80158270,26,9
2,2,0.875,0.9090909090909091,80174694,16,14
2,1,0.75,0.5,82090917,4,3
2,0,1.0,1.0,82041893,3,3
2,0,1.0,1.0,73650983,2,2
2,1,0.75,0.8,80158259,4,3
1,7,0.4166666666666667,0.7,73412836,12,5
2,2,0.6666666666666666,0.6666666666666666,70844284,6,4
2,2,0.8181818181818182,0.9,69033622,11,9
0,1,0.0,0.0,76601175,1,0
0,4,0.2,0.15789473684210525,66285492,5,1
2,0,1.0,1.0,82052102,4,4
1,2,0.3333333333333333,0.6,65014502,3,1
0,1,0.0,0.0,80158298,1,0
2,1,0.75,0.5,72697954,4,3
1,3,0.4,0.6,70493584,5,2
2,2,0.5,0.7777777777777778,82024249,4,2
0,2,0.0,0.0,69422066,2,0
0,1,0.0,0.0,82143739,1,0
0,5,0.16666666666666666,0.375,80131191,6,1
1,6,0.14285714285714285,0.5238095238095238,82103926,7,1
1,4,0.3333333333333333,0.9375,70343763,6,2
1,8,0.2727272727272727,0.696969696969697,64041873,11,3
0,2,0.0,0.0,82006289,2,0
0,4,0.0,0.0,66783563,4,0
1,4,0.2,0.7142857142857143,66787210,5,1
0,4,0.0,0.0,66786615,4,0
2,1,0.5,0.6666666666666666,80176644,2,1
0,3,0.0,0.0,67871433,3,0
0,2,0.0,0.0,80118157,2,0
2,0,1.0,1.0,70418362,2,2
0,1,0.0,0.0,70704753,1,0
2,1,0.5,0.8181818181818182,67620861,2,1
2,0,1.0,1.0,67286590,2,2
2,0,1.0,1.0,79785860,2,2
0,1,0.0,0.0,67690672,1,0
0,18,0.05263157894736842,0.0,60195065,19,1
0,13,0.0,0.0,67315010,13,0
1,7,0.2222222222222222,0.7301587301587301,70239442,9,2
0,5,0.16666666666666666,0.2222222222222222,70705201,6,1
0,1,0.0,0.0,70705761,1,0
0,2,0.0,0.0,69041105,2,0
0,2,0.0,0.0,70705180,2,0
1,7,0.46153846153846156,0.88,69314931,13,6
2,0,1.0,1.0,63337855,1,1
0,5,0.2857142857142857,0.125,69998026,7,2
0,1,0.0,0.0,82013531,1,0
0,2,0.0,0.0,65292696,2,0
0,3,0.0,0.0,82050509,3,0
0,1,0.0,0.0,70230384,1,0
0,6,0.0,0.0,70747880,6,0
0,1,0.0,0.0,66231795,1,0
0,2,0.0,0.0,70063665,2,0
2,1,0.8,0.8,70713622,5,4
2,1,0.5,0.6666666666666666,67626881,2,1
2,3,0.5,0.8888888888888888,82001871,6,3
0,3,0.0,0.0,82251453,3,0
0,4,0.0,0.0,82251461,4,0
2,0,1.0,1.0,82170909,2,2
0,1,0.0,0.0,82024324,1,0
0,10,0.0,0.0,70685013,10,0
0,2,0.0,0.0,70698124,2,0
2,2,0.7142857142857143,0.5,67779761,7,5
1,5,0.375,0.7307692307692307,82052052,8,3
2,5,0.5454545454545454,0.9743589743589743,71341795,11,6
0,3,0.4,0.42857142857142855,70927031,5,2
0,3,0.0,0.0,69701184,3,0
2,1,0.5,0.6,70109851,2,1
2,2,0.6,0.8333333333333334,70109921,5,3
2,1,0.5,0.5,70563276,2,1
2,1,0.5,0.5,67786810,2,1
0,2,0.0,0.0,68748302,2,0
0,1,0.0,0.0,69540905,1,0
2,0,1.0,1.0,82022335,2,2
0,2,0.0,0.0,79254826,2,0
2,2,0.6666666666666666,0.5,80090185,6,4
1,13,0.4583333333333333,0.9473684210526315,69180132,24,11
0,4,0.3333333333333333,0.47619047619047616,70843164,6,2
0,2,0.0,0.0,70706895,2,0
0,2,0.3333333333333333,0.25,69997900,3,1
1,7,0.4166666666666667,0.9375,79760072,12,5
0,6,0.14285714285714285,0.12,70632142,7,1
2,3,0.5,0.6363636363636364,69557061,6,3
0,2,0.0,0.0,70701820,2,0
2,2,0.5,0.8,72801904,4,2
2,2,0.7142857142857143,0.5,67792004,7,5
0,3,0.25,0.46153846153846156,68942972,4,1
2,2,0.6666666666666666,0.5,69129634,6,4
0,5,0.16666666666666666,0.18181818181818182,69031326,6,1
2,3,0.5,0.8,67410931,6,3
1,14,0.17647058823529413,0.5833333333333334,73295593,17,3
2,1,0.75,0.5,66228785,4,3
0,7,0.125,0.0,72809205,8,1
2,1,0.6666666666666666,0.5,69534192,3,2
1,5,0.2857142857142857,0.8260869565217391,69582870,7,2
0,3,0.0,0.0,68498885,3,0
1,4,0.2,0.8205128205128205,68499165,5,1
0,1,0.0,0.0,68500243,1,0
0,5,0.0,0.0,69478920,5,0
0,3,0.0,0.0,70229425,3,0
1,2,0.3333333333333333,0.8333333333333334,70229453,3,1
0,3,0.0,0.0,70229495,3,0
0,3,0.0,0.0,70229544,3,0
0,1,0.0,0.0,70230272,1,0
0,1,0.0,0.0,68190220,1,0
0,1,0.0,0.0,70685202,1,0
1,2,0.3333333333333333,0.7837837837837838,82108553,3,1
1,3,0.4,0.7142857142857143,65598813,5,2
0,2,0.0,0.0,70769405,2,0
0,5,0.2857142857142857,0.375,78449021,7,2
0,1,0.0,0.0,70779016,1,0
2,2,0.5,0.6666666666666666,67097065,4,2
1,12,0.2,0.6384615384615384,80118321,15,3
0,6,0.14285714285714285,0.48623853211009177,80118322,7,1
0,2,0.0,0.0,80118323,2,0
2,2,0.5,0.8333333333333334,82041897,4,2
2,4,0.6666666666666666,0.9230769230769231,69129445,12,8
1,13,0.35,0.8,80127001,20,7
2,1,0.6666666666666666,0.6666666666666666,68497212,3,2
2,7,0.5,0.75,70925736,14,7
0,4,0.0,0.0,70680183,4,0
2,1,0.5,0.6666666666666666,67276482,2,1
0,5,0.16666666666666666,0.15384615384615385,64976142,6,1
0,3,0.0,0.0,69602953,3,0
2,0,1.0,1.0,68748260,2,2
0,1,0.0,0.0,66657220,1,0
2,0,1.0,1.0,73390086,4,4
2,0,1.0,1.0,69951385,2,2
1,2,0.3333333333333333,0.5,66379152,3,1
2,0,1.0,1.0,70639835,2,2
2,0,1.0,1.0,80092236,1,1
0,1,0.0,0.0,70678104,1,0
0,7,0.0,0.0,70681786,7,0
0,4,0.0,0.0,73400565,4,0
0,12,0.14285714285714285,0.1794871794871795,66408615,14,2
2,1,0.6666666666666666,0.5,80091844,3,2
2,1,0.5,0.0,80094091,2,1
2,1,0.5,0.8333333333333334,70674492,2,1
0,3,0.25,0.14285714285714285,80150340,4,1
2,3,0.5714285714285714,0.6666666666666666,70670621,7,4
0,11,0.15384615384615385,0.26666666666666666,70566664,13,2
1,2,0.3333333333333333,0.7333333333333333,80145714,3,1
2,1,0.8333333333333334,0.6666666666666666,61101971,6,5
2,1,0.6666666666666666,0.5,68805464,3,2
1,3,0.4,0.9523809523809523,70691621,5,2
0,2,0.0,0.0,69478416,2,0
0,9,0.25,0.4888888888888889,69479053,12,3
0,5,0.16666666666666666,0.3333333333333333,80128800,6,1
2,0,1.0,1.0,70688030,1,1
0,1,0.0,0.0,80165813,1,0
2,1,0.6666666666666666,0.5,80173408,3,2
0,6,0.0,0.0,64399482,6,0
1,4,0.42857142857142855,0.9090909090909091,70467992,7,3
0,7,0.0,0.0,70398293,7,0
0,17,0.10526315789473684,0.3114754098360656,80163178,19,2
0,19,0.13636363636363635,0.43478260869565216,80155855,22,3
0,1,0.0,0.0,80163183,1,0
0,2,0.0,0.0,82102773,2,0
0,1,0.0,0.0,82006767,1,0
2,1,0.5,0.6666666666666666,80162784,2,1
1,5,0.2857142857142857,0.7857142857142857,80181344,7,2
0,6,0.0,0.0,82102519,6,0
0,2,0.0,0.0,82102758,2,0
0,5,0.16666666666666666,0.47368421052631576,82102881,6,1
0,2,0.0,0.0,82006710,2,0
0,1,0.0,0.0,82006774,1,0
2,1,0.5,0.5,70213836,2,1
2,1,0.5,0.9285714285714286,68150985,2,1
1,8,0.2,0.5384615384615384,68271273,10,2
0,6,0.25,0.0625,82010256,8,2
1,5,0.375,0.5555555555555556,82060540,8,3
0,5,0.2857142857142857,0.3076923076923077,70566244,7,2
2,2,0.5,0.6666666666666666,72814742,4,2
0,1,0.0,0.0,70705152,1,0
0,3,0.25,0.4,73296125,4,1
2,0,1.0,1.0,72814770,1,1
2,0,1.0,1.0,68258085,9,9
1,2,0.3333333333333333,0.5,67030292,3,1
0,4,0.0,0.0,69416165,4,0
2,1,0.6666666666666666,0.6666666666666666,75048211,3,2
2,0,1.0,1.0,70575015,1,1
1,8,0.2,0.7321428571428571,68497695,10,2
2,0,1.0,1.0,82105388,1,1
2,1,0.5,0.5,63461454,2,1
2,1,0.8,0.5,66257261,5,4
2,0,1.0,1.0,80092075,1,1
1,4,0.2,0.6,69723815,5,1
2,0,1.0,1.0,69579314,4,4
2,0,1.0,1.0,76081313,1,1
2,0,1.0,1.0,69878865,2,2
1,4,0.2,0.8181818181818182,69463142,5,1
0,2,0.0,0.0,74960235,2,0
1,2,0.3333333333333333,0.75,82102925,3,1
2,1,0.75,0.6666666666666666,66253586,4,3
0,4,0.0,0.0,68805373,4,0
1,2,0.3333333333333333,0.8666666666666667,63375704,3,1
1,6,0.25,0.8387096774193549,67475436,8,2
0,7,0.0,0.0,67475751,7,0
1,3,0.25,0.875,69234893,4,1
0,5,0.0,0.0,70679784,5,0
2,0,1.0,1.0,82023685,1,1
2,0,1.0,1.0,82042618,3,3
0,17,0.10526315789473684,0.03333333333333333,80180204,19,2
2,0,1.0,1.0,66423056,1,1
2,0,1.0,1.0,82018579,5,5
2,1,0.5,0.6666666666666666,70063084,2,1
0,3,0.0,0.0,80118171,3,0
1,7,0.4166666666666667,0.8787878787878788,70184226,12,5
1,4,0.42857142857142855,0.5555555555555556,69617296,7,3
0,7,0.0,0.0,70684110,7,0
2,1,0.5,0.9411764705882353,71212246,2,1
2,1,0.5,0.8,70700700,2,1
0,5,0.16666666666666666,0.45454545454545453,82021920,6,1
0,3,0.25,0.42857142857142855,67993856,4,1
2,0,1.0,1.0,81875439,1,1
0,9,0.18181818181818182,0.3333333333333333,73800972,11,2
2,2,0.875,0.9411764705882353,69314063,16,14
1,2,0.3333333333333333,0.8,69468973,3,1
2,0,1.0,1.0,66237570,3,3
0,6,0.25,0.36363636363636365,69588183,8,2
0,2,0.0,0.0,80070011,2,0
0,1,0.0,0.0,68755533,1,0
0,3,0.4,0.3333333333333333,68755582,5,2
0,3,0.0,0.0,70674842,3,0
0,5,0.0,0.0,70677740,5,0
0,5,0.0,0.0,70696955,5,0
0,2,0.0,0.0,70697802,2,0
0,2,0.0,0.0,70699895,2,0
1,3,0.25,0.7272727272727273,82002221,4,1
2,3,0.5714285714285714,0.9615384615384616,79990106,7,4
2,5,0.6153846153846154,0.8888888888888888,80158283,13,8
2,0,1.0,1.0,75362252,2,2
2,5,0.6153846153846154,0.75,80162556,13,8
0,3,0.25,0.2222222222222222,70701400,4,1
2,0,1.0,1.0,82041309,5,5
2,0,1.0,1.0,82042121,2,2
2,0,1.0,1.0,82016279,1,1
2,0,1.0,1.0,80159765,2,2
0,1,0.0,0.0,82064830,1,0
2,1,0.9230769230769231,0.5,80118582,13,12
1,2,0.3333333333333333,0.5,79792671,3,1
2,0,1.0,1.0,75384085,1,1
2,0,1.0,1.0,82020835,2,2
2,0,1.0,1.0,82095282,4,4
2,0,1.0,1.0,73551415,7,7
2,0,1.0,1.0,67259780,1,1
2,1,0.6666666666666666,0.5,70720846,3,2
2,0,1.0,1.0,67248580,1,1
2,1,0.5,0.0,70521472,2,1
2,2,0.6,0.75,70521493,5,3
1,13,0.35,0.8939393939393939,82032906,20,7
1,5,0.2857142857142857,0.8636363636363636,70801864,7,2
2,1,0.8333333333333334,0.6666666666666666,82039862,6,5
1,8,0.2727272727272727,0.5,72785874,11,3
0,7,0.2222222222222222,0.4117647058823529,69116950,9,2
1,6,0.3333333333333333,0.75,69626333,9,3
0,3,0.0,0.0,70199710,3,0
0,6,0.14285714285714285,0.0,69117132,7,1
2,5,0.7058823529411765,0.8181818181818182,66054485,17,12
2,4,0.5,0.8461538461538461,80166902,8,4
1,7,0.4166666666666667,0.8125,70809480,12,5
0,2,0.0,0.0,82067330,2,0
2,2,0.5,0.8333333333333334,82067332,4,2
2,1,0.5,0.6666666666666666,69039005,2,1
0,1,0.0,0.0,62957412,1,0
0,1,0.0,0.0,70684516,1,0
2,3,0.5714285714285714,0.875,64475446,7,4
0,1,0.0,0.0,65717596,1,0
0,1,0.0,0.0,80163197,1,0
1,3,0.25,0.75,63166803,4,1
2,0,1.0,1.0,82019970,1,1
2,1,0.5,0.9166666666666666,69693484,2,1
0,1,0.0,0.0,69693855,1,0
0,1,0.0,0.0,69693974,1,0
0,2,0.3333333333333333,0.16666666666666666,79462586,3,1
0,9,0.1,0.275,70677201,10,1
0,2,0.0,0.0,70567854,2,0
2,0,1.0,1.0,67131344,3,3
2,1,0.875,0.5,82014475,8,7
2,0,1.0,1.0,70944944,1,1
0,2,0.3333333333333333,0.42857142857142855,81989202,3,1
2,5,0.5833333333333334,0.8461538461538461,70966196,12,7
2,1,0.6666666666666666,0.8333333333333334,82012770,3,2
2,0,1.0,1.0,80176640,7,7
0,1,0.0,0.0,76606271,1,0
2,2,0.7777777777777778,0.6666666666666666,80151018,9,7
1,2,0.3333333333333333,0.5714285714285714,73443944,3,1
2,1,0.8,0.5,76941683,5,4
2,0,1.0,1.0,80178235,2,2
0,2,0.0,0.0,69640613,2,0
1,6,0.4,0.9333333333333333,70468426,10,4
2,4,0.5,0.875,78252762,8,4
0,3,0.0,0.0,71112363,3,0
0,1,0.0,0.0,69836935,1,0
1,4,0.2,0.6153846153846154,82121126,5,1
0,1,0.0,0.0,82121146,1,0
0,4,0.0,0.0,68225976,4,0
1,2,0.3333333333333333,0.5714285714285714,65278766,3,1
2,2,0.5,0.6666666666666666,80056634,4,2
0,4,0.2,0.2222222222222222,70658924,5,1
0,1,0.0,0.0,67120291,1,0
1,2,0.3333333333333333,0.7142857142857143,65279690,3,1
0,8,0.1111111111111111,0.14814814814814814,70681954,9,1
2,4,0.5,0.9230769230769231,68289900,8,4
0,20,0.0,0.0,63239750,20,0
0,5,0.0,0.0,80165327,5,0
0,1,0.0,0.0,68044452,1,0
2,2,0.6666666666666666,0.8,67786474,6,4
1,4,0.3333333333333333,0.7586206896551724,72801834,6,2
2,0,1.0,1.0,65960713,1,1
1,4,0.42857142857142855,0.8,82022876,7,3
2,2,0.7142857142857143,0.6666666666666666,80124634,7,5
1,9,0.18181818181818182,0.6666666666666666,70239414,11,2
1,5,0.375,0.8928571428571429,69007141,8,3
1,2,0.3333333333333333,0.75,69478430,3,1
2,3,0.5714285714285714,0.4,67347735,7,4
1,4,0.2,0.5,70761663,5,1
0,3,0.0,0.0,69335525,3,0
1,12,0.2,0.66,70630084,15,3
0,3,0.0,0.0,67130392,3,0
0,2,0.3333333333333333,0.3333333333333333,69635776,3,1
0,2,0.0,0.0,70036785,2,0
1,2,0.3333333333333333,0.5,70037331,3,1
0,12,0.0,0.0,70686343,12,0
0,1,0.0,0.0,70692216,1,0
1,2,0.3333333333333333,0.6666666666666666,68009333,3,1
0,3,0.0,0.0,67585665,3,0
0,6,0.14285714285714285,0.4,70567721,7,1
0,8,0.0,0.0,80124205,8,0
2,0,1.0,1.0,80132335,5,5
0,8,0.1111111111111111,0.2857142857142857,65280495,9,1
2,2,0.5,0.6666666666666666,67786964,4,2
1,3,0.4,0.75,65116772,5,2
0,3,0.25,0.4444444444444444,69549445,4,1
0,1,0.0,0.0,68167631,1,0
2,2,0.8,0.8,68639620,10,8
2,1,0.5,0.8,73632475,2,1
0,2,0.0,0.0,69534213,2,0
0,7,0.0,0.0,67095084,7,0
2,5,0.5,0.625,61549572,10,5
2,1,0.6666666666666666,0.8571428571428571,80133888,3,2
0,8,0.1111111111111111,0.23076923076923078,68785122,9,1
2,1,0.6666666666666666,0.8,68168723,3,2
0,11,0.15384615384615385,0.34375,82019421,13,2
2,0,1.0,1.0,70189406,1,1
1,5,0.2857142857142857,0.5,68812331,7,2
0,6,0.14285714285714285,0.36363636363636365,68812366,7,1
0,5,0.2857142857142857,0.36363636363636365,69162926,7,2
0,6,0.0,0.0,70693532,6,0
0,3,0.0,0.0,70238532,3,0
0,18,0.0,0.0,70239435,18,0
2,0,1.0,1.0,82185033,1,1
0,5,0.0,0.0,80130690,5,0
2,2,0.7142857142857143,0.5,82049158,7,5
2,0,1.0,1.0,82102179,3,3
2,2,0.6,0.8333333333333334,80163684,5,3
0,5,0.0,0.0,70705684,5,0
2,1,0.875,0.5,80145721,8,7
2,1,0.5,0.8571428571428571,70416990,2,1
2,2,0.5,0.8571428571428571,67797716,4,2
2,0,1.0,1.0,80092355,1,1
2,0,1.0,1.0,80132956,1,1
0,1,0.0,0.0,82202322,1,0
2,0,1.0,1.0,82020139,2,2
2,0,1.0,1.0,80159668,6,6
1,5,0.4444444444444444,0.75,69555451,9,4
1,8,0.42857142857142855,0.5833333333333334,80019303,14,6
2,2,0.6,0.6,80019324,5,3
0,4,0.0,0.0,70701834,4,0
0,4,0.3333333333333333,0.36363636363636365,67637731,6,2
2,0,1.0,1.0,82023216,5,5
2,0,1.0,1.0,80132914,1,1
0,3,0.0,0.0,67706394,3,0
1,14,0.3,0.5,68400633,20,6
0,2,0.0,0.0,79989994,2,0
1,7,0.2222222222222222,0.7083333333333334,80128491,9,2
2,1,0.5,0.8888888888888888,82152438,2,1
0,1,0.0,0.0,78762691,1,0
0,3,0.0,0.0,64359673,3,0
2,2,0.5,0.75,70821345,4,2
0,2,0.0,0.0,82118245,2,0
1,8,0.2,0.813953488372093,70634970,10,2
0,5,0.0,0.0,75855633,5,0
0,8,0.1111111111111111,0.28125,80170976,9,1
0,8,0.1111111111111111,0.3103448275862069,80163167,9,1
0,1,0.0,0.0,70214963,1,0
1,3,0.25,0.8636363636363636,80150709,4,1
1,8,0.1111111111111111,0.5714285714285714,80131198,9,1
1,2,0.3333333333333333,0.8,82006201,3,1
1,7,0.125,0.6666666666666666,80150691,8,1
1,3,0.4,0.8571428571428571,73460030,5,2
0,5,0.0,0.0,75855626,5,0
2,0,1.0,1.0,70693560,1,1
2,0,1.0,1.0,80105585,1,1
0,5,0.0,0.0,67776702,5,0
0,11,0.15384615384615385,0.09090909090909091,70488390,13,2
0,4,0.0,0.0,70684082,4,0
2,0,1.0,1.0,69703893,1,1
0,1,0.0,0.0,68143866,1,0
2,0,1.0,1.0,80118230,3,3
1,7,0.3,0.7857142857142857,74789841,10,3
0,3,0.0,0.0,71081731,3,0
0,1,0.0,0.0,82019860,1,0
0,1,0.0,0.0,82020027,1,0
1,4,0.42857142857142855,0.8181818181818182,76347474,7,3
2,8,0.5789473684210527,0.8333333333333334,80089555,19,11
1,3,0.4,0.6363636363636364,80124546,5,2
2,0,1.0,1.0,68884522,3,3
0,5,0.0,0.0,81989198,5,0
2,0,1.0,1.0,65290372,2,2
0,11,0.08333333333333333,0.10256410256410256,74086796,12,1
0,7,0.0,0.0,69320902,7,0
2,0,1.0,1.0,82037172,3,3
0,2,0.0,0.0,70037303,2,0
0,1,0.0,0.0,68164313,1,0
2,2,0.6,0.8,75272645,5,3
2,1,0.5,0.0,75272883,2,1
0,4,0.0,0.0,67434633,4,0
0,3,0.0,0.0,78507506,3,0
0,2,0.0,0.0,64141686,2,0
0,4,0.0,0.0,70568561,4,0
0,1,0.0,0.0,70759990,1,0
1,4,0.2,0.7142857142857143,70527394,5,1
0,1,0.0,0.0,66534986,1,0
0,6,0.14285714285714285,0.0,69602995,7,1
2,4,0.6,0.8333333333333334,68034393,10,6
0,6,0.0,0.0,70679840,6,0
2,0,1.0,1.0,82054013,1,1
2,1,0.6666666666666666,0.5,76941690,3,2
0,3,0.25,0.4,70415562,4,1
1,4,0.2,0.5454545454545454,67053651,5,1
0,7,0.125,0.15,69604220,8,1
2,3,0.5,0.7777777777777778,66304805,6,3
1,2,0.3333333333333333,0.7142857142857143,70351190,3,1
1,4,0.3333333333333333,0.8461538461538461,66379194,6,2
1,6,0.3333333333333333,0.6363636363636364,82101245,9,3
2,1,0.6666666666666666,0.5,68624066,3,2
2,0,1.0,1.0,82054725,2,2
2,0,1.0,1.0,80004071,1,1
0,4,0.0,0.0,70252602,4,0
0,4,0.0,0.0,70678076,4,0
2,1,0.875,0.5,69206802,8,7
2,4,0.6363636363636364,0.6,82008303,11,7
2,1,0.5,0.0,82053161,2,1
0,1,0.0,0.0,80128581,1,0
0,2,0.3333333333333333,0.3333333333333333,80135344,3,1
2,0,1.0,1.0,82054741,1,1
2,0,1.0,1.0,82145119,8,8
2,0,1.0,1.0,80118490,1,1
2,0,1.0,1.0,82038274,1,1
2,0,1.0,1.0,66228974,1,1
2,1,0.5,0.8,80145814,2,1
2,0,1.0,1.0,80136561,14,14
2,0,1.0,1.0,80118489,1,1
2,1,0.8571428571428571,0.5,80159169,7,6
2,2,0.5,0.8333333333333334,80119182,4,2
1,3,0.25,0.5714285714285714,67286303,4,1
2,0,1.0,1.0,80176348,1,1
2,3,0.5714285714285714,0.8333333333333334,63177604,7,4
1,4,0.2,0.5405405405405406,70674513,5,1
0,1,0.0,0.0,70677922,1,0
0,2,0.0,0.0,80126766,2,0
1,5,0.4444444444444444,0.9230769230769231,70676025,9,4
0,1,0.0,0.0,79936171,1,0
0,7,0.2222222222222222,0.48,66225593,9,2
0,1,0.0,0.0,80153567,1,0
0,4,0.0,0.0,68273793,4,0
0,18,0.1,0.15942028985507245,515494,20,2
2,0,1.0,1.0,67786852,2,2
0,5,0.0,0.0,70488894,5,0
1,8,0.2,0.7547169811320755,80166923,10,2
0,5,0.16666666666666666,0.0,69228222,6,1
1,15,0.2857142857142857,0.7674418604651163,69112351,21,6
0,3,0.0,0.0,69640564,3,0
0,3,0.0,0.0,69640585,3,0
2,4,0.5,0.9166666666666666,80135223,8,4
0,6,0.0,0.0,70680015,6,0
0,7,0.0,0.0,67049122,7,0
2,0,1.0,1.0,80139945,5,5
1,8,0.4666666666666667,0.88,80165172,15,7
0,6,0.0,0.0,70683760,6,0
2,2,0.5,0.9090909090909091,64976156,4,2
2,3,0.6666666666666666,0.875,68040511,9,6
2,1,0.6666666666666666,0.6666666666666666,69483414,3,2
0,1,0.0,0.0,69484401,1,0
0,4,0.2,0.4375,82019482,5,1
0,1,0.0,0.0,82012786,1,0
0,3,0.0,0.0,82012816,3,0
2,0,1.0,1.0,80092621,2,2
1,5,0.2857142857142857,0.6428571428571429,70684733,7,2
0,12,0.07692307692307693,0.46551724137931033,70230440,13,1
2,0,1.0,1.0,73609984,2,2
0,3,0.0,0.0,70820085,3,0
0,3,0.0,0.0,80163690,3,0
0,4,0.0,0.0,70686231,4,0
2,1,0.8,0.8333333333333334,67836895,5,4
0,8,0.3333333333333333,0.3181818181818182,69484660,12,4
0,15,0.0,0.0,62839210,15,0
1,6,0.3333333333333333,0.5909090909090909,75149683,9,3
2,3,0.5,0.7142857142857143,70729344,6,3
0,4,0.2,0.3333333333333333,75149480,5,1
2,1,0.75,0.5,72526062,4,3
0,10,0.16666666666666666,0.41935483870967744,69603961,12,2
0,8,0.1111111111111111,0.1,65896950,9,1
1,5,0.375,0.5833333333333334,65565710,8,3
0,6,0.0,0.0,67393676,6,0
2,0,1.0,1.0,80137590,4,4
0,6,0.0,0.0,82090204,6,0
0,5,0.0,0.0,82090206,5,0
0,5,0.0,0.0,82090207,5,0
1,6,0.14285714285714285,0.6,82090208,7,1
0,6,0.0,0.0,82090209,6,0
0,6,0.0,0.0,82090210,6,0
0,1,0.0,0.0,82090212,1,0
2,1,0.75,0.6666666666666666,69404636,4,3
2,0,1.0,1.0,82182756,1,1
0,6,0.14285714285714285,0.24324324324324326,69030990,7,1
1,7,0.36363636363636365,0.7142857142857143,79792356,11,4
0,1,0.0,0.0,82175567,1,0
1,2,0.3333333333333333,0.8333333333333334,69412651,3,1
2,5,0.5,0.9629629629629629,69667731,10,5
1,4,0.42857142857142855,0.8571428571428571,65812250,7,3
2,4,0.6363636363636364,0.9,69492724,11,7
0,13,0.13333333333333333,0.10256410256410256,69128136,15,2
2,0,1.0,1.0,68675075,1,1
2,1,0.6666666666666666,0.8,65291044,3,2
0,10,0.0,0.0,69508985,10,0
0,4,0.0,0.0,66499055,4,0
0,2,0.0,0.0,82021373,2,0
0,1,0.0,0.0,74989635,1,0
0,2,0.0,0.0,80124367,2,0
0,14,0.06666666666666667,0.0784313725490196,68391204,15,1
0,3,0.0,0.0,80132902,3,0
2,0,1.0,1.0,63127015,1,1
0,4,0.0,0.0,69158502,4,0
0,2,0.0,0.0,69158516,2,0
0,1,0.0,0.0,69160070,1,0
0,18,0.14285714285714285,0.2894736842105263,70685552,21,3
0,9,0.0,0.0,70693336,9,0
0,2,0.0,0.0,70493955,2,0
0,5,0.2857142857142857,0.2222222222222222,65280201,7,2
0,4,0.0,0.0,66304945,4,0
2,1,0.5,0.5,69551265,2,1
2,0,1.0,1.0,70189875,2,2
0,17,0.05555555555555555,0.29411764705882354,64234996,18,1
0,2,0.0,0.0,82006761,2,0
2,3,0.5714285714285714,0.8333333333333334,67726190,7,4
0,5,0.16666666666666666,0.3333333333333333,70821786,6,1
1,8,0.2,0.8541666666666666,82006665,10,2
0,12,0.0,0.0,82006674,12,0
0,1,0.0,0.0,82102632,1,0
0,13,0.0,0.0,67888471,13,0
2,2,0.6666666666666666,0.6666666666666666,80172636,6,4
0,4,0.0,0.0,70917875,4,0
1,4,0.3333333333333333,0.5714285714285714,70861805,6,2
1,10,0.16666666666666666,0.5192307692307693,80162812,12,2
0,3,0.0,0.0,80165757,3,0
0,1,0.0,0.0,80165765,1,0
0,1,0.0,0.0,80165775,1,0
1,5,0.16666666666666666,0.71875,80165787,6,1
0,4,0.0,0.0,80150578,4,0
0,3,0.0,0.0,80150524,3,0
0,3,0.0,0.0,80150611,3,0
1,2,0.3333333333333333,0.7857142857142857,80150612,3,1
0,3,0.0,0.0,80150613,3,0
0,4,0.0,0.0,64220660,4,0
0,1,0.0,0.0,80150623,1,0
0,4,0.0,0.0,80150646,4,0
2,0,1.0,1.0,69708555,3,3
1,8,0.2727272727272727,0.5172413793103449,80176647,11,3
2,1,0.75,0.8,67264134,4,3
1,2,0.3333333333333333,0.75,65460710,3,1
2,0,1.0,1.0,68194546,1,1
1,6,0.45454545454545453,0.8181818181818182,69594875,11,5
2,1,0.8,0.6666666666666666,69579615,5,4
2,0,1.0,1.0,68884053,1,1
0,2,0.0,0.0,80150410,2,0
2,1,0.5,0.8,70047873,2,1
0,1,0.0,0.0,69027063,1,0
0,7,0.0,0.0,80116876,7,0
0,7,0.125,0.12,82010282,8,1
1,2,0.3333333333333333,0.5714285714285714,68805905,3,1
0,1,0.0,0.0,80122874,1,0
2,2,0.7142857142857143,0.5,80118261,7,5
0,3,0.0,0.0,70743211,3,0
0,4,0.0,0.0,70743533,4,0
2,0,1.0,1.0,82019882,2,2
2,2,0.5,0.875,80176688,4,2
0,5,0.0,0.0,69895665,5,0
2,0,1.0,1.0,82182745,1,1
1,5,0.16666666666666666,0.6,69895763,6,1
2,0,1.0,1.0,81888445,3,3
2,0,1.0,1.0,80145880,2,2
0,4,0.3333333333333333,0.42857142857142855,80175666,6,2
2,2,0.5,0.6666666666666666,68401760,4,2
2,1,0.5,0.6666666666666666,67669084,2,1
1,9,0.3076923076923077,0.8,70185031,13,4
0,2,0.0,0.0,66560592,2,0
0,6,0.14285714285714285,0.23529411764705882,70660233,7,1
2,3,0.5714285714285714,0.8,68573862,7,4
0,2,0.0,0.0,70697543,2,0
0,1,0.0,0.0,70743981,1,0
2,1,0.6666666666666666,0.5,82163437,3,2
2,2,0.5,0.8571428571428571,70470092,4,2
2,2,0.5,0.6666666666666666,66379565,4,2
2,2,0.5,0.8888888888888888,72803563,4,2
0,1,0.0,0.0,80113600,1,0
2,2,0.6,0.8333333333333334,82013526,5,3
0,8,0.2,0.3333333333333333,63050764,10,2
2,0,1.0,1.0,61771143,2,2
2,0,1.0,1.0,80132878,2,2
2,0,1.0,1.0,73623620,2,2
1,2,0.3333333333333333,0.5,69735561,3,1
2,0,1.0,1.0,72915402,2,2
0,2,0.3333333333333333,0.3333333333333333,67311216,3,1
2,0,1.0,1.0,80176658,4,4
1,5,0.4444444444444444,0.8333333333333334,69867301,9,4
2,0,1.0,1.0,82025200,4,4
2,1,0.75,0.5,82059904,4,3
1,4,0.2,0.625,80159199,5,1
2,2,0.5,0.9333333333333333,67265240,4,2
0,1,0.0,0.0,82037233,1,0
2,1,0.8,0.3333333333333333,80080175,5,4
2,0,1.0,1.0,70747425,3,3
2,1,0.5,0.8,80176653,2,1
2,0,1.0,1.0,80162137,5,5
2,0,1.0,1.0,80176493,2,2
2,2,0.8666666666666667,0.75,82042620,15,13
0,6,0.0,0.0,69384133,6,0
2,0,1.0,1.0,80139949,1,1
0,13,0.07142857142857142,0.29333333333333333,70675556,14,1
1,2,0.3333333333333333,0.5,70189196,3,1
1,12,0.25,0.6666666666666666,67188996,16,4
0,4,0.2,0.35294117647058826,80128358,5,1
2,2,0.6666666666666666,0.9,70637392,6,4
1,5,0.2857142857142857,0.7083333333333334,69187846,7,2
1,3,0.25,0.75,80128754,4,1
0,6,0.0,0.0,69526163,6,0
0,1,0.0,0.0,70681373,1,0
2,1,0.75,0.5,69976172,4,3
0,5,0.16666666666666666,0.0,60332384,6,1
1,3,0.4,0.5,70704060,5,2
0,2,0.0,0.0,66782086,2,0
0,2,0.3333333333333333,0.3333333333333333,77224833,3,1
1,3,0.4,0.875,69887006,5,2
2,0,1.0,1.0,80159651,2,2
2,1,0.6666666666666666,0.6666666666666666,67699513,3,2
2,0,1.0,1.0,80054961,8,8
2,1,0.5,0.8333333333333334,82013574,2,1
0,1,0.0,0.0,80145422,1,0
0,1,0.0,0.0,80145787,1,0
0,3,0.4,0.25,80118341,5,2
0,2,0.0,0.0,80118342,2,0
2,2,0.6,0.9230769230769231,67592091,5,3
2,1,0.5,0.5,80165460,2,1
0,1,0.0,0.0,66227483,1,0
0,4,0.0,0.0,69640606,4,0
2,0,1.0,1.0,80134647,2,2
0,16,0.1111111111111111,0.39285714285714285,80124169,18,2
0,2,0.0,0.0,82121111,2,0
1,9,0.35714285714285715,0.8076923076923077,69518134,14,5
0,2,0.3333333333333333,0.0,82018726,3,1
0,2,0.3333333333333333,0.25,73823603,3,1
2,1,0.8333333333333334,0.9166666666666666,69483204,6,5
2,0,1.0,1.0,82037298,1,1
2,0,1.0,1.0,80092600,1,1
2,0,1.0,1.0,80091795,1,1
0,1,0.0,0.0,68747756,1,0
0,6,0.4,0.4,82002314,10,4
2,0,1.0,1.0,64086561,2,2
1,3,0.25,0.5,68558434,4,1
0,15,0.0,0.0,82019477,15,0
0,2,0.0,0.0,63273504,2,0
1,12,0.29411764705882354,0.7872340425531915,70516684,17,5
0,1,0.0,0.0,67133010,1,0
0,1,0.0,0.0,82143783,1,0
2,5,0.7619047619047619,0.9545454545454546,80126555,21,16
0,1,0.0,0.0,66998603,1,0
2,1,0.75,0.6666666666666666,70792274,4,3
2,0,1.0,1.0,69172663,2,2
2,3,0.5714285714285714,0.6666666666666666,80132901,7,4
2,1,0.5,0.0,63698495,2,1
0,6,0.3333333333333333,0.42857142857142855,69489455,9,3
2,0,1.0,1.0,69207005,3,3
0,5,0.2857142857142857,0.1111111111111111,66459260,7,2
2,0,1.0,1.0,69587826,1,1
0,2,0.0,0.0,70005040,2,0
0,1,0.0,0.0,72785790,1,0
2,0,1.0,1.0,80150369,2,2
2,1,0.5,0.5,80058755,2,1
1,4,0.2,0.5609756097560976,70693693,5,1
0,6,0.14285714285714285,0.4186046511627907,70695016,7,1
2,2,0.5,0.8571428571428571,65282210,4,2
2,0,1.0,1.0,69608644,2,2
2,7,0.6666666666666666,0.8571428571428571,82096254,21,14
2,2,0.6,0.9,70926324,5,3
0,12,0.07692307692307693,0.20408163265306123,82032900,13,1
1,4,0.3333333333333333,0.5714285714285714,80128545,6,2
0,1,0.0,0.0,69867315,1,0
0,6,0.14285714285714285,0.07692307692307693,82129395,7,1
0,7,0.0,0.0,71212253,7,0
0,5,0.0,0.0,70707525,5,0
2,0,1.0,1.0,69975556,1,1
1,2,0.3333333333333333,0.625,73295880,3,1
0,6,0.25,0.4444444444444444,70246694,8,2
2,2,0.5,0.9090909090909091,80153689,4,2
2,5,0.5454545454545454,0.7,70343315,11,6
0,3,0.25,0.4444444444444444,69634992,4,1
0,3,0.0,0.0,70674562,3,0
2,1,0.5,0.5,80118247,2,1
0,4,0.3333333333333333,0.0,80118301,6,2
2,1,0.5,0.6666666666666666,19339712,2,1
0,1,0.0,0.0,80126841,1,0
0,16,0.058823529411764705,0.2857142857142857,72809275,17,1
0,1,0.0,0.0,80165435,1,0
1,5,0.4444444444444444,0.6363636363636364,80067414,9,4
0,4,0.0,0.0,72809135,4,0
1,5,0.2857142857142857,0.8181818181818182,80155205,7,2
2,3,0.5,0.8571428571428571,70845901,6,3
2,1,0.875,0.6666666666666666,80092222,8,7
1,5,0.2857142857142857,0.8571428571428571,69611164,7,2
1,7,0.2222222222222222,0.5555555555555556,69611423,9,2
0,3,0.0,0.0,70120974,3,0
2,1,0.5,0.9523809523809523,73858911,2,1
0,3,0.0,0.0,67917444,3,0
0,7,0.0,0.0,80150574,7,0
0,2,0.0,0.0,80150522,2,0
2,0,1.0,1.0,82102373,1,1
0,1,0.0,0.0,64252825,1,0
0,5,0.0,0.0,80162833,5,0
0,1,0.0,0.0,80162884,1,0
1,5,0.2857142857142857,0.8055555555555556,70821366,7,2
1,7,0.125,0.6486486486486487,69519884,8,1
0,8,0.0,0.0,70482076,8,0
0,11,0.0,0.0,70482216,11,0
1,2,0.3333333333333333,0.8,67917255,3,1
1,4,0.42857142857142855,0.8,70821681,7,3
0,6,0.0,0.0,69407184,6,0
0,19,0.09523809523809523,0.16129032258064516,71081304,21,2
0,4,0.0,0.0,82006485,4,0
0,2,0.0,0.0,69528053,2,0
1,11,0.21428571428571427,0.627906976744186,68669090,14,3
2,0,1.0,1.0,80094483,2,2
2,2,0.5,0.75,17805361,4,2
0,1,0.0,0.0,60070311,1,0
2,0,1.0,1.0,82135112,7,7
0,5,0.0,0.0,67925452,5,0
2,1,0.8333333333333334,0.5,69187370,6,5
0,1,0.0,0.0,80145429,1,0
2,0,1.0,1.0,80145564,2,2
2,0,1.0,1.0,82062123,5,5
2,1,0.75,0.6666666666666666,69058521,4,3
0,2,0.0,0.0,70070693,2,0
2,0,1.0,1.0,70459585,1,1
0,11,0.0,0.0,69726454,11,0
2,1,0.8333333333333334,0.8,70325045,6,5
0,1,0.0,0.0,80139898,1,0
0,1,0.0,0.0,80139904,1,0
0,5,0.0,0.0,66783612,5,0
2,0,1.0,1.0,68340916,4,4
2,2,0.7142857142857143,0.6666666666666666,66810352,7,5
2,0,1.0,1.0,80084123,1,1
1,6,0.25,0.5,78609580,8,2
1,7,0.3,0.5789473684210527,80104990,10,3
0,2,0.0,0.0,68538344,2,0
1,2,0.3333333333333333,0.6923076923076923,76551916,3,1
1,8,0.3333333333333333,0.7049180327868853,70678034,12,4
0,9,0.18181818181818182,0.48717948717948717,70605724,11,2
0,3,0.0,0.0,67132212,3,0
0,1,0.0,0.0,68784632,1,0
2,0,1.0,1.0,70675283,2,2
0,3,0.25,0.25,70683172,4,1
0,3,0.25,0.4,69069805,4,1
0,2,0.0,0.0,70699195,2,0
0,2,0.0,0.0,80126877,2,0
1,7,0.3,0.6071428571428571,69186355,10,3
2,1,0.6666666666666666,0.5,68546940,3,2
0,9,0.18181818181818182,0.47058823529411764,69951371,11,2
1,5,0.2857142857142857,0.6363636363636364,66802820,7,2
0,8,0.2,0.38461538461538464,66802785,10,2
0,1,0.0,0.0,63675220,1,0
2,0,1.0,1.0,69021071,1,1
0,2,0.0,0.0,72866745,2,0
2,2,0.6,0.8888888888888888,72802695,5,3
2,0,1.0,1.0,82020755,1,1
2,0,1.0,1.0,80178439,1,1
0,1,0.0,0.0,82013563,1,0
0,1,0.0,0.0,82013571,1,0
2,0,1.0,1.0,82061904,6,6
0,6,0.25,0.0,80176351,8,2
2,0,1.0,1.0,82020565,4,4
2,2,0.6,0.8571428571428571,73650976,5,3
2,2,0.5,0.8571428571428571,82024275,4,2
2,0,1.0,1.0,82038277,2,2
2,0,1.0,1.0,82037580,1,1
2,2,0.7142857142857143,0.9166666666666666,82052109,7,5
2,0,1.0,1.0,70746886,9,9
2,2,0.8333333333333334,0.0,70314293,12,10
2,0,1.0,1.0,70747551,1,1
2,2,0.8,0.9285714285714286,82018810,10,8
2,0,1.0,1.0,80159541,4,4
2,0,1.0,1.0,82023126,1,1
0,1,0.0,0.0,68499221,1,0
0,1,0.0,0.0,68499256,1,0
0,1,0.0,0.0,68499284,1,0
0,4,0.0,0.0,68499466,4,0
0,3,0.0,0.0,70230195,3,0
0,1,0.0,0.0,80132910,1,0
1,4,0.42857142857142855,0.9444444444444444,13379996,7,3
0,1,0.0,0.0,69464451,1,0
0,1,0.0,0.0,64322524,1,0
2,1,0.5,0.5,69962291,2,1
2,1,0.75,0.5,74027926,4,3
0,2,0.0,0.0,70930846,2,0
2,0,1.0,1.0,78735342,3,3
1,4,0.42857142857142855,0.7857142857142857,71618890,7,3
0,3,0.0,0.0,70702436,3,0
0,1,0.0,0.0,70707483,1,0
0,1,0.0,0.0,65972550,1,0
1,2,0.3333333333333333,0.6666666666666666,69064282,3,1
0,1,0.0,0.0,82102212,1,0
0,1,0.0,0.0,82102254,1,0
0,1,0.0,0.0,82102275,1,0
0,2,0.0,0.0,78858864,2,0
0,3,0.0,0.0,80172025,3,0
2,7,0.5882352941176471,0.9230769230769231,62140694,17,10
2,0,1.0,1.0,80165267,5,5
1,4,0.3333333333333333,0.8636363636363636,80132904,6,2
1,2,0.3333333333333333,0.7407407407407407,70692951,3,1
0,3,0.25,0.1111111111111111,64279033,4,1
0,4,0.0,0.0,70866845,4,0
1,6,0.4,0.9285714285714286,69534101,10,4
0,1,0.0,0.0,72474591,1,0
0,1,0.0,0.0,70509621,1,0
1,5,0.16666666666666666,0.6382978723404256,79994292,6,1
0,3,0.0,0.0,70706230,3,0
0,2,0.3333333333333333,0.4,68546611,3,1
0,4,0.0,0.0,67131743,4,0
2,1,0.8571428571428571,0.5,74484053,7,6
0,6,0.0,0.0,69640536,6,0
2,1,0.5,0.6666666666666666,80105144,2,1
0,2,0.0,0.0,66040912,2,0
2,2,0.5,0.6666666666666666,82018737,4,2
0,12,0.0,0.0,80141483,12,0
0,5,0.0,0.0,69041175,5,0
0,1,0.0,0.0,70684292,1,0
2,1,0.8,0.5,69562850,5,4
2,3,0.625,0.9,68107165,8,5
0,11,0.08333333333333333,0.358974358974359,82102610,12,1
0,7,0.0,0.0,68498136,7,0
0,14,0.0,0.0,68498171,14,0
2,2,0.6,0.9,72804396,5,3
0,3,0.25,0.25,79218916,4,1
2,1,0.5,0.6666666666666666,60170565,2,1
0,3,0.0,0.0,69538742,3,0
0,2,0.0,0.0,69951490,2,0
0,2,0.0,0.0,67703720,2,0
2,1,0.5,0.6666666666666666,69213732,2,1
2,0,1.0,1.0,80174146,1,1
2,0,1.0,1.0,80175968,2,2
0,6,0.14285714285714285,0.35294117647058826,70674233,7,1
2,0,1.0,1.0,69587763,1,1
2,0,1.0,1.0,80053785,1,1
0,2,0.0,0.0,70779030,2,0
0,4,0.0,0.0,65430764,4,0
0,2,0.0,0.0,69417194,2,0
1,6,0.4,0.8095238095238095,72887402,10,4
0,1,0.0,0.0,69475406,1,0
1,6,0.14285714285714285,0.5208333333333334,80124299,7,1
2,0,1.0,1.0,82070248,1,1
0,6,0.0,0.0,70081480,6,0
0,6,0.14285714285714285,0.21052631578947367,70675633,7,1
2,2,0.6,0.9,72803416,5,3
2,1,0.75,0.75,68025573,4,3
0,3,0.0,0.0,70676935,3,0
2,2,0.6666666666666666,0.8571428571428571,82133038,6,4
2,3,0.7,0.8571428571428571,82018856,10,7
0,9,0.0,0.0,82019429,9,0
0,10,0.09090909090909091,0.20930232558139536,82022514,11,1
0,2,0.3333333333333333,0.375,69997844,3,1
1,4,0.2,0.5,67378416,5,1
2,0,1.0,1.0,80136927,3,3
0,19,0.13636363636363635,0.2894736842105263,67285582,22,3
2,2,0.75,0.9230769230769231,60968446,8,6
0,10,0.0,0.0,80123384,10,0
1,3,0.4,0.7142857142857143,65835686,5,2
2,1,0.75,0.8,76571803,4,3
2,0,1.0,1.0,82052099,1,1
0,1,0.0,0.0,69020952,1,0
0,10,0.09090909090909091,0.16279069767441862,70683606,11,1
2,1,0.5,0.8571428571428571,69629063,2,1
0,3,0.25,0.0,69597423,4,1
0,2,0.0,0.0,70693525,2,0
0,6,0.0,0.0,70699300,6,0
0,2,0.0,0.0,70700196,2,0
0,9,0.0,0.0,68948936,9,0
2,0,1.0,1.0,69903631,3,3
0,3,0.25,0.0,82185017,4,1
0,3,0.0,0.0,70677446,3,0
0,1,0.0,0.0,82023085,1,0
0,3,0.0,0.0,70758863,3,0
0,1,0.0,0.0,80054051,1,0
2,0,1.0,1.0,80176441,8,8
1,2,0.3333333333333333,0.75,70405720,3,1
1,8,0.38461538461538464,0.8048780487804879,80145876,13,5
0,2,0.3333333333333333,0.0,69469064,3,1
2,0,1.0,1.0,70565124,1,1
0,4,0.2,0.0,70253806,5,1
0,1,0.0,0.0,78286922,1,0
0,4,0.0,0.0,82102509,4,0
2,2,0.8181818181818182,0.6666666666666666,80051482,11,9
0,1,0.0,0.0,70686112,1,0
2,10,0.5238095238095238,0.9393939393939394,69418650,21,11
0,2,0.0,0.0,69946954,2,0
2,6,0.5,0.9642857142857143,69518183,12,6
0,13,0.0,0.0,80128460,13,0
1,3,0.25,0.7,68226900,4,1
2,2,0.6,0.6666666666666666,69579531,5,3
0,3,0.0,0.0,80172530,3,0
0,4,0.2,0.25,82039837,5,1
1,4,0.3333333333333333,0.7777777777777778,80172922,6,2
0,4,0.2,0.4666666666666667,82118262,5,1
0,9,0.0,0.0,70917693,9,0
1,5,0.2857142857142857,0.75,80172665,7,2
0,2,0.0,0.0,80162871,2,0
1,11,0.26666666666666666,0.7258064516129032,71619121,15,4
0,11,0.0,0.0,80163184,11,0
0,2,0.0,0.0,80165785,2,0
0,2,0.0,0.0,82006858,2,0
0,9,0.0,0.0,68905592,9,0
0,4,0.0,0.0,69549690,4,0
1,2,0.3333333333333333,0.5,80056032,3,1
0,3,0.0,0.0,80131190,3,0
0,2,0.0,0.0,82152444,2,0
0,4,0.2,0.4166666666666667,82006525,5,1
0,13,0.0,0.0,80150729,13,0
0,3,0.0,0.0,74924010,3,0
0,5,0.0,0.0,80165844,5,0
2,1,0.6666666666666666,0.9,69983641,3,2
0,3,0.0,0.0,80150620,3,0
0,8,0.2,0.34782608695652173,80180263,10,2
0,5,0.0,0.0,80172659,5,0
2,0,1.0,1.0,73102260,4,4
2,0,1.0,1.0,69164466,1,1
1,3,0.4,0.6,72808631,5,2
0,6,0.0,0.0,72474633,6,0
2,0,1.0,1.0,82102175,2,2
2,2,0.5,0.6666666666666666,70691845,4,2
0,3,0.0,0.0,80124363,3,0
1,2,0.3333333333333333,0.9,67982131,3,1
0,3,0.0,0.0,70696430,3,0
0,3,0.0,0.0,63277802,3,0
0,1,0.0,0.0,69640053,1,0
0,1,0.0,0.0,68437362,1,0
1,7,0.3,0.6842105263157895,72775283,10,3
2,2,0.6,0.9473684210526315,80150305,5,3
2,1,0.8,0.75,70245595,5,4
2,0,1.0,1.0,80136655,2,2
2,0,1.0,1.0,82009400,4,4
0,3,0.0,0.0,82038345,3,0
0,4,0.0,0.0,82038346,4,0
0,1,0.0,0.0,73624635,1,0
0,2,0.0,0.0,82010292,2,0
1,3,0.25,0.6666666666666666,73366083,4,1
2,2,0.8947368421052632,0.75,82041335,19,17
0,4,0.0,0.0,82090202,4,0
1,5,0.375,0.625,70183505,8,3
1,5,0.16666666666666666,0.55,70184233,6,1
0,1,0.0,0.0,70685734,1,0
0,5,0.0,0.0,70686035,5,0
0,15,0.0625,0.05,68642196,16,1
2,1,0.8333333333333334,0.5,82018735,6,5
2,2,0.6666666666666666,0.75,70818916,6,4
2,1,0.5,0.5,70190190,2,1
2,0,1.0,1.0,76941781,2,2
2,11,0.5217391304347826,0.9285714285714286,70959805,23,12
2,3,0.5,0.9285714285714286,69212843,6,3
0,7,0.125,0.09523809523809523,73863902,8,1
0,1,0.0,0.0,82024221,1,0
2,0,1.0,1.0,70587160,1,1
2,0,1.0,1.0,69064625,1,1
0,8,0.1111111111111111,0.0625,60519956,9,1
2,0,1.0,1.0,66848642,1,1
2,1,0.5,0.5,69635832,2,1
0,11,0.08333333333333333,0.12048192771084337,70704585,12,1
2,1,0.5,0.5,71879423,2,1
0,6,0.3333333333333333,0.3333333333333333,75120990,9,3
2,2,0.5,0.4,73850826,4,2
2,0,1.0,1.0,75295241,3,3
2,2,0.5,0.7777777777777778,78763713,4,2
2,0,1.0,1.0,81896321,2,2
2,1,0.875,0.5,70185675,8,7
2,1,0.8888888888888888,0.8333333333333334,80052770,9,8
2,0,1.0,1.0,75362245,4,4
2,0,1.0,1.0,80159557,15,15
2,0,1.0,1.0,80162133,3,3
1,3,0.25,0.6666666666666666,68500005,4,1
0,1,0.0,0.0,80128385,1,0
0,1,0.0,0.0,80128400,1,0
0,8,0.1111111111111111,0.35714285714285715,70704256,9,1
2,4,0.5555555555555556,0.9655172413793104,71341802,9,5
1,5,0.375,0.8205128205128205,82018711,8,3
0,2,0.0,0.0,69635671,2,0
1,5,0.2857142857142857,0.8,80164931,7,2
2,2,0.8666666666666667,0.6666666666666666,74511472,15,13
0,7,0.125,0.45,70343791,8,1
0,8,0.1111111111111111,0.22727272727272727,64041705,9,1
0,6,0.14285714285714285,0.47058823529411764,64041726,7,1
0,3,0.0,0.0,74924115,3,0
0,4,0.0,0.0,65768983,4,0
0,6,0.3333333333333333,0.3888888888888889,68400780,9,3
2,4,0.6,0.92,69997935,10,6
0,3,0.0,0.0,66257576,3,0
2,1,0.5,0.6666666666666666,70417613,2,1
2,2,0.5,0.2857142857142857,82090249,4,2
0,1,0.0,0.0,68155724,1,0
1,3,0.25,0.5,72785860,4,1
0,3,0.0,0.0,82019433,3,0
2,1,0.5,0.8333333333333334,80156301,2,1
0,1,0.0,0.0,80156601,1,0
0,4,0.3333333333333333,0.375,80127703,6,2
1,14,0.36363636363636365,0.7419354838709677,80178133,22,8
2,0,1.0,1.0,82015870,2,2
1,3,0.25,0.5263157894736842,70843283,4,1
1,4,0.3333333333333333,0.7777777777777778,68784863,6,2
2,0,1.0,1.0,72760023,1,1
0,5,0.0,0.0,70695142,5,0
0,5,0.0,0.0,70747740,5,0
2,0,1.0,1.0,82037901,1,1
1,3,0.25,0.6666666666666666,54569291,4,1
0,2,0.0,0.0,66381910,2,0
0,2,0.0,0.0,66381924,2,0
0,1,0.0,0.0,66381952,1,0
2,0,1.0,1.0,70474222,1,1
2,1,0.6666666666666666,0.5,68546793,3,2
2,4,0.5,0.9444444444444444,66161221,8,4
0,1,0.0,0.0,62385323,1,0
0,1,0.0,0.0,72669961,1,0
0,9,0.0,0.0,70908432,9,0
2,2,0.5,0.0,80181924,4,2
2,4,0.5,0.9285714285714286,69064492,8,4
2,1,0.5,0.5,68518681,2,1
0,1,0.0,0.0,66258010,1,0
0,2,0.0,0.0,70674163,2,0
0,1,0.0,0.0,70697291,1,0
0,1,0.0,0.0,69994540,1,0
0,2,0.0,0.0,68536153,2,0
2,1,0.5,0.5,68595681,2,1
2,2,0.6,0.8,80135181,5,3
0,4,0.42857142857142855,0.45454545454545453,68718874,7,3
0,2,0.0,0.0,80132951,2,0
2,1,0.5,0.5,64192450,2,1
2,1,0.75,0.8,68252842,4,3
0,6,0.0,0.0,61976404,6,0
0,2,0.0,0.0,69626193,2,0
1,6,0.25,0.8064516129032258,81971192,8,2
2,0,1.0,1.0,82041913,1,1
0,1,0.0,0.0,73850833,1,0
2,3,0.5714285714285714,0.7142857142857143,82154395,7,4
0,3,0.0,0.0,73635135,3,0
0,1,0.0,0.0,65328130,1,0
0,6,0.0,0.0,73245473,6,0
0,1,0.0,0.0,70575302,1,0
2,2,0.75,0.75,80127418,8,6
2,1,0.8,0.5,74320715,5,4
1,10,0.23076923076923078,0.5,65279935,13,3
2,0,1.0,1.0,69137243,2,2
2,2,0.5,0.5,70672322,4,2
0,4,0.0,0.0,65280131,4,0
0,11,0.15384615384615385,0.17647058823529413,65281552,13,2
0,11,0.15384615384615385,0.16666666666666666,66560662,13,2
1,3,0.4,0.5,82040653,5,2
2,1,0.6666666666666666,0.8888888888888888,66816911,3,2
0,9,0.1,0.09375,69498996,10,1
0,7,0.0,0.0,66304770,7,0
2,0,1.0,1.0,80132281,1,1
0,5,0.16666666666666666,0.3125,70679042,6,1
0,1,0.0,0.0,82019799,1,0
0,1,0.0,0.0,80145789,1,0
2,3,0.5714285714285714,0.8571428571428571,72472876,7,4
0,2,0.0,0.0,69868113,2,0
0,1,0.0,0.0,67297874,1,0
1,2,0.3333333333333333,0.6666666666666666,70678244,3,1
2,4,0.6363636363636364,0.3333333333333333,80163151,11,7
1,5,0.2857142857142857,0.6176470588235294,70758786,7,2
2,1,0.8333333333333334,0.5,80132897,6,5
0,3,0.0,0.0,69518155,3,0
2,1,0.5,0.5,70945000,2,1
0,1,0.0,0.0,70945063,1,0
1,5,0.375,0.9375,82009367,8,3
1,6,0.25,0.6363636363636364,80124696,8,2
0,3,0.25,0.1111111111111111,80153637,4,1
0,2,0.0,0.0,70697396,2,0
0,1,0.0,0.0,80177547,1,0
1,3,0.25,0.5714285714285714,70694463,4,1
0,2,0.0,0.0,70746872,2,0
0,1,0.0,0.0,65328102,1,0
0,2,0.0,0.0,82010251,2,0
0,3,0.0,0.0,65901150,3,0
0,13,0.1875,0.3333333333333333,70013013,16,3
2,0,1.0,1.0,80176433,4,4
2,1,0.5,0.5,80091823,2,1
0,6,0.0,0.0,68497170,6,0
2,1,0.75,0.5,80162566,4,3
0,3,0.0,0.0,70704480,3,0
0,1,0.0,0.0,70705642,1,0
0,3,0.0,0.0,70705691,3,0
1,9,0.3076923076923077,0.8095238095238095,70691670,13,4
0,2,0.0,0.0,70743911,2,0
2,0,1.0,1.0,74051334,5,5
2,1,0.5,0.5,66245522,2,1
2,0,1.0,1.0,80090892,2,2
2,2,0.6,0.8333333333333334,66279381,5,3
1,2,0.3333333333333333,0.8571428571428571,69701303,3,1
0,3,0.0,0.0,80150653,3,0
2,0,1.0,1.0,73403750,12,12
2,0,1.0,1.0,80178220,2,2
0,1,0.0,0.0,80056312,1,0
0,1,0.0,0.0,70908180,1,0
0,2,0.0,0.0,78762733,2,0
0,3,0.0,0.0,80163391,3,0
0,1,0.0,0.0,80172654,1,0
0,1,0.0,0.0,82006210,1,0
1,3,0.4,0.7692307692307693,80168259,5,2
0,13,0.0,0.0,67858980,13,0
0,3,0.0,0.0,82006370,3,0
0,4,0.0,0.0,80167316,4,0
1,3,0.4,0.8888888888888888,82006696,5,2
0,3,0.0,0.0,67900392,3,0
0,5,0.0,0.0,80162891,5,0
0,1,0.0,0.0,80173421,1,0
0,12,0.0,0.0,82036407,12,0
0,1,0.0,0.0,74161234,1,0
0,1,0.0,0.0,74161241,1,0
1,6,0.25,0.7586206896551724,67359502,8,2
2,7,0.5333333333333333,0.8181818181818182,80135232,15,8
0,1,0.0,0.0,82205862,1,0
2,0,1.0,1.0,69905724,1,1
0,3,0.0,0.0,71619695,3,0
0,2,0.0,0.0,82006524,2,0
2,1,0.75,0.5,70843234,4,3
1,7,0.2222222222222222,0.8378378378378378,64969303,9,2
1,7,0.2222222222222222,0.5714285714285714,66046834,9,2
1,6,0.3333333333333333,0.6666666666666666,66264310,9,3
0,7,0.0,0.0,68500236,7,0
0,1,0.0,0.0,72417933,1,0
1,3,0.25,0.75,74778326,4,1
1,10,0.2857142857142857,0.7419354838709677,69056386,14,4
1,5,0.2857142857142857,0.7391304347826086,80126776,7,2
2,2,0.5,0.9090909090909091,71081381,4,2
1,5,0.4444444444444444,0.9090909090909091,80156408,9,4
0,2,0.0,0.0,62130516,2,0
1,3,0.25,0.8,70697025,4,1
1,5,0.2857142857142857,0.5714285714285714,70947002,7,2
2,0,1.0,1.0,80134754,1,1
2,0,1.0,1.0,82135129,3,3
0,14,0.125,0.4634146341463415,63993370,16,2
0,4,0.0,0.0,71458562,4,0
0,1,0.0,0.0,71879213,1,0
1,3,0.25,0.6764705882352942,66782870,4,1
2,2,0.7142857142857143,0.8,80124628,7,5
0,4,0.42857142857142855,0.42857142857142855,69089902,7,3
1,9,0.1,0.575,66782142,10,1
1,3,0.4,0.8461538461538461,66783794,5,2
1,3,0.4,0.9,80128822,5,2
0,2,0.0,0.0,82013525,2,0
0,8,0.0,0.0,69234004,8,0
2,1,0.6666666666666666,0.8571428571428571,63832195,3,2
1,4,0.42857142857142855,0.7647058823529411,72439556,7,3
0,9,0.18181818181818182,0.25,70317996,11,2
0,3,0.0,0.0,71536556,3,0
0,3,0.0,0.0,68273751,3,0
2,6,0.5,0.9411764705882353,68144783,12,6
0,10,0.0,0.0,67379606,10,0
1,5,0.375,0.6666666666666666,69189246,8,3
2,0,1.0,1.0,80132877,1,1
2,0,1.0,1.0,70854014,1,1
0,3,0.4,0.2,82010323,5,2
0,3,0.0,0.0,73064446,3,0
2,1,0.75,0.5,68041484,4,3
2,2,0.8461538461538461,0.6666666666666666,70868532,13,11
0,2,0.0,0.0,80126875,2,0
0,6,0.14285714285714285,0.2608695652173913,66225964,7,1
0,6,0.0,0.0,77563906,6,0
1,3,0.4,0.75,70175826,5,2
0,9,0.3076923076923077,0.48,68401921,13,4
2,1,0.5,0.5,82047507,2,1
2,3,0.7857142857142857,0.5,82051747,14,11
2,2,0.5,0.625,82051775,4,2
2,0,1.0,1.0,82054056,1,1
2,0,1.0,1.0,80139942,2,2
2,2,0.5,0.5,80158320,4,2
0,4,0.2,0.2,70844326,5,1
2,0,1.0,1.0,80176465,1,1
2,0,1.0,1.0,80093643,1,1
2,0,1.0,1.0,82041566,2,2
0,3,0.0,0.0,69596835,3,0
2,3,0.5,0.5,82154367,6,3
0,12,0.2,0.42592592592592593,68546366,15,3
0,5,0.0,0.0,70685965,5,0
0,1,0.0,0.0,69640333,1,0
0,2,0.0,0.0,69640424,2,0
0,4,0.0,0.0,69526142,4,0
0,9,0.0,0.0,69525666,9,0
1,14,0.125,0.5510204081632653,80150797,16,2
2,1,0.75,0.9285714285714286,80176503,4,3
0,2,0.0,0.0,70744576,2,0
2,0,1.0,1.0,82033533,5,5
2,1,0.75,0.9090909090909091,65234652,4,3
2,1,0.5,0.3333333333333333,82179480,2,1
0,2,0.0,0.0,70635404,2,0
1,2,0.3333333333333333,0.5,71619044,3,1
0,4,0.2,0.26666666666666666,80125061,5,1
0,2,0.3333333333333333,0.3333333333333333,67754393,3,1
2,0,1.0,1.0,73245802,1,1
0,1,0.0,0.0,69388172,1,0
0,3,0.4,0.3333333333333333,74362225,5,2
2,0,1.0,1.0,70121492,1,1
2,0,1.0,1.0,80003630,3,3
0,1,0.0,0.0,82070250,1,0
0,1,0.0,0.0,67335345,1,0
0,1,0.0,0.0,69064450,1,0
0,2,0.0,0.0,69463331,2,0
2,2,0.5,0.75,67551554,4,2
0,1,0.0,0.0,71112370,1,0
1,4,0.2,0.5,70850780,5,1
0,1,0.0,0.0,66169936,1,0
2,1,0.8333333333333334,0.5,82003955,6,5
2,2,0.5,0.5,72376843,4,2
2,1,0.5,0.0,68284650,2,1
0,6,0.14285714285714285,0.4090909090909091,71618904,7,1
0,7,0.125,0.0,69998061,8,1
1,5,0.375,0.96,80137357,8,3
0,1,0.0,0.0,69667773,1,0
0,3,0.0,0.0,70121023,3,0
0,9,0.1,0.35,72808603,10,1
1,6,0.25,0.5454545454545454,80176682,8,2
2,4,0.5,0.9411764705882353,82251460,8,4
0,2,0.3333333333333333,0.4,70646093,3,1
0,6,0.0,0.0,73421495,6,0
0,1,0.0,0.0,70250845,1,0
0,4,0.0,0.0,67665416,4,0
2,2,0.6,0.3333333333333333,70717983,5,3
2,0,1.0,1.0,82016289,2,2
0,1,0.0,0.0,71588321,1,0
2,2,0.5,0.9565217391304348,70669452,4,2
0,8,0.0,0.0,70238735,8,0
1,6,0.3333333333333333,0.7,69489133,9,3
1,7,0.2222222222222222,0.5555555555555556,69626403,9,2
0,4,0.2,0.14285714285714285,69538931,5,1
2,2,0.5,0.875,73917795,4,2
1,5,0.2857142857142857,0.8125,69031354,7,2
2,1,0.5,0.6666666666666666,70717990,2,1
0,6,0.0,0.0,70705894,6,0
1,3,0.4,0.5,66257044,5,2
0,1,0.0,0.0,80122864,1,0
0,2,0.3333333333333333,0.0,80094546,3,1
2,4,0.5555555555555556,0.8,72804116,9,5
2,0,1.0,1.0,69479403,1,1
2,1,0.5,0.92,67890802,2,1
2,0,1.0,1.0,82019827,3,3
0,3,0.0,0.0,67094832,3,0
0,7,0.0,0.0,67095063,7,0
1,3,0.25,0.6363636363636364,67514062,4,1
1,11,0.26666666666666666,0.7021276595744681,69562661,15,4
0,1,0.0,0.0,82152126,1,0
0,7,0.125,0.07142857142857142,70748265,8,1
2,4,0.5555555555555556,0.875,62143494,9,5
2,0,1.0,1.0,72802996,1,1
0,1,0.0,0.0,80118220,1,0
2,1,0.5,0.5,80118244,2,1
0,4,0.0,0.0,70745976,4,0
0,1,0.0,0.0,70746242,1,0
0,8,0.0,0.0,70746396,8,0
0,1,0.0,0.0,70746683,1,0
2,1,0.6666666666666666,0.6666666666666666,79792265,3,2
0,1,0.0,0.0,70175014,1,0
0,3,0.0,0.0,70701631,3,0
0,2,0.0,0.0,70701666,2,0
0,3,0.0,0.0,70702030,3,0
0,2,0.0,0.0,70702226,2,0
2,2,0.5,0.9230769230769231,70704942,4,2
2,6,0.5384615384615384,0.7,66228533,13,7
0,7,0.125,0.0,65282315,8,1
0,2,0.0,0.0,82010328,2,0
0,13,0.0,0.0,70691593,13,0
0,9,0.1,0.3333333333333333,70693182,10,1
0,1,0.0,0.0,67779180,1,0
0,1,0.0,0.0,67779194,1,0
0,1,0.0,0.0,67779201,1,0
2,1,0.5,0.75,67779215,2,1
2,1,0.5,0.6666666666666666,80176258,2,1
2,0,1.0,1.0,82024239,1,1
0,1,0.0,0.0,70968765,1,0
0,1,0.0,0.0,70968786,1,0
2,1,0.75,0.8571428571428571,72392894,4,3
0,5,0.0,0.0,70705131,5,0
2,1,0.8333333333333334,0.9523809523809523,72801435,6,5
0,8,0.2727272727272727,0.43478260869565216,71081675,11,3
2,1,0.5,0.8888888888888888,70745794,2,1
0,7,0.0,0.0,62837705,7,0
2,0,1.0,1.0,79816604,1,1
0,6,0.0,0.0,82102590,6,0
0,6,0.0,0.0,82102924,6,0
1,3,0.25,0.5,70675640,4,1
2,3,0.6666666666666666,0.6,69634971,9,6
2,1,0.5,0.6666666666666666,68641853,2,1
0,1,0.0,0.0,69474741,1,0
0,1,0.0,0.0,69521543,1,0
1,4,0.3333333333333333,0.7142857142857143,73702566,6,2
0,1,0.0,0.0,80094903,1,0
2,0,1.0,1.0,80132981,3,3
2,0,1.0,1.0,73344824,1,1
0,7,0.0,0.0,70704970,7,0
0,4,0.2,0.25,63580713,5,1
0,2,0.0,0.0,70013622,2,0
0,3,0.0,0.0,74047106,3,0
1,3,0.4,0.5,80118182,5,2
2,1,0.5,0.6666666666666666,13574222,2,1
2,0,1.0,1.0,71567174,2,2
2,2,0.6,0.7777777777777778,80153661,5,3
0,3,0.0,0.0,80131193,3,0
2,0,1.0,1.0,70821800,1,1
2,1,0.6666666666666666,0.6666666666666666,70821534,3,2
0,1,0.0,0.0,69911114,1,0
1,7,0.3,0.8823529411764706,68213635,10,3
1,2,0.3333333333333333,0.7142857142857143,66804024,3,1
1,3,0.4,0.8,80162905,5,2
0,2,0.0,0.0,82006248,2,0
1,18,0.1,0.5487804878048781,63955724,20,2
1,3,0.25,0.92,68607140,4,1
0,8,0.0,0.0,70468174,8,0
2,0,1.0,1.0,70230503,1,1
0,1,0.0,0.0,72474563,1,0
2,1,0.75,0.75,80135028,4,3
0,6,0.0,0.0,68138553,6,0
2,0,1.0,1.0,69975514,2,2
2,1,0.6666666666666666,0.75,70933730,3,2
2,1,0.75,0.5,67032805,4,3
0,2,0.0,0.0,70701246,2,0
0,3,0.0,0.0,70701603,3,0
0,1,0.0,0.0,70702345,1,0
2,0,1.0,1.0,70758842,2,2
0,2,0.0,0.0,70515130,2,0
0,6,0.0,0.0,70698362,6,0
1,2,0.3333333333333333,0.5454545454545454,82024205,3,1
2,5,0.5454545454545454,0.7391304347826086,67843244,11,6
0,9,0.18181818181818182,0.23529411764705882,70063476,11,2
2,1,0.6666666666666666,0.0,69587686,3,2
0,4,0.0,0.0,69158446,4,0
0,5,0.0,0.0,75148724,5,0
2,0,1.0,1.0,77113946,3,3
0,8,0.0,0.0,66010000,8,0
1,3,0.4,0.8709677419354839,82143736,5,2
2,1,0.8,0.5,80093146,5,4
1,3,0.25,0.6,70343413,4,1
0,10,0.0,0.0,67475793,10,0
1,4,0.3333333333333333,0.7142857142857143,71081563,6,2
2,3,0.5,0.6,68654243,6,3
0,7,0.125,0.26666666666666666,65713662,8,1
0,6,0.25,0.35294117647058826,75338781,8,2
1,2,0.3333333333333333,0.6,80150351,3,1
0,5,0.4444444444444444,0.4444444444444444,66257513,9,4
0,1,0.0,0.0,66547481,1,0
2,1,0.6666666666666666,0.75,75346404,3,2
2,0,1.0,1.0,63398202,1,1
0,3,0.0,0.0,69078604,3,0
0,6,0.0,0.0,67199720,6,0
2,0,1.0,1.0,82046250,1,1
1,2,0.3333333333333333,0.8,69693932,3,1
0,6,0.0,0.0,80122865,6,0
2,2,0.6666666666666666,0.75,70718802,6,4
2,2,0.6,0.8571428571428571,75120976,5,3
2,0,1.0,1.0,68532184,1,1
1,5,0.16666666666666666,0.5555555555555556,80149868,6,1
2,1,0.5,0.6666666666666666,66225404,2,1
0,2,0.0,0.0,82024204,2,0
1,2,0.3333333333333333,0.6666666666666666,69699021,3,1
1,3,0.4,0.9411764705882353,69417040,5,2
2,1,0.5,0.0,80181398,2,1
2,1,0.6666666666666666,0.5,68400241,3,2
2,0,1.0,1.0,69705594,1,1
2,0,1.0,1.0,80159149,3,3
2,0,1.0,1.0,70074172,3,3
2,0,1.0,1.0,70314300,4,4
2,3,0.7692307692307693,0.75,69168211,13,10
2,0,1.0,1.0,82041560,1,1
2,0,1.0,1.0,80080035,4,4
2,1,0.5,0.8,70120890,2,1
0,2,0.3333333333333333,0.2,65730105,3,1
2,0,1.0,1.0,70179634,2,2
2,0,1.0,1.0,69979931,3,3
0,6,0.25,0.3333333333333333,82041885,8,2
0,5,0.2857142857142857,0.14285714285714285,75545904,7,2
2,0,1.0,1.0,80162134,3,3
0,10,0.0,0.0,79990043,10,0
0,3,0.0,0.0,70224091,3,0
2,0,1.0,1.0,67754995,2,2
1,6,0.25,0.7,70048034,8,2
1,2,0.3333333333333333,0.6666666666666666,69633081,3,1
0,13,0.0,0.0,80131227,13,0
0,18,0.0,0.0,80131228,18,0
1,16,0.1111111111111111,0.5517241379310345,82003719,18,2
2,1,0.5,0.0,66232971,2,1
2,1,0.5,0.5,68715570,2,1
0,4,0.2,0.09090909090909091,71618953,5,1
1,6,0.3333333333333333,0.7647058823529411,68294835,9,3
1,3,0.4,0.8571428571428571,70467705,5,2
0,3,0.0,0.0,70698040,3,0
0,4,0.2,0.2,71588104,5,1
2,4,0.7333333333333333,0.9375,74095385,15,11
2,0,1.0,1.0,66231823,1,1
2,3,0.625,0.75,67973213,8,5
2,0,1.0,1.0,70537523,1,1
2,1,0.75,0.5,66232481,4,3
1,7,0.4166666666666667,0.8787878787878788,66221232,12,5
2,0,1.0,1.0,82020267,2,2
0,1,0.0,0.0,73801266,1,0
2,0,1.0,1.0,68614686,2,2
2,2,0.6666666666666666,0.6666666666666666,65278150,6,4
2,0,1.0,1.0,66253572,2,2
0,1,0.0,0.0,69483694,1,0
2,1,0.6666666666666666,0.8,82018725,3,2
0,17,0.10526315789473684,0.13725490196078433,70679091,19,2
0,1,0.0,0.0,74048695,1,0
2,1,0.5,0.5,70705880,2,1
2,1,0.75,0.9230769230769231,68469681,4,3
0,2,0.0,0.0,73255602,2,0
2,0,1.0,1.0,705761,1,1
0,3,0.4,0.42857142857142855,70407442,5,2
0,5,0.4444444444444444,0.26666666666666666,70179872,9,4
2,0,1.0,1.0,74749633,6,6
2,3,0.5714285714285714,0.9090909090909091,72803066,7,4
0,2,0.0,0.0,68621833,2,0
1,5,0.16666666666666666,0.6818181818181818,71537592,6,1
2,3,0.5714285714285714,0.8571428571428571,74619804,7,4
0,5,0.0,0.0,69997473,5,0
2,3,0.5714285714285714,0.875,80158273,7,4
0,2,0.0,0.0,82206216,2,0
0,1,0.0,0.0,67822153,1,0
1,3,0.4,0.8,67822412,5,2
1,2,0.3333333333333333,0.8333333333333334,82012776,3,1
1,5,0.2857142857142857,0.6,70459186,7,2
2,0,1.0,1.0,68060853,1,1
1,2,0.3333333333333333,0.6666666666666666,72882761,3,1
2,0,1.0,1.0,81989200,2,2
0,5,0.0,0.0,67580135,5,0
0,4,0.0,0.0,80126852,4,0
0,2,0.0,0.0,80145821,2,0
2,1,0.75,0.5,80176666,4,3
2,0,1.0,1.0,70406203,1,1
1,5,0.2857142857142857,0.55,76807430,7,2
0,6,0.25,0.4666666666666667,80090213,8,2
0,1,0.0,0.0,82110394,1,0
0,1,0.0,0.0,70639891,1,0
0,19,0.17391304347826086,0.3770491803278688,67199671,23,4
0,5,0.16666666666666666,0.18181818181818182,82002268,6,1
1,6,0.25,0.5,70175294,8,2
1,4,0.2,0.7,62219402,5,1
0,1,0.0,0.0,65812201,1,0
0,3,0.0,0.0,65293123,3,0
2,0,1.0,1.0,80132287,1,1
0,3,0.0,0.0,72337286,3,0
2,0,1.0,1.0,80165240,2,2
0,4,0.42857142857142855,0.0,68340083,7,3
2,1,0.5,0.9473684210526315,74124001,2,1
0,3,0.0,0.0,80153682,3,0
2,0,1.0,1.0,82165040,1,1
2,0,1.0,1.0,68393374,5,5
0,1,0.0,0.0,70703283,1,0
1,2,0.3333333333333333,0.6666666666666666,79788366,3,1
1,3,0.25,0.7142857142857143,66133270,4,1
0,17,0.22727272727272727,0.4090909090909091,80150335,22,5
1,11,0.3125,0.5,80134749,16,5
0,6,0.0,0.0,70238000,6,0
0,6,0.14285714285714285,0.48936170212765956,82118289,7,1
2,1,0.5,0.8333333333333334,70059122,2,1
2,2,0.5,0.0,67787594,4,2
0,1,0.0,0.0,82019438,1,0
0,3,0.0,0.0,69693722,3,0
0,8,0.0,0.0,69693750,8,0
0,1,0.0,0.0,80093153,1,0
0,2,0.0,0.0,69831650,2,0
0,11,0.21428571428571427,0.2727272727272727,64052296,14,3
2,1,0.75,0.5,73029124,4,3
0,1,0.0,0.0,82006236,1,0
0,2,0.0,0.0,66512775,2,0
2,0,1.0,1.0,65630600,1,1
0,10,0.0,0.0,67051614,10,0
0,10,0.0,0.0,82102880,10,0
0,1,0.0,0.0,68042114,1,0
0,1,0.0,0.0,70467453,1,0
2,3,0.625,0.9,70759150,8,5
0,1,0.0,0.0,67359523,1,0
0,6,0.0,0.0,64027383,6,0
1,2,0.3333333333333333,0.8,71081311,3,1
1,11,0.08333333333333333,0.6185567010309279,68384484,12,1
1,8,0.1111111111111111,0.7866666666666666,69867826,9,1
1,3,0.25,0.5714285714285714,80167313,4,1
0,2,0.0,0.0,80171077,2,0
2,4,0.5555555555555556,0.95,77321951,9,5
2,0,1.0,1.0,80055290,1,1
0,2,0.0,0.0,70682325,2,0
0,1,0.0,0.0,70685685,1,0
2,0,1.0,1.0,80132965,1,1
0,2,0.0,0.0,68017726,2,0
0,8,0.2,0.2916666666666667,82210120,10,2
0,5,0.16666666666666666,0.375,65279382,6,1
2,2,0.5,0.75,65280950,4,2
2,0,1.0,1.0,80094854,1,1
0,2,0.0,0.0,70679791,2,0
2,1,0.75,0.8,66509492,4,3
2,2,0.6666666666666666,0.8333333333333334,80135278,6,4
1,4,0.2,0.6470588235294118,82070159,5,1
2,1,0.75,0.6666666666666666,80133903,4,3
0,1,0.0,0.0,80133947,1,0
0,1,0.0,0.0,80133955,1,0
2,0,1.0,1.0,70189035,4,4
1,3,0.25,0.5,69604094,4,1
2,0,1.0,1.0,82069229,1,1
0,1,0.0,0.0,82039301,1,0
0,1,0.0,0.0,74944583,1,0
0,7,0.0,0.0,70679595,7,0
0,5,0.16666666666666666,0.41379310344827586,69693953,6,1
2,0,1.0,1.0,69598326,1,1
2,0,1.0,1.0,80136601,12,12
0,5,0.16666666666666666,0.20833333333333334,80128902,6,1
0,9,0.0,0.0,66786293,9,0
2,2,0.5,0.875,69193754,4,2
0,6,0.0,0.0,69311522,6,0
0,2,0.0,0.0,69313125,2,0
0,3,0.0,0.0,73801070,3,0
1,3,0.25,0.5,73801084,4,1
1,2,0.3333333333333333,0.75,73421523,3,1
2,5,0.5833333333333334,0.9666666666666667,70760326,12,7
0,2,0.0,0.0,73535455,2,0
0,2,0.0,0.0,73535511,2,0
0,5,0.0,0.0,73535532,5,0
0,7,0.0,0.0,73536771,7,0
0,7,0.0,0.0,73536785,7,0
0,6,0.0,0.0,73536806,6,0
0,5,0.0,0.0,70568386,5,0
2,0,1.0,1.0,70743736,3,3
0,16,0.0,0.0,70677103,16,0
0,5,0.0,0.0,70695205,5,0
0,1,0.0,0.0,68740721,1,0
1,4,0.42857142857142855,0.8571428571428571,64976163,7,3
2,0,1.0,1.0,70046354,2,2
2,1,0.6666666666666666,0.5,69468952,3,2
1,8,0.3333333333333333,0.6,70854196,12,4
2,0,1.0,1.0,74129342,1,1
2,2,0.5,0.9230769230769231,70078456,4,2
2,0,1.0,1.0,68044620,1,1
2,1,0.5,0.5,69555535,2,1
0,5,0.0,0.0,70692181,5,0
0,1,0.0,0.0,70912765,1,0
2,0,1.0,1.0,80176494,4,4
2,4,0.5,0.8,82062241,8,4
2,1,0.75,0.5,80151040,4,3
2,0,1.0,1.0,69976375,2,2
2,1,0.875,0.5,70747586,8,7
2,0,1.0,1.0,68748491,1,1
2,7,0.5,0.8235294117647058,69055273,14,7
2,0,1.0,1.0,82039343,5,5
2,0,1.0,1.0,73551443,1,1
0,2,0.3333333333333333,0.0,82060555,3,1
2,0,1.0,1.0,60261803,6,6
2,0,1.0,1.0,82061346,1,1
0,3,0.0,0.0,72808890,3,0
2,0,1.0,1.0,80179228,1,1
1,6,0.3333333333333333,0.7142857142857143,75377001,9,3
2,0,1.0,1.0,69693190,2,2
2,1,0.6666666666666666,0.5,69202546,3,2
2,3,0.5714285714285714,0.8333333333333334,65087841,7,4
0,6,0.0,0.0,74776870,6,0
0,2,0.0,0.0,63094535,2,0
0,1,0.0,0.0,68569410,1,0
1,6,0.25,0.6,70658882,8,2
0,1,0.0,0.0,69638191,1,0
1,7,0.125,0.6111111111111112,69638261,8,1
1,3,0.25,0.75,70198135,4,1
0,16,0.1111111111111111,0.47297297297297297,65882782,18,2
1,3,0.25,0.7647058823529411,67278001,4,1
0,10,0.0,0.0,66782114,10,0
0,9,0.0,0.0,66786202,9,0
0,3,0.25,0.4444444444444444,80163208,4,1
0,1,0.0,0.0,66786713,1,0
2,1,0.75,0.5,82139989,4,3
0,4,0.2,0.35294117647058826,71619156,5,1
2,1,0.5,0.75,71619184,2,1
1,4,0.3333333333333333,0.8367346938775511,80114202,6,2
0,3,0.0,0.0,63182553,3,0
1,6,0.25,0.5,65557121,8,2
0,2,0.0,0.0,68290236,2,0
0,4,0.2,0.0,72809331,5,1
0,3,0.0,0.0,69693281,3,0
0,1,0.0,0.0,69693841,1,0
0,1,0.0,0.0,69693981,1,0
2,1,0.8571428571428571,0.5,76974170,7,6
0,3,0.0,0.0,74989614,3,0
1,6,0.4,0.8913043478260869,80163455,10,4
0,2,0.0,0.0,82019445,2,0
0,7,0.0,0.0,82022530,7,0
2,2,0.5,0.6666666666666666,64457204,4,2
2,8,0.5789473684210527,0.9615384615384616,82049143,19,11
0,5,0.0,0.0,70676270,5,0
1,8,0.2727272727272727,0.8,70058436,11,3
0,2,0.0,0.0,80168317,2,0
0,5,0.16666666666666666,0.46511627906976744,80124191,6,1
1,4,0.2,0.8888888888888888,79791355,5,1
0,1,0.0,0.0,70013650,1,0
0,7,0.2222222222222222,0.3333333333333333,69691965,9,2
2,2,0.7142857142857143,0.8333333333333334,70282051,7,5
0,4,0.2,0.4166666666666667,58873745,5,1
2,1,0.6666666666666666,0.5,80131238,3,2
0,1,0.0,0.0,82012795,1,0
2,0,1.0,1.0,70563241,1,1
2,0,1.0,1.0,80130698,1,1
0,15,0.0625,0.125,80128099,16,1
0,9,0.0,0.0,80130307,9,0
2,0,1.0,1.0,69205934,1,1
0,8,0.0,0.0,67846282,8,0
2,1,0.75,0.5,69622161,4,3
0,1,0.0,0.0,82250604,1,0
0,1,0.0,0.0,66234406,1,0
0,3,0.0,0.0,70508851,3,0
2,2,0.5,0.5,80145435,4,2
0,3,0.0,0.0,80128561,3,0
2,1,0.8571428571428571,0.5,73102274,7,6
0,1,0.0,0.0,66233335,1,0
0,2,0.0,0.0,82251449,2,0
0,3,0.0,0.0,69602960,3,0
2,1,0.5,0.6,70744023,2,1
2,1,0.75,0.8333333333333334,76941795,4,3
0,6,0.0,0.0,82019478,6,0
1,5,0.2857142857142857,0.5555555555555556,82022515,7,2
1,4,0.2,0.5,80051755,5,1
0,4,0.0,0.0,80051762,4,0
0,2,0.0,0.0,67654804,2,0
0,3,0.0,0.0,82103836,3,0
0,17,0.10526315789473684,0.17647058823529413,80018841,19,2
0,6,0.0,0.0,69626263,6,0
1,6,0.14285714285714285,0.5,63613235,7,1
0,1,0.0,0.0,82019810,1,0
0,1,0.0,0.0,72803752,1,0
1,4,0.3333333333333333,0.6,65280012,6,2
2,0,1.0,1.0,68254123,2,2
0,1,0.0,0.0,69478262,1,0
1,4,0.3333333333333333,0.6818181818181818,69483645,6,2
1,5,0.375,0.8947368421052632,77576723,8,3
1,7,0.2222222222222222,0.6875,77577255,9,2
0,10,0.09090909090909091,0.3,80128815,11,1
0,1,0.0,0.0,70821016,1,0
2,2,0.6666666666666666,0.75,70821051,6,4
0,1,0.0,0.0,70821100,1,0
0,4,0.2,0.4666666666666667,70677110,5,1
0,3,0.4,0.2,69484646,5,2
2,2,0.8181818181818182,0.75,82039352,11,9
2,1,0.5,0.6666666666666666,61568521,2,1
0,9,0.18181818181818182,0.29411764705882354,80051615,11,2
1,8,0.2,0.56,69625752,10,2
2,0,1.0,1.0,82020792,2,2
2,2,0.6,0.6666666666666666,69997963,5,3
1,4,0.2,0.6875,62507690,5,1
0,2,0.0,0.0,82102197,2,0
2,2,0.5,0.5,82102218,4,2
0,12,0.07692307692307693,0.05714285714285714,80134789,13,1
2,1,0.5,0.8,73635352,2,1
0,4,0.2,0.4375,66405101,5,1
0,9,0.1,0.0,82018992,10,1
0,6,0.0,0.0,72910075,6,0
2,2,0.7142857142857143,0.8888888888888888,75550321,7,5
0,2,0.3333333333333333,0.3333333333333333,75264280,3,1
2,0,1.0,1.0,70819021,2,2
0,3,0.0,0.0,66397702,3,0
0,3,0.0,0.0,70238994,3,0
0,2,0.0,0.0,70239120,2,0
0,1,0.0,0.0,70239365,1,0
0,1,0.0,0.0,70595364,1,0
2,1,0.5,0.75,69416991,2,1
2,2,0.6,0.8,66333813,5,3
1,8,0.3333333333333333,0.890625,63188314,12,4
2,3,0.5,0.9615384615384616,80167318,6,3
0,4,0.2,0.2,75883094,5,1
2,1,0.5,0.0,70174181,2,1
0,7,0.0,0.0,74923891,7,0
0,1,0.0,0.0,70213472,1,0
0,10,0.0,0.0,80150515,10,0
2,4,0.6363636363636364,0.9230769230769231,69042806,11,7
1,4,0.2,0.78125,80150713,5,1
1,6,0.45454545454545453,0.7777777777777778,80056256,11,5
0,4,0.0,0.0,73533334,4,0
0,4,0.0,0.0,80172525,4,0
0,3,0.0,0.0,82006714,3,0
1,9,0.25,0.5681818181818182,72546313,12,3
2,0,1.0,1.0,82036954,2,2
0,4,0.0,0.0,73801686,4,0
2,2,0.6666666666666666,0.8,67170740,6,4
0,1,0.0,0.0,79514561,1,0
2,1,0.6666666666666666,0.9230769230769231,69653073,3,2
0,2,0.0,0.0,75147541,2,0
2,0,1.0,1.0,80159155,3,3
0,1,0.0,0.0,141351,1,0
0,2,0.0,0.0,70706111,2,0
0,3,0.0,0.0,70682045,3,0
0,11,0.0,0.0,74460533,11,0
0,15,0.0625,0.14705882352941177,74460575,16,1
0,7,0.2222222222222222,0.4358974358974359,80134778,9,2
0,2,0.0,0.0,70686175,2,0
0,1,0.0,0.0,70645253,1,0
0,8,0.1111111111111111,0.21052631578947367,80128241,9,1
2,0,1.0,1.0,66379124,2,2
0,7,0.2222222222222222,0.4482758620689655,65291163,9,2
2,5,0.5833333333333334,0.9230769230769231,69630071,12,7
0,2,0.0,0.0,80135212,2,0
0,6,0.14285714285714285,0.45454545454545453,69895476,7,1
0,3,0.25,0.3333333333333333,69482392,4,1
0,3,0.0,0.0,69482490,3,0
2,0,1.0,1.0,67890774,4,4
2,0,1.0,1.0,80141324,2,2
2,0,1.0,1.0,67308234,1,1
2,0,1.0,1.0,72801785,1,1
1,5,0.375,0.8333333333333334,70184100,8,3
2,0,1.0,1.0,82020275,4,4
2,0,1.0,1.0,82145180,3,3
2,0,1.0,1.0,60660663,1,1
1,8,0.2727272727272727,0.7037037037037037,65280341,11,3
0,3,0.0,0.0,62449660,3,0
1,4,0.2,0.75,70119896,5,1
0,2,0.0,0.0,70013265,2,0
0,3,0.0,0.0,80150236,3,0
0,3,0.0,0.0,70685902,3,0
2,0,1.0,1.0,70672056,1,1
2,4,0.6363636363636364,0.9444444444444444,80158262,11,7
2,0,1.0,1.0,80174152,1,1
2,0,1.0,1.0,82038295,2,2
2,4,0.6363636363636364,0.9,74094965,11,7
2,0,1.0,1.0,82125462,1,1
2,0,1.0,1.0,70060403,2,2
2,0,1.0,1.0,80174128,1,1
2,0,1.0,1.0,17382806,2,2
2,0,1.0,1.0,68784646,1,1
0,8,0.1111111111111111,0.35294117647058826,69693435,9,1
0,1,0.0,0.0,70704053,1,0
0,2,0.0,0.0,67286142,2,0
1,2,0.3333333333333333,0.625,67286212,3,1
0,3,0.0,0.0,67514153,3,0
0,2,0.0,0.0,80165165,2,0
0,4,0.3333333333333333,0.4,69153840,6,2
1,2,0.3333333333333333,0.8,69064394,3,1
2,0,1.0,1.0,70654073,4,4
1,3,0.25,0.7777777777777778,70676193,4,1
1,6,0.14285714285714285,0.65,66785194,7,1
1,6,0.4,0.9583333333333334,72906764,10,4
0,2,0.0,0.0,82206093,2,0
0,2,0.0,0.0,72900156,2,0
2,2,0.7142857142857143,0.8571428571428571,69597843,7,5
0,6,0.14285714285714285,0.20689655172413793,69653122,7,1
0,3,0.0,0.0,70705495,3,0
2,2,0.6666666666666666,0.875,69608805,6,4
0,2,0.0,0.0,80135025,2,0
0,1,0.0,0.0,72786021,1,0
1,11,0.35294117647058826,0.84,71618722,17,6
1,17,0.22727272727272727,0.5405405405405406,70908761,22,5
0,6,0.14285714285714285,0.46153846153846156,70675101,7,1
1,3,0.25,0.5,70683494,4,1
2,0,1.0,1.0,80051902,2,2
0,2,0.0,0.0,70063700,2,0
0,6,0.14285714285714285,0.375,67782946,7,1
0,6,0.0,0.0,70702450,6,0
0,5,0.0,0.0,70696395,5,0
0,5,0.16666666666666666,0.125,70598164,6,1
2,2,0.75,0.6666666666666666,75264322,8,6
0,2,0.0,0.0,67568683,2,0
2,0,1.0,1.0,80139951,4,4
0,4,0.0,0.0,68497954,4,0
0,3,0.0,0.0,69479564,3,0
1,4,0.3333333333333333,0.5,82145366,6,2
0,4,0.3333333333333333,0.375,70250754,6,2
2,1,0.5,0.5,77283661,2,1
0,4,0.2,0.21428571428571427,69009094,5,1
1,2,0.3333333333333333,0.5,69547625,3,1
1,3,0.4,0.8125,82250591,5,2
0,1,0.0,0.0,82009413,1,0
0,1,0.0,0.0,82012230,1,0
0,11,0.08333333333333333,0.08571428571428572,68454631,12,1
2,1,0.5,0.5,80168337,2,1
2,0,1.0,1.0,68255852,1,1
0,1,0.0,0.0,82038809,1,0
1,4,0.3333333333333333,0.5238095238095238,65899344,6,2
2,1,0.5,0.7142857142857143,82247784,2,1
2,1,0.6666666666666666,0.5,82090283,3,2
0,1,0.0,0.0,65278822,1,0
2,0,1.0,1.0,66364333,1,1
0,2,0.0,0.0,69414933,2,0
2,0,1.0,1.0,74129391,1,1
1,6,0.14285714285714285,0.5,70678720,7,1
0,1,0.0,0.0,70696801,1,0
0,3,0.0,0.0,70407582,3,0
2,2,0.7142857142857143,0.75,81989161,7,5
2,0,1.0,1.0,80176466,4,4
1,5,0.2857142857142857,0.6153846153846154,81956350,7,2
0,2,0.3333333333333333,0.4,82046918,3,1
2,1,0.5,0.8,62881371,2,1
1,9,0.4,0.8571428571428571,61021996,15,6
1,2,0.3333333333333333,0.8181818181818182,70706272,3,1
2,3,0.5,0.8571428571428571,70609952,6,3
1,4,0.2,0.5,82012792,5,1
0,6,0.14285714285714285,0.4444444444444444,82021847,7,1
0,7,0.125,0.11764705882352941,69499185,8,1
0,3,0.25,0.2,80176347,4,1
0,1,0.0,0.0,80176353,1,0
2,1,0.8571428571428571,0.6666666666666666,80176361,7,6
0,3,0.0,0.0,70679602,3,0
0,7,0.3,0.3,71288742,10,3
2,3,0.5,0.875,82069227,6,3
0,7,0.0,0.0,70941654,7,0
0,1,0.0,0.0,81254261,1,0
1,2,0.3333333333333333,0.5,82038253,3,1
2,3,0.625,0.8,80145830,8,5
1,8,0.1111111111111111,0.5,73295502,9,1
2,0,1.0,1.0,80152990,2,2
1,7,0.4166666666666667,0.7619047619047619,70718634,12,5
0,2,0.0,0.0,70702324,2,0
2,1,0.6666666666666666,0.0,73313926,3,2
0,2,0.3333333333333333,0.25,70626206,3,1
1,3,0.4,0.6363636363636364,67656925,5,2
0,8,0.0,0.0,82056901,8,0
0,3,0.25,0.36363636363636365,80128477,4,1
2,2,0.6666666666666666,0.6666666666666666,75851475,6,4
0,2,0.0,0.0,70694470,2,0
0,22,0.08333333333333333,0.17073170731707318,66222576,24,2
1,5,0.16666666666666666,0.6363636363636364,70682080,6,1
0,1,0.0,0.0,80126748,1,0
2,0,1.0,1.0,70537600,4,4
2,1,0.5,0.5,69558475,2,1
2,1,0.75,0.6666666666666666,69660654,4,3
1,3,0.25,0.6666666666666666,72540496,4,1
0,2,0.0,0.0,67376435,2,0
0,1,0.0,0.0,69390111,1,0
0,5,0.2857142857142857,0.0,80137917,7,2
2,0,1.0,1.0,69129830,11,11
2,4,0.5,0.4,69669705,8,4
0,2,0.0,0.0,70698642,2,0
0,9,0.0,0.0,69416242,9,0
0,10,0.09090909090909091,0.24444444444444444,69416781,11,1
0,2,0.0,0.0,68999840,2,0
0,3,0.25,0.14285714285714285,69422745,4,1
0,1,0.0,0.0,68785346,1,0
2,0,1.0,1.0,71619471,2,2
0,2,0.0,0.0,82102558,2,0
0,2,0.3333333333333333,0.2,69538826,3,1
0,1,0.0,0.0,69538840,1,0
0,4,0.0,0.0,82006636,4,0
0,4,0.0,0.0,82006661,4,0
1,5,0.16666666666666666,0.6666666666666666,82006701,6,1
0,2,0.0,0.0,82006720,2,0
0,6,0.0,0.0,80150571,6,0
1,6,0.14285714285714285,0.7674418604651163,80150577,7,1
1,9,0.1,0.6666666666666666,80150588,10,1
0,15,0.0,0.0,80163206,15,0
1,4,0.2,0.6,63091532,5,1
0,1,0.0,0.0,80150641,1,0
0,3,0.0,0.0,80162858,3,0
0,1,0.0,0.0,82006310,1,0
0,7,0.125,0.43478260869565216,82118291,8,1
0,2,0.0,0.0,69100745,2,0
2,1,0.5,0.9,79410044,2,1
1,5,0.375,0.6923076923076923,66304826,8,3
2,0,1.0,1.0,82046054,1,1
2,0,1.0,1.0,65981846,3,3
2,2,0.5,0.8333333333333334,70698530,4,2
0,2,0.0,0.0,69500844,2,0
2,0,1.0,1.0,82016262,1,1
2,0,1.0,1.0,80176458,2,2
2,1,0.5,0.6666666666666666,72804165,2,1
2,2,0.5,0.5,66232145,4,2
0,2,0.0,0.0,80124633,2,0
1,3,0.25,0.6,82102478,4,1
1,9,0.25,0.8181818181818182,80128157,12,3
0,1,0.0,0.0,65977345,1,0
2,0,1.0,1.0,67831372,1,1
0,1,0.0,0.0,69550460,1,0
0,1,0.0,0.0,63245301,1,0
2,0,1.0,1.0,82135125,3,3
0,1,0.0,0.0,80145718,1,0
1,4,0.3333333333333333,0.8333333333333334,69895511,6,2
0,3,0.0,0.0,80135027,3,0
0,2,0.0,0.0,70818083,2,0
0,2,0.0,0.0,70676081,2,0
0,6,0.14285714285714285,0.23333333333333334,70678734,7,1
1,7,0.2222222222222222,0.5,72802982,9,2
0,13,0.07142857142857142,0.3246753246753247,70239225,14,1
0,15,0.0625,0.2692307692307692,70239393,16,1
0,1,0.0,0.0,74511640,1,0
0,1,0.0,0.0,66770781,1,0
1,5,0.16666666666666666,0.6363636363636364,82019424,6,1
0,3,0.0,0.0,70679252,3,0
0,10,0.0,0.0,80124417,10,0
0,8,0.1111111111111111,0.14285714285714285,70183932,9,1
0,6,0.0,0.0,69693421,6,0
0,3,0.0,0.0,74087811,3,0
2,1,0.5,0.0,67335786,2,1
2,1,0.6666666666666666,0.5,68169206,3,2
0,7,0.2222222222222222,0.2903225806451613,69604164,9,2
2,2,0.6,0.6666666666666666,66969630,5,3
0,1,0.0,0.0,69701471,1,0
2,0,1.0,1.0,80126578,1,1
2,0,1.0,1.0,65292885,1,1
2,3,0.625,0.75,70253743,8,5
2,0,1.0,1.0,69315834,1,1
1,12,0.3333333333333333,0.7619047619047619,65279151,18,6
2,5,0.6153846153846154,0.9090909090909091,66850560,13,8
2,4,0.5,0.5,82113159,8,4
0,1,0.0,0.0,70698460,1,0
2,0,1.0,1.0,69627901,3,3
2,0,1.0,1.0,69555234,2,2
2,0,1.0,1.0,82047509,1,1
2,1,0.5,0.6666666666666666,80172920,2,1
2,0,1.0,1.0,75295220,1,1
0,1,0.0,0.0,82025213,1,0
2,0,1.0,1.0,80051643,1,1
2,1,0.875,0.8,80062353,8,7
2,1,0.6666666666666666,0.75,68380291,3,2
2,0,1.0,1.0,82032896,4,4
2,0,1.0,1.0,82096375,1,1
2,0,1.0,1.0,82041545,1,1
0,4,0.0,0.0,67286184,4,0
0,5,0.0,0.0,67286345,5,0
0,3,0.0,0.0,73800832,3,0
2,3,0.5714285714285714,0.8571428571428571,69517021,7,4
0,6,0.0,0.0,67467974,6,0
0,4,0.0,0.0,70216741,4,0
0,2,0.0,0.0,66785215,2,0
0,4,0.0,0.0,66786923,4,0
2,1,0.6666666666666666,0.5,82093727,3,2
2,2,0.5,0.0,251601,4,2
0,7,0.0,0.0,70405664,7,0
0,4,0.0,0.0,70681555,4,0
2,1,0.6666666666666666,0.0,62958651,3,2
2,1,0.6666666666666666,0.0,65539481,3,2
0,2,0.0,0.0,69575534,2,0
0,1,0.0,0.0,81888450,1,0
2,1,0.6666666666666666,0.75,70418152,3,2
2,1,0.5,0.5,66471496,2,1
0,1,0.0,0.0,68680612,1,0
2,1,0.5,0.875,70707385,2,1
0,2,0.0,0.0,82143738,2,0
2,2,0.6,0.6666666666666666,69489413,5,3
2,1,0.8,0.5,69206795,5,4
0,7,0.0,0.0,65293095,7,0
1,10,0.23076923076923078,0.8055555555555556,70697312,13,3
2,1,0.5,0.5,68338725,2,1
2,2,0.7142857142857143,0.75,82023128,7,5
1,6,0.45454545454545453,0.8461538461538461,68654250,11,5
1,2,0.3333333333333333,0.6666666666666666,70494116,3,1
0,2,0.0,0.0,72808960,2,0
0,1,0.0,0.0,70696843,1,0
2,0,1.0,1.0,64353471,4,4
0,3,0.0,0.0,82040659,3,0
0,2,0.0,0.0,70597870,2,0
0,1,0.0,0.0,80165161,1,0
2,0,1.0,1.0,69212374,2,2
2,0,1.0,1.0,80176871,3,3
2,1,0.75,0.5,82250596,4,3
2,0,1.0,1.0,82250584,2,2
0,5,0.0,0.0,80128562,5,0
2,0,1.0,1.0,69470863,4,4
2,2,0.5,0.8,70245924,4,2
0,12,0.0,0.0,70941556,12,0
2,1,0.75,0.967741935483871,68655923,4,3
1,5,0.2857142857142857,0.6363636363636364,66257884,7,2
0,2,0.0,0.0,70682213,2,0
2,2,0.5,0.6666666666666666,62207880,4,2
1,3,0.4,0.5,70036211,5,2
0,10,0.23076923076923078,0.4166666666666667,80051566,13,3
2,0,1.0,1.0,72930935,1,1
0,1,0.0,0.0,70219331,1,0
1,3,0.25,0.6363636363636364,69061692,4,1
2,0,1.0,1.0,72804305,1,1
2,0,1.0,1.0,68520151,1,1
2,1,0.8,0.6666666666666666,70494193,5,4
2,3,0.5714285714285714,0.7142857142857143,70494235,7,4
2,0,1.0,1.0,66227973,3,3
1,3,0.4,0.6,67835180,5,2
0,1,0.0,0.0,73623235,1,0
0,3,0.0,0.0,67620931,3,0
2,1,0.8571428571428571,0.5,70406000,7,6
0,2,0.0,0.0,70744926,2,0
0,9,0.0,0.0,69311550,9,0
0,7,0.125,0.36363636363636365,69313083,8,1
2,0,1.0,1.0,82019825,4,4
1,3,0.25,0.9259259259259259,67094300,4,1
0,7,0.0,0.0,70573335,7,0
0,1,0.0,0.0,80165898,1,0
2,0,1.0,1.0,68459104,1,1
0,1,0.0,0.0,66459491,1,0
1,4,0.3333333333333333,0.875,66399060,6,2
2,2,0.5,0.9,65677990,4,2
2,7,0.5625,0.9545454545454546,79792510,16,9
0,3,0.0,0.0,67289971,3,0
0,10,0.09090909090909091,0.047619047619047616,69712216,11,1
0,1,0.0,0.0,66235645,1,0
2,1,0.5,0.0,80095071,2,1
0,5,0.0,0.0,82022527,5,0
2,1,0.8,0.5,67824225,5,4
2,1,0.5,0.6666666666666666,69185403,2,1
2,0,1.0,1.0,12970244,4,4
2,3,0.6666666666666666,0.75,67694613,9,6
0,1,0.0,0.0,63526911,1,0
2,0,1.0,1.0,69159412,4,4
1,3,0.4,0.8846153846153846,72801813,5,2
1,5,0.4444444444444444,0.8125,68519983,9,4
2,4,0.6363636363636364,0.9166666666666666,64196062,11,7
0,2,0.0,0.0,70697956,2,0
2,1,0.5,0.75,80150355,2,1
0,6,0.14285714285714285,0.4,69198451,7,1
0,1,0.0,0.0,68044613,1,0
1,3,0.25,0.5833333333333334,70843290,4,1
0,2,0.0,0.0,82205613,2,0
1,2,0.3333333333333333,0.8571428571428571,68805814,3,1
0,1,0.0,0.0,70703885,1,0
2,1,0.5,0.6666666666666666,70707182,2,1
0,5,0.16666666666666666,0.2777777777777778,68783484,6,1
2,1,0.8,0.5,69959225,5,4
0,3,0.25,0.4,71878485,4,1
2,3,0.5714285714285714,0.8888888888888888,80180178,7,4
0,4,0.0,0.0,82006631,4,0
0,3,0.0,0.0,80165760,3,0
0,3,0.0,0.0,80165766,3,0
0,4,0.0,0.0,67978043,4,0
0,2,0.0,0.0,66793762,2,0
0,3,0.0,0.0,80163168,3,0
1,10,0.16666666666666666,0.7631578947368421,80163381,12,2
2,9,0.5,0.8846153846153846,67799123,18,9
0,3,0.0,0.0,80165759,3,0
0,1,0.0,0.0,80056074,1,0
0,6,0.0,0.0,70467803,6,0
0,1,0.0,0.0,70917532,1,0
1,5,0.2857142857142857,0.8275862068965517,71618862,7,2
1,8,0.1111111111111111,0.55,62748196,9,1
0,9,0.1,0.47619047619047616,80172579,10,1
0,4,0.0,0.0,70481761,4,0
1,4,0.2,0.8571428571428571,82102528,5,1
0,2,0.0,0.0,70818321,2,0
1,3,0.25,0.7058823529411765,80172526,4,1
1,3,0.25,0.8571428571428571,65363823,4,1
0,2,0.0,0.0,80162896,2,0
0,4,0.0,0.0,70629643,4,0
0,1,0.0,0.0,70398972,1,0
2,1,0.6666666666666666,0.5,72411192,3,2
2,1,0.5,0.875,82010247,2,1
0,5,0.0,0.0,82019481,5,0
2,0,1.0,1.0,67786670,2,2
1,7,0.36363636363636365,0.8333333333333334,65282854,11,4
2,1,0.5,0.8571428571428571,73801665,2,1
0,5,0.16666666666666666,0.3125,73801672,6,1
0,1,0.0,0.0,70702933,1,0
1,15,0.11764705882352941,0.5692307692307692,70746592,17,2
2,0,1.0,1.0,82013519,1,1
1,4,0.3333333333333333,0.6666666666666666,80126756,6,2
1,5,0.375,0.7647058823529411,70646282,8,3
2,10,0.5238095238095238,0.9142857142857143,68645955,21,11
2,1,0.875,0.5,64038975,8,7
1,2,0.3333333333333333,0.5,66212013,3,1
0,7,0.2222222222222222,0.0,68401165,9,2
0,5,0.0,0.0,68546716,5,0
1,7,0.2222222222222222,0.6521739130434783,74086621,9,2
0,2,0.0,0.0,70680344,2,0
0,2,0.0,0.0,70696416,2,0
2,0,1.0,1.0,82023661,1,1
2,1,0.5,0.6666666666666666,82023669,2,1
2,1,0.6666666666666666,0.5,68474763,3,2
2,1,0.75,0.9,74027765,4,3
1,3,0.4,0.5,68907440,5,2
0,4,0.0,0.0,69693351,4,0
0,2,0.0,0.0,70696542,2,0
0,4,0.0,0.0,70696661,4,0
2,0,1.0,1.0,80132891,1,1
0,2,0.0,0.0,61266625,2,0
2,0,1.0,1.0,71619590,2,2
2,0,1.0,1.0,68394032,2,2
2,0,1.0,1.0,80126542,2,2
2,0,1.0,1.0,68805422,1,1
0,1,0.0,0.0,70674996,1,0
2,1,0.5,0.5,70675395,2,1
0,2,0.0,0.0,68164082,2,0
1,2,0.3333333333333333,0.8888888888888888,80136724,3,1
2,1,0.5,0.6666666666666666,65905000,2,1
1,2,0.3333333333333333,0.875,66930220,3,1
0,1,0.0,0.0,65293165,1,0
2,0,1.0,1.0,65942905,2,2
0,1,0.0,0.0,82016658,1,0
0,9,0.25,0.4,65280313,12,3
0,7,0.3,0.4117647058823529,68400801,10,3
1,2,0.3333333333333333,0.6666666666666666,82002289,3,1
2,0,1.0,1.0,71565046,2,2
0,1,0.0,0.0,69054930,1,0
2,0,1.0,1.0,66827313,1,1
2,3,0.5714285714285714,0.875,80151032,7,4
1,9,0.3076923076923077,0.5121951219512195,80136840,13,4
2,0,1.0,1.0,80159551,12,12
2,1,0.875,0.5,75265085,8,7
0,4,0.0,0.0,82024203,4,0
2,1,0.5,0.0,67248405,2,1
2,2,0.6,0.6666666666666666,66257562,5,3
2,0,1.0,1.0,82045541,5,5
2,1,0.5,0.0,80176443,2,1
1,6,0.14285714285714285,0.5,70719005,7,1
0,7,0.125,0.3103448275862069,80180261,8,1
2,1,0.5,0.5,70343385,2,1
2,0,1.0,1.0,67300240,1,1
0,2,0.0,0.0,68747462,2,0
1,5,0.2857142857142857,0.9166666666666666,68748645,7,2
2,0,1.0,1.0,70070735,3,3
2,1,0.6666666666666666,0.0,74165280,3,2
2,0,1.0,1.0,82039177,1,1
0,1,0.0,0.0,82020024,1,0
2,2,0.7777777777777778,0.75,80043026,9,7
2,1,0.5,0.6666666666666666,70488383,2,1
1,3,0.25,0.5625,70918141,4,1
2,2,0.7142857142857143,0.6666666666666666,82009531,7,5
2,1,0.5,0.5,70635075,2,1
0,3,0.0,0.0,66785936,3,0
1,8,0.1111111111111111,0.5172413793103449,66784375,9,1
0,5,0.0,0.0,61228734,5,0
1,8,0.1111111111111111,0.5,61228755,9,1
0,3,0.0,0.0,64045842,3,0
2,1,0.5,0.5,70758730,2,1
0,1,0.0,0.0,64457421,1,0
0,1,0.0,0.0,69693463,1,0
1,2,0.3333333333333333,0.8125,69693904,3,1
1,3,0.25,0.625,80145893,4,1
2,0,1.0,1.0,82137400,1,1
0,5,0.2857142857142857,0.4,80174908,7,2
2,1,0.8888888888888888,0.5,70750953,9,8
0,4,0.2,0.2222222222222222,67435774,5,1
1,12,0.14285714285714285,0.5652173913043478,80124361,14,2
0,7,0.0,0.0,70697424,7,0
2,0,1.0,1.0,80176416,2,2
0,2,0.0,0.0,62841821,2,0
1,6,0.3333333333333333,0.6666666666666666,70843794,9,3
0,2,0.3333333333333333,0.4,66101203,3,1
0,7,0.3,0.18181818181818182,61501713,10,3
2,0,1.0,1.0,80092985,1,1
2,1,0.5,0.5,69482980,2,1
2,0,1.0,1.0,70414372,1,1
2,1,0.5,0.5,67986800,2,1
0,2,0.0,0.0,74539325,2,0
2,1,0.5,0.6666666666666666,65281286,2,1
2,2,0.5,0.7777777777777778,65283001,4,2
2,0,1.0,1.0,82054747,1,1
1,5,0.16666666666666666,0.5454545454545454,70801766,6,1
0,3,0.0,0.0,73801623,3,0
0,4,0.2,0.45454545454545453,73801630,5,1
1,3,0.25,0.7,70701554,4,1
2,0,1.0,1.0,76941746,4,4
0,1,0.0,0.0,70761691,1,0
2,1,0.6666666666666666,0.5,70761901,3,2
2,1,0.5,0.5,70906885,2,1
0,2,0.0,0.0,70004984,2,0
2,3,0.5714285714285714,0.6666666666666666,69925275,7,4
2,1,0.75,0.5,68167764,4,3
2,0,1.0,1.0,72812390,1,1
1,3,0.25,0.6923076923076923,70692503,4,1
2,4,0.6363636363636364,0.75,66239061,11,7
0,14,0.06666666666666667,0.35135135135135137,73245704,15,1
2,0,1.0,1.0,82018705,3,3
0,4,0.0,0.0,70675220,4,0
0,9,0.1,0.3333333333333333,70677502,10,1
0,1,0.0,0.0,80126801,1,0
0,2,0.0,0.0,65282231,2,0
2,3,0.7,0.75,68060594,10,7
1,3,0.4,0.8571428571428571,70230174,5,2
0,3,0.0,0.0,68666703,3,0
0,1,0.0,0.0,69560575,1,0
0,5,0.0,0.0,68273464,5,0
2,0,1.0,1.0,82144700,2,2
0,3,0.0,0.0,70680694,3,0
0,7,0.0,0.0,80126795,7,0
2,0,1.0,1.0,70706825,1,1
2,0,1.0,1.0,80118387,1,1
0,7,0.0,0.0,82090196,7,0
0,8,0.0,0.0,82090197,8,0
2,1,0.6666666666666666,0.875,72804074,3,2
2,0,1.0,1.0,66227175,2,2
2,0,1.0,1.0,80158339,4,4
0,2,0.0,0.0,64235472,2,0
2,1,0.5,0.3333333333333333,74360335,2,1
2,1,0.6666666666666666,0.8571428571428571,82002321,3,2
1,6,0.3333333333333333,0.8,69699882,9,3
0,4,0.2,0.3,67298280,5,1
2,0,1.0,1.0,70713741,2,2
0,2,0.0,0.0,82119389,2,0
1,2,0.3333333333333333,0.875,69693694,3,1
0,3,0.0,0.0,80118287,3,0
2,0,1.0,1.0,65276820,1,1
0,1,0.0,0.0,70674086,1,0
0,3,0.0,0.0,70714014,3,0
1,3,0.4,0.7272727272727273,80149269,5,2
2,0,1.0,1.0,72802891,7,7
1,4,0.3333333333333333,0.625,80145416,6,2
1,2,0.3333333333333333,0.8333333333333334,80156040,3,1
0,2,0.0,0.0,82009533,2,0
2,0,1.0,1.0,66110296,1,1
2,1,0.5,0.5,72802044,2,1
2,1,0.5,0.0,69069210,2,1
0,1,0.0,0.0,68532156,1,0
0,1,0.0,0.0,67290083,1,0
0,3,0.0,0.0,70323043,3,0
0,4,0.0,0.0,80162889,4,0
0,4,0.0,0.0,70634634,4,0
0,8,0.1111111111111111,0.0967741935483871,82053041,9,1
2,3,0.5,0.9583333333333334,70398286,6,3
0,3,0.25,0.3333333333333333,74161143,4,1
1,4,0.3333333333333333,0.875,80163177,6,2
0,3,0.0,0.0,80150624,3,0
1,4,0.2,0.7692307692307693,80150657,5,1
0,7,0.0,0.0,70634893,7,0
0,8,0.0,0.0,80150715,8,0
2,1,0.6666666666666666,0.75,80118134,3,2
0,3,0.0,0.0,80137530,3,0
1,2,0.3333333333333333,0.6363636363636364,80162810,3,1
0,6,0.14285714285714285,0.2727272727272727,67195485,7,1
2,3,0.5,0.6666666666666666,72803724,6,3
2,0,1.0,1.0,67744663,9,9
0,1,0.0,0.0,78479800,1,0
2,0,1.0,1.0,65966005,1,1
1,2,0.3333333333333333,0.8666666666666667,70080353,3,1
2,0,1.0,1.0,68805415,1,1
0,4,0.0,0.0,69739313,4,0
2,0,1.0,1.0,82101057,1,1
0,2,0.0,0.0,82152078,2,0
2,0,1.0,1.0,80145786,1,1
2,1,0.5,0.75,72539964,2,1
0,1,0.0,0.0,72540286,1,0
1,5,0.16666666666666666,0.625,80128904,6,1
2,0,1.0,1.0,82020075,7,7
1,8,0.1111111111111111,0.5454545454545454,64232882,9,1
0,1,0.0,0.0,80057026,1,0
2,0,1.0,1.0,82020368,4,4
2,1,0.8333333333333334,0.5,69049960,6,5
2,1,0.5,0.6666666666666666,67779502,2,1
1,3,0.4,0.8,69895245,5,2
2,0,1.0,1.0,69499430,3,3
2,2,0.5,0.9411764705882353,82101567,4,2
0,2,0.0,0.0,70742910,2,0
0,1,0.0,0.0,69160245,1,0
0,1,0.0,0.0,66236590,1,0
2,1,0.6666666666666666,0.5,66256883,3,2
2,2,0.5,0.8461538461538461,79989644,4,2
2,0,1.0,1.0,68042940,1,1
0,1,0.0,0.0,65252614,1,0
0,1,0.0,0.0,82018672,1,0
2,1,0.6666666666666666,0.5,73588354,3,2
0,2,0.0,0.0,70675444,2,0
0,2,0.0,0.0,70680904,2,0
2,4,0.6923076923076923,0.9090909090909091,65279424,13,9
2,0,1.0,1.0,79843995,1,1
2,0,1.0,1.0,70688023,1,1
1,9,0.3076923076923077,0.6086956521739131,66802680,13,4
2,2,0.8181818181818182,0.8888888888888888,80152794,11,9
2,0,1.0,1.0,82102239,3,3
2,1,0.5,0.6666666666666666,68400703,2,1
2,0,1.0,1.0,82037589,2,2
2,1,0.5,0.75,69597241,2,1
1,4,0.42857142857142855,0.8888888888888888,80114825,7,3
2,2,0.5,0.8461538461538461,70843682,4,2
0,9,0.18181818181818182,0.4444444444444444,80054002,11,2
2,0,1.0,1.0,82052068,4,4
2,1,0.8333333333333334,0.5,82041270,6,5
2,0,1.0,1.0,16769620,12,12
2,0,1.0,1.0,80145845,1,1
2,2,0.7142857142857143,0.8,69518162,7,5
2,0,1.0,1.0,82102245,3,3
2,0,1.0,1.0,80161940,2,2
2,1,0.5,0.75,69478290,2,1
0,17,0.0,0.0,80132939,17,0
0,7,0.0,0.0,80132941,7,0
2,0,1.0,1.0,80161925,1,1
2,1,0.6666666666666666,0.8333333333333334,80128401,3,2
1,6,0.3333333333333333,0.7083333333333334,64260476,9,3
0,9,0.1,0.15151515151515152,70759206,10,1
1,6,0.14285714285714285,0.6190476190476191,66786160,7,1
0,1,0.0,0.0,82102889,1,0
2,2,0.8571428571428571,0.5,69158782,14,12
0,2,0.0,0.0,69561044,2,0
0,2,0.0,0.0,67800586,2,0
1,2,0.3333333333333333,0.6666666666666666,65543912,3,1
1,6,0.45454545454545453,0.9230769230769231,68520074,11,5
2,0,1.0,1.0,80018442,2,2
2,1,0.6666666666666666,0.6666666666666666,69152251,3,2
0,4,0.0,0.0,67132303,4,0
2,0,1.0,1.0,80178131,2,2
0,2,0.0,0.0,79792650,2,0
1,3,0.25,0.84,82205852,4,1
0,1,0.0,0.0,71938622,1,0
1,3,0.25,0.5,70693581,4,1
0,4,0.0,0.0,82019437,4,0
0,2,0.0,0.0,82019453,2,0
0,3,0.0,0.0,82152770,3,0
2,4,0.6,0.9166666666666666,82152785,10,6
0,10,0.16666666666666666,0.32727272727272727,70660366,12,2
2,0,1.0,1.0,60261782,10,10
2,1,0.6666666666666666,0.5,82037838,3,2
0,1,0.0,0.0,69611374,1,0
0,2,0.0,0.0,70697144,2,0
0,1,0.0,0.0,70697823,1,0
0,1,0.0,0.0,70704025,1,0
0,1,0.0,0.0,70705271,1,0
0,1,0.0,0.0,70198170,1,0
0,1,0.0,0.0,82250614,1,0
1,3,0.25,0.6,70699545,4,1
0,2,0.0,0.0,69599320,2,0
0,1,0.0,0.0,69599502,1,0
0,4,0.2,0.08333333333333333,70779485,5,1
0,11,0.0,0.0,67775176,11,0
2,1,0.8,0.5,82037237,5,4
0,7,0.125,0.3611111111111111,70697200,8,1
1,5,0.2857142857142857,0.75,66229240,7,2
2,0,1.0,1.0,69574463,1,1
0,4,0.3333333333333333,0.3,71619093,6,2
1,5,0.16666666666666666,0.6111111111111112,82206215,6,1
0,10,0.0,0.0,82158895,10,0
0,10,0.0,0.0,82158896,10,0
2,0,1.0,1.0,68773943,1,1
0,4,0.0,0.0,73295831,4,0
0,4,0.0,0.0,73859506,4,0
2,1,0.6666666666666666,0.6666666666666666,69490120,3,2
1,4,0.2,0.5714285714285714,62006910,5,1
0,4,0.0,0.0,70699951,4,0
2,0,1.0,1.0,61440554,3,3
0,1,0.0,0.0,67094230,1,0
2,1,0.5,0.6666666666666666,329133,2,1
0,9,0.1,0.0,67668811,10,1
2,0,1.0,1.0,62234620,1,1
0,6,0.14285714285714285,0.2,66115413,7,1
0,1,0.0,0.0,70720825,1,0
0,2,0.0,0.0,62791393,2,0
0,2,0.0,0.0,69634306,2,0
0,1,0.0,0.0,69634383,1,0
0,1,0.0,0.0,68283180,1,0
0,2,0.3333333333333333,0.4,65601410,3,1
2,3,0.6666666666666666,0.9428571428571428,80166919,9,6
0,1,0.0,0.0,66355590,1,0
2,0,1.0,1.0,80141405,2,2
1,3,0.25,0.8333333333333334,64470140,4,1
2,3,0.5714285714285714,0.9375,72813615,7,4
2,0,1.0,1.0,82020763,1,1
0,4,0.2,0.3333333333333333,61750731,5,1
2,0,1.0,1.0,80159548,5,5
0,1,0.0,0.0,68406016,1,0
0,1,0.0,0.0,80158295,1,0
0,5,0.0,0.0,82006678,5,0
1,2,0.3333333333333333,0.75,67434612,3,1
0,4,0.0,0.0,80172535,4,0
0,6,0.0,0.0,82006751,6,0
2,1,0.6666666666666666,0.6666666666666666,68227152,3,2
1,4,0.2,0.625,82006705,5,1
2,0,1.0,1.0,71619534,1,1
0,6,0.0,0.0,70635411,6,0
0,1,0.0,0.0,82006745,1,0
0,1,0.0,0.0,70916846,1,0
0,14,0.125,0.3076923076923077,70635334,16,2
0,4,0.0,0.0,80150587,4,0
0,2,0.0,0.0,80165876,2,0
1,6,0.14285714285714285,0.6451612903225806,80168237,7,1
0,2,0.0,0.0,80165776,2,0
1,2,0.3333333333333333,0.8947368421052632,67326784,3,1
0,6,0.0,0.0,70918225,6,0
1,4,0.42857142857142855,0.7857142857142857,82142128,7,3
0,5,0.0,0.0,71619436,5,0
0,1,0.0,0.0,68498724,1,0
0,5,0.16666666666666666,0.0,72759736,6,1
2,1,0.5,0.75,70713783,2,1
2,1,0.9090909090909091,0.8,590870,11,10
2,1,0.6666666666666666,0.8333333333333334,70850752,3,2
2,1,0.6666666666666666,0.6666666666666666,69390685,3,2
2,1,0.8888888888888888,0.5,66228666,9,8
0,3,0.0,0.0,82018931,3,0
0,6,0.0,0.0,82018933,6,0
2,0,1.0,1.0,70747376,1,1
2,0,1.0,1.0,70036953,1,1
2,5,0.7222222222222222,0.75,69840764,18,13
2,2,0.6,0.8333333333333334,69150760,5,3
0,1,0.0,0.0,70705320,1,0
0,11,0.15384615384615385,0.16129032258064516,70413035,13,2
2,0,1.0,1.0,69482875,1,1
2,1,0.5,0.8571428571428571,69407296,2,1
1,5,0.2857142857142857,0.8461538461538461,71434713,7,2
0,3,0.0,0.0,70705005,3,0
1,5,0.2857142857142857,0.75,69633242,7,2
0,2,0.0,0.0,70704151,2,0
0,8,0.2727272727272727,0.42424242424242425,70223916,11,3
1,2,0.3333333333333333,0.6666666666666666,74047414,3,1
2,0,1.0,1.0,82117686,2,2
2,0,1.0,1.0,70768320,1,1
2,5,0.5454545454545454,0.8333333333333334,73939670,11,6
2,2,0.5,0.8,64233582,4,2
2,2,0.5,0.6666666666666666,70395535,4,2
2,1,0.5,0.0,82022167,2,1
0,1,0.0,0.0,80169827,1,0
2,0,1.0,1.0,80004323,2,2
2,0,1.0,1.0,80139972,4,4
2,0,1.0,1.0,82175573,1,1
2,2,0.75,0.8,82096285,8,6
2,1,0.5,0.5,80056690,2,1
2,0,1.0,1.0,66090003,1,1
2,0,1.0,1.0,82041887,2,2
2,1,0.8,0.5,72803101,5,4
2,0,1.0,1.0,80176010,2,2
2,0,1.0,1.0,67248321,1,1
2,0,1.0,1.0,80159646,2,2
2,0,1.0,1.0,70183421,2,2
2,2,0.6,0.8888888888888888,80127707,5,3
0,1,0.0,0.0,67286254,1,0
2,1,0.8,0.5,81899335,5,4
0,11,0.08333333333333333,0.3888888888888889,67466630,12,1
2,0,1.0,1.0,80118177,3,3
1,8,0.2,0.6904761904761905,67466665,10,2
1,5,0.375,0.6666666666666666,73443930,8,3
0,3,0.0,0.0,69547786,3,0
1,7,0.125,0.58,66782772,8,1
0,2,0.0,0.0,66786783,2,0
0,2,0.0,0.0,66786790,2,0
0,1,0.0,0.0,70621824,1,0
0,1,0.0,0.0,70843472,1,0
1,4,0.3333333333333333,0.7692307692307693,73295950,6,2
2,0,1.0,1.0,79785874,2,2
2,4,0.5,0.0,70818923,8,4
0,1,0.0,0.0,73715530,1,0
0,5,0.2857142857142857,0.47368421052631576,79410065,7,2
0,2,0.0,0.0,67322780,2,0
0,3,0.0,0.0,67322815,3,0
2,2,0.5,0.8888888888888888,72803885,4,2
0,1,0.0,0.0,82018614,1,0
2,2,0.5,0.42857142857142855,82018675,4,2
2,2,0.5,0.8571428571428571,70693812,4,2
2,0,1.0,1.0,80163122,2,2
2,0,1.0,1.0,70593901,11,11
0,4,0.0,0.0,70677285,4,0
0,2,0.0,0.0,68402852,2,0
0,4,0.0,0.0,68402866,4,0
2,1,0.8333333333333334,0.75,67726932,6,5
0,4,0.0,0.0,66224655,4,0
2,0,1.0,1.0,68240172,1,1
0,3,0.25,0.4,70692594,4,1
0,2,0.0,0.0,65293081,2,0
2,0,1.0,1.0,61599832,2,2
1,8,0.3333333333333333,0.7,82159202,12,4
2,1,0.75,0.8333333333333334,68908224,4,3
1,2,0.3333333333333333,0.5714285714285714,70677411,3,1
2,1,0.5,0.5714285714285714,73632391,2,1
0,1,0.0,0.0,73801315,1,0
2,0,1.0,1.0,68749030,1,1
0,1,0.0,0.0,80085033,1,0
2,1,0.5,0.6666666666666666,82247753,2,1
0,3,0.0,0.0,67053700,3,0
0,3,0.0,0.0,70318031,3,0
0,1,0.0,0.0,68748463,1,0
0,5,0.0,0.0,70245903,5,0
0,1,0.0,0.0,68750381,1,0
0,3,0.25,0.35714285714285715,70701792,4,1
0,2,0.0,0.0,79678704,2,0
2,0,1.0,1.0,82038232,4,4
2,1,0.5,0.75,70699664,2,1
1,5,0.2857142857142857,0.6666666666666666,70691390,7,2
0,1,0.0,0.0,72802485,1,0
0,4,0.0,0.0,69581631,4,0
0,6,0.0,0.0,82003716,6,0
2,0,1.0,1.0,70314412,4,4
1,3,0.25,0.5,80163132,4,1
0,1,0.0,0.0,72493806,1,0
2,1,0.5,0.5,80137608,2,1
2,0,1.0,1.0,82061202,1,1
2,1,0.5,0.9411764705882353,82096302,2,1
0,1,0.0,0.0,64354500,1,0
2,0,1.0,1.0,80089373,3,3
0,1,0.0,0.0,66800601,1,0
2,2,0.75,0.6666666666666666,63970494,8,6
1,2,0.3333333333333333,0.6666666666666666,68032062,3,1
0,2,0.0,0.0,70701281,2,0
1,5,0.375,0.75,76941711,8,3
0,5,0.16666666666666666,0.20833333333333334,72808820,6,1
2,5,0.5454545454545454,0.9090909090909091,70658763,11,6
0,2,0.0,0.0,58855405,2,0
2,0,1.0,1.0,70182595,7,7
1,4,0.2,0.6666666666666666,73634554,5,1
2,2,0.7142857142857143,0.0,82019048,7,5
2,0,1.0,1.0,80136552,8,8
1,2,0.3333333333333333,0.6363636363636364,70919205,3,1
2,0,1.0,1.0,67744565,3,3
2,1,0.6666666666666666,0.8333333333333334,72803346,3,2
0,1,0.0,0.0,82102878,1,0
1,5,0.2857142857142857,0.6153846153846154,71618631,7,2
2,0,1.0,1.0,80139954,1,1
2,0,1.0,1.0,66823792,2,2
0,1,0.0,0.0,68805520,1,0
2,0,1.0,1.0,65330524,1,1
0,5,0.0,0.0,82006476,5,0
0,2,0.0,0.0,67834893,2,0
1,3,0.4,0.8571428571428571,74942525,5,2
0,7,0.0,0.0,67467596,7,0
0,3,0.0,0.0,82006860,3,0
0,2,0.0,0.0,67526844,2,0
0,2,0.0,0.0,68498941,2,0
0,4,0.0,0.0,68499095,4,0
0,4,0.0,0.0,68499130,4,0
0,3,0.0,0.0,68499312,3,0
0,2,0.0,0.0,68499375,2,0
1,3,0.25,0.64,68499403,4,1
0,5,0.0,0.0,69478381,5,0
0,2,0.0,0.0,82145128,2,0
2,1,0.6666666666666666,0.5,82060534,3,2
0,6,0.0,0.0,82090182,6,0
0,1,0.0,0.0,65908941,1,0
2,2,0.5,0.7142857142857143,64864422,4,2
0,12,0.07692307692307693,0.41818181818181815,82049110,13,1
2,1,0.75,0.5,66917473,4,3
1,3,0.25,0.8461538461538461,70743064,4,1
2,1,0.5,0.5,82110096,2,1
2,1,0.5,0.5,70843570,2,1
0,1,0.0,0.0,82024285,1,0
0,9,0.0,0.0,68784142,9,0
2,6,0.5384615384615384,0.9473684210526315,82011256,13,7
0,1,0.0,0.0,70967673,1,0
0,2,0.0,0.0,70467810,2,0
0,2,0.0,0.0,71588230,2,0
0,3,0.25,0.0,74046952,4,1
2,1,0.5,0.6666666666666666,69979525,2,1
0,1,0.0,0.0,70063770,1,0
0,11,0.0,0.0,82018907,11,0
0,1,0.0,0.0,69700960,1,0
2,0,1.0,1.0,82061921,2,2
1,8,0.38461538461538464,0.9090909090909091,70675500,13,5
2,0,1.0,1.0,66064544,1,1
2,3,0.625,0.8571428571428571,80056354,8,5
1,8,0.2,0.5128205128205128,69637771,10,2
2,1,0.75,0.5,80094441,4,3
2,3,0.625,0.5,68546982,8,5
0,1,0.0,0.0,80093860,1,0
2,1,0.5,0.0,65534532,2,1
1,5,0.16666666666666666,0.7567567567567568,69407072,6,1
0,2,0.0,0.0,73295691,2,0
0,3,0.0,0.0,69616722,3,0
2,0,1.0,1.0,70691334,1,1
2,1,0.8,0.5,74027905,5,4
2,0,1.0,1.0,66948392,1,1
0,8,0.0,0.0,80181788,8,0
0,1,0.0,0.0,69997984,1,0
2,0,1.0,1.0,81888449,4,4
2,1,0.5,0.5,70036890,2,1
2,1,0.5,0.5,74708921,2,1
2,5,0.7058823529411765,0.8888888888888888,79792643,17,12
2,0,1.0,1.0,82007553,9,9
2,1,0.75,0.5,82037171,4,3
2,0,1.0,1.0,80126591,1,1
2,0,1.0,1.0,82043221,2,2
2,1,0.9,0.5,82045539,10,9
2,0,1.0,1.0,66238396,3,3
2,0,1.0,1.0,82037308,1,1
2,0,1.0,1.0,82145154,1,1
2,0,1.0,1.0,82051757,4,4
2,0,1.0,1.0,82039321,6,6
2,0,1.0,1.0,80134850,1,1
2,0,1.0,1.0,76028960,2,2
2,0,1.0,1.0,82051900,2,2
2,1,0.5,0.5,82022953,2,1
2,0,1.0,1.0,82051754,6,6
2,3,0.625,0.8,64211105,8,5
2,0,1.0,1.0,64353485,4,4
1,3,0.4,0.8,82013575,5,2
2,2,0.5,0.8571428571428571,82145135,4,2
0,1,0.0,0.0,70684411,1,0
0,4,0.0,0.0,80010791,4,0
0,11,0.0,0.0,80163410,11,0
1,6,0.3333333333333333,0.7222222222222222,80168314,9,3
0,3,0.25,0.0,79816590,4,1
0,6,0.0,0.0,70621495,6,0
2,0,1.0,1.0,70699391,2,2
1,3,0.4,0.8125,70675332,5,2
0,2,0.0,0.0,80126754,2,0
2,0,1.0,1.0,70563283,1,1
1,8,0.3333333333333333,0.782608695652174,80118242,12,4
2,0,1.0,1.0,69980274,1,1
2,5,0.5,0.9230769230769231,74982523,10,5
2,1,0.5,0.6666666666666666,80150243,2,1
2,1,0.5,0.6,70691362,2,1
2,0,1.0,1.0,67656904,1,1
2,1,0.75,0.5,70063833,4,3
0,2,0.3333333333333333,0.25,67672430,3,1
2,1,0.6666666666666666,0.75,67428676,3,2
2,1,0.5,0.5,82022370,2,1
0,6,0.0,0.0,72809023,6,0
0,2,0.0,0.0,80123383,2,0
0,2,0.0,0.0,82024251,2,0
2,3,0.6666666666666666,0.9444444444444444,70925575,9,6
1,8,0.3333333333333333,0.5,70718893,12,4
1,6,0.14285714285714285,0.5454545454545454,64318751,7,1
0,2,0.0,0.0,74360741,2,0
0,5,0.2857142857142857,0.3333333333333333,80046120,7,2
0,7,0.0,0.0,70237860,7,0
0,11,0.08333333333333333,0.4166666666666667,70239316,12,1
0,6,0.0,0.0,70239400,6,0
0,2,0.0,0.0,67029445,2,0
0,3,0.0,0.0,70908362,3,0
1,4,0.42857142857142855,0.9333333333333333,80176837,7,3
0,1,0.0,0.0,70568463,1,0
2,1,0.5,0.5,82019928,2,1
0,2,0.0,0.0,67763514,2,0
2,2,0.6,0.75,79989434,5,3
0,3,0.0,0.0,70334845,3,0
0,4,0.0,0.0,70761544,4,0
2,0,1.0,1.0,69078534,1,1
2,1,0.5,0.8125,82009824,2,1
0,1,0.0,0.0,69069763,1,0
0,1,0.0,0.0,15012130,1,0
1,2,0.3333333333333333,0.6666666666666666,70702331,3,1
1,6,0.25,0.6666666666666666,80132916,8,2
0,4,0.0,0.0,65904923,4,0
2,2,0.6,0.3333333333333333,80128569,5,3
0,1,0.0,0.0,510286,1,0
0,1,0.0,0.0,69643175,1,0
0,7,0.2222222222222222,0.4444444444444444,82010272,9,2
0,3,0.0,0.0,70062531,3,0
2,0,1.0,1.0,70408002,6,6
2,0,1.0,1.0,74129440,1,1
2,1,0.8,0.6666666666666666,70813092,5,4
0,5,0.16666666666666666,0.2608695652173913,80121205,6,1
0,2,0.0,0.0,82143733,2,0
0,2,0.0,0.0,66110513,2,0
0,3,0.0,0.0,66110835,3,0
0,2,0.0,0.0,61751256,2,0
0,7,0.125,0.2647058823529412,69724186,8,1
0,3,0.0,0.0,82102375,3,0
0,12,0.14285714285714285,0.23529411764705882,70843584,14,2
0,3,0.0,0.0,80162654,3,0
1,4,0.2,0.5555555555555556,69093115,5,1
0,4,0.0,0.0,66973123,4,0
2,1,0.8,0.5,613991,5,4
2,1,0.6666666666666666,0.5,70629083,3,2
2,1,0.875,0.9090909090909091,70494795,8,7
2,2,0.6,0.8,68625060,5,3
1,4,0.2,0.78125,70238644,5,1
0,1,0.0,0.0,67322801,1,0
0,1,0.0,0.0,65502003,1,0
2,0,1.0,1.0,80118173,2,2
2,1,0.5,0.5,68060762,2,1
0,2,0.0,0.0,69701821,2,0
0,1,0.0,0.0,70109592,1,0
0,3,0.0,0.0,80126787,3,0
2,1,0.8333333333333334,0.6666666666666666,66864504,6,5
1,4,0.3333333333333333,0.7333333333333333,67993625,6,2
2,0,1.0,1.0,66379145,1,1
2,1,0.6666666666666666,0.5,68531106,3,2
0,1,0.0,0.0,65997575,1,0
1,6,0.3333333333333333,0.8695652173913043,82002254,9,3
0,2,0.0,0.0,67779376,2,0
0,2,0.0,0.0,66861676,2,0
0,16,0.15789473684210525,0.1,66855775,19,3
2,2,0.75,0.8888888888888888,67985652,8,6
2,1,0.8571428571428571,0.8333333333333334,82020092,7,6
1,4,0.3333333333333333,0.7272727272727273,67516582,6,2
0,1,0.0,0.0,71764210,1,0
0,1,0.0,0.0,68805674,1,0
2,1,0.6666666666666666,0.6666666666666666,68273765,3,2
0,3,0.0,0.0,79678690,3,0
1,5,0.2857142857142857,0.8378378378378378,64230796,7,2
0,5,0.0,0.0,82006482,5,0
2,1,0.5,0.6666666666666666,82006283,2,1
0,4,0.0,0.0,67359593,4,0
0,3,0.0,0.0,82102578,3,0
0,2,0.0,0.0,80162887,2,0
0,1,0.0,0.0,80173422,1,0
1,2,0.3333333333333333,0.8125,80172591,3,1
0,3,0.0,0.0,80162834,3,0
1,7,0.36363636363636365,0.875,69895854,11,4
0,1,0.0,0.0,82102856,1,0
0,2,0.0,0.0,82152441,2,0
0,8,0.0,0.0,80162868,8,0
0,2,0.0,0.0,80165863,2,0
0,2,0.0,0.0,71619583,2,0
0,4,0.0,0.0,82006641,4,0
0,3,0.0,0.0,82006663,3,0
0,2,0.0,0.0,70489321,2,0
2,0,1.0,1.0,68498794,1,1
1,4,0.42857142857142855,0.6470588235294118,67149103,7,3
0,1,0.0,0.0,82182766,1,0
2,1,0.5,0.0,69164571,2,1
2,0,1.0,1.0,80132899,4,4
0,9,0.25,0.2916666666666667,80135285,12,3
0,1,0.0,0.0,70699601,1,0
0,1,0.0,0.0,70701302,1,0
0,2,0.0,0.0,70702261,2,0
0,2,0.0,0.0,70703654,2,0
0,3,0.0,0.0,69006525,3,0
1,4,0.2,0.7666666666666667,71277605,5,1
2,0,1.0,1.0,82022401,2,2
2,1,0.5,0.8333333333333334,69633823,2,1
0,2,0.0,0.0,80128812,2,0
2,0,1.0,1.0,70492023,3,3
1,3,0.25,0.625,69596884,4,1
2,1,0.6666666666666666,0.5,82200587,3,2
0,3,0.25,0.4666666666666667,65290582,4,1
1,6,0.14285714285714285,0.64,68021723,7,1
0,4,0.0,0.0,80153538,4,0
0,4,0.0,0.0,67475324,4,0
1,5,0.2857142857142857,0.7142857142857143,80001803,7,2
1,4,0.3333333333333333,0.8727272727272727,70747964,6,2
0,5,0.2857142857142857,0.3,60900203,7,2
1,2,0.3333333333333333,0.85,70499660,3,1
2,1,0.6666666666666666,0.5,82064870,3,2
0,2,0.0,0.0,70185353,2,0
0,2,0.0,0.0,69311466,2,0
0,8,0.0,0.0,69311515,8,0
0,2,0.0,0.0,74087804,2,0
2,0,1.0,1.0,70712250,1,1
0,6,0.25,0.3333333333333333,70640101,8,2
2,1,0.6666666666666666,0.8,67067434,3,2
0,1,0.0,0.0,70238196,1,0
0,3,0.0,0.0,79953902,3,0
2,2,0.6666666666666666,0.6666666666666666,70189784,6,4
0,5,0.0,0.0,70682255,5,0
2,1,0.5,0.875,70399385,2,1
0,3,0.0,0.0,69467013,3,0
0,1,0.0,0.0,72472771,1,0
0,1,0.0,0.0,73623676,1,0
2,5,0.5833333333333334,0.4,80118330,12,7
1,2,0.3333333333333333,0.6363636363636364,66861690,3,1
2,1,0.6666666666666666,0.5,82039370,3,2
2,0,1.0,1.0,80018974,1,1
2,0,1.0,1.0,67245255,1,1
2,0,1.0,1.0,80176498,4,4
2,1,0.6666666666666666,0.6666666666666666,82013617,3,2
2,0,1.0,1.0,70279853,5,5
2,1,0.75,0.5,237650,4,3
2,0,1.0,1.0,67248202,2,2
2,7,0.5,0.7,71388044,14,7
2,1,0.75,0.5,366590,4,3
0,1,0.0,0.0,80132366,1,0
0,6,0.0,0.0,70476140,6,0
0,6,0.0,0.0,70183141,6,0
1,3,0.25,0.6,70183155,4,1
2,0,1.0,1.0,68755561,6,6
0,6,0.0,0.0,64041614,6,0
2,1,0.5,0.75,64458065,2,1
0,1,0.0,0.0,66203816,1,0
0,1,0.0,0.0,70700126,1,0
2,1,0.5,0.8,70493843,2,1
2,3,0.7,0.8333333333333334,69201454,10,7
1,4,0.2,0.6666666666666666,64192254,5,1
2,3,0.5714285714285714,0.9090909090909091,78266713,7,4
2,0,1.0,1.0,69482371,2,2
0,5,0.0,0.0,82018990,5,0
0,1,0.0,0.0,70706846,1,0
2,3,0.5,0.9230769230769231,70707581,6,3
2,1,0.5,0.6666666666666666,72804340,2,1
0,1,0.0,0.0,75048071,1,0
2,3,0.5714285714285714,0.875,72803010,7,4
0,2,0.0,0.0,70683942,2,0
2,2,0.5,0.8571428571428571,68543531,4,2
2,6,0.6,0.8,1064770,15,9
0,14,0.0,0.0,67455332,14,0
2,1,0.6666666666666666,0.5,71588202,3,2
1,5,0.2857142857142857,0.6666666666666666,668892,7,2
0,5,0.0,0.0,65509871,5,0
2,0,1.0,1.0,80160080,1,1
2,0,1.0,1.0,80165381,2,2
1,11,0.42105263157894735,0.8148148148148148,72803234,19,8
0,2,0.0,0.0,80121037,2,0
0,3,0.0,0.0,70908285,3,0
0,2,0.0,0.0,70585690,2,0
2,1,0.5,0.5,82018716,2,1
2,5,0.5,0.8888888888888888,80176693,10,5
0,4,0.0,0.0,69596954,4,0
1,3,0.25,0.6666666666666666,80124353,4,1
0,2,0.0,0.0,70343364,2,0
0,2,0.0,0.0,68544770,2,0
0,3,0.0,0.0,69479613,3,0
0,1,0.0,0.0,66235253,1,0
2,0,1.0,1.0,69055574,1,1
2,0,1.0,1.0,80159659,4,4
0,7,0.0,0.0,68356421,7,0
2,0,1.0,1.0,82043123,1,1
1,5,0.2857142857142857,0.8333333333333334,66224795,7,2
2,0,1.0,1.0,80141389,1,1
0,9,0.0,0.0,41860,9,0
2,0,1.0,1.0,82033534,3,3
0,6,0.14285714285714285,0.19230769230769232,65281083,7,1
2,1,0.6666666666666666,0.5,69698055,3,2
0,2,0.0,0.0,82010283,2,0
0,1,0.0,0.0,82222803,1,0
2,0,1.0,1.0,80162573,1,1
1,11,0.15384615384615385,0.546875,69143305,13,2
2,2,0.6666666666666666,0.8,70536746,6,4
2,0,1.0,1.0,72814084,2,2
2,1,0.75,0.5,67824211,4,3
2,1,0.5,0.5,68475442,2,1
0,5,0.16666666666666666,0.3888888888888889,82152771,6,1
2,0,1.0,1.0,69966533,5,5
1,5,0.16666666666666666,0.6666666666666666,69311473,6,1
2,1,0.8571428571428571,0.6666666666666666,67744306,7,6
2,0,1.0,1.0,73390072,19,19
0,1,0.0,0.0,80139941,1,0
0,13,0.07142857142857142,0.44,70489174,14,1
2,4,0.7894736842105263,0.8571428571428571,69055140,19,15
2,0,1.0,1.0,68556355,1,1
0,3,0.0,0.0,66253131,3,0
0,1,0.0,0.0,69544685,1,0
0,3,0.25,0.30434782608695654,82018921,4,1
0,9,0.0,0.0,70680400,9,0
0,6,0.14285714285714285,0.48717948717948717,69153161,7,1
0,1,0.0,0.0,70680561,1,0
0,3,0.0,0.0,69072185,3,0
0,1,0.0,0.0,68498486,1,0
0,1,0.0,0.0,69479270,1,0
2,0,1.0,1.0,80156390,1,1
1,4,0.3333333333333333,0.8709677419354839,70417081,6,2
0,4,0.0,0.0,70238231,4,0
0,2,0.0,0.0,69948375,2,0
2,2,0.5,0.8,69707946,4,2
0,2,0.0,0.0,70699363,2,0
2,0,1.0,1.0,79453171,3,3
0,12,0.0,0.0,73411926,12,0
1,5,0.375,0.6,80176254,8,3
0,3,0.0,0.0,67516316,3,0
0,4,0.2,0.29411764705882354,82010324,5,1
2,0,1.0,1.0,82019831,2,2
0,2,0.0,0.0,66998596,2,0
2,2,0.6,0.75,68281843,5,3
1,2,0.3333333333333333,0.5714285714285714,73634673,3,1
2,1,0.5,0.9333333333333333,82102751,2,1
0,1,0.0,0.0,68198984,1,0
0,2,0.0,0.0,82018972,2,0
2,1,0.6666666666666666,0.5,80165824,3,2
0,3,0.0,0.0,69910281,3,0
0,3,0.0,0.0,82102476,3,0
0,1,0.0,0.0,82102481,1,0
1,3,0.4,0.8571428571428571,82102636,5,2
2,2,0.7777777777777778,0.875,66258122,9,7
2,0,1.0,1.0,82018720,2,2
2,0,1.0,1.0,68254585,1,1
2,4,0.7142857142857143,0.8,77318892,14,10
0,2,0.0,0.0,80053624,2,0
0,10,0.23076923076923078,0.375,80003224,13,3
2,1,0.5,0.6666666666666666,82022333,2,1
0,1,0.0,0.0,80176346,1,0
0,5,0.16666666666666666,0.35,66202206,6,1
2,2,0.5,0.8888888888888888,72706116,4,2
0,3,0.0,0.0,66785222,3,0
0,2,0.0,0.0,72918741,2,0
0,4,0.0,0.0,78762950,4,0
0,2,0.0,0.0,65547650,2,0
2,0,1.0,1.0,63992782,2,2
2,0,1.0,1.0,82015766,2,2
2,0,1.0,1.0,66379425,2,2
1,6,0.25,0.5,67405030,8,2
0,4,0.0,0.0,70679070,4,0
0,2,0.0,0.0,70693875,2,0
2,7,0.5333333333333333,0.8333333333333334,80019492,15,8
2,1,0.5,0.5,70527443,2,1
2,1,0.6666666666666666,0.5,70675423,3,2
2,1,0.5,0.5,82108144,2,1
0,1,0.0,0.0,68254620,1,0
0,1,0.0,0.0,73102862,1,0
0,1,0.0,0.0,67667131,1,0
0,10,0.23076923076923078,0.2916666666666667,66930465,13,3
2,1,0.5,0.6666666666666666,69021750,2,1
0,2,0.0,0.0,62838622,2,0
2,1,0.5,0.6666666666666666,82002267,2,1
0,1,0.0,0.0,72909781,1,0
2,2,0.5,0.3333333333333333,80019331,4,2
2,1,0.8,0.5,74965611,5,4
2,0,1.0,1.0,80141343,1,1
2,1,0.8333333333333334,0.0,80159566,6,5
2,0,1.0,1.0,73245795,5,5
2,2,0.6,0.75,80018260,5,3
2,5,0.5,0.8823529411764706,80019072,10,5
2,0,1.0,1.0,75362175,3,3
2,0,1.0,1.0,73652362,2,2
2,1,0.6666666666666666,0.75,69185424,3,2
2,0,1.0,1.0,66229611,1,1
2,0,1.0,1.0,82113160,1,1
2,0,1.0,1.0,82125489,1,1
2,0,1.0,1.0,82046081,1,1
2,0,1.0,1.0,69878872,2,2
0,2,0.0,0.0,80135038,2,0
2,0,1.0,1.0,69334202,1,1
2,1,0.5,0.5,70407603,2,1
2,1,0.5,0.5,80128326,2,1
0,1,0.0,0.0,70692755,1,0
0,1,0.0,0.0,70694666,1,0
0,1,0.0,0.0,70239064,1,0
2,1,0.5,0.5,69482945,2,1
2,0,1.0,1.0,67801433,2,2
0,4,0.0,0.0,70252644,4,0
0,4,0.2,0.23076923076923078,66782002,5,1
0,10,0.0,0.0,66783514,10,0
2,4,0.6363636363636364,0.875,563416,11,7
0,4,0.0,0.0,66998610,4,0
1,16,0.4838709677419355,0.90625,71783754,31,15
0,3,0.0,0.0,80124799,3,0
2,0,1.0,1.0,82201008,6,6
2,1,0.5,0.75,69983620,2,1
0,2,0.0,0.0,70682332,2,0
0,4,0.0,0.0,70693434,4,0
2,1,0.75,0.6666666666666666,79453101,4,3
2,0,1.0,1.0,80156836,1,1
2,0,1.0,1.0,67663050,1,1
0,6,0.14285714285714285,0.25,69509020,7,1
0,2,0.0,0.0,70704312,2,0
0,3,0.0,0.0,70683032,3,0
1,2,0.3333333333333333,0.6,70216755,3,1
2,1,0.5,0.75,67344690,2,1
2,0,1.0,1.0,82018613,1,1
2,0,1.0,1.0,68747126,3,3
0,3,0.0,0.0,69064093,3,0
0,4,0.0,0.0,76340915,4,0
2,0,1.0,1.0,70492114,1,1
0,4,0.0,0.0,68649252,4,0
0,2,0.0,0.0,70761775,2,0
0,2,0.3333333333333333,0.0,75327210,3,1
2,1,0.8,0.9090909090909091,80180268,5,4
2,3,0.7,0.6666666666666666,80094175,10,7
2,1,0.6666666666666666,0.6666666666666666,82013604,3,2
2,2,0.5,0.75,68366781,4,2
2,0,1.0,1.0,70585802,5,5
2,2,0.6,0.9090909090909091,72522961,5,3
2,0,1.0,1.0,68436914,5,5
2,0,1.0,1.0,80159208,2,2
2,1,0.5,0.5,79989441,2,1
0,5,0.16666666666666666,0.4,70527422,6,1
0,1,0.0,0.0,69887531,1,0
0,2,0.3333333333333333,0.42857142857142855,69538791,3,1
0,2,0.0,0.0,80158325,2,0
0,1,0.0,0.0,82022430,1,0
2,1,0.75,0.6666666666666666,66253544,4,3
2,0,1.0,1.0,82039405,2,2
1,3,0.4,0.6,80165800,5,2
2,1,0.6666666666666666,0.5,69187244,3,2
2,0,1.0,1.0,71878534,1,1
2,2,0.5,0.6,82042677,4,2
0,2,0.0,0.0,70801724,2,0
2,1,0.6666666666666666,0.875,82182787,3,2
0,2,0.0,0.0,68229084,2,0
0,11,0.15384615384615385,0.275,82002261,13,2
2,0,1.0,1.0,82009403,9,9
1,4,0.3333333333333333,0.7692307692307693,80141468,6,2
1,6,0.45454545454545453,0.9411764705882353,65282511,11,5
0,8,0.0,0.0,66264590,8,0
0,2,0.0,0.0,67779453,2,0
0,1,0.0,0.0,67779530,1,0
0,1,0.0,0.0,67779544,1,0
0,2,0.0,0.0,68544896,2,0
2,1,0.5,0.6666666666666666,82145507,2,1
0,1,0.0,0.0,66237871,1,0
2,1,0.8571428571428571,0.5,17374,7,6
0,5,0.16666666666666666,0.041666666666666664,69726412,6,1
2,1,0.75,0.6666666666666666,67822496,4,3
2,6,0.5384615384615384,0.625,82009580,13,7
2,0,1.0,1.0,70623826,3,3
2,1,0.6666666666666666,0.6666666666666666,70926415,3,2
1,4,0.3333333333333333,0.6666666666666666,82041863,6,2
0,2,0.0,0.0,70678223,2,0
0,2,0.0,0.0,70251643,2,0
2,3,0.5,0.8571428571428571,80159643,6,3
2,0,1.0,1.0,65293130,1,1
0,1,0.0,0.0,69735834,1,0
0,7,0.0,0.0,72775101,7,0
2,1,0.6666666666666666,0.8,590926,3,2
0,3,0.0,0.0,74776856,3,0
0,2,0.0,0.0,66382400,2,0
0,2,0.0,0.0,67837994,2,0
2,1,0.6666666666666666,0.5,69412623,3,2
0,2,0.0,0.0,68544735,2,0
0,2,0.0,0.0,82019440,2,0
0,2,0.0,0.0,68531645,2,0
2,0,1.0,1.0,82019870,2,2
2,0,1.0,1.0,70698733,4,4
1,2,0.3333333333333333,0.5,69954374,3,1
0,1,0.0,0.0,70417571,1,0
1,3,0.25,0.6,75883115,4,1
2,2,0.5,0.8333333333333334,80162856,4,2
0,11,0.0,0.0,80150850,11,0
0,4,0.0,0.0,80168248,4,0
0,2,0.0,0.0,80162899,2,0
0,2,0.0,0.0,82102568,2,0
0,1,0.0,0.0,82006707,1,0
0,4,0.0,0.0,80162835,4,0
0,2,0.0,0.0,82006329,2,0
0,3,0.0,0.0,82006349,3,0
0,5,0.0,0.0,64462986,5,0
0,2,0.0,0.0,69879110,2,0
0,2,0.0,0.0,70635166,2,0
1,6,0.3333333333333333,0.8918918918918919,70343595,9,3
2,1,0.5,0.75,82006877,2,1
0,4,0.0,0.0,75342134,4,0
0,1,0.0,0.0,70322952,1,0
1,8,0.2,0.7105263157894737,82118234,10,2
2,2,0.5,0.8,74924395,4,2
2,0,1.0,1.0,67130112,1,1
0,3,0.0,0.0,70701442,3,0
2,0,1.0,1.0,80161962,2,2
0,2,0.3333333333333333,0.42857142857142855,68159063,3,1
0,1,0.0,0.0,69633872,1,0
2,0,1.0,1.0,69712685,1,1
2,2,0.5,0.875,66844540,4,2
0,7,0.2222222222222222,0.30434782608695654,69135080,9,2
1,2,0.3333333333333333,0.6,80126889,3,1
0,3,0.0,0.0,70699013,3,0
0,4,0.0,0.0,82024274,4,0
2,4,0.5,0.9130434782608695,82152767,8,4
0,6,0.14285714285714285,0.2962962962962963,70844081,7,1
0,2,0.0,0.0,82023109,2,0
0,4,0.0,0.0,70697564,4,0
2,1,0.5,0.6666666666666666,80131308,2,1
2,1,0.5,0.9285714285714286,82021469,2,1
1,7,0.4166666666666667,0.9375,68401571,12,5
0,2,0.0,0.0,80124355,2,0
2,3,0.625,0.5,72417891,8,5
0,1,0.0,0.0,82090223,1,0
2,1,0.5,0.3333333333333333,69876450,2,1
1,4,0.3333333333333333,0.5714285714285714,69573350,6,2
0,1,0.0,0.0,70229950,1,0
2,0,1.0,1.0,82102238,2,2
2,2,0.5,0.75,80177558,4,2
2,1,0.5,0.5,69948410,2,1
2,0,1.0,1.0,70746634,2,2
2,1,0.8,0.75,69483463,5,4
0,11,0.21428571428571427,0.23809523809523808,70037352,14,3
1,9,0.47058823529411764,0.7777777777777778,82043177,17,8
2,0,1.0,1.0,70513842,1,1
2,0,1.0,1.0,80136533,2,2
2,0,1.0,1.0,82025188,1,1
2,0,1.0,1.0,70687085,2,2
2,1,0.5,0.3333333333333333,70747446,2,1
0,1,0.0,0.0,70747593,1,0
0,9,0.1,0.08333333333333333,70037534,10,1
2,1,0.75,0.5,80159745,4,3
2,1,0.6666666666666666,0.6666666666666666,54413114,3,2
2,0,1.0,1.0,82095221,2,2
2,1,0.5,0.0,80053484,2,1
2,0,1.0,1.0,82054735,2,2
2,1,0.6666666666666666,0.5,69604703,3,2
2,0,1.0,1.0,73651004,1,1
2,1,0.5,0.5,69640620,2,1
0,3,0.0,0.0,69134212,3,0
0,5,0.0,0.0,80149789,5,0
0,6,0.0,0.0,69525701,6,0
0,8,0.2,0.48484848484848486,70634683,10,2
1,9,0.35714285714285715,0.6428571428571429,80155209,14,5
2,0,1.0,1.0,66235792,1,1
0,3,0.0,0.0,68631696,3,0
2,2,0.6,0.6666666666666666,80118267,5,3
2,1,0.75,0.9545454545454546,69712461,4,3
2,0,1.0,1.0,80118243,1,1
1,9,0.3076923076923077,0.7636363636363637,70494802,13,4
0,2,0.0,0.0,82019460,2,0
2,0,1.0,1.0,17853528,4,4
1,3,0.4,0.8666666666666667,68391505,5,2
0,2,0.0,0.0,80122846,2,0
0,3,0.0,0.0,80123389,3,0
0,1,0.0,0.0,69640270,1,0
0,3,0.0,0.0,69640592,3,0
1,5,0.2857142857142857,0.6666666666666666,70760452,7,2
0,7,0.0,0.0,69064184,7,0
1,5,0.16666666666666666,0.5333333333333333,72775213,6,1
0,2,0.0,0.0,65283022,2,0
2,1,0.5,0.5,68341924,2,1
0,2,0.0,0.0,69693295,2,0
2,3,0.5,0.8571428571428571,82018677,6,3
2,0,1.0,1.0,70036246,2,2
2,2,0.6,0.8571428571428571,74432925,5,3
0,1,0.0,0.0,73632461,1,0
0,6,0.0,0.0,70682234,6,0
0,3,0.0,0.0,70704865,3,0
0,4,0.0,0.0,70699986,4,0
1,4,0.3333333333333333,0.8648648648648649,68500152,6,2
2,1,0.5,0.75,68560751,2,1
0,2,0.0,0.0,70703122,2,0
0,3,0.0,0.0,70704620,3,0
2,0,1.0,1.0,82059895,2,2
0,3,0.25,0.2,82167861,4,1
2,2,0.5,0.8,65279445,4,2
0,5,0.0,0.0,69596394,5,0
2,0,1.0,1.0,70602994,1,1
0,1,0.0,0.0,65931866,1,0
2,0,1.0,1.0,65949394,4,4
0,2,0.0,0.0,79466065,2,0
2,1,0.6666666666666666,0.75,68461631,3,2
0,1,0.0,0.0,63317583,1,0
0,4,0.2,0.0,69997872,5,1
2,0,1.0,1.0,80139930,1,1
2,1,0.6666666666666666,0.5,67831561,3,2
2,1,0.75,0.5,82013524,4,3
0,7,0.125,0.3684210526315789,82206217,8,1
0,3,0.0,0.0,70703976,3,0
0,3,0.0,0.0,70707245,3,0
0,1,0.0,0.0,71081815,1,0
0,15,0.0,0.0,80121203,15,0
2,1,0.6666666666666666,0.8,69538980,3,2
2,0,1.0,1.0,82037887,1,1
0,3,0.0,0.0,65279914,3,0
1,5,0.16666666666666666,0.5,70081354,6,1
2,2,0.5,0.8333333333333334,82200541,4,2
1,4,0.3333333333333333,0.8181818181818182,68338711,6,2
1,3,0.25,0.6,70679350,4,1
0,6,0.0,0.0,70679826,6,0
2,0,1.0,1.0,82024326,1,1
0,1,0.0,0.0,80105165,1,0
1,2,0.3333333333333333,0.6666666666666666,70703794,3,1
2,0,1.0,1.0,82019839,1,1
0,4,0.0,0.0,80126790,4,0
2,1,0.75,0.5,80118253,4,3
0,3,0.0,0.0,70692090,3,0
2,1,0.5,0.8333333333333334,68147436,2,1
0,3,0.25,0.3333333333333333,69498912,4,1
0,4,0.0,0.0,67730124,4,0
2,0,1.0,1.0,80003644,4,4
2,0,1.0,1.0,80178176,1,1
2,0,1.0,1.0,80131364,3,3
0,4,0.0,0.0,70568435,4,0
1,7,0.46153846153846156,0.7333333333333333,82172727,13,6
0,2,0.0,0.0,80130689,2,0
0,1,0.0,0.0,68159350,1,0
0,1,0.0,0.0,70469070,1,0
0,5,0.0,0.0,82090195,5,0
0,6,0.0,0.0,82090198,6,0
0,7,0.0,0.0,82090199,7,0
2,1,0.75,0.8,80128025,4,3
1,4,0.42857142857142855,0.6923076923076923,72417884,7,3
0,2,0.0,0.0,82118253,2,0
0,2,0.0,0.0,69911730,2,0
0,1,0.0,0.0,82006324,1,0
0,1,0.0,0.0,67797170,1,0
0,3,0.0,0.0,73459932,3,0
0,1,0.0,0.0,64351392,1,0
0,1,0.0,0.0,70482181,1,0
2,1,0.5,0.75,82118263,2,1
0,8,0.0,0.0,64149001,8,0
0,2,0.0,0.0,80150536,2,0
1,4,0.2,0.5217391304347826,80156306,5,1
0,4,0.0,0.0,82102551,4,0
0,4,0.2,0.25,74089316,5,1
0,2,0.0,0.0,82006250,2,0
0,1,0.0,0.0,82006266,1,0
2,1,0.5,0.6666666666666666,82052037,2,1
0,1,0.0,0.0,67311440,1,0
0,3,0.0,0.0,70680484,3,0
0,1,0.0,0.0,70682220,1,0
2,2,0.5,0.75,65991646,4,2
1,4,0.2,0.7368421052631579,69158831,5,1
0,3,0.25,0.1,80126947,4,1
2,0,1.0,1.0,82025183,2,2
0,1,0.0,0.0,68540906,1,0
1,4,0.3333333333333333,0.9090909090909091,70621635,6,2
0,4,0.0,0.0,80150278,4,0
0,1,0.0,0.0,70686105,1,0
0,1,0.0,0.0,70692685,1,0
2,1,0.8333333333333334,0.5,78286915,6,5
2,2,0.5,0.8,65291506,4,2
0,8,0.0,0.0,82102887,8,0
0,2,0.0,0.0,65977310,2,0
1,2,0.3333333333333333,0.9285714285714286,67626853,3,1
2,2,0.6666666666666666,0.8,66588424,6,4
1,5,0.2857142857142857,0.7142857142857143,70693973,7,2
1,3,0.25,0.7142857142857143,82018678,4,1
0,10,0.16666666666666666,0.375,63992705,12,2
0,1,0.0,0.0,67755023,1,0
0,2,0.3333333333333333,0.35714285714285715,66232866,3,1
0,4,0.2,0.4090909090909091,70524454,5,1
2,2,0.75,0.9411764705882353,70509250,8,6
0,8,0.1111111111111111,0.16,69582940,9,1
1,4,0.2,0.5833333333333334,80083381,5,1
0,2,0.3333333333333333,0.2857142857142857,69483995,3,1
0,4,0.0,0.0,80176839,4,0
0,4,0.0,0.0,72697870,4,0
0,5,0.16666666666666666,0.0,73588935,6,1
1,4,0.3333333333333333,0.8571428571428571,70459193,6,2
2,3,0.5714285714285714,0.8888888888888888,68047861,7,4
2,0,1.0,1.0,70801773,1,1
2,1,0.8571428571428571,0.8333333333333334,67744712,7,6
0,2,0.0,0.0,65933196,2,0
2,1,0.6666666666666666,0.8571428571428571,69587910,3,2
2,0,1.0,1.0,80003651,1,1
0,2,0.0,0.0,69101781,2,0
2,0,1.0,1.0,82054034,1,1
2,1,0.6666666666666666,0.5,69389460,3,2
2,0,1.0,1.0,72445751,2,2
0,4,0.0,0.0,70175175,4,0
0,6,0.0,0.0,66257842,6,0
2,4,0.5,0.875,80118179,8,4
2,0,1.0,1.0,82110456,1,1
1,3,0.25,0.5882352941176471,69100794,4,1
2,4,0.6666666666666666,0.8,82051904,12,8
0,2,0.3333333333333333,0.4,68546590,3,1
2,1,0.5,0.8,70702716,2,1
2,1,0.875,0.5,79792412,8,7
2,0,1.0,1.0,67256161,1,1
1,2,0.3333333333333333,0.6363636363636364,82024302,3,1
2,1,0.5,0.5,82013587,2,1
2,0,1.0,1.0,82047593,1,1
2,0,1.0,1.0,80159554,12,12
0,2,0.3333333333333333,0.0,80019345,3,1
0,1,0.0,0.0,82039434,1,0
1,2,0.3333333333333333,0.6,69110692,3,1
2,2,0.75,0.5,80043012,8,6
1,2,0.3333333333333333,0.8333333333333334,70238980,3,1
0,3,0.0,0.0,80149783,3,0
2,0,1.0,1.0,82019441,1,1
0,10,0.0,0.0,80126815,10,0
2,1,0.5,0.6666666666666666,68747560,2,1
2,0,1.0,1.0,69391861,3,3
0,22,0.043478260869565216,0.4195804195804196,66025064,23,1
2,0,1.0,1.0,82206016,1,1
2,4,0.5,0.9230769230769231,64046003,8,4
0,22,0.18518518518518517,0.3142857142857143,70209531,27,5
0,9,0.1,0.11428571428571428,80003210,10,1
1,5,0.2857142857142857,0.8292682926829268,66816883,7,2
2,2,0.6,0.6666666666666666,67066755,5,3
1,4,0.3333333333333333,0.8214285714285714,69228236,6,2
0,2,0.0,0.0,66402420,2,0
2,0,1.0,1.0,68015444,2,2
2,0,1.0,1.0,82144706,2,2
2,4,0.5,0.875,71588076,8,4
2,2,0.5,0.5,66233006,4,2
0,1,0.0,0.0,82102749,1,0
0,3,0.0,0.0,65277870,3,0
0,4,0.2,0.3333333333333333,72692060,5,1
2,0,1.0,1.0,82024245,1,1
2,2,0.7142857142857143,0.875,64191820,7,5
0,1,0.0,0.0,82163434,1,0
0,3,0.0,0.0,69044675,3,0
0,1,0.0,0.0,68987142,1,0
1,2,0.3333333333333333,0.6923076923076923,71215032,3,1
0,7,0.0,0.0,70681261,7,0
0,6,0.14285714285714285,0.05555555555555555,80019100,7,1
1,2,0.3333333333333333,0.6666666666666666,70803103,3,1
2,4,0.5,0.9090909090909091,74776863,8,4
0,1,0.0,0.0,69866034,1,0
2,1,0.5,0.5,69866055,2,1
2,3,0.5,0.3333333333333333,66257170,6,3
2,2,0.6,0.6666666666666666,66257814,5,3
2,1,0.5,0.75,63279531,2,1
2,1,0.5,0.5,69226444,2,1
2,2,0.5,0.75,66827845,4,2
0,1,0.0,0.0,82110216,1,0
2,1,0.5,0.75,80150344,2,1
2,2,0.5,0.6,80130703,4,2
0,4,0.0,0.0,80159200,4,0
0,10,0.16666666666666666,0.3225806451612903,66035165,12,2
2,2,0.5,0.8,70926436,4,2
2,1,0.75,0.5,80095232,4,3
0,1,0.0,0.0,69634215,1,0
0,2,0.0,0.0,66235722,2,0
2,0,1.0,1.0,67270406,4,4
0,4,0.2,0.25,65279473,5,1
0,1,0.0,0.0,64982526,1,0
2,3,0.5,0.9583333333333334,80128183,6,3
0,2,0.0,0.0,66469935,2,0
2,2,0.5,0.6666666666666666,70861882,4,2
0,3,0.0,0.0,70705936,3,0
2,0,1.0,1.0,82070151,1,1
2,0,1.0,1.0,82105393,1,1
1,6,0.25,0.5769230769230769,72909774,8,2
2,0,1.0,1.0,80134203,1,1
0,1,0.0,0.0,70635320,1,0
1,6,0.25,0.6363636363636364,66372565,8,2
0,2,0.0,0.0,80172639,2,0
0,3,0.0,0.0,80150561,3,0
0,2,0.0,0.0,69736345,2,0
0,2,0.0,0.0,80089135,2,0
1,8,0.2727272727272727,0.6666666666666666,70821604,11,3
0,11,0.0,0.0,82049101,11,0
0,8,0.0,0.0,80150689,8,0
0,1,0.0,0.0,70821464,1,0
0,1,0.0,0.0,82118260,1,0
2,3,0.5,0.7142857142857143,70821492,6,3
0,2,0.0,0.0,80172554,2,0
0,3,0.0,0.0,80172570,3,0
1,2,0.3333333333333333,0.6,67667082,3,1
0,3,0.0,0.0,69100696,3,0
2,0,1.0,1.0,80165230,1,1
0,5,0.0,0.0,70489503,5,0
0,4,0.0,0.0,70745983,4,0
0,20,0.0,0.0,70746130,20,0
0,2,0.0,0.0,70746403,2,0
0,21,0.0,0.0,70746424,21,0
1,4,0.3333333333333333,0.6666666666666666,67844490,6,2
0,6,0.0,0.0,70678055,6,0
1,3,0.4,0.8333333333333334,71081871,5,2
0,3,0.4,0.4,69152615,5,2
0,1,0.0,0.0,79976505,1,0
2,2,0.6,0.875,80118331,5,3
2,1,0.5,0.5,80092341,2,1
2,2,0.5,0.6666666666666666,80141392,4,2
0,2,0.0,0.0,82018730,2,0
1,5,0.375,0.8666666666666667,74086761,8,3
0,5,0.16666666666666666,0.2222222222222222,80128042,6,1
0,4,0.0,0.0,66365005,4,0
0,3,0.0,0.0,69701163,3,0
2,1,0.5,0.5,68572350,2,1
0,4,0.2,0.36363636363636365,82024294,5,1
0,3,0.4,0.3333333333333333,80095323,5,2
2,0,1.0,1.0,65831416,2,2
0,2,0.0,0.0,70879186,2,0
2,0,1.0,1.0,82200592,1,1
0,1,0.0,0.0,70684026,1,0
1,20,0.3103448275862069,0.509090909090909,80176696,29,9
2,2,0.7777777777777778,0.8,70057764,9,7
0,7,0.0,0.0,72809002,7,0
2,0,1.0,1.0,70566685,2,2
0,1,0.0,0.0,70768145,1,0
2,0,1.0,1.0,74442935,8,8
0,3,0.0,0.0,70705054,3,0
1,4,0.3333333333333333,0.6363636363636364,82002317,6,2
0,3,0.0,0.0,70598220,3,0
2,1,0.6666666666666666,0.6666666666666666,69964412,3,2
0,5,0.0,0.0,70684236,5,0
0,4,0.0,0.0,70693903,4,0
2,0,1.0,1.0,69996682,3,3
2,0,1.0,1.0,70314181,3,3
2,0,1.0,1.0,82095241,1,1
2,1,0.6666666666666666,0.5,80132889,3,2
2,0,1.0,1.0,70357056,1,1
2,0,1.0,1.0,73651186,3,3
2,0,1.0,1.0,80136709,1,1
2,0,1.0,1.0,82022165,1,1
2,1,0.9333333333333333,0.5,82062195,15,14
2,0,1.0,1.0,80159151,4,4
2,0,1.0,1.0,80175994,2,2
0,1,0.0,0.0,68768553,1,0
2,0,1.0,1.0,80118938,2,2
1,3,0.25,0.5714285714285714,82050508,4,1
0,5,0.16666666666666666,0.15,82216216,6,1
0,8,0.0,0.0,69958882,8,0
2,0,1.0,1.0,80128022,1,1
0,7,0.0,0.0,69634131,7,0
2,1,0.5,0.8333333333333334,82047568,2,1
2,0,1.0,1.0,67744600,1,1
2,1,0.75,0.5,72803983,4,3
0,9,0.0,0.0,82050073,9,0
0,4,0.0,0.0,66785712,4,0
2,1,0.5,0.5,70818104,2,1
0,1,0.0,0.0,71618666,1,0
0,1,0.0,0.0,71618883,1,0
0,4,0.2,0.4444444444444444,63969003,5,1
0,7,0.0,0.0,66786734,7,0
0,3,0.0,0.0,80131209,3,0
0,1,0.0,0.0,69958070,1,0
1,6,0.4,0.8148148148148148,65408154,10,4
0,5,0.2857142857142857,0.3333333333333333,69974555,7,2
0,1,0.0,0.0,68784345,1,0
1,3,0.25,0.6470588235294118,82176826,4,1
2,0,1.0,1.0,82121159,1,1
2,0,1.0,1.0,82019849,2,2
2,0,1.0,1.0,70743386,2,2
2,0,1.0,1.0,80165375,1,1
2,0,1.0,1.0,67782953,5,5
2,2,0.7142857142857143,0.6666666666666666,69987722,7,5
2,0,1.0,1.0,63605045,2,2
2,1,0.5,0.0,69588071,2,1
2,0,1.0,1.0,82019678,1,1
0,3,0.0,0.0,69469624,3,0
0,2,0.0,0.0,82022965,2,0
0,2,0.0,0.0,70174951,2,0
0,2,0.0,0.0,58866472,2,0
1,5,0.2857142857142857,0.6363636363636364,73295985,7,2
0,3,0.0,0.0,70743043,3,0
2,0,1.0,1.0,68272211,1,1
2,2,0.6,0.8571428571428571,70747670,5,3
0,1,0.0,0.0,80126882,1,0
0,8,0.0,0.0,70677523,8,0
2,0,1.0,1.0,67429012,2,2
2,0,1.0,1.0,70509201,1,1
0,2,0.0,0.0,70705845,2,0
0,2,0.0,0.0,73296041,2,0
2,0,1.0,1.0,65282574,1,1
2,5,0.5454545454545454,0.9473684210526315,66916276,11,6
0,1,0.0,0.0,70045696,1,0
1,5,0.375,0.5454545454545454,80134798,8,3
2,1,0.5,0.5,956851,2,1
0,2,0.0,0.0,69207082,2,0
2,0,1.0,1.0,73037020,1,1
1,2,0.3333333333333333,0.8333333333333334,70685335,3,1
2,0,1.0,1.0,80174101,1,1
0,10,0.0,0.0,70080920,10,0
0,12,0.14285714285714285,0.3157894736842105,70081214,14,2
2,1,0.5,0.5,73102463,2,1
0,3,0.0,0.0,64025150,3,0
0,3,0.0,0.0,72808953,3,0
2,1,0.6666666666666666,0.875,68254081,3,2
0,3,0.0,0.0,70209685,3,0
1,2,0.3333333333333333,0.8,82012774,3,1
0,4,0.0,0.0,70677656,4,0
0,2,0.3333333333333333,0.3333333333333333,69064100,3,1
2,0,1.0,1.0,80128761,5,5
0,4,0.2,0.3333333333333333,66379096,5,1
2,0,1.0,1.0,82018770,2,2
2,0,1.0,1.0,82009386,3,3
2,1,0.6666666666666666,0.5,72377235,3,2
0,1,0.0,0.0,68519773,1,0
1,2,0.3333333333333333,0.8,69153224,3,1
0,1,0.0,0.0,70820106,1,0
0,4,0.0,0.0,65294033,4,0
2,0,1.0,1.0,82037904,2,2
1,3,0.4,0.6666666666666666,67982194,5,2
2,0,1.0,1.0,67286632,2,2
2,1,0.5,0.6666666666666666,70621705,2,1
1,3,0.4,0.6666666666666666,70418173,5,2
0,6,0.0,0.0,69064205,6,0
0,6,0.25,0.2727272727272727,80135259,8,2
0,2,0.0,0.0,67359432,2,0
0,1,0.0,0.0,80169898,1,0
0,3,0.0,0.0,64469454,3,0
2,0,1.0,1.0,70194635,1,1
0,4,0.0,0.0,80173397,4,0
0,2,0.0,0.0,80172649,2,0
0,2,0.0,0.0,82118277,2,0
0,3,0.0,0.0,70629174,3,0
0,3,0.0,0.0,80163175,3,0
1,2,0.3333333333333333,0.6666666666666666,81989172,3,1
0,3,0.25,0.42857142857142855,70909321,4,1
2,1,0.6666666666666666,0.6666666666666666,66309215,3,2
1,5,0.2857142857142857,0.7333333333333333,69500130,7,2
2,0,1.0,1.0,72718002,1,1
0,3,0.25,0.16666666666666666,69064275,4,1
2,0,1.0,1.0,82016122,1,1
2,1,0.5,0.5,70573531,2,1
0,2,0.0,0.0,70694085,2,0
0,4,0.2,0.3684210526315789,80150362,5,1
2,0,1.0,1.0,70701505,2,2
2,0,1.0,1.0,64332492,1,1
0,5,0.0,0.0,68318124,5,0
2,1,0.75,0.5,66379502,4,3
0,1,0.0,0.0,73623522,1,0
2,0,1.0,1.0,82012232,3,3
0,6,0.14285714285714285,0.48148148148148145,69895315,7,1
0,6,0.0,0.0,66784053,6,0
0,5,0.0,0.0,65382163,5,0
0,1,0.0,0.0,70518000,1,0
0,2,0.0,0.0,79990085,2,0
0,4,0.0,0.0,54468442,4,0
2,1,0.6666666666666666,0.5,64896972,3,2
1,2,0.3333333333333333,0.9166666666666666,70184023,3,1
0,1,0.0,0.0,70759584,1,0
2,1,0.5,0.8571428571428571,66195255,2,1
2,3,0.5,0.8333333333333334,70717976,6,3
2,1,0.5,0.75,69623722,2,1
2,0,1.0,1.0,72469530,2,2
0,2,0.0,0.0,70696346,2,0
1,4,0.2,0.5714285714285714,69538910,5,1
2,0,1.0,1.0,69139154,3,3
0,4,0.0,0.0,70697991,4,0
2,0,1.0,1.0,70768131,1,1
0,1,0.0,0.0,80052756,1,0
2,1,0.5,0.5,81989615,2,1
2,0,1.0,1.0,73652383,2,2
2,0,1.0,1.0,70314566,7,7
0,2,0.3333333333333333,0.25,67120354,3,1
0,3,0.0,0.0,70702982,3,0
0,1,0.0,0.0,68164040,1,0
2,4,0.5,0.7142857142857143,71859774,8,4
1,8,0.2727272727272727,0.5,70567035,11,3
0,7,0.0,0.0,81968370,7,0
0,8,0.0,0.0,81968540,8,0
0,1,0.0,0.0,70674926,1,0
0,1,0.0,0.0,70685776,1,0
0,9,0.0,0.0,65498692,9,0
2,2,0.6,0.6666666666666666,65716931,5,3
0,6,0.14285714285714285,0.25,66785901,7,1
0,1,0.0,0.0,82246713,1,0
0,4,0.0,0.0,72802072,4,0
0,1,0.0,0.0,70417683,1,0
2,1,0.5,0.8888888888888888,67870523,2,1
0,2,0.0,0.0,70494312,2,0
1,3,0.25,0.8409090909090909,79994411,4,1
0,3,0.25,0.25,80167078,4,1
2,5,0.5,0.7272727272727273,68286260,10,5
2,1,0.6666666666666666,0.5,60024601,3,2
2,2,0.5,0.8,70282373,4,2
0,2,0.0,0.0,82049179,2,0
1,5,0.2857142857142857,0.5,69219115,7,2
0,1,0.0,0.0,70702093,1,0
2,0,1.0,1.0,80127010,1,1
0,3,0.4,0.16666666666666666,66258031,5,2
2,0,1.0,1.0,68171670,2,2
0,1,0.0,0.0,70175406,1,0
0,4,0.0,0.0,66115455,4,0
0,3,0.25,0.2,69468966,4,1
0,1,0.0,0.0,82019701,1,0
0,2,0.0,0.0,70679945,2,0
2,0,1.0,1.0,69094760,2,2
0,4,0.2,0.2222222222222222,82018818,5,1
0,1,0.0,0.0,70768292,1,0
0,1,0.0,0.0,70820036,1,0
0,1,0.0,0.0,70820162,1,0
0,1,0.0,0.0,70820183,1,0
0,1,0.0,0.0,70573636,1,0
2,4,0.6363636363636364,0.875,70818636,11,7
2,0,1.0,1.0,68577033,4,4
2,3,0.5,0.75,69561051,6,3
1,6,0.25,0.55,65288895,8,2
1,5,0.375,0.6363636363636364,66019625,8,3
2,0,1.0,1.0,67383974,1,1
0,6,0.0,0.0,66997770,6,0
2,2,0.5,0.5,82127545,4,2
2,0,1.0,1.0,68203471,1,1
1,6,0.4,0.8787878787878788,69622035,10,4
1,3,0.4,0.8461538461538461,70927402,5,2
2,2,0.5,0.8571428571428571,71588153,4,2
0,1,0.0,0.0,68191354,1,0
1,4,0.2,0.75,80122873,5,1
2,0,1.0,1.0,70057295,1,1
1,8,0.2,0.6521739130434783,69143361,10,2
0,6,0.0,0.0,80067316,6,0
0,2,0.0,0.0,72900464,2,0
2,0,1.0,1.0,66232824,1,1
2,1,0.5,0.8,82024199,2,1
2,0,1.0,1.0,72425766,2,2
0,2,0.0,0.0,70705740,2,0
2,2,0.6,0.875,64086575,5,3
1,8,0.38461538461538464,0.8421052631578947,66225061,13,5
0,1,0.0,0.0,70406042,1,0
0,6,0.4,0.4375,70408450,10,4
2,5,0.6153846153846154,0.625,62465305,13,8
0,1,0.0,0.0,82145513,1,0
1,2,0.3333333333333333,0.5,70036162,3,1
1,5,0.2857142857142857,0.5,65852402,7,2
2,1,0.5,0.8,72804375,2,1
2,4,0.5,0.9047619047619048,80136953,8,4
0,2,0.0,0.0,63115066,2,0
0,2,0.0,0.0,82016405,2,0
0,1,0.0,0.0,82152775,1,0
2,2,0.6,0.8571428571428571,64976114,5,3
2,1,0.5,0.5,66238053,2,1
2,0,1.0,1.0,82039799,1,1
0,3,0.0,0.0,14103761,3,0
2,2,0.5,0.75,70562051,4,2
0,3,0.0,0.0,71762565,3,0
2,0,1.0,1.0,69152454,3,3
0,3,0.25,0.4444444444444444,68666920,4,1
2,0,1.0,1.0,82018834,2,2
0,2,0.0,0.0,82102514,2,0
1,2,0.3333333333333333,0.6666666666666666,80092551,3,1
0,6,0.0,0.0,82137451,6,0
2,0,1.0,1.0,66560676,5,5
0,2,0.3333333333333333,0.0,69172670,3,1
0,1,0.0,0.0,80172648,1,0
0,1,0.0,0.0,82206190,1,0
0,1,0.0,0.0,69973274,1,0
0,3,0.0,0.0,73533285,3,0
1,7,0.2222222222222222,0.7804878048780488,70463120,9,2
0,2,0.0,0.0,80162855,2,0
0,7,0.0,0.0,82006523,7,0
0,5,0.0,0.0,82006526,5,0
1,4,0.3333333333333333,0.8260869565217391,69912493,6,2
0,2,0.0,0.0,82102747,2,0
0,2,0.0,0.0,82102927,2,0
0,1,0.0,0.0,82102939,1,0
0,2,0.0,0.0,80172537,2,0
0,4,0.0,0.0,70610736,4,0
0,3,0.0,0.0,70702702,3,0
2,0,1.0,1.0,82021515,2,2
1,4,0.2,0.5,73295642,5,1
1,4,0.2,0.7142857142857143,69416200,5,1
0,2,0.0,0.0,80165377,2,0
0,1,0.0,0.0,80165434,1,0
0,2,0.0,0.0,69597150,2,0
0,2,0.0,0.0,70691523,2,0
0,3,0.0,0.0,70694631,3,0
0,6,0.0,0.0,82152777,6,0
0,7,0.0,0.0,82152781,7,0
1,4,0.3333333333333333,0.5,80122645,6,2
2,1,0.5,0.6666666666666666,66237913,2,1
0,2,0.0,0.0,82019458,2,0
2,0,1.0,1.0,82070218,1,1
0,2,0.0,0.0,80118871,2,0
2,1,0.5,0.8,80118873,2,1
0,7,0.0,0.0,70037184,7,0
0,1,0.0,0.0,61563215,1,0
1,2,0.3333333333333333,0.6,65286606,3,1
2,1,0.5,0.9230769230769231,70491386,2,1
0,1,0.0,0.0,66806712,1,0
0,1,0.0,0.0,82182813,1,0
1,3,0.4,0.9024390243902439,70606172,5,2
0,5,0.16666666666666666,0.3333333333333333,66816876,6,1
1,2,0.3333333333333333,0.8,70184191,3,1
2,3,0.5,0.7,61751592,6,3
0,1,0.0,0.0,75147996,1,0
0,3,0.25,0.375,69596233,4,1
2,0,1.0,1.0,80162156,1,1
2,0,1.0,1.0,82042616,3,3
2,0,1.0,1.0,80126962,3,3
0,2,0.3333333333333333,0.0,66973781,3,1
2,0,1.0,1.0,70398986,1,1
0,4,0.0,0.0,68500180,4,0
0,3,0.0,0.0,68500306,3,0
0,1,0.0,0.0,69006875,1,0
0,2,0.0,0.0,69006973,2,0
2,1,0.5,0.75,69007050,2,1
0,2,0.0,0.0,70230034,2,0
0,1,0.0,0.0,70230454,1,0
2,0,1.0,1.0,82045543,4,4
2,1,0.5,0.5,82047577,2,1
2,1,0.875,0.5,73313863,8,7
2,1,0.5,0.5,82047566,2,1
0,10,0.09090909090909091,0.4,69144446,11,1
1,4,0.3333333333333333,0.8333333333333334,70515403,6,2
0,6,0.0,0.0,70199591,6,0
0,2,0.0,0.0,67668881,2,0
2,2,0.5,0.8333333333333334,80069801,4,2
2,1,0.5,0.5,67830336,2,1
0,1,0.0,0.0,82023118,1,0
0,1,0.0,0.0,64458086,1,0
0,7,0.0,0.0,70493822,7,0
2,0,1.0,1.0,72801911,1,1
0,2,0.0,0.0,70707091,2,0
2,1,0.5,0.9,78735321,2,1
2,2,0.75,0.9090909090909091,67843251,8,6
0,4,0.0,0.0,69640410,4,0
0,2,0.0,0.0,69640431,2,0
2,0,1.0,1.0,79844002,1,1
0,1,0.0,0.0,82121026,1,0
0,1,0.0,0.0,82121153,1,0
2,0,1.0,1.0,60532815,1,1
2,0,1.0,1.0,82016277,2,2
2,2,0.7777777777777778,0.6666666666666666,19133933,9,7
2,5,0.6153846153846154,0.95,80158245,13,8
2,1,0.75,0.5,69318284,4,3
1,2,0.3333333333333333,0.8571428571428571,75456822,3,1
0,5,0.0,0.0,75456836,5,0
0,7,0.0,0.0,75456871,7,0
0,8,0.0,0.0,75456892,8,0
2,0,1.0,1.0,70669060,1,1
0,5,0.16666666666666666,0.16666666666666666,69557131,6,1
2,0,1.0,1.0,82037159,6,6
2,1,0.75,0.5,72801890,4,3
2,2,0.6,0.5,72410933,5,3
1,3,0.25,0.5,66189984,4,1
0,1,0.0,0.0,66224081,1,0
1,2,0.3333333333333333,0.5555555555555556,66224186,3,1
0,1,0.0,0.0,67276874,1,0
0,1,0.0,0.0,68544875,1,0
0,1,0.0,0.0,67667096,1,0
0,1,0.0,0.0,70768215,1,0
0,3,0.0,0.0,63140315,3,0
0,2,0.0,0.0,70843192,2,0
0,1,0.0,0.0,70582505,1,0
0,1,0.0,0.0,66235463,1,0
2,0,1.0,1.0,80119179,5,5
2,0,1.0,1.0,80169313,4,4
2,2,0.5,0.6,82012241,4,2
2,1,0.6666666666666666,0.8,69316422,3,2
2,2,0.6,0.9411764705882353,71458772,5,3
0,3,0.0,0.0,70698705,3,0
2,1,0.5,0.5,67779593,2,1
0,9,0.25,0.35294117647058826,69571264,12,3
2,1,0.5,0.5,62512121,2,1
2,2,0.7142857142857143,0.8333333333333334,82052034,7,5
0,2,0.0,0.0,80158267,2,0
0,2,0.3333333333333333,0.25,82061339,3,1
2,0,1.0,1.0,70347452,6,6
0,1,0.0,0.0,70528150,1,0
2,0,1.0,1.0,73634883,1,1
1,2,0.3333333333333333,0.75,70702275,3,1
0,4,0.3333333333333333,0.375,80163142,6,2
2,0,1.0,1.0,80139973,1,1
2,0,1.0,1.0,61630702,1,1
0,2,0.0,0.0,72545823,2,0
0,3,0.0,0.0,80168233,3,0
2,0,1.0,1.0,74161171,1,1
0,3,0.0,0.0,82102479,3,0
1,6,0.25,0.5555555555555556,80163395,8,2
0,2,0.0,0.0,82006484,2,0
0,3,0.0,0.0,82006506,3,0
0,2,0.0,0.0,80162913,2,0
0,6,0.0,0.0,80167276,6,0
0,2,0.0,0.0,80167290,2,0
0,4,0.0,0.0,80172540,4,0
0,1,0.0,0.0,74059272,1,0
0,3,0.0,0.0,70230251,3,0
2,2,0.7142857142857143,0.8,82039822,7,5
2,1,0.5,0.5,80134289,2,1
0,3,0.0,0.0,70683291,3,0
2,1,0.6666666666666666,0.8333333333333334,82037166,3,2
1,4,0.2,0.5714285714285714,70926331,5,1
0,1,0.0,0.0,70063903,1,0
1,4,0.42857142857142855,0.875,80094896,7,3
0,1,0.0,0.0,69007211,1,0
1,2,0.3333333333333333,0.5714285714285714,70013790,3,1
2,0,1.0,1.0,80178953,5,5
1,3,0.4,0.8,279811,5,2
2,0,1.0,1.0,68366515,2,2
0,3,0.25,0.2222222222222222,68748505,4,1
0,2,0.0,0.0,70683851,2,0
0,4,0.0,0.0,70691600,4,0
0,1,0.0,0.0,70693490,1,0
0,9,0.25,0.46875,69530825,12,3
0,2,0.0,0.0,57210244,2,0
2,0,1.0,1.0,80159231,4,4
2,0,1.0,1.0,82046293,1,1
2,2,0.6,0.75,66379383,5,3
2,0,1.0,1.0,69587742,1,1
0,3,0.25,0.25,63980084,4,1
1,3,0.25,0.6956521739130435,69179810,4,1
2,2,0.7142857142857143,0.6666666666666666,80141334,7,5
0,1,0.0,0.0,70675843,1,0
0,1,0.0,0.0,70685314,1,0
1,6,0.3333333333333333,0.8709677419354839,70184310,9,3
2,0,1.0,1.0,82038887,1,1
0,3,0.25,0.3333333333333333,80165177,4,1
2,0,1.0,1.0,82046120,4,4
2,0,1.0,1.0,80080014,4,4
2,1,0.8333333333333334,0.6666666666666666,80132913,6,5
2,1,0.5,0.5,70853762,2,1
0,2,0.0,0.0,82042615,2,0
2,0,1.0,1.0,19487902,5,5
2,0,1.0,1.0,82110452,2,2
0,4,0.2,0.42857142857142855,80145709,5,1
2,0,1.0,1.0,82042123,1,1
2,0,1.0,1.0,80169828,1,1
2,0,1.0,1.0,68997621,2,2
2,2,0.6666666666666666,0.875,67663001,6,4
2,1,0.75,0.5,70073955,4,3
0,1,0.0,0.0,80128331,1,0
2,1,0.5,0.6666666666666666,82024318,2,1
2,1,0.5,0.5,82037924,2,1
0,1,0.0,0.0,82037926,1,0
0,5,0.16666666666666666,0.16666666666666666,67454912,6,1
2,0,1.0,1.0,80094196,1,1
0,1,0.0,0.0,66782240,1,0
0,2,0.0,0.0,66783570,2,0
0,1,0.0,0.0,64458884,1,0
2,1,0.6666666666666666,0.6666666666666666,73870083,3,2
0,2,0.0,0.0,67276405,2,0
0,3,0.0,0.0,70489265,3,0
2,0,1.0,1.0,70190365,1,1
2,0,1.0,1.0,75346432,1,1
0,2,0.0,0.0,82206086,2,0
2,1,0.8,0.9230769230769231,82023686,5,4
2,0,1.0,1.0,69608042,1,1
0,7,0.125,0.3333333333333333,80126839,8,1
2,1,0.8333333333333334,0.8333333333333334,74086824,6,5
0,3,0.25,0.4166666666666667,70759311,4,1
2,0,1.0,1.0,82038897,1,1
2,0,1.0,1.0,82021521,1,1
0,2,0.0,0.0,80150352,2,0
0,3,0.0,0.0,68350625,3,0
0,10,0.16666666666666666,0.3333333333333333,76039264,12,2
1,4,0.2,0.6666666666666666,70691936,5,1
2,1,0.8888888888888888,0.5,66460786,9,8
2,1,0.5,0.6666666666666666,64402023,2,1
1,6,0.4,0.90625,69946961,10,4
1,2,0.3333333333333333,0.6666666666666666,71879640,3,1
0,6,0.0,0.0,69626396,6,0
2,2,0.5,0.8484848484848485,69862485,4,2
2,0,1.0,1.0,69701226,1,1
0,2,0.3333333333333333,0.3333333333333333,70223965,3,1
2,0,1.0,1.0,63698082,1,1
2,3,0.625,0.9375,80124460,8,5
0,2,0.0,0.0,69724403,2,0
1,6,0.3333333333333333,0.7272727272727273,70318024,9,3
0,1,0.0,0.0,82110385,1,0
0,1,0.0,0.0,82110397,1,0
0,2,0.3333333333333333,0.42857142857142855,70231511,3,1
0,4,0.2,0.3076923076923077,62637260,5,1
2,1,0.5,0.75,70698145,2,1
0,5,0.16666666666666666,0.1111111111111111,66110905,6,1
0,5,0.16666666666666666,0.2,66364326,6,1
0,10,0.16666666666666666,0.15,66698940,12,2
0,1,0.0,0.0,79030042,1,0
2,1,0.5,0.5,70259406,2,1
0,1,0.0,0.0,60191852,1,0
0,1,0.0,0.0,70699783,1,0
2,0,1.0,1.0,68249034,1,1
0,5,0.0,0.0,70680834,5,0
0,2,0.0,0.0,70685762,2,0
0,2,0.0,0.0,70691985,2,0
2,2,0.6666666666666666,0.75,70598773,6,4
2,0,1.0,1.0,69964573,2,2
0,3,0.25,0.47368421052631576,70063560,4,1
1,4,0.3333333333333333,0.5714285714285714,70417606,6,2
1,14,0.3333333333333333,0.8648648648648649,71618743,21,7
1,2,0.3333333333333333,0.5454545454545454,80128375,3,1
2,0,1.0,1.0,82023101,1,1
2,2,0.5,0.7142857142857143,66861053,4,2
0,5,0.16666666666666666,0.4666666666666667,70514325,6,1
2,0,1.0,1.0,80178959,1,1
1,4,0.3333333333333333,0.75,69489224,6,2
0,4,0.42857142857142855,0.4166666666666667,80056403,7,3
0,1,0.0,0.0,82042149,1,0
1,3,0.4,0.7857142857142857,80150499,5,2
0,9,0.0,0.0,80150705,9,0
0,2,0.0,0.0,68193251,2,0
2,0,1.0,1.0,69973393,1,1
2,0,1.0,1.0,82006726,1,1
0,2,0.0,0.0,70759885,2,0
0,6,0.14285714285714285,0.4230769230769231,78762670,7,1
0,3,0.0,0.0,66203382,3,0
1,2,0.3333333333333333,0.5555555555555556,80162900,3,1
0,2,0.0,0.0,19989361,2,0
0,2,0.0,0.0,82164473,2,0
2,1,0.5,0.5,82182811,2,1
2,1,0.8571428571428571,0.6666666666666666,69972630,7,6
0,1,0.0,0.0,70567952,1,0
0,4,0.2,0.1111111111111111,76904331,5,1
0,2,0.0,0.0,79990022,2,0
1,6,0.4,0.8,71388065,10,4
0,2,0.0,0.0,68805492,2,0
0,5,0.0,0.0,70702065,5,0
1,3,0.4,0.8571428571428571,69391035,5,2
0,2,0.0,0.0,70697095,2,0
0,1,0.0,0.0,70697375,1,0
0,4,0.2,0.0,68383714,5,1
2,0,1.0,1.0,70492940,1,1
1,2,0.3333333333333333,0.5555555555555556,70909013,3,1
2,1,0.5,0.5,82039415,2,1
2,2,0.5,0.8,70752066,4,2
2,0,1.0,1.0,82020759,1,1
0,4,0.0,0.0,72377214,4,0
0,3,0.25,0.0,62045872,4,1
2,0,1.0,1.0,82145124,2,2
2,0,1.0,1.0,67276972,1,1
2,0,1.0,1.0,80094665,2,2
1,6,0.25,0.5945945945945946,70691726,8,2
0,1,0.0,0.0,69187685,1,0
0,2,0.0,0.0,67514195,2,0
2,0,1.0,1.0,82018584,2,2
0,1,0.0,0.0,68044445,1,0
2,0,1.0,1.0,82145114,5,5
2,1,0.6666666666666666,0.5,72802296,3,2
2,0,1.0,1.0,80162553,1,1
1,13,0.23529411764705882,0.7321428571428571,80180994,17,4
0,1,0.0,0.0,82042134,1,0
2,1,0.8,0.6666666666666666,82039848,5,4
2,0,1.0,1.0,82059897,2,2
2,0,1.0,1.0,77112882,7,7
2,0,1.0,1.0,82043183,3,3
2,1,0.8,0.5,69972595,5,4
0,1,0.0,0.0,70036701,1,0
0,1,0.0,0.0,70037016,1,0
2,0,1.0,1.0,66440871,1,1
2,0,1.0,1.0,82018703,2,2
2,1,0.5,0.9,82041708,2,1
2,0,1.0,1.0,82020821,1,1
1,2,0.3333333333333333,0.7142857142857143,70184730,3,1
0,4,0.0,0.0,80124400,4,0
2,3,0.5,0.9230769230769231,80149793,6,3
1,4,0.2,0.7333333333333333,66784263,5,1
0,1,0.0,0.0,66786846,1,0
0,1,0.0,0.0,68641321,1,0
2,0,1.0,1.0,69530454,1,1
2,1,0.6666666666666666,0.75,60013345,3,2
0,2,0.0,0.0,68784065,2,0
0,5,0.0,0.0,66304833,5,0
2,0,1.0,1.0,79816506,2,2
0,2,0.0,0.0,71618624,2,0
2,2,0.5,0.75,74129363,4,2
1,3,0.25,0.5,80168313,4,1
1,2,0.3333333333333333,0.5,70598325,3,1
0,1,0.0,0.0,70680813,1,0
0,1,0.0,0.0,70696626,1,0
0,3,0.0,0.0,70700070,3,0
2,3,0.5714285714285714,0.7142857142857143,80152631,7,4
2,2,0.5,0.6666666666666666,69483610,4,2
2,2,0.5,0.8571428571428571,80140255,4,2
2,1,0.5,0.5,80092453,2,1
0,1,0.0,0.0,66755353,1,0
2,0,1.0,1.0,70251923,1,1
2,1,0.5,0.8,70257026,2,1
2,0,1.0,1.0,82250603,2,2
2,0,1.0,1.0,69182106,1,1
2,1,0.5,0.3333333333333333,76396593,2,1
2,1,0.5,0.5,69635041,2,1
2,0,1.0,1.0,80162123,1,1
0,1,0.0,0.0,67315080,1,0
0,2,0.0,0.0,67315094,2,0
0,2,0.0,0.0,69596212,2,0
0,1,0.0,0.0,69597066,1,0
0,2,0.0,0.0,69603275,2,0
2,1,0.6666666666666666,0.75,68478291,3,2
2,0,1.0,1.0,68193384,1,1
0,2,0.0,0.0,70682682,2,0
0,4,0.0,0.0,68763611,4,0
2,0,1.0,1.0,80025211,3,3
2,2,0.6,0.8888888888888888,80141329,5,3
1,3,0.4,0.5714285714285714,70563563,5,2
0,1,0.0,0.0,67131351,1,0
2,0,1.0,1.0,82052078,1,1
2,2,0.6,0.5,80174695,5,3
1,11,0.35294117647058826,0.8076923076923077,65290246,17,6
0,3,0.0,0.0,70707294,3,0
0,5,0.16666666666666666,0.0,80174674,6,1
2,0,1.0,1.0,67347336,4,4
0,4,0.0,0.0,67094272,4,0
2,0,1.0,1.0,68330220,1,1
0,1,0.0,0.0,80180010,1,0
0,1,0.0,0.0,68471571,1,0
2,0,1.0,1.0,70752633,1,1
0,8,0.0,0.0,70692720,8,0
2,2,0.6,0.9,82152762,5,3
0,1,0.0,0.0,67822594,1,0
1,3,0.4,0.8928571428571429,79990190,5,2
0,1,0.0,0.0,82182803,1,0
2,0,1.0,1.0,82012814,1,1
0,6,0.0,0.0,68130965,6,0
0,1,0.0,0.0,69170850,1,0
0,1,0.0,0.0,67802406,1,0
0,11,0.15384615384615385,0.1875,67672871,13,2
2,0,1.0,1.0,68248775,1,1
0,1,0.0,0.0,65336355,1,0
2,1,0.5,0.3333333333333333,67786432,2,1
0,5,0.0,0.0,61976320,5,0
0,4,0.2,0.2,70946995,5,1
2,1,0.6666666666666666,0.8571428571428571,68626775,3,2
2,1,0.5,0.5,67285862,2,1
0,1,0.0,0.0,67285890,1,0
0,4,0.0,0.0,69867294,4,0
2,0,1.0,1.0,82019824,2,2
0,5,0.0,0.0,69526156,5,0
0,1,0.0,0.0,82006576,1,0
0,1,0.0,0.0,80153532,1,0
0,4,0.0,0.0,69559385,4,0
0,5,0.16666666666666666,0.18518518518518517,71081353,6,1
0,1,0.0,0.0,69973043,1,0
2,0,1.0,1.0,80128336,1,1
1,2,0.3333333333333333,0.6,82102535,3,1
0,2,0.0,0.0,82022878,2,0
2,0,1.0,1.0,82135128,1,1
0,1,0.0,0.0,69604185,1,0
0,1,0.0,0.0,64053752,1,0
0,1,0.0,0.0,65812313,1,0
1,3,0.4,0.625,69597213,5,2
2,0,1.0,1.0,70608153,1,1
0,2,0.0,0.0,82019723,2,0
0,1,0.0,0.0,82019747,1,0
2,2,0.6666666666666666,0.6666666666666666,80139963,6,4
0,3,0.0,0.0,72470041,3,0
1,4,0.2,0.6363636363636364,70230132,5,1
0,3,0.25,0.18181818181818182,65291051,4,1
0,1,0.0,0.0,69597276,1,0
0,2,0.0,0.0,69604045,2,0
1,2,0.3333333333333333,0.5,70682556,3,1
0,5,0.0,0.0,69007246,5,0
1,2,0.3333333333333333,0.9230769230769231,69007316,3,1
2,1,0.75,0.6666666666666666,70583303,4,3
2,0,1.0,1.0,69975934,2,2
0,3,0.0,0.0,66782765,3,0
1,3,0.4,0.8636363636363636,67754750,5,2
1,3,0.4,0.7777777777777778,70692335,5,2
2,1,0.5,0.5,67994724,2,1
2,0,1.0,1.0,69240955,1,1
1,3,0.4,0.5,80180334,5,2
2,1,0.6666666666666666,0.5,80092054,3,2
2,3,0.5714285714285714,0.8571428571428571,73590062,7,4
0,1,0.0,0.0,67666571,1,0
0,1,0.0,0.0,66971884,1,0
0,1,0.0,0.0,70282751,1,0
0,2,0.0,0.0,70238021,2,0
0,7,0.0,0.0,70239582,7,0
0,1,0.0,0.0,82141834,1,0
2,1,0.8333333333333334,0.6666666666666666,71526413,6,5
2,2,0.5,0.8333333333333334,70692251,4,2
0,4,0.2,0.25,70675675,5,1
2,1,0.5,0.6,68546604,2,1
0,3,0.0,0.0,65761346,3,0
1,2,0.3333333333333333,0.5,65761381,3,1
0,3,0.0,0.0,65761395,3,0
2,0,1.0,1.0,69206746,1,1
2,2,0.6666666666666666,0.6666666666666666,82062665,6,4
2,0,1.0,1.0,70036876,1,1
2,0,1.0,1.0,70747250,4,4
2,0,1.0,1.0,80092215,1,1
0,2,0.0,0.0,80158321,2,0
2,1,0.75,0.5,67199125,4,3
2,0,1.0,1.0,80159707,4,4
2,0,1.0,1.0,80178179,3,3
2,1,0.6666666666666666,0.0,68884536,3,2
2,0,1.0,1.0,62589821,3,3
2,0,1.0,1.0,66235071,1,1
2,3,0.5,0.875,66337691,6,3
0,1,0.0,0.0,82013538,1,0
0,2,0.3333333333333333,0.0,69320692,3,1
2,0,1.0,1.0,70063056,1,1
0,3,0.0,0.0,80132279,3,0
0,2,0.0,0.0,82019444,2,0
0,5,0.0,0.0,80135295,5,0
0,8,0.0,0.0,70323036,8,0
0,2,0.0,0.0,70635600,2,0
0,1,0.0,0.0,67963910,1,0
2,2,0.6666666666666666,0.9,64092224,6,4
0,7,0.125,0.2916666666666667,65295153,8,1
2,0,1.0,1.0,80168316,1,1
0,4,0.2,0.19047619047619047,67508224,5,1
2,2,0.5,0.8888888888888888,67508245,4,2
0,1,0.0,0.0,69041063,1,0
1,7,0.2222222222222222,0.6,69630106,9,2
1,3,0.4,0.5,72868565,5,2
2,1,0.5,0.875,69483246,2,1
2,0,1.0,1.0,82052059,1,1
0,11,0.0,0.0,67846296,11,0
2,2,0.5,0.875,70867216,4,2
1,2,0.3333333333333333,0.5,82250571,3,1
0,2,0.0,0.0,70674184,2,0
1,3,0.25,0.6,67220972,4,1
0,2,0.0,0.0,80090234,2,0
0,1,0.0,0.0,67899405,1,0
2,1,0.5,0.5,68047756,2,1
0,3,0.25,0.25,69997662,4,1
1,2,0.3333333333333333,0.6666666666666666,69562773,3,1
0,1,0.0,0.0,68240872,1,0
2,0,1.0,1.0,82012777,2,2
1,8,0.2727272727272727,0.8363636363636363,71537543,11,3
0,2,0.0,0.0,80105375,2,0
2,1,0.5,0.5,60547620,2,1
2,1,0.5,0.5,69733965,2,1
2,1,0.5,0.5,70591731,2,1
1,3,0.25,0.7142857142857143,67748331,4,1
2,1,0.5,0.6666666666666666,82040806,2,1
0,3,0.0,0.0,69473614,3,0
0,4,0.0,0.0,80126840,4,0
2,0,1.0,1.0,82052077,3,3
1,4,0.42857142857142855,0.5714285714285714,80165344,7,3
0,2,0.0,0.0,73295922,2,0
2,1,0.9,0.5,69579622,10,9
0,1,0.0,0.0,70595322,1,0
0,1,0.0,0.0,73824296,1,0
0,2,0.0,0.0,70190092,2,0
2,1,0.5,0.75,67836503,2,1
0,1,0.0,0.0,66849902,1,0
2,2,0.5,0.625,82018723,4,2
2,0,1.0,1.0,80166913,1,1
0,1,0.0,0.0,69700533,1,0
2,1,0.6666666666666666,0.6666666666666666,80128567,3,2
0,2,0.0,0.0,70109690,2,0
0,1,0.0,0.0,70860601,1,0
2,0,1.0,1.0,82077195,1,1
1,4,0.3333333333333333,0.8571428571428571,80153580,6,2
0,6,0.0,0.0,80176295,6,0
0,6,0.0,0.0,82118275,6,0
2,0,1.0,1.0,80003812,1,1
0,4,0.0,0.0,80163172,4,0
2,1,0.5,0.8571428571428571,82006173,2,1
0,5,0.0,0.0,80150558,5,0
0,1,0.0,0.0,82006362,1,0
0,1,0.0,0.0,82006392,1,0
1,4,0.2,0.5,80131207,5,1
0,4,0.0,0.0,69407226,4,0
0,4,0.0,0.0,80176290,4,0
1,5,0.16666666666666666,0.6216216216216216,67975670,6,1
2,1,0.5,0.3333333333333333,69736492,2,1
0,1,0.0,0.0,82118268,1,0
0,11,0.0,0.0,70746802,11,0
2,0,1.0,1.0,70909643,1,1
0,7,0.2222222222222222,0.44,70582533,9,2
0,6,0.4,0.45454545454545453,73977155,10,4
0,4,0.2,0.391304347826087,82018937,5,1
2,1,0.6666666666666666,0.6666666666666666,63726026,3,2
0,1,0.0,0.0,70221333,1,0
2,1,0.75,0.9230769230769231,82018701,4,3
0,1,0.0,0.0,68393451,1,0
1,2,0.3333333333333333,0.9,82090167,3,1
1,2,0.3333333333333333,0.75,80174675,3,1
2,0,1.0,1.0,66859772,1,1
0,1,0.0,0.0,82018664,1,0
2,2,0.7777777777777778,0.75,75264336,9,7
2,1,0.5,0.0,70189896,2,1
2,1,0.6666666666666666,0.5,70190456,3,2
2,0,1.0,1.0,68286855,9,9
0,4,0.3333333333333333,0.36363636363636365,82013609,6,2
0,3,0.0,0.0,80131225,3,0
0,1,0.0,0.0,70698110,1,0
0,3,0.0,0.0,80126880,3,0
2,0,1.0,1.0,80159766,1,1
2,1,0.9,0.6666666666666666,72823380,10,9
2,2,0.6,0.5,80095015,5,3
0,2,0.0,0.0,70184156,2,0
1,2,0.3333333333333333,0.6666666666666666,69315575,3,1
0,2,0.0,0.0,69723703,2,0
0,1,0.0,0.0,70064001,1,0
1,4,0.3333333333333333,0.68,82126595,6,2
2,1,0.5,0.5,60193434,2,1
0,5,0.0,0.0,68499081,5,0
0,2,0.0,0.0,68499123,2,0
0,2,0.0,0.0,70230370,2,0
1,3,0.4,0.7142857142857143,66413704,5,2
0,1,0.0,0.0,68475470,1,0
2,2,0.6,0.3333333333333333,82023218,5,3
0,4,0.0,0.0,67841151,4,0
2,0,1.0,1.0,69148786,1,1
2,0,1.0,1.0,80180274,2,2
0,1,0.0,0.0,67365571,1,0
2,0,1.0,1.0,69979882,1,1
2,0,1.0,1.0,80162116,6,6
0,1,0.0,0.0,82102187,1,0
2,1,0.5,0.5,69975955,2,1
0,8,0.2727272727272727,0.15384615384615385,66973774,11,3
2,0,1.0,1.0,82009409,2,2
0,3,0.4,0.25,80149481,5,2
2,2,0.5,0.5,74362120,4,2
2,0,1.0,1.0,80083493,5,5
2,0,1.0,1.0,69979833,7,7
0,1,0.0,0.0,70049084,1,0
0,5,0.16666666666666666,0.2222222222222222,58878995,6,1
0,4,0.0,0.0,65286326,4,0
2,0,1.0,1.0,70566545,3,3
2,1,0.5,0.0,70524475,2,1
0,5,0.16666666666666666,0.3333333333333333,64355620,6,1
0,1,0.0,0.0,67899335,1,0
1,6,0.14285714285714285,0.5357142857142857,67899503,7,1
2,1,0.6666666666666666,0.6666666666666666,80155198,3,2
0,1,0.0,0.0,70574371,1,0
0,1,0.0,0.0,70574455,1,0
0,1,0.0,0.0,70574651,1,0
0,1,0.0,0.0,70574770,1,0
2,1,0.5,0.5,80162831,2,1
0,1,0.0,0.0,82114238,1,0
2,0,1.0,1.0,66229394,1,1
2,1,0.75,0.5,82033334,4,3
2,1,0.5,0.5,72480541,2,1
2,0,1.0,1.0,70761614,1,1
0,2,0.0,0.0,69640550,2,0
1,3,0.4,0.8,79785643,5,2
0,3,0.0,0.0,71588181,3,0
2,2,0.5,0.75,71588223,4,2
0,4,0.0,0.0,80132364,4,0
0,7,0.0,0.0,72910201,7,0
0,6,0.0,0.0,70680652,6,0
2,0,1.0,1.0,80159154,2,2
2,1,0.5,0.7777777777777778,72813811,2,1
2,0,1.0,1.0,69975045,1,1
2,0,1.0,1.0,80165349,2,2
2,1,0.75,0.5,80133913,4,3
0,1,0.0,0.0,80133941,1,0
2,0,1.0,1.0,70186445,1,1
2,1,0.5,0.5,67704392,2,1
0,1,0.0,0.0,80150478,1,0
2,1,0.5,0.5,82019719,2,1
0,1,0.0,0.0,80133629,1,0
1,4,0.3333333333333333,0.9473684210526315,80128817,6,2
0,2,0.0,0.0,67824120,2,0
2,2,0.7142857142857143,0.75,67824204,7,5
0,1,0.0,0.0,67286730,1,0
2,1,0.8333333333333334,0.75,69168015,6,5
2,6,0.6,0.9411764705882353,66353812,15,9
0,3,0.25,0.0,74088462,4,1
0,2,0.3333333333333333,0.25,77088235,3,1
0,3,0.25,0.4,69691244,4,1
0,2,0.0,0.0,70586075,2,0
2,0,1.0,1.0,69118735,1,1
2,1,0.8571428571428571,0.8333333333333334,72802681,7,6
0,2,0.0,0.0,70678335,2,0
2,0,1.0,1.0,61383700,4,4
0,2,0.0,0.0,67703580,2,0
1,5,0.16666666666666666,0.5882352941176471,67703643,6,1
0,3,0.0,0.0,67703811,3,0
2,4,0.5555555555555556,0.6666666666666666,80137614,9,5
0,8,0.2,0.1111111111111111,65279130,10,2
0,1,0.0,0.0,80165376,1,0
0,2,0.0,0.0,68536125,2,0
0,1,0.0,0.0,68539226,1,0
0,1,0.0,0.0,69832000,1,0
2,0,1.0,1.0,66086720,1,1
2,2,0.6666666666666666,0.8,70812994,6,4
2,0,1.0,1.0,70758513,2,2
2,2,0.5,0.4,82105394,4,2
0,1,0.0,0.0,82119391,1,0
2,1,0.8,0.5,80153634,5,4
1,5,0.16666666666666666,0.7,70608440,6,1
1,5,0.2857142857142857,0.7647058823529411,70608461,7,2
0,4,0.0,0.0,68607042,4,0
0,1,0.0,0.0,68607112,1,0
2,2,0.5,0.6666666666666666,69964342,4,2
0,6,0.0,0.0,68255810,6,0
0,6,0.0,0.0,68255964,6,0
0,4,0.0,0.0,68256006,4,0
0,4,0.0,0.0,68256286,4,0
0,5,0.0,0.0,68256321,5,0
1,6,0.14285714285714285,0.9230769230769231,68256370,7,1
0,3,0.0,0.0,70072135,3,0
1,6,0.14285714285714285,0.6086956521739131,70693266,7,1
0,1,0.0,0.0,80126788,1,0
2,0,1.0,1.0,80165259,6,6
0,2,0.0,0.0,72882873,2,0
0,3,0.25,0.4444444444444444,76326796,4,1
0,3,0.25,0.14285714285714285,80165478,4,1
0,2,0.3333333333333333,0.2,80165480,3,1
0,6,0.25,0.4117647058823529,70223895,8,2
2,0,1.0,1.0,80082310,1,1
0,3,0.0,0.0,70680624,3,0
0,3,0.0,0.0,82102806,3,0
2,2,0.5,0.8888888888888888,65295412,4,2
2,0,1.0,1.0,69973575,1,1
0,4,0.0,0.0,70045570,4,0
2,1,0.5,0.6666666666666666,73623102,2,1
1,3,0.4,0.6,69596576,5,2
0,4,0.0,0.0,69006084,4,0
2,0,1.0,1.0,67917094,1,1
0,2,0.0,0.0,82102792,2,0
0,4,0.0,0.0,68905606,4,0
0,9,0.0,0.0,82006653,9,0
0,2,0.0,0.0,82006666,2,0
1,6,0.14285714285714285,0.5641025641025641,70634760,7,1
0,2,0.0,0.0,67309102,2,0
0,12,0.0,0.0,80180995,12,0
0,11,0.0,0.0,63701953,11,0
2,1,0.5,0.6666666666666666,65048144,2,1
2,1,0.5,0.5,69596611,2,1
0,1,0.0,0.0,67308213,1,0
1,3,0.4,0.7777777777777778,80150342,5,2
0,5,0.0,0.0,80126845,5,0
0,1,0.0,0.0,70696500,1,0
0,1,0.0,0.0,68007751,1,0
0,3,0.0,0.0,82010253,3,0
0,4,0.0,0.0,82023771,4,0
0,1,0.0,0.0,70464156,1,0
1,4,0.3333333333333333,0.5833333333333334,67930863,6,2
2,1,0.8571428571428571,0.5,82039342,7,6
0,2,0.0,0.0,80122855,2,0
0,2,0.0,0.0,65282882,2,0
0,2,0.0,0.0,54252030,2,0
1,3,0.25,0.875,76028372,4,1
0,3,0.0,0.0,80128215,3,0
0,6,0.0,0.0,80128267,6,0
0,6,0.0,0.0,70908915,6,0
0,1,0.0,0.0,70697641,1,0
2,0,1.0,1.0,80055122,2,2
0,3,0.0,0.0,80029166,3,0
2,2,0.6666666666666666,0.75,75733574,6,4
0,2,0.0,0.0,80153640,2,0
0,3,0.0,0.0,70686021,3,0
2,0,1.0,1.0,70632310,2,2
2,0,1.0,1.0,70718263,2,2
0,3,0.4,0.4,74443824,5,2
2,1,0.6666666666666666,0.75,67533004,3,2
1,7,0.125,0.5263157894736842,69313034,8,1
0,2,0.3333333333333333,0.4,72475144,3,1
2,2,0.5,0.8333333333333334,80126843,4,2
0,1,0.0,0.0,80132898,1,0
2,1,0.5,0.6666666666666666,80177689,2,1
2,1,0.75,0.5,70762776,4,3
1,5,0.375,0.8333333333333334,66379292,8,3
0,3,0.0,0.0,66833130,3,0
2,1,0.5,0.8,70718970,2,1
2,2,0.5,0.75,70808290,4,2
2,1,0.6666666666666666,0.6666666666666666,69701933,3,2
2,0,1.0,1.0,70189371,2,2
2,1,0.5,0.6666666666666666,69555220,2,1
2,2,0.5,0.8333333333333334,69992720,4,2
0,3,0.25,0.0,80137566,4,1
2,0,1.0,1.0,80134822,1,1
2,0,1.0,1.0,82054719,1,1
2,0,1.0,1.0,80159275,1,1
2,0,1.0,1.0,82020767,1,1
0,3,0.25,0.0,73102834,4,1
0,1,0.0,0.0,82054053,1,0
2,0,1.0,1.0,80178173,2,2
2,0,1.0,1.0,66359202,5,5
2,0,1.0,1.0,82041573,1,1
2,0,1.0,1.0,12299222,1,1
2,0,1.0,1.0,70717122,4,4
2,1,0.6666666666666666,0.5,67259801,3,2
1,6,0.25,0.7567567567567568,82143727,8,2
0,7,0.0,0.0,70680260,7,0
2,1,0.5,0.9285714285714286,67900441,2,1
2,1,0.875,0.75,80131222,8,7
0,2,0.0,0.0,66783073,2,0
2,0,1.0,1.0,63114996,3,3
2,0,1.0,1.0,73870321,1,1
1,2,0.3333333333333333,0.8888888888888888,80150546,3,1
2,0,1.0,1.0,79989602,1,1
2,1,0.6666666666666666,0.6666666666666666,69594896,3,2
0,1,0.0,0.0,82119916,1,0
2,0,1.0,1.0,82052076,5,5
2,1,0.75,0.5,80135605,4,3
1,3,0.25,0.6,69886222,4,1
0,1,0.0,0.0,80145777,1,0
2,1,0.5,0.9,76575674,2,1
0,5,0.2857142857142857,0.3888888888888889,80105214,7,2
0,1,0.0,0.0,82019702,1,0
2,1,0.6666666666666666,0.5,71416520,3,2
0,3,0.0,0.0,72785853,3,0
2,0,1.0,1.0,82037964,1,1
2,0,1.0,1.0,70927633,1,1
1,7,0.4166666666666667,0.9473684210526315,65709840,12,5
2,0,1.0,1.0,82200608,1,1
2,0,1.0,1.0,67307184,3,3
2,0,1.0,1.0,61599734,1,1
2,1,0.75,0.8333333333333334,82017796,4,3
1,7,0.3,0.6666666666666666,82096304,10,3
0,1,0.0,0.0,82110399,1,0
1,6,0.3333333333333333,0.5,80163670,9,3
0,1,0.0,0.0,70743652,1,0
2,1,0.75,0.6666666666666666,66238144,4,3
0,1,0.0,0.0,70758534,1,0
0,2,0.0,0.0,70407491,2,0
0,2,0.0,0.0,70407505,2,0
0,6,0.0,0.0,70701946,6,0
2,1,0.5,0.8,80003595,2,1
0,1,0.0,0.0,80145837,1,0
0,3,0.0,0.0,82024276,3,0
2,1,0.6666666666666666,0.8333333333333334,72337300,3,2
1,4,0.3333333333333333,0.6111111111111112,74027835,6,2
2,2,0.5,0.9285714285714286,66228456,4,2
2,0,1.0,1.0,82059906,1,1
0,1,0.0,0.0,70940275,1,0
0,4,0.0,0.0,80165170,4,0
2,1,0.5,0.0,65249632,2,1
2,1,0.6666666666666666,0.8333333333333334,67917605,3,2
0,2,0.0,0.0,80150680,2,0
0,4,0.0,0.0,82205856,4,0
0,6,0.0,0.0,80150636,6,0
0,7,0.0,0.0,80163174,7,0
0,1,0.0,0.0,80173400,1,0
0,3,0.0,0.0,80150629,3,0
0,7,0.0,0.0,82102653,7,0
2,1,0.6666666666666666,0.6666666666666666,70821380,3,2
0,1,0.0,0.0,70916685,1,0
2,0,1.0,1.0,70062300,3,3
0,2,0.0,0.0,70704116,2,0
1,4,0.3333333333333333,0.75,72816695,6,2
0,1,0.0,0.0,67289922,1,0
0,2,0.0,0.0,69160546,2,0
2,1,0.6666666666666666,0.5,67485810,3,2
2,1,0.5,0.6666666666666666,82070185,2,1
0,12,0.0,0.0,70515361,12,0
0,1,0.0,0.0,79453192,1,0
0,2,0.0,0.0,69007281,2,0
0,2,0.0,0.0,70685244,2,0
0,8,0.0,0.0,82102912,8,0
2,1,0.8888888888888888,0.5,82019737,9,8
0,3,0.0,0.0,66784844,3,0
2,1,0.8,0.75,82110450,5,4
2,1,0.5,0.6666666666666666,80163445,2,1
0,7,0.0,0.0,72808883,7,0
2,0,1.0,1.0,69213452,1,1
2,0,1.0,1.0,67545562,1,1
2,1,0.5,0.75,70835401,2,1
0,2,0.0,0.0,70702086,2,0
0,3,0.0,0.0,70703353,3,0
0,4,0.2,0.2857142857142857,69912430,5,1
0,13,0.13333333333333333,0.38,65282714,15,2
1,5,0.16666666666666666,0.53125,70694960,6,1
0,3,0.25,0.2222222222222222,80150234,4,1
2,0,1.0,1.0,80092824,1,1
2,0,1.0,1.0,68157201,2,2
0,3,0.0,0.0,13776364,3,0
2,0,1.0,1.0,75361762,2,2
1,7,0.4166666666666667,0.7142857142857143,69974520,12,5
2,0,1.0,1.0,73403316,2,2
2,0,1.0,1.0,82102195,1,1
2,0,1.0,1.0,67257022,1,1
0,5,0.2857142857142857,0.0,80126602,7,2
2,0,1.0,1.0,80136550,16,16
2,1,0.9230769230769231,0.5,70411264,13,12
2,0,1.0,1.0,82053165,3,3
2,0,1.0,1.0,82095273,1,1
2,0,1.0,1.0,82090252,1,1
1,4,0.42857142857142855,0.7777777777777778,70680225,7,3
0,1,0.0,0.0,67286156,1,0
0,8,0.0,0.0,69724291,8,0
2,0,1.0,1.0,70576373,6,6
0,3,0.0,0.0,69424271,3,0
0,2,0.0,0.0,82134967,2,0
0,3,0.0,0.0,72660301,3,0
0,1,0.0,0.0,69693316,1,0
0,1,0.0,0.0,69693890,1,0
2,1,0.8,0.6666666666666666,69144453,5,4
2,0,1.0,1.0,73632384,2,2
2,2,0.7142857142857143,0.9230769230769231,70615111,7,5
2,1,0.5,0.75,70694554,2,1
0,2,0.0,0.0,65899645,2,0
1,6,0.4,0.5,65899904,10,4
1,2,0.3333333333333333,0.8333333333333334,70691586,3,1
1,2,0.3333333333333333,0.8571428571428571,82206153,3,1
0,1,0.0,0.0,67334043,1,0
2,1,0.6666666666666666,0.8571428571428571,67184110,3,2
0,5,0.16666666666666666,0.391304347826087,82102492,6,1
0,7,0.0,0.0,82102630,7,0
1,2,0.3333333333333333,0.6666666666666666,65286214,3,1
0,1,0.0,0.0,65290932,1,0
0,3,0.0,0.0,70608895,3,0
0,8,0.1111111111111111,0.4444444444444444,68199663,9,1
2,0,1.0,1.0,80134826,1,1
2,1,0.5,0.8,80126781,2,1
2,0,1.0,1.0,80083696,5,5
2,0,1.0,1.0,69213235,1,1
2,1,0.5,0.5,64190420,2,1
2,0,1.0,1.0,82053042,1,1
2,0,1.0,1.0,67823301,3,3
0,2,0.0,0.0,69644666,2,0
0,2,0.0,0.0,70491176,2,0
2,1,0.75,0.5,70646394,4,3
1,4,0.3333333333333333,0.7857142857142857,68401886,6,2
0,1,0.0,0.0,79617573,1,0
0,2,0.3333333333333333,0.4166666666666667,79617580,3,1
2,0,1.0,1.0,79849140,1,1
0,1,0.0,0.0,82021463,1,0
2,4,0.5555555555555556,0.5,67822993,9,5
2,3,0.5,0.6666666666666666,70861812,6,3
2,1,0.75,0.5,69611325,4,3
2,0,1.0,1.0,80150232,1,1
2,0,1.0,1.0,69885046,1,1
2,1,0.5,0.75,80069920,2,1
0,2,0.3333333333333333,0.3333333333333333,74882542,3,1
0,1,0.0,0.0,68341560,1,0
2,1,0.5,0.3333333333333333,68341574,2,1
2,1,0.5,0.5,70492002,2,1
0,1,0.0,0.0,70744191,1,0
1,2,0.3333333333333333,0.8333333333333334,73632454,3,1
0,2,0.0,0.0,80124326,2,0
0,4,0.0,0.0,70545902,4,0
2,0,1.0,1.0,73651123,2,2
0,3,0.25,0.4827586206896552,70743421,4,1
2,1,0.8888888888888888,0.6666666666666666,80176363,9,8
1,3,0.4,0.6666666666666666,80054030,5,2
0,1,0.0,0.0,66231606,1,0
2,1,0.8571428571428571,0.5,69049393,7,6
0,1,0.0,0.0,70527415,1,0
1,12,0.25,0.5,65289966,16,4
1,5,0.375,0.9,80180338,8,3
2,2,0.5,0.625,82023077,4,2
0,2,0.0,0.0,70524405,2,0
0,1,0.0,0.0,62563816,1,0
2,0,1.0,1.0,68805534,1,1
2,1,0.6666666666666666,0.5,71278704,3,2
2,0,1.0,1.0,80093720,1,1
0,3,0.0,0.0,82010250,3,0
0,2,0.0,0.0,82205612,2,0
2,0,1.0,1.0,82019663,2,2
0,4,0.0,0.0,80165755,4,0
0,2,0.0,0.0,69911940,2,0
1,5,0.16666666666666666,0.819672131147541,80150717,6,1
0,7,0.0,0.0,82102862,7,0
1,7,0.125,0.54,66804052,8,1
0,4,0.2,0.2727272727272727,70463225,5,1
2,0,1.0,1.0,80171056,1,1
1,8,0.2727272727272727,0.8888888888888888,82032905,11,3
0,5,0.0,0.0,69912136,5,0
0,5,0.0,0.0,80172663,5,0
0,1,0.0,0.0,280154,1,0
0,2,0.3333333333333333,0.0,70770693,3,1
2,2,0.6,0.6666666666666666,74708942,5,3
2,1,0.5,0.6666666666666666,82019924,2,1
2,0,1.0,1.0,82163467,1,1
2,0,1.0,1.0,68400724,1,1
0,3,0.25,0.4,68785066,4,1
2,0,1.0,1.0,82018702,2,2
0,1,0.0,0.0,80176690,1,0
0,1,0.0,0.0,67208442,1,0
0,2,0.0,0.0,80128043,2,0
2,0,1.0,1.0,68747553,1,1
0,4,0.0,0.0,68254851,4,0
1,2,0.3333333333333333,0.8928571428571429,71212274,3,1
2,0,1.0,1.0,80095036,1,1
0,1,0.0,0.0,82019826,1,0
0,4,0.0,0.0,66782170,4,0
0,3,0.0,0.0,64338113,3,0
0,6,0.14285714285714285,0.4074074074074074,70743232,7,1
0,7,0.0,0.0,70679882,7,0
0,4,0.0,0.0,82018747,4,0
0,1,0.0,0.0,70685174,1,0
2,0,1.0,1.0,82039353,10,10
0,5,0.0,0.0,64133531,5,0
0,6,0.14285714285714285,0.0625,80105011,7,1
2,0,1.0,1.0,69623694,1,1
2,0,1.0,1.0,63036043,3,3
2,0,1.0,1.0,80136698,2,2
0,4,0.2,0.26666666666666666,66081323,5,1
2,4,0.6363636363636364,0.9230769230769231,65279606,11,7
2,0,1.0,1.0,63819595,2,2
0,1,0.0,0.0,72474752,1,0
2,0,1.0,1.0,82018976,5,5
2,0,1.0,1.0,82025201,2,2
2,1,0.6666666666666666,0.0,82038283,3,2
0,2,0.0,0.0,82184061,2,0
0,2,0.0,0.0,82184062,2,0
2,0,1.0,1.0,69979812,2,2
2,0,1.0,1.0,82025184,1,1
2,0,1.0,1.0,80176865,3,3
2,1,0.5,0.5,80125208,2,1
2,0,1.0,1.0,82041868,1,1
2,0,1.0,1.0,69979756,4,4
2,2,0.6,0.8,82061899,5,3
2,0,1.0,1.0,82025189,3,3
2,1,0.75,0.9166666666666666,80176655,4,3
0,2,0.0,0.0,69943454,2,0
2,0,1.0,1.0,69634544,1,1
2,2,0.6,0.8333333333333334,69314980,5,3
2,1,0.6666666666666666,0.6666666666666666,70802823,3,2
0,3,0.0,0.0,72910124,3,0
0,3,0.0,0.0,82019463,3,0
0,3,0.0,0.0,82019425,3,0
1,6,0.25,0.7777777777777778,82022542,8,2
0,1,0.0,0.0,69394570,1,0
1,4,0.2,0.5714285714285714,67754505,5,1
2,1,0.5,0.75,74129412,2,1
2,0,1.0,1.0,69638016,1,1
0,4,0.2,0.46153846153846156,66785033,5,1
1,3,0.4,0.75,70596050,5,2
0,1,0.0,0.0,67053301,1,0
0,1,0.0,0.0,80126865,1,0
0,1,0.0,0.0,70509320,1,0
0,4,0.0,0.0,70049476,4,0
2,4,0.6363636363636364,0.8181818181818182,66337852,11,7
2,1,0.6666666666666666,0.5,80141344,3,2
2,0,1.0,1.0,80145788,1,1
2,1,0.6666666666666666,0.9444444444444444,70238840,3,2
2,1,0.5,0.6666666666666666,63632814,2,1
2,1,0.5,0.6666666666666666,69071464,2,1
1,4,0.3333333333333333,0.6666666666666666,80051622,6,2
0,2,0.0,0.0,67876025,2,0
2,0,1.0,1.0,70492870,1,1
2,0,1.0,1.0,82247760,1,1
2,1,0.5,0.5,80130664,2,1
0,4,0.0,0.0,65280936,4,0
2,0,1.0,1.0,80165298,5,5
2,0,1.0,1.0,80125202,2,2
0,3,0.0,0.0,58873815,3,0
2,1,0.5,0.6666666666666666,68285756,2,1
2,0,1.0,1.0,82014477,5,5
0,2,0.0,0.0,82018906,2,0
0,4,0.0,0.0,68199733,4,0
2,0,1.0,1.0,66092621,2,2
1,2,0.3333333333333333,0.8,70700294,3,1
0,1,0.0,0.0,72332190,1,0
0,2,0.0,0.0,70073241,2,0
0,4,0.0,0.0,68607133,4,0
0,8,0.1111111111111111,0.11666666666666667,66225586,9,1
2,4,0.5,0.625,68192082,8,4
2,0,1.0,1.0,70071365,2,2
0,4,0.2,0.45454545454545453,82002246,5,1
2,1,0.8571428571428571,0.875,80118181,7,6
2,1,0.5,0.25,69660563,2,1
2,0,1.0,1.0,74058600,3,3
2,0,1.0,1.0,67584090,1,1
2,0,1.0,1.0,82239989,2,2
2,1,0.8333333333333334,0.8333333333333334,67779782,6,5
0,1,0.0,0.0,71458765,1,0
0,2,0.3333333333333333,0.25,80134750,3,1
2,0,1.0,1.0,69168666,1,1
0,4,0.0,0.0,80128176,4,0
0,7,0.0,0.0,82102586,7,0
0,2,0.0,0.0,67703685,2,0
1,7,0.46153846153846156,0.9166666666666666,68625711,13,6
0,1,0.0,0.0,68541956,1,0
0,1,0.0,0.0,68545743,1,0
1,2,0.3333333333333333,0.8666666666666667,71212295,3,1
2,4,0.5555555555555556,0.9,68400612,9,5
1,3,0.25,0.9230769230769231,80150579,4,1
0,6,0.0,0.0,80150582,6,0
0,5,0.0,0.0,70918736,5,0
2,1,0.5,0.5,82006856,2,1
0,2,0.0,0.0,80167234,2,0
1,4,0.2,0.7857142857142857,69133743,5,1
1,2,0.3333333333333333,0.8333333333333334,80172656,3,1
1,4,0.3333333333333333,0.8421052631578947,82006197,6,2
0,1,0.0,0.0,82102869,1,0
0,3,0.0,0.0,82006868,3,0
0,6,0.0,0.0,80150654,6,0
0,2,0.0,0.0,80150532,2,0
1,4,0.2,0.5833333333333334,70463463,5,1
0,4,0.0,0.0,67804961,4,0
0,1,0.0,0.0,82152436,1,0
0,2,0.0,0.0,80165865,2,0
0,2,0.0,0.0,80163402,2,0
1,5,0.16666666666666666,0.5,78506953,6,1
0,3,0.0,0.0,78506981,3,0
0,8,0.1111111111111111,0.1,70638120,9,1
0,4,0.2,0.3076923076923077,70704221,5,1
2,0,1.0,1.0,80165255,3,3
0,1,0.0,0.0,68532205,1,0
0,3,0.0,0.0,65830583,3,0
0,1,0.0,0.0,69980155,1,0
0,1,0.0,0.0,72480506,1,0
2,0,1.0,1.0,80176464,2,2
0,5,0.2857142857142857,0.18181818181818182,66256841,7,2
0,1,0.0,0.0,80124797,1,0
0,1,0.0,0.0,80124801,1,0
0,10,0.0,0.0,82102612,10,0
2,0,1.0,1.0,66933195,1,1
0,5,0.0,0.0,82137458,5,0
0,1,0.0,0.0,82137506,1,0
0,1,0.0,0.0,82137507,1,0
2,0,1.0,1.0,67276860,1,1
1,2,0.3333333333333333,0.6666666666666666,66379446,3,1
2,1,0.8,0.75,82039327,5,4
2,3,0.7272727272727273,0.8461538461538461,82020069,11,8
0,1,0.0,0.0,69575191,1,0
1,4,0.3333333333333333,0.5625,70252952,6,2
2,0,1.0,1.0,80047072,1,1
2,1,0.5,0.6666666666666666,80150238,2,1
2,0,1.0,1.0,74043935,5,5
0,4,0.2,0.14285714285714285,80054695,5,1
2,0,1.0,1.0,82145145,5,5
2,1,0.5,0.6666666666666666,70674863,2,1
2,0,1.0,1.0,82205601,1,1
2,0,1.0,1.0,80165299,1,1
2,0,1.0,1.0,70074333,9,9
1,3,0.25,0.875,67846254,4,1
2,0,1.0,1.0,72111865,2,2
2,0,1.0,1.0,66257205,2,2
2,0,1.0,1.0,82138707,1,1
2,1,0.75,0.9130434782608695,82036968,4,3
2,1,0.6666666666666666,0.5,68340902,3,2
0,1,0.0,0.0,70759654,1,0
2,0,1.0,1.0,68656224,1,1
2,1,0.5,0.8333333333333334,70599123,2,1
0,1,0.0,0.0,77676326,1,0
2,1,0.75,0.8,80135296,4,3
0,2,0.0,0.0,82006245,2,0
1,3,0.25,0.7142857142857143,64469412,4,1
0,3,0.0,0.0,66786650,3,0
1,3,0.25,0.625,66786664,4,1
0,1,0.0,0.0,82039884,1,0
0,3,0.25,0.38461538461538464,80176629,4,1
2,1,0.6666666666666666,0.5,80122941,3,2
2,1,0.5,0.0,82182808,2,1
1,7,0.46153846153846156,0.9459459459459459,69557152,13,6
1,4,0.3333333333333333,0.5882352941176471,70694043,6,2
2,0,1.0,1.0,82105386,3,3
2,1,0.5,0.0,82170911,2,1
1,4,0.2,0.5,66110590,5,1
2,1,0.5,0.6666666666666666,70475076,2,1
2,0,1.0,1.0,70753011,1,1
1,4,0.2,0.5,69644771,5,1
0,3,0.0,0.0,80176801,3,0
1,2,0.3333333333333333,0.5714285714285714,72804151,3,1
0,6,0.0,0.0,72809310,6,0
2,3,0.7,0.8,66061450,10,7
2,1,0.5,0.5,67822986,2,1
0,3,0.25,0.2,70179746,4,1
1,5,0.4444444444444444,0.9047619047619048,69997606,9,4
0,3,0.25,0.4,65859864,4,1
0,4,0.0,0.0,80145829,4,0
0,4,0.0,0.0,67403784,4,0
0,5,0.16666666666666666,0.2727272727272727,80168107,6,1
0,2,0.0,0.0,82090201,2,0
0,4,0.2,0.2727272727272727,80051881,5,1
2,0,1.0,1.0,79462530,1,1
0,3,0.25,0.4,69729282,4,1
2,1,0.5,0.6666666666666666,72814154,2,1
2,0,1.0,1.0,65256842,1,1
0,1,0.0,0.0,67667180,1,0
0,4,0.0,0.0,67434675,4,0
2,0,1.0,1.0,82061928,2,2
2,2,0.5,0.9230769230769231,69021036,4,2
2,1,0.5,0.6666666666666666,70720874,2,1
2,1,0.6666666666666666,0.6666666666666666,70682073,3,2
0,1,0.0,0.0,64248884,1,0
2,0,1.0,1.0,68573876,2,2
0,2,0.0,0.0,70704662,2,0
0,6,0.0,0.0,82102505,6,0
1,3,0.4,0.8,71618855,5,2
0,1,0.0,0.0,79793875,1,0
2,1,0.5,0.8333333333333334,79795793,2,1
0,2,0.0,0.0,68748673,2,0
2,0,1.0,1.0,80159669,1,1
2,1,0.5,0.6666666666666666,70746186,2,1
0,2,0.0,0.0,82006326,2,0
1,6,0.3333333333333333,0.56,69522894,9,3
0,1,0.0,0.0,82006651,1,0
1,3,0.25,0.9411764705882353,80150614,4,1
1,2,0.3333333333333333,0.8571428571428571,80162783,3,1
0,3,0.0,0.0,80165859,3,0
1,4,0.2,0.5263157894736842,80163378,5,1
0,3,0.0,0.0,80131220,3,0
1,7,0.2222222222222222,0.68,69407121,9,2
0,5,0.16666666666666666,0.18181818181818182,80131205,6,1
0,1,0.0,0.0,69951840,1,0
0,3,0.0,0.0,80150526,3,0
1,3,0.25,0.6666666666666666,80172547,4,1
0,2,0.0,0.0,64227464,2,0
0,1,0.0,0.0,70672203,1,0
0,1,0.0,0.0,78858626,1,0
0,1,0.0,0.0,82062266,1,0
0,1,0.0,0.0,82206185,1,0
0,3,0.25,0.42857142857142855,76904345,4,1
2,0,1.0,1.0,80135286,1,1
2,1,0.6666666666666666,0.875,70283045,3,2
2,0,1.0,1.0,68784324,1,1
0,3,0.25,0.125,69049414,4,1
2,1,0.5,0.5,82015756,2,1
2,3,0.5,0.875,69597563,6,3
2,1,0.6666666666666666,0.8333333333333334,70753081,3,2
2,1,0.5,0.75,69546015,2,1
1,3,0.25,0.5,65289973,4,1
2,1,0.5,0.75,65352301,2,1
2,0,1.0,1.0,75362616,1,1
0,1,0.0,0.0,82090168,1,0
0,1,0.0,0.0,82090169,1,0
0,1,0.0,0.0,82090170,1,0
0,1,0.0,0.0,82090171,1,0
0,1,0.0,0.0,82090172,1,0
0,1,0.0,0.0,82090173,1,0
2,0,1.0,1.0,66848635,1,1
0,3,0.0,0.0,66784921,3,0
0,4,0.0,0.0,68390084,4,0
0,1,0.0,0.0,70818300,1,0
2,0,1.0,1.0,65972935,2,2
2,1,0.5,0.6666666666666666,80051300,2,1
2,0,1.0,1.0,69547905,1,1
0,2,0.0,0.0,72759764,2,0
0,2,0.0,0.0,69707932,2,0
2,0,1.0,1.0,70415590,1,1
0,2,0.0,0.0,69549662,2,0
0,2,0.0,0.0,70197554,2,0
2,1,0.5,0.8,70250831,2,1
2,1,0.5,0.6666666666666666,67779803,2,1
2,2,0.6666666666666666,0.75,70531083,6,4
2,0,1.0,1.0,80080042,1,1
2,0,1.0,1.0,72445982,5,5
0,1,0.0,0.0,82023760,1,0
2,0,1.0,1.0,70026642,4,4
2,0,1.0,1.0,79792335,4,4
2,0,1.0,1.0,73900141,10,10
2,0,1.0,1.0,82102172,2,2
0,2,0.0,0.0,73444840,2,0
0,1,0.0,0.0,70183911,1,0
2,0,1.0,1.0,82046290,1,1
2,0,1.0,1.0,82018617,4,4
2,0,1.0,1.0,82110462,4,4
0,7,0.0,0.0,70820050,7,0
2,0,1.0,1.0,70460243,1,1
0,2,0.0,0.0,66782331,2,0
0,1,0.0,0.0,66787154,1,0
0,7,0.0,0.0,70683242,7,0
0,5,0.0,0.0,70923846,5,0
2,0,1.0,1.0,68457970,1,1
2,0,1.0,1.0,80132970,1,1
0,2,0.0,0.0,67260004,2,0
1,3,0.25,0.5333333333333333,80113642,4,1
2,2,0.6666666666666666,0.8571428571428571,80132789,6,4
0,7,0.36363636363636365,0.14285714285714285,80176058,11,4
2,0,1.0,1.0,66225376,2,2
2,1,0.5,0.5,82121148,2,1
0,1,0.0,0.0,82121173,1,0
0,1,0.0,0.0,70207893,1,0
1,3,0.4,0.95,80163448,5,2
0,1,0.0,0.0,80163450,1,0
0,1,0.0,0.0,65291275,1,0
2,1,0.5,0.5,70408023,2,1
2,0,1.0,1.0,68544924,1,1
2,1,0.5,0.0,80165238,2,1
0,2,0.0,0.0,70587776,2,0
0,4,0.2,0.375,70685881,5,1
2,0,1.0,1.0,67657044,1,1
2,0,1.0,1.0,80163447,1,1
1,3,0.25,0.5,69626305,4,1
0,1,0.0,0.0,82012794,1,0
2,0,1.0,1.0,69033594,2,2
1,3,0.4,0.8,69412630,5,2
0,9,0.0,0.0,70685601,9,0
0,1,0.0,0.0,69582996,1,0
0,2,0.0,0.0,70675206,2,0
0,5,0.0,0.0,70679343,5,0
0,2,0.0,0.0,82022334,2,0
0,3,0.0,0.0,69483974,3,0
0,1,0.0,0.0,73623844,1,0
2,0,1.0,1.0,80176634,1,1
2,0,1.0,1.0,80128784,4,4
2,1,0.5,0.8333333333333334,70747852,2,1
2,3,0.5,0.972972972972973,74923996,6,3
2,0,1.0,1.0,67744635,3,3
0,2,0.0,0.0,68812373,2,0
2,2,0.6,0.6666666666666666,79980145,5,3
2,0,1.0,1.0,70078043,3,3
0,3,0.25,0.3,70525315,4,1
0,6,0.25,0.4,80153631,8,2
0,1,0.0,0.0,69863241,1,0
0,3,0.0,0.0,70746333,3,0
0,1,0.0,0.0,70759360,1,0
0,4,0.0,0.0,69693554,4,0
0,1,0.0,0.0,69693701,1,0
0,1,0.0,0.0,69469134,1,0
1,3,0.25,0.8636363636363636,71341830,4,1
1,2,0.3333333333333333,0.5714285714285714,70413490,3,1
2,0,1.0,1.0,66848544,1,1
1,4,0.3333333333333333,0.6666666666666666,60591545,6,2
0,4,0.2,0.2,80135806,5,1
1,2,0.3333333333333333,0.6,80167315,3,1
1,6,0.4,0.8518518518518519,82006874,10,4
0,4,0.0,0.0,70821352,4,0
0,8,0.0,0.0,69234816,8,0
2,0,1.0,1.0,80168242,1,1
0,4,0.0,0.0,80131201,4,0
2,0,1.0,1.0,82012801,2,2
2,0,1.0,1.0,69161085,1,1
2,2,0.5,0.8333333333333334,62957671,4,2
0,2,0.0,0.0,68327686,2,0
2,1,0.5,0.6666666666666666,82054037,2,1
2,1,0.6666666666666666,0.75,82019649,3,2
2,1,0.5,0.8571428571428571,68413611,2,1
2,0,1.0,1.0,69712811,1,1
0,1,0.0,0.0,70698600,1,0
0,2,0.0,0.0,70698796,2,0
0,3,0.0,0.0,69700946,3,0
0,1,0.0,0.0,69700953,1,0
2,0,1.0,1.0,80136558,2,2
0,5,0.16666666666666666,0.38461538461538464,70175756,6,1
1,6,0.25,0.6341463414634146,70682143,8,2
1,5,0.2857142857142857,0.8695652173913043,71458905,7,2
2,1,0.5,0.6666666666666666,70683550,2,1
0,2,0.0,0.0,79678711,2,0
2,0,1.0,1.0,65043083,7,7
0,2,0.0,0.0,67277616,2,0
2,1,0.5,0.6666666666666666,68805604,2,1
2,0,1.0,1.0,70705796,1,1
0,1,0.0,0.0,69603310,1,0
0,4,0.0,0.0,70680666,4,0
2,0,1.0,1.0,69972966,4,4
1,9,0.4,0.7777777777777778,69469141,15,6
0,1,0.0,0.0,70683690,1,0
2,1,0.6666666666666666,0.5,80150364,3,2
2,1,0.8,0.5,82145104,5,4
0,1,0.0,0.0,70598241,1,0
0,1,0.0,0.0,70598255,1,0
2,0,1.0,1.0,82033524,3,3
2,0,1.0,1.0,70925155,2,2
1,4,0.42857142857142855,0.5,70257033,7,3
0,1,0.0,0.0,80119186,1,0
2,0,1.0,1.0,82024246,4,4
2,1,0.5,0.5,82039423,2,1
2,0,1.0,1.0,82059899,2,2
2,0,1.0,1.0,82042079,1,1
2,0,1.0,1.0,80162128,5,5
2,4,0.5,0.8181818181818182,80158307,8,4
2,0,1.0,1.0,80162170,3,3
2,0,1.0,1.0,80080105,9,9
0,1,0.0,0.0,66975251,1,0
0,1,0.0,0.0,66975265,1,0
2,1,0.5,0.6666666666666666,82090266,2,1
2,1,0.875,0.0,70593943,8,7
0,1,0.0,0.0,67286121,1,0
0,1,0.0,0.0,82022972,1,0
1,3,0.4,0.8181818181818182,80118139,5,2
2,1,0.5,0.5882352941176471,80178934,2,1
1,4,0.2,0.5789473684210527,72802142,5,1
2,2,0.5,0.8888888888888888,73801035,4,2
0,2,0.3333333333333333,0.3333333333333333,70599900,3,1
0,2,0.0,0.0,70701981,2,0
2,1,0.5,0.75,67259976,2,1
2,0,1.0,1.0,77112875,1,1
2,0,1.0,1.0,69215034,3,3
1,2,0.3333333333333333,0.5,69064443,3,1
2,1,0.5,0.5,69604101,2,1
0,2,0.3333333333333333,0.4,82185022,3,1
2,0,1.0,1.0,80159728,3,3
2,1,0.5,0.6666666666666666,82037229,2,1
0,1,0.0,0.0,70698656,1,0
2,3,0.6666666666666666,0.9473684210526315,82017804,9,6
0,1,0.0,0.0,70474460,1,0
0,4,0.2,0.15384615384615385,67656911,5,1
0,3,0.0,0.0,67835194,3,0
2,2,0.5,0.6,75346411,4,2
1,4,0.42857142857142855,0.75,70052010,7,3
2,0,1.0,1.0,72768423,1,1
2,0,1.0,1.0,293601,1,1
0,1,0.0,0.0,79030056,1,0
0,1,0.0,0.0,67259962,1,0
0,3,0.4,0.0,66069640,5,2
0,2,0.0,0.0,69482931,2,0
0,5,0.0,0.0,64956766,5,0
1,4,0.2,0.5384615384615384,70489104,5,1
2,1,0.6666666666666666,0.5,65276771,3,2
2,0,1.0,1.0,79976526,4,4
0,1,0.0,0.0,68173651,1,0
2,0,1.0,1.0,68943000,1,1
2,0,1.0,1.0,80174115,1,1
2,1,0.5,0.6666666666666666,82015867,2,1
0,2,0.0,0.0,70814555,2,0
2,0,1.0,1.0,80162558,1,1
0,1,0.0,0.0,69334685,1,0
2,1,0.6666666666666666,0.5,67600232,3,2
0,2,0.0,0.0,70703003,2,0
2,0,1.0,1.0,82245624,1,1
2,0,1.0,1.0,68242594,2,2
0,1,0.0,0.0,68530056,1,0
0,2,0.0,0.0,69006854,2,0
0,3,0.0,0.0,70509481,3,0
2,1,0.5,0.6666666666666666,69945575,2,1
0,1,0.0,0.0,82024319,1,0
2,0,1.0,1.0,72801680,2,2
0,4,0.0,0.0,70062552,4,0
0,3,0.25,0.2857142857142857,78858892,4,1
0,2,0.0,0.0,65295286,2,0
0,2,0.0,0.0,65942765,2,0
0,2,0.0,0.0,69908573,2,0
0,9,0.0,0.0,80167277,9,0
0,1,0.0,0.0,82006309,1,0
1,4,0.3333333333333333,0.9411764705882353,82103920,6,2
1,2,0.3333333333333333,0.8461538461538461,82006866,3,1
0,2,0.0,0.0,67838393,2,0
2,1,0.8,0.0,82143387,5,4
0,1,0.0,0.0,70909041,1,0
0,3,0.0,0.0,70842450,3,0
0,1,0.0,0.0,67290664,1,0
0,1,0.0,0.0,68563390,1,0
2,1,0.5,0.5,69500340,2,1
2,2,0.5,0.8,72775563,4,2
2,0,1.0,1.0,70467691,4,4
0,1,0.0,0.0,69117090,1,0
0,3,0.0,0.0,82102588,3,0
0,1,0.0,0.0,70591920,1,0
1,9,0.18181818181818182,0.5454545454545454,67498690,11,2
0,7,0.125,0.19047619047619047,68613993,8,1
0,1,0.0,0.0,67754771,1,0
0,3,0.0,0.0,82010297,3,0
2,0,1.0,1.0,82019845,2,2
0,6,0.14285714285714285,0.4642857142857143,66503066,7,1
0,1,0.0,0.0,67552583,1,0
0,1,0.0,0.0,68748001,1,0
2,2,0.5,0.6666666666666666,68748722,4,2
2,0,1.0,1.0,65116744,5,5
2,1,0.5,0.8333333333333334,70675976,2,1
2,1,0.5,0.75,68544630,2,1
0,1,0.0,0.0,67325055,1,0
2,3,0.6666666666666666,0.6,80176086,9,6
0,9,0.0,0.0,70703570,9,0
2,0,1.0,1.0,82143731,3,3
1,8,0.2,0.5434782608695652,69640781,10,2
0,3,0.25,0.14285714285714285,66379005,4,1
0,2,0.0,0.0,69164186,2,0
0,1,0.0,0.0,82022391,1,0
2,0,1.0,1.0,68586595,1,1
2,3,0.5714285714285714,0.9090909090909091,70609973,7,4
0,2,0.3333333333333333,0.25,72803591,3,1
2,0,1.0,1.0,69553841,1,1
2,0,1.0,1.0,80067351,1,1
2,0,1.0,1.0,80174147,1,1
2,0,1.0,1.0,80158279,1,1
2,0,1.0,1.0,82145171,3,3
2,1,0.6666666666666666,0.5,70493542,3,2
2,0,1.0,1.0,82054703,1,1
2,0,1.0,1.0,82102183,3,3
2,0,1.0,1.0,73652271,2,2
2,0,1.0,1.0,67258695,1,1
2,0,1.0,1.0,80091872,1,1
0,1,0.0,0.0,80114783,1,0
0,1,0.0,0.0,68536146,1,0
2,0,1.0,1.0,69522901,3,3
0,4,0.0,0.0,82206191,4,0
2,1,0.5,0.5,69464472,2,1
0,2,0.0,0.0,70822290,2,0
0,3,0.0,0.0,66782324,3,0
0,3,0.0,0.0,66782492,3,0
0,7,0.125,0.1,70718284,8,1
2,0,1.0,1.0,60585133,1,1
0,9,0.0,0.0,66111220,9,0
0,2,0.0,0.0,70489461,2,0
2,0,1.0,1.0,82135136,1,1
2,0,1.0,1.0,13734462,3,3
1,4,0.42857142857142855,0.75,68512766,7,3
2,0,1.0,1.0,80152994,5,5
1,3,0.4,0.6,72692032,5,2
2,1,0.6666666666666666,0.9090909090909091,70843633,3,2
0,3,0.0,0.0,82019455,3,0
0,1,0.0,0.0,72813783,1,0
0,2,0.0,0.0,73295614,2,0
0,2,0.0,0.0,68784184,2,0
2,2,0.6666666666666666,0.9166666666666666,80150331,6,4
0,2,0.0,0.0,70703381,2,0
0,8,0.1111111111111111,0.36,73295600,9,1
2,1,0.5,0.0,66859835,2,1
2,0,1.0,1.0,60909142,1,1
2,0,1.0,1.0,70238413,1,1
2,1,0.8333333333333334,0.8333333333333334,80155252,6,5
1,2,0.3333333333333333,0.6,68391106,3,1
0,1,0.0,0.0,68391533,1,0
2,1,0.5,0.7777777777777778,68391561,2,1
0,1,0.0,0.0,82041915,1,0
2,1,0.6666666666666666,0.0,80181403,3,2
2,0,1.0,1.0,69840785,5,5
0,1,0.0,0.0,70694050,1,0
2,1,0.8888888888888888,0.5,72822652,9,8
0,2,0.0,0.0,70675626,2,0
2,1,0.5,0.5,82069228,2,1
0,5,0.0,0.0,70927374,5,0
0,1,0.0,0.0,69954395,1,0
1,4,0.42857142857142855,0.9333333333333333,82036406,7,3
0,1,0.0,0.0,67118506,1,0
2,2,0.5,0.6666666666666666,80150933,4,2
2,0,1.0,1.0,82024305,1,1
0,1,0.0,0.0,73870230,1,0
2,1,0.6666666666666666,0.5,70671832,3,2
2,1,0.6666666666666666,0.5,82040652,3,2
2,1,0.6666666666666666,0.0,65951025,3,2
2,1,0.5,0.8333333333333334,70694995,2,1
0,1,0.0,0.0,67094531,1,0
0,3,0.0,0.0,70694645,3,0
0,1,0.0,0.0,70744261,1,0
1,5,0.375,0.5833333333333334,70509033,8,3
0,3,0.25,0.375,67654783,4,1
0,1,0.0,0.0,78589483,1,0
0,3,0.25,0.2857142857142857,70415541,4,1
1,2,0.3333333333333333,0.5,69611346,3,1
2,0,1.0,1.0,80126797,1,1
0,1,0.0,0.0,79989742,1,0
0,1,0.0,0.0,65008181,1,0
2,0,1.0,1.0,73344873,1,1
0,1,0.0,0.0,70474705,1,0
0,4,0.0,0.0,80128353,4,0
1,2,0.3333333333333333,0.6,65602635,3,1
0,2,0.0,0.0,80150610,2,0
0,2,0.0,0.0,80165773,2,0
0,1,0.0,0.0,70629041,1,0
0,1,0.0,0.0,70629146,1,0
0,3,0.0,0.0,70629265,3,0
0,7,0.0,0.0,80163408,7,0
2,0,1.0,1.0,70759262,1,1
0,4,0.0,0.0,80172544,4,0
2,0,1.0,1.0,66631572,1,1
0,3,0.0,0.0,70696682,3,0
0,1,0.0,0.0,67259745,1,0
2,0,1.0,1.0,69958483,1,1
2,0,1.0,1.0,80128573,1,1
2,0,1.0,1.0,69530923,1,1
0,5,0.0,0.0,69495972,5,0
2,2,0.5,0.75,77528843,4,2
2,1,0.6666666666666666,0.9,69602876,3,2
0,1,0.0,0.0,67290482,1,0
0,2,0.3333333333333333,0.3333333333333333,69730101,3,1
2,0,1.0,1.0,72801505,1,1
0,1,0.0,0.0,69652996,1,0
0,7,0.2222222222222222,0.2,69616743,9,2
0,1,0.0,0.0,70493654,1,0
1,2,0.3333333333333333,0.6,67264106,3,1
0,1,0.0,0.0,70843521,1,0
2,0,1.0,1.0,80128020,1,1
0,2,0.0,0.0,80150350,2,0
0,1,0.0,0.0,82206019,1,0
0,1,0.0,0.0,70036960,1,0
2,0,1.0,1.0,81995638,2,2
0,2,0.0,0.0,66379110,2,0
0,4,0.0,0.0,65286732,4,0
2,0,1.0,1.0,69049953,4,4
0,2,0.0,0.0,70698775,2,0
0,4,0.0,0.0,67665486,4,0
0,9,0.0,0.0,82002407,9,0
0,1,0.0,0.0,67657604,1,0
0,1,0.0,0.0,82137452,1,0
0,1,0.0,0.0,70565383,1,0
0,3,0.0,0.0,72909732,3,0
0,2,0.3333333333333333,0.4,69981674,3,1
0,1,0.0,0.0,80131102,1,0
2,0,1.0,1.0,82018757,1,1
0,1,0.0,0.0,80145824,1,0
2,1,0.8333333333333334,0.6666666666666666,82055258,6,5
0,2,0.0,0.0,71358861,2,0
2,1,0.6666666666666666,0.6666666666666666,80125899,3,2
1,3,0.25,0.8260869565217391,66264933,4,1
2,0,1.0,1.0,74725672,2,2
0,1,0.0,0.0,70573391,1,0
2,0,1.0,1.0,82039336,2,2
2,0,1.0,1.0,80159174,1,1
2,0,1.0,1.0,82046216,2,2
2,0,1.0,1.0,82037535,1,1
0,3,0.0,0.0,82126258,3,0
2,1,0.75,0.6666666666666666,70183645,4,3
0,1,0.0,0.0,82126262,1,0
0,2,0.0,0.0,82126265,2,0
2,0,1.0,1.0,82102219,1,1
2,0,1.0,1.0,80162131,7,7
2,0,1.0,1.0,80175634,2,2
2,0,1.0,1.0,80175998,2,2
2,0,1.0,1.0,82039428,3,3
0,2,0.0,0.0,69478892,2,0
2,0,1.0,1.0,80128386,1,1
0,2,0.0,0.0,69637904,2,0
0,4,0.0,0.0,64045884,4,0
1,5,0.16666666666666666,0.5,67758880,6,1
2,0,1.0,1.0,68009200,1,1
2,0,1.0,1.0,68250014,2,2
2,1,0.5,0.6666666666666666,82202273,2,1
2,0,1.0,1.0,69554205,1,1
1,5,0.2857142857142857,0.7878787878787878,70660296,7,2
0,3,0.0,0.0,72785825,3,0
0,1,0.0,0.0,72785832,1,0
0,3,0.0,0.0,58873752,3,0
1,4,0.42857142857142855,0.9487179487179487,80176325,7,3
0,3,0.0,0.0,63109144,3,0
2,2,0.6666666666666666,0.6666666666666666,69997613,6,4
2,2,0.6666666666666666,0.75,68192075,6,4
2,1,0.5,0.75,68449682,2,1
0,1,0.0,0.0,82251452,1,0
2,0,1.0,1.0,67791934,1,1
0,1,0.0,0.0,82250576,1,0
2,2,0.5,0.8888888888888888,67833353,4,2
1,4,0.3333333333333333,0.8461538461538461,67833360,6,2
0,1,0.0,0.0,68058291,1,0
0,3,0.0,0.0,70703332,3,0
0,3,0.0,0.0,72439570,3,0
1,9,0.25,0.5833333333333334,68060531,12,3
0,4,0.2,0.0,80165158,5,1
1,4,0.2,0.5769230769230769,73537415,5,1
0,1,0.0,0.0,70185430,1,0
2,1,0.5,0.5,82040654,2,1
0,4,0.0,0.0,82038352,4,0
2,1,0.6666666666666666,0.5,67822734,3,2
0,3,0.0,0.0,67094111,3,0
0,1,0.0,0.0,69473621,1,0
0,2,0.0,0.0,82018941,2,0
0,1,0.0,0.0,67066846,1,0
2,1,0.6666666666666666,0.3333333333333333,67241965,3,2
0,2,0.0,0.0,70683263,2,0
2,1,0.5,0.7142857142857143,70405685,2,1
0,3,0.25,0.0,80127007,4,1
2,2,0.6666666666666666,0.6666666666666666,74386340,6,4
2,0,1.0,1.0,74619790,2,2
2,0,1.0,1.0,82007797,2,2
0,1,0.0,0.0,66374406,1,0
0,1,0.0,0.0,70693224,1,0
2,1,0.6666666666666666,0.5,70238553,3,2
0,1,0.0,0.0,68746720,1,0
0,1,0.0,0.0,68746881,1,0
0,1,0.0,0.0,68746902,1,0
0,1,0.0,0.0,68748953,1,0
2,1,0.75,0.0,68163025,4,3
0,3,0.0,0.0,75456864,3,0
0,4,0.2,0.16666666666666666,69061671,5,1
2,3,0.5714285714285714,0.4,80118135,7,4
1,4,0.2,0.5555555555555556,82006573,5,1
2,0,1.0,1.0,71619513,1,1
0,6,0.14285714285714285,0.2631578947368421,69886495,7,1
0,4,0.0,0.0,80176283,4,0
0,2,0.0,0.0,80176284,2,0
0,4,0.0,0.0,80176285,4,0
1,5,0.2857142857142857,0.7692307692307693,82006581,7,2
2,3,0.5,0.9615384615384616,67509785,6,3
0,2,0.0,0.0,82102879,2,0
0,3,0.0,0.0,80165823,3,0
0,2,0.0,0.0,68158503,2,0
1,2,0.3333333333333333,0.7142857142857143,73295712,3,1
2,1,0.5,0.6666666666666666,68186636,2,1
2,1,0.6666666666666666,0.75,79793756,3,2
0,1,0.0,0.0,82013559,1,0
0,3,0.0,0.0,70694750,3,0
2,0,1.0,1.0,70399322,1,1
2,1,0.5,0.75,79817010,2,1
2,0,1.0,1.0,69633865,2,2
1,7,0.2222222222222222,0.6578947368421053,76080956,9,2
1,2,0.3333333333333333,0.8095238095238095,70747684,3,1
0,4,0.3333333333333333,0.4444444444444444,73137155,6,2
1,5,0.2857142857142857,0.625,73734360,7,2
1,5,0.2857142857142857,0.9230769230769231,66785866,7,2
2,0,1.0,1.0,67423531,2,2
2,1,0.5,0.5,68613272,2,1
0,1,0.0,0.0,69693715,1,0
0,2,0.0,0.0,69693771,2,0
0,2,0.0,0.0,69693911,2,0
0,3,0.4,0.0,65949163,5,2
2,1,0.8571428571428571,0.5,68426512,7,6
0,1,0.0,0.0,70681814,1,0
0,1,0.0,0.0,70691950,1,0
2,0,1.0,1.0,67668790,2,2
2,0,1.0,1.0,69470835,1,1
0,1,0.0,0.0,69179803,1,0
0,1,0.0,0.0,80165421,1,0
0,2,0.0,0.0,70489244,2,0
0,13,0.0,0.0,70746060,13,0
0,1,0.0,0.0,82090227,1,0
2,0,1.0,1.0,82016075,1,1
2,0,1.0,1.0,80092572,1,1
2,0,1.0,1.0,82102376,1,1
2,0,1.0,1.0,80175979,3,3
2,0,1.0,1.0,73823624,1,1
2,2,0.6,0.6666666666666666,79785902,5,3
0,1,0.0,0.0,80132926,1,0
2,1,0.6666666666666666,0.75,79994313,3,2
2,1,0.6666666666666666,0.875,66281852,3,2
0,5,0.16666666666666666,0.13333333333333333,66825570,6,1
0,1,0.0,0.0,73255693,1,0
0,1,0.0,0.0,70415611,1,0
0,1,0.0,0.0,67619265,1,0
0,2,0.0,0.0,80118376,2,0
0,5,0.16666666666666666,0.09090909090909091,70415506,6,1
0,4,0.0,0.0,70701435,4,0
2,1,0.75,0.5,80165222,4,3
2,0,1.0,1.0,69836214,1,1
1,2,0.3333333333333333,0.8,80160436,3,1
2,0,1.0,1.0,82019852,2,2
2,0,1.0,1.0,67744376,3,3
0,5,0.0,0.0,72692004,5,0
1,7,0.2222222222222222,0.6176470588235294,70237846,9,2
0,1,0.0,0.0,70704123,1,0
0,2,0.0,0.0,82251465,2,0
2,1,0.5,0.5,82250611,2,1
0,2,0.3333333333333333,0.0,80168334,3,1
2,2,0.5,0.6666666666666666,71879591,4,2
0,2,0.0,0.0,72768395,2,0
0,2,0.3333333333333333,0.4,79792426,3,1
1,3,0.4,0.7,67282180,5,2
2,1,0.5,0.8,66379306,2,1
0,3,0.0,0.0,70183204,3,0
2,1,0.5,0.8,69092765,2,1
2,1,0.5,0.6666666666666666,67352915,2,1
2,1,0.75,0.9166666666666666,67003853,4,3
2,0,1.0,1.0,82054039,3,3
1,7,0.2222222222222222,0.5172413793103449,64976191,9,2
0,2,0.0,0.0,80132958,2,0
0,1,0.0,0.0,80132968,1,0
1,4,0.2,0.75,69417474,5,1
0,4,0.0,0.0,70490315,4,0
2,1,0.5,0.8,69701513,2,1
0,2,0.0,0.0,80150246,2,0
0,6,0.14285714285714285,0.2222222222222222,65352315,7,1
2,0,1.0,1.0,69604066,1,1
2,1,0.5,0.0,80158230,2,1
1,2,0.3333333333333333,0.8333333333333334,72749243,3,1
1,2,0.3333333333333333,0.8,69124713,3,1
2,0,1.0,1.0,82185026,1,1
0,2,0.0,0.0,64053836,2,0
2,1,0.6666666666666666,0.5,69571201,3,2
0,3,0.25,0.0,80153672,4,1
0,2,0.0,0.0,70637791,2,0
0,1,0.0,0.0,70843325,1,0
0,2,0.0,0.0,82010313,2,0
0,5,0.0,0.0,75347041,5,0
0,5,0.0,0.0,75347055,5,0
2,7,0.631578947368421,0.9166666666666666,65947315,19,12
0,1,0.0,0.0,82202288,1,0
2,0,1.0,1.0,82036940,2,2
1,10,0.09090909090909091,0.5172413793103449,70746452,11,1
0,2,0.0,0.0,80163449,2,0
0,2,0.3333333333333333,0.3333333333333333,67315115,3,1
2,4,0.5555555555555556,0.9090909090909091,70871402,9,5
2,0,1.0,1.0,80135022,1,1
0,1,0.0,0.0,67986702,1,0
0,2,0.0,0.0,82039856,2,0
0,2,0.0,0.0,69311431,2,0
0,1,0.0,0.0,69723843,1,0
0,1,0.0,0.0,80172620,1,0
0,4,0.0,0.0,80172631,4,0
0,1,0.0,0.0,80162778,1,0
0,2,0.0,0.0,82006205,2,0
0,2,0.0,0.0,70483014,2,0
0,2,0.0,0.0,80172653,2,0
0,4,0.0,0.0,80138902,4,0
0,3,0.0,0.0,82006508,3,0
0,4,0.0,0.0,82006511,4,0
0,3,0.0,0.0,82006512,3,0
0,5,0.0,0.0,82006518,5,0
0,4,0.0,0.0,82006522,4,0
2,4,0.5,0.875,69946933,8,4
2,1,0.5,0.8571428571428571,75813941,2,1
0,1,0.0,0.0,80165351,1,0
0,1,0.0,0.0,66228043,1,0
2,1,0.5,0.5,80092012,2,1
0,2,0.0,0.0,80095092,2,0
0,2,0.3333333333333333,0.4,69309240,3,1
0,1,0.0,0.0,70707070,1,0
0,2,0.0,0.0,69193782,2,0
0,1,0.0,0.0,70675486,1,0
0,2,0.0,0.0,70691530,2,0
2,0,1.0,1.0,80136924,1,1
2,1,0.5,0.0,67672724,2,1
2,0,1.0,1.0,80092796,1,1
1,2,0.3333333333333333,0.7777777777777778,70494480,3,1
2,0,1.0,1.0,74032420,4,4
0,1,0.0,0.0,69463114,1,0
0,3,0.0,0.0,69475056,3,0
0,1,0.0,0.0,80128427,1,0
0,1,0.0,0.0,74362281,1,0
2,0,1.0,1.0,70565250,2,2
0,2,0.0,0.0,64281371,2,0
2,1,0.75,0.6666666666666666,82019834,4,3
2,1,0.5,0.5,72802422,2,1
0,4,0.0,0.0,70081186,4,0
2,1,0.6666666666666666,0.5,69582793,3,2
1,5,0.4444444444444444,0.9230769230769231,68238030,9,4
0,1,0.0,0.0,70674793,1,0
0,1,0.0,0.0,70678006,1,0
1,2,0.3333333333333333,0.6666666666666666,67715235,3,1
2,4,0.5,0.8571428571428571,79783760,8,4
2,0,1.0,1.0,69011026,1,1
2,2,0.5,0.6666666666666666,67799256,4,2
0,1,0.0,0.0,70399420,1,0
2,1,0.75,0.0,80176460,4,3
2,1,0.6666666666666666,0.6666666666666666,69715555,3,2
0,1,0.0,0.0,72962470,1,0
0,3,0.0,0.0,68199754,3,0
2,1,0.6666666666666666,0.5,80162119,3,2
2,0,1.0,1.0,62791526,2,2
2,0,1.0,1.0,82038888,7,7
2,0,1.0,1.0,80004225,2,2
2,0,1.0,1.0,82020751,1,1
2,0,1.0,1.0,82145520,1,1
2,0,1.0,1.0,80145835,2,2
0,3,0.0,0.0,69158103,3,0
0,4,0.0,0.0,69158460,4,0
0,1,0.0,0.0,69160322,1,0
0,6,0.0,0.0,69525694,6,0
2,0,1.0,1.0,82024190,2,2
1,2,0.3333333333333333,0.5,70674261,3,1
0,1,0.0,0.0,70683452,1,0
2,0,1.0,1.0,80162817,2,2
2,1,0.5,0.5,71689541,2,1
0,2,0.0,0.0,66785824,2,0
0,2,0.0,0.0,70675430,2,0
0,2,0.0,0.0,70684481,2,0
0,2,0.0,0.0,70693966,2,0
0,2,0.0,0.0,68746776,2,0
0,1,0.0,0.0,70331072,1,0
0,5,0.16666666666666666,0.0,80130733,6,1
0,1,0.0,0.0,66610306,1,0
0,1,0.0,0.0,73036985,1,0
0,2,0.0,0.0,70018382,2,0
2,1,0.5,0.25,72803976,2,1
0,1,0.0,0.0,70509474,1,0
0,2,0.0,0.0,70675136,2,0
2,0,1.0,1.0,63188685,1,1
1,3,0.25,0.875,82090205,4,1
0,2,0.0,0.0,80091830,2,0
1,3,0.25,0.75,80094952,4,1
1,2,0.3333333333333333,0.8,79787974,3,1
2,4,0.5,0.6666666666666666,82056732,8,4
0,2,0.0,0.0,70674422,2,0
2,0,1.0,1.0,69158355,1,1
0,4,0.0,0.0,69021043,4,0
2,1,0.5,0.6666666666666666,78858696,2,1
0,1,0.0,0.0,70615643,1,0
0,2,0.0,0.0,65116751,2,0
0,1,0.0,0.0,82070153,1,0
0,1,0.0,0.0,80137600,1,0
0,3,0.0,0.0,80133437,3,0
0,2,0.0,0.0,70683375,2,0
0,3,0.0,0.0,70693882,3,0
0,2,0.0,0.0,70699244,2,0
2,0,1.0,1.0,81888448,1,1
0,5,0.2857142857142857,0.4166666666666667,69604171,7,2
0,2,0.3333333333333333,0.0,69604213,3,1
0,2,0.0,0.0,73535595,2,0
0,4,0.0,0.0,73535623,4,0
0,3,0.0,0.0,73535665,3,0
0,4,0.0,0.0,73535686,4,0
0,3,0.0,0.0,73537261,3,0
0,4,0.0,0.0,73801042,4,0
0,2,0.0,0.0,73801063,2,0
0,3,0.25,0.3333333333333333,65280215,4,1
0,5,0.0,0.0,73801595,5,0
0,1,0.0,0.0,73985632,1,0
0,1,0.0,0.0,68333405,1,0
2,0,1.0,1.0,62884913,5,5
0,3,0.0,0.0,66378893,3,0
0,2,0.0,0.0,66378900,2,0
2,0,1.0,1.0,82020373,12,12
0,2,0.0,0.0,70768166,2,0
2,0,1.0,1.0,68285882,7,7
2,2,0.7142857142857143,0.6666666666666666,67833374,7,5
2,0,1.0,1.0,70459410,1,1
1,4,0.3333333333333333,0.8333333333333334,69597444,6,2
0,1,0.0,0.0,68657085,1,0
0,1,0.0,0.0,74027751,1,0
2,0,1.0,1.0,80133914,1,1
2,1,0.5,0.8125,82201376,2,1
2,0,1.0,1.0,64197931,1,1
0,2,0.0,0.0,70705866,2,0
2,1,0.8,0.5,68960241,5,4
0,3,0.0,0.0,80055976,3,0
0,3,0.0,0.0,80172541,3,0
2,0,1.0,1.0,82019991,2,2
0,3,0.0,0.0,82006699,3,0
0,2,0.0,0.0,82006700,2,0
0,3,0.0,0.0,80131214,3,0
0,3,0.0,0.0,80176282,3,0
0,1,0.0,0.0,66033016,1,0
0,1,0.0,0.0,64359540,1,0
1,3,0.25,0.625,80162846,4,1
2,1,0.5,0.8571428571428571,82050505,2,1
2,1,0.5,0.8571428571428571,63395472,2,1
1,3,0.25,0.9,69407114,4,1
0,2,0.0,0.0,76551874,2,0
0,1,0.0,0.0,80150637,1,0
1,4,0.2,0.6,69407212,5,1
0,1,0.0,0.0,67879385,1,0
0,1,0.0,0.0,80167319,1,0
1,4,0.2,0.6875,70635264,5,1
0,2,0.0,0.0,80165834,2,0
0,3,0.0,0.0,82006235,3,0
2,0,1.0,1.0,82102487,1,1
0,3,0.0,0.0,68289760,3,0
0,1,0.0,0.0,68158433,1,0
0,1,0.0,0.0,68144146,1,0
2,0,1.0,1.0,69071422,1,1
2,1,0.6666666666666666,0.9285714285714286,70747166,3,2
2,1,0.5,0.5,80172948,2,1
0,4,0.0,0.0,68805401,4,0
0,2,0.0,0.0,68805884,2,0
1,3,0.25,0.7,82002287,4,1
0,1,0.0,0.0,70699314,1,0
2,0,1.0,1.0,80053701,1,1
1,3,0.25,0.5555555555555556,64343335,4,1
0,1,0.0,0.0,69160441,1,0
0,1,0.0,0.0,70700280,1,0
0,4,0.0,0.0,66222856,4,0
0,1,0.0,0.0,68191690,1,0
0,3,0.25,0.0,69055700,4,1
0,4,0.0,0.0,70064064,4,0
0,2,0.0,0.0,67214623,2,0
2,0,1.0,1.0,70718732,1,1
0,4,0.0,0.0,63781774,4,0
2,0,1.0,1.0,80159767,9,9
2,0,1.0,1.0,82046259,2,2
2,0,1.0,1.0,80149257,6,6
2,1,0.6666666666666666,0.5,67131722,3,2
2,0,1.0,1.0,82037553,1,1
2,0,1.0,1.0,80162145,3,3
2,0,1.0,1.0,62746103,2,2
2,0,1.0,1.0,70851291,2,2
2,0,1.0,1.0,80159168,3,3
0,2,0.0,0.0,79678732,2,0
0,5,0.0,0.0,67468163,5,0
2,0,1.0,1.0,80105333,2,2
0,7,0.125,0.23076923076923078,80018876,8,1
0,6,0.0,0.0,66786181,6,0
1,3,0.25,0.8787878787878788,80131202,4,1
0,1,0.0,0.0,66782394,1,0
1,2,0.3333333333333333,0.75,60547746,3,1
2,2,0.6666666666666666,0.6666666666666666,73870062,6,4
2,0,1.0,1.0,70677964,1,1
0,1,0.0,0.0,82119899,1,0
2,0,1.0,1.0,67822706,1,1
2,2,0.5,0.6,68402803,4,2
1,3,0.4,0.7333333333333333,70843003,5,2
0,1,0.0,0.0,82019073,1,0
0,1,0.0,0.0,68785010,1,0
0,2,0.0,0.0,82102635,2,0
0,1,0.0,0.0,82102904,1,0
0,9,0.1,0.13333333333333333,67775253,10,1
0,4,0.0,0.0,73643920,4,0
2,0,1.0,1.0,66232796,3,3
0,3,0.0,0.0,70747873,3,0
2,3,0.5,0.8,72640974,6,3
2,0,1.0,1.0,80025246,1,1
2,0,1.0,1.0,82038878,1,1
2,0,1.0,1.0,80162149,2,2
2,0,1.0,1.0,66237696,3,3
2,2,0.5,0.75,69064114,4,2
2,1,0.6666666666666666,0.5,70750715,3,2
0,1,0.0,0.0,70683676,1,0
0,2,0.0,0.0,80126764,2,0
2,0,1.0,1.0,82110449,4,4
0,1,0.0,0.0,67799340,1,0
2,0,1.0,1.0,68230764,1,1
2,0,1.0,1.0,80172952,3,3
1,2,0.3333333333333333,0.8,70629055,3,1
0,3,0.0,0.0,70629216,3,0
2,0,1.0,1.0,80152717,2,2
0,5,0.16666666666666666,0.34615384615384615,82102615,6,1
2,0,1.0,1.0,62257594,1,1
2,0,1.0,1.0,69384434,3,3
0,2,0.3333333333333333,0.2857142857142857,72786000,3,1
2,0,1.0,1.0,80149462,1,1
0,2,0.0,0.0,70229446,2,0
0,1,0.0,0.0,70230412,1,0
2,0,1.0,1.0,80172946,1,1
0,1,0.0,0.0,70210413,1,0
0,3,0.0,0.0,70202594,3,0
0,2,0.0,0.0,69699910,2,0
2,0,1.0,1.0,69172712,1,1
0,2,0.3333333333333333,0.4444444444444444,80127360,3,1
0,4,0.0,0.0,80108616,4,0
0,1,0.0,0.0,67652753,1,0
0,6,0.14285714285714285,0.3333333333333333,78762992,7,1
0,2,0.0,0.0,69466992,2,0
0,1,0.0,0.0,67704371,1,0
2,1,0.6666666666666666,0.5,80066420,3,2
0,1,0.0,0.0,67347651,1,0
0,2,0.0,0.0,68768490,2,0
0,1,0.0,0.0,68768546,1,0
0,2,0.0,0.0,67052930,2,0
2,0,1.0,1.0,82266725,1,1
2,1,0.6666666666666666,0.5,70062993,3,2
2,0,1.0,1.0,82019658,2,2
1,2,0.3333333333333333,0.7692307692307693,70921102,3,1
0,2,0.0,0.0,82006596,2,0
2,1,0.5,0.6666666666666666,69117013,2,1
2,0,1.0,1.0,82105387,1,1
2,0,1.0,1.0,80165212,3,3
2,1,0.6666666666666666,0.5,69479732,3,2
0,3,0.0,0.0,70513695,3,0
0,2,0.0,0.0,81971195,2,0
2,0,1.0,1.0,70705040,1,1
2,0,1.0,1.0,70238763,1,1
1,4,0.3333333333333333,0.8285714285714286,70746046,6,2
0,5,0.0,0.0,66782541,5,0
1,3,0.4,0.9210526315789473,82018913,5,2
0,2,0.0,0.0,80069675,2,0
1,2,0.3333333333333333,0.5,69517014,3,1
0,1,0.0,0.0,70760711,1,0
0,1,0.0,0.0,70760802,1,0
2,0,1.0,1.0,63738080,2,2
0,1,0.0,0.0,69478304,1,0
0,1,0.0,0.0,67626874,1,0
0,3,0.0,0.0,68241334,3,0
2,2,0.5,0.875,71434811,4,2
2,0,1.0,1.0,69954612,1,1
2,0,1.0,1.0,69597535,1,1
1,2,0.3333333333333333,0.6,69319320,3,1
2,0,1.0,1.0,80113635,2,2
0,5,0.0,0.0,80163688,5,0
1,3,0.25,0.5714285714285714,70175371,4,1
2,0,1.0,1.0,70314230,2,2
2,1,0.5,0.0,67248384,2,1
2,0,1.0,1.0,80136606,2,2
1,3,0.25,0.75,70223580,4,1
2,0,1.0,1.0,68391540,1,1
2,2,0.7142857142857143,0.9,68290194,7,5
2,0,1.0,1.0,82093807,1,1
2,0,1.0,1.0,68747791,2,2
0,1,0.0,0.0,70109872,1,0
2,0,1.0,1.0,80074484,1,1
0,2,0.0,0.0,82018949,2,0
2,1,0.5,0.6666666666666666,66353861,2,1
0,1,0.0,0.0,82018776,1,0
2,0,1.0,1.0,62939485,1,1
0,2,0.3333333333333333,0.3333333333333333,69534850,3,1
2,0,1.0,1.0,66786384,1,1
2,0,1.0,1.0,82006296,1,1
2,0,1.0,1.0,70758506,1,1
1,3,0.25,0.8125,66784214,4,1
0,1,0.0,0.0,70705033,1,0
0,2,0.0,0.0,80156081,2,0
2,0,1.0,1.0,82121160,2,2
1,5,0.2857142857142857,0.5384615384615384,68234334,7,2
0,1,0.0,0.0,82141884,1,0
0,2,0.0,0.0,69693820,2,0
2,1,0.6666666666666666,0.6,80165380,3,2
0,3,0.25,0.4166666666666667,70283745,4,1
0,1,0.0,0.0,70474250,1,0
2,4,0.5,0.8888888888888888,66364361,8,4
1,7,0.2222222222222222,0.7272727272727273,68352466,9,2
0,2,0.0,0.0,68667004,2,0
0,1,0.0,0.0,82247764,1,0
0,5,0.0,0.0,70705341,5,0
0,1,0.0,0.0,67335772,1,0
1,3,0.4,0.7,67276664,5,2
0,1,0.0,0.0,70768264,1,0
2,0,1.0,1.0,80089513,1,1
0,2,0.0,0.0,69581750,2,0
0,1,0.0,0.0,62696935,1,0
2,0,1.0,1.0,82037955,1,1
0,8,0.0,0.0,69575471,8,0
2,0,1.0,1.0,80003560,2,2
0,1,0.0,0.0,70703535,1,0
2,0,1.0,1.0,63239071,1,1
2,0,1.0,1.0,75295262,2,2
0,3,0.0,0.0,67094573,3,0
2,0,1.0,1.0,80092586,1,1
2,1,0.6666666666666666,0.75,75045446,3,2
0,1,0.0,0.0,73102456,1,0
1,4,0.2,0.6363636363636364,68234355,5,1
2,1,0.5,0.8333333333333334,82018724,2,1
2,0,1.0,1.0,70057302,1,1
2,1,0.5,0.6666666666666666,66238501,2,1
1,3,0.4,0.8888888888888888,69997501,5,2
2,0,1.0,1.0,68058305,1,1
0,7,0.125,0.2692307692307692,69596996,8,1
1,2,0.3333333333333333,0.6,67513621,3,1
0,1,0.0,0.0,80128397,1,0
2,0,1.0,1.0,68747000,1,1
0,3,0.25,0.0,69666821,4,1
0,2,0.0,0.0,69490106,2,0
0,4,0.2,0.0,70566300,5,1
0,7,0.125,0.3125,70685181,8,1
0,1,0.0,0.0,82019456,1,0
2,0,1.0,1.0,80054492,1,1
0,1,0.0,0.0,64236886,1,0
0,2,0.0,0.0,68326993,2,0
0,3,0.0,0.0,69185333,3,0
2,0,1.0,1.0,65730203,1,1
0,6,0.0,0.0,80163191,6,0
0,1,0.0,0.0,82006168,1,0
0,2,0.0,0.0,71357321,2,0
0,1,0.0,0.0,82053054,1,0
0,3,0.0,0.0,80162873,3,0
1,2,0.3333333333333333,0.7222222222222222,80165831,3,1
0,1,0.0,0.0,80165862,1,0
0,2,0.0,0.0,82006330,2,0
2,0,1.0,1.0,70687036,2,2
2,0,1.0,1.0,65943514,1,1
2,2,0.6666666666666666,0.5,68755575,6,4
1,3,0.4,0.9375,69078590,5,2
2,1,0.5,0.6666666666666666,68498164,2,1
0,1,0.0,0.0,68498402,1,0
0,1,0.0,0.0,69478710,1,0
2,1,0.5,0.8,80104962,2,1
2,1,0.5,0.5,70509600,2,1
2,0,1.0,1.0,82038204,1,1
1,3,0.25,0.7741935483870968,70230202,4,1
2,0,1.0,1.0,66227700,1,1
2,1,0.8,0.8333333333333334,82145523,5,4
0,1,0.0,0.0,82138592,1,0
1,5,0.2857142857142857,0.8947368421052632,82102770,7,2
0,2,0.0,0.0,69384574,2,0
0,5,0.16666666666666666,0.2,70654325,6,1
0,1,0.0,0.0,60909450,1,0
0,4,0.0,0.0,65544906,4,0
2,0,1.0,1.0,82020253,2,2
2,1,0.5,0.5,70474614,2,1
2,1,0.5,0.75,66229345,2,1
0,8,0.0,0.0,70679581,8,0
0,1,0.0,0.0,68538246,1,0
2,0,1.0,1.0,69575282,1,1
2,0,1.0,1.0,57186241,2,2
2,0,1.0,1.0,80176373,1,1
2,1,0.5,0.75,68566792,2,1
2,0,1.0,1.0,80049851,2,2
2,0,1.0,1.0,82046062,3,3
2,0,1.0,1.0,82138728,1,1
2,0,1.0,1.0,80159259,3,3
2,0,1.0,1.0,82126261,1,1
2,0,1.0,1.0,74047043,3,3
2,0,1.0,1.0,80178237,1,1
0,2,0.3333333333333333,0.0,69483883,3,1
0,1,0.0,0.0,68007674,1,0
2,0,1.0,1.0,80153548,1,1
1,2,0.3333333333333333,0.7,70216951,3,1
1,2,0.3333333333333333,0.75,70621642,3,1
0,1,0.0,0.0,66931494,1,0
0,2,0.0,0.0,69597115,2,0
0,3,0.0,0.0,80145847,3,0
0,3,0.0,0.0,70684894,3,0
2,1,0.5,0.5,67059881,2,1
2,3,0.5,0.8,69064471,6,3
0,1,0.0,0.0,69136011,1,0
2,0,1.0,1.0,70189644,1,1
1,3,0.25,0.5,70654234,4,1
2,0,1.0,1.0,69319376,1,1
0,7,0.0,0.0,81989174,7,0
0,1,0.0,0.0,62985391,1,0
0,2,0.0,0.0,67322843,2,0
0,3,0.0,0.0,67322850,3,0
0,1,0.0,0.0,70316211,1,0
2,1,0.5,0.5,65103563,2,1
2,1,0.5,0.3333333333333333,65045344,2,1
2,0,1.0,1.0,71389213,1,1
2,0,1.0,1.0,69976256,1,1
0,4,0.0,0.0,70229894,4,0
2,0,1.0,1.0,67308003,1,1
0,8,0.0,0.0,68763891,8,0
2,0,1.0,1.0,74314912,2,2
2,0,1.0,1.0,82054061,2,2
0,3,0.0,0.0,70566531,3,0
0,7,0.125,0.24528301886792453,76028365,8,1
0,2,0.0,0.0,69490750,2,0
2,0,1.0,1.0,80095253,1,1
2,1,0.5,0.5,66237234,2,1
2,0,1.0,1.0,80004190,5,5
2,2,0.7142857142857143,0.6666666666666666,82105397,7,5
2,0,1.0,1.0,67786061,1,1
2,0,1.0,1.0,82024288,1,1
0,7,0.0,0.0,82102855,7,0
0,1,0.0,0.0,70223706,1,0
2,0,1.0,1.0,70697333,1,1
0,1,0.0,0.0,69184234,1,0
0,2,0.0,0.0,70004942,2,0
0,3,0.0,0.0,68356435,3,0
0,2,0.0,0.0,70036722,2,0
2,0,1.0,1.0,68546730,1,1
0,1,0.0,0.0,80172617,1,0
0,3,0.0,0.0,65175915,3,0
1,2,0.3333333333333333,0.8148148148148148,71619681,3,1
2,1,0.5,0.9090909090909091,80168257,2,1
0,10,0.0,0.0,70918890,10,0
0,1,0.0,0.0,73634890,1,0
2,0,1.0,1.0,79457462,2,2
0,3,0.0,0.0,80176172,3,0
2,0,1.0,1.0,82016206,1,1
0,2,0.0,0.0,69998005,2,0
2,0,1.0,1.0,80128519,1,1
2,2,0.6,0.6666666666666666,70493115,5,3
0,3,0.0,0.0,82102603,3,0
0,5,0.0,0.0,82102618,5,0
0,5,0.0,0.0,68497730,5,0
2,0,1.0,1.0,80165241,4,4
0,3,0.0,0.0,64262016,3,0
0,1,0.0,0.0,64352624,1,0
2,3,0.5,0.875,68543573,6,3
0,4,0.2,0.38461538461538464,67665346,5,1
2,0,1.0,1.0,80178177,1,1
1,4,0.3333333333333333,0.5,70921116,6,2
2,1,0.75,0.6666666666666666,80126937,4,3
0,3,0.4,0.2857142857142857,69394213,5,2
2,2,0.6666666666666666,0.6,82018819,6,4
2,0,1.0,1.0,80174140,2,2
2,0,1.0,1.0,82175549,1,1
2,0,1.0,1.0,69313314,3,3
2,0,1.0,1.0,82046137,1,1
2,0,1.0,1.0,82175554,1,1
2,2,0.7142857142857143,0.8,62552105,7,5
0,1,0.0,0.0,62965483,1,0
0,2,0.0,0.0,63962710,2,0
0,2,0.0,0.0,80128325,2,0
0,1,0.0,0.0,69945036,1,0
0,3,0.25,0.3333333333333333,69514403,4,1
2,1,0.6666666666666666,0.75,66738231,3,2
2,0,1.0,1.0,67823371,9,9
2,0,1.0,1.0,82061203,1,1
0,2,0.0,0.0,82206125,2,0
0,1,0.0,0.0,82182765,1,0
2,0,1.0,1.0,82200593,2,2
0,2,0.0,0.0,82022522,2,0
0,5,0.0,0.0,67376456,5,0
2,2,0.5,0.8333333333333334,69621741,4,2
2,1,0.75,0.6666666666666666,69031340,4,3
0,1,0.0,0.0,69412546,1,0
2,0,1.0,1.0,70700140,1,1
0,1,0.0,0.0,82119888,1,0
0,1,0.0,0.0,82127712,1,0
0,1,0.0,0.0,82019759,1,0
0,3,0.0,0.0,82019910,3,0
2,1,0.5,0.5,80092264,2,1
2,1,0.8,0.5,70051205,5,4
2,0,1.0,1.0,66234245,1,1
2,0,1.0,1.0,82163432,1,1
2,1,0.5,0.6666666666666666,72801820,2,1
0,3,0.4,0.4444444444444444,82113201,5,2
1,7,0.46153846153846156,0.7692307692307693,65865975,13,6
2,2,0.5,0.8333333333333334,75149564,4,2
0,2,0.0,0.0,70597961,2,0
2,0,1.0,1.0,82247776,1,1
0,1,0.0,0.0,63445081,1,0
2,1,0.5,0.6666666666666666,68538862,2,1
2,0,1.0,1.0,80176263,3,3
0,1,0.0,0.0,67823070,1,0
2,1,0.5,0.5,82054035,2,1
2,0,1.0,1.0,69483176,1,1
2,0,1.0,1.0,63397691,2,2
0,1,0.0,0.0,66545675,1,0
2,0,1.0,1.0,82138581,1,1
0,1,0.0,0.0,70524545,1,0
0,1,0.0,0.0,70707063,1,0
0,11,0.15384615384615385,0.3333333333333333,72910222,13,2
0,15,0.0625,0.26153846153846155,70250810,16,1
2,1,0.6666666666666666,0.0,80162597,3,2
2,0,1.0,1.0,70759913,1,1
0,1,0.0,0.0,70641053,1,0
2,0,1.0,1.0,68284713,1,1
0,1,0.0,0.0,68498962,1,0
2,0,1.0,1.0,82039337,7,7
2,2,0.5,0.0,80165235,4,2
2,0,1.0,1.0,82102180,5,5
2,2,0.7142857142857143,0.8,69003291,7,5
2,0,1.0,1.0,608776,5,5
2,1,0.8,0.6666666666666666,68563152,5,4
1,4,0.3333333333333333,0.8461538461538461,68253003,6,2
0,2,0.3333333333333333,0.2857142857142857,65084866,3,1
2,0,1.0,1.0,82002315,1,1
2,4,0.5,0.5,70868525,8,4
0,1,0.0,0.0,80156708,1,0
2,0,1.0,1.0,82037200,3,3
1,2,0.3333333333333333,0.7777777777777778,72804095,3,1
0,2,0.3333333333333333,0.0,64166312,3,1
2,0,1.0,1.0,80118887,2,2
0,4,0.0,0.0,141260,4,0
1,2,0.3333333333333333,0.7647058823529411,67315101,3,1
0,1,0.0,0.0,66817233,1,0
0,2,0.0,0.0,80156009,2,0
1,10,0.2857142857142857,0.68,72523094,14,4
1,3,0.4,0.8333333333333334,79994341,5,2
0,1,0.0,0.0,72522800,1,0
2,1,0.6666666666666666,0.9,80158254,3,2
0,2,0.0,0.0,67669091,2,0
2,0,1.0,1.0,82019694,1,1
0,6,0.0,0.0,82150102,6,0
1,4,0.42857142857142855,0.8333333333333334,75363694,7,3
0,2,0.0,0.0,80167305,2,0
1,5,0.16666666666666666,0.7142857142857143,67834704,6,1
2,1,0.5,0.8,70760011,2,1
0,2,0.0,0.0,80089156,2,0
2,3,0.5714285714285714,0.8333333333333334,68115201,7,4
0,2,0.3333333333333333,0.4,80165855,3,1
2,0,1.0,1.0,82019232,1,1
1,4,0.3333333333333333,0.6,82043178,6,2
0,1,0.0,0.0,68267843,1,0
0,1,0.0,0.0,70608972,1,0
0,1,0.0,0.0,70591465,1,0
1,3,0.25,0.5833333333333334,82010244,4,1
0,1,0.0,0.0,68441940,1,0
2,1,0.5,0.75,69491282,2,1
2,0,1.0,1.0,70692293,1,1
0,2,0.0,0.0,79146053,2,0
2,0,1.0,1.0,72814686,2,2
0,1,0.0,0.0,70678510,1,0
2,0,1.0,1.0,67791920,1,1
0,1,0.0,0.0,70238315,1,0
0,1,0.0,0.0,70239596,1,0
0,1,0.0,0.0,67779621,1,0
2,0,1.0,1.0,68260934,2,2
2,2,0.5,0.8,68212011,4,2
2,1,0.5,0.6666666666666666,69478283,2,1
2,0,1.0,1.0,70692300,1,1
2,0,1.0,1.0,68344605,1,1
2,0,1.0,1.0,80018176,2,2
2,0,1.0,1.0,80118922,1,1
2,0,1.0,1.0,80176007,4,4
1,2,0.3333333333333333,0.875,69159993,3,1
2,0,1.0,1.0,80118458,1,1
2,1,0.6666666666666666,0.5,69285804,3,2
2,0,1.0,1.0,82096556,4,4
2,0,1.0,1.0,82054044,1,1
2,0,1.0,1.0,82095298,1,1
1,2,0.3333333333333333,0.6666666666666666,67286261,3,1
1,2,0.3333333333333333,0.8333333333333334,69945001,3,1
2,0,1.0,1.0,82033537,5,5
2,0,1.0,1.0,66237836,1,1
2,0,1.0,1.0,68423712,2,2
0,6,0.14285714285714285,0.3888888888888889,70476154,7,1
0,1,0.0,0.0,70629314,1,0
0,2,0.0,0.0,82006332,2,0
0,5,0.0,0.0,70682360,5,0
2,1,0.8333333333333334,0.5,80004113,6,5
2,0,1.0,1.0,68344612,4,4
2,1,0.8333333333333334,0.75,80132327,6,5
2,1,0.5,0.9,70702646,2,1
0,3,0.0,0.0,70704305,3,0
0,1,0.0,0.0,70703262,1,0
0,1,0.0,0.0,67902835,1,0
1,2,0.3333333333333333,0.6,73635051,3,1
0,1,0.0,0.0,82206046,1,0
2,0,1.0,1.0,70672301,1,1
0,5,0.16666666666666666,0.14285714285714285,70842912,6,1
1,2,0.3333333333333333,0.5833333333333334,69867560,3,1
0,3,0.0,0.0,82102634,3,0
0,8,0.0,0.0,82102890,8,0
2,0,1.0,1.0,67831505,1,1
1,2,0.3333333333333333,0.5,57188474,3,1
2,1,0.5,0.8,80118185,2,1
0,2,0.3333333333333333,0.3333333333333333,80165406,3,1
0,2,0.0,0.0,72882824,2,0
2,1,0.6666666666666666,0.5,79520070,3,2
0,2,0.0,0.0,70637224,2,0
0,2,0.3333333333333333,0.3333333333333333,70637280,3,1
0,2,0.0,0.0,72377193,2,0
0,2,0.0,0.0,66257996,2,0
2,1,0.5,0.875,70490322,2,1
1,5,0.2857142857142857,0.7333333333333333,70843122,7,2
0,1,0.0,0.0,80123781,1,0
0,1,0.0,0.0,68541725,1,0
1,7,0.4166666666666667,0.9166666666666666,80163129,12,5
2,0,1.0,1.0,82020813,2,2
1,2,0.3333333333333333,0.6428571428571429,70691775,3,1
0,2,0.0,0.0,70698950,2,0
0,1,0.0,0.0,70682752,1,0
1,2,0.3333333333333333,0.8,70921424,3,1
0,1,0.0,0.0,80156061,1,0
0,1,0.0,0.0,65007460,1,0
0,1,0.0,0.0,65116975,1,0
2,0,1.0,1.0,69164214,1,1
1,2,0.3333333333333333,0.5,82010310,3,1
2,0,1.0,1.0,82025218,1,1
1,4,0.2,0.5625,69633032,5,1
0,2,0.0,0.0,80080980,2,0
0,1,0.0,0.0,80124745,1,0
0,1,0.0,0.0,75456885,1,0
2,0,1.0,1.0,82163429,1,1
0,4,0.0,0.0,67889045,4,0
0,3,0.0,0.0,82118252,3,0
0,2,0.0,0.0,80056536,2,0
2,1,0.5,0.8888888888888888,69164081,2,1
2,0,1.0,1.0,69564803,1,1
0,1,0.0,0.0,73919111,1,0
0,2,0.3333333333333333,0.3333333333333333,69479725,3,1
0,1,0.0,0.0,68784814,1,0
2,0,1.0,1.0,82061927,1,1
0,4,0.3333333333333333,0.46153846153846156,82013532,6,2
2,1,0.5,0.5,70239176,2,1
2,1,0.5,0.6666666666666666,69596905,2,1
2,0,1.0,1.0,82002282,1,1
2,1,0.5,0.6666666666666666,67865595,2,1
0,2,0.0,0.0,72539943,2,0
2,0,1.0,1.0,70692552,1,1
2,0,1.0,1.0,80134741,5,5
2,0,1.0,1.0,67540571,1,1
2,0,1.0,1.0,69470814,1,1
2,1,0.8,0.5,80172921,5,4
2,0,1.0,1.0,80162727,1,1
0,1,0.0,0.0,82016043,1,0
2,0,1.0,1.0,82039318,1,1
2,0,1.0,1.0,80172930,4,4
2,0,1.0,1.0,80136691,4,4
2,1,0.875,0.5,80145437,8,7
0,1,0.0,0.0,80130726,1,0
2,0,1.0,1.0,80165239,2,2
1,3,0.25,0.7142857142857143,76694723,4,1
2,0,1.0,1.0,70930916,1,1
0,2,0.0,0.0,66784032,2,0
0,2,0.0,0.0,82006239,2,0
0,1,0.0,0.0,69638163,1,0
2,0,1.0,1.0,69660731,1,1
2,2,0.7142857142857143,0.875,72802961,7,5
0,2,0.0,0.0,80145425,2,0
2,0,1.0,1.0,82039378,2,2
0,3,0.0,0.0,68234411,3,0
2,0,1.0,1.0,82037832,2,2
1,4,0.3333333333333333,0.8888888888888888,68060370,6,2
0,3,0.0,0.0,69408192,3,0
0,9,0.18181818181818182,0.34615384615384615,903546,11,2
2,0,1.0,1.0,82250594,2,2
2,1,0.5,0.5,82247759,2,1
0,2,0.0,0.0,80176625,2,0
2,1,0.5,0.8,67830315,2,1
0,4,0.42857142857142855,0.42857142857142855,67686255,7,3
2,1,0.5,0.5,74619776,2,1
0,3,0.0,0.0,69582814,3,0
0,1,0.0,0.0,82023132,1,0
0,1,0.0,0.0,82023133,1,0
0,1,0.0,0.0,69391924,1,0
0,1,0.0,0.0,70706524,1,0
2,1,0.5,0.6,70408401,2,1
0,3,0.25,0.25,69055721,4,1
0,6,0.0,0.0,68039013,6,0
0,1,0.0,0.0,68478053,1,0
0,9,0.1,0.03571428571428571,79781646,10,1
2,0,1.0,1.0,70063000,2,2
0,1,0.0,0.0,67170803,1,0
2,0,1.0,1.0,69988450,2,2
0,1,0.0,0.0,70676291,1,0
0,1,0.0,0.0,70692545,1,0
2,2,0.6,0.7,68031761,5,3
0,1,0.0,0.0,75149606,1,0
0,11,0.15384615384615385,0.1875,80054583,13,2
1,2,0.3333333333333333,0.6666666666666666,80179942,3,1
1,8,0.1111111111111111,0.6428571428571429,70238203,9,1
2,0,1.0,1.0,80159260,3,3
0,1,0.0,0.0,70676151,1,0
0,1,0.0,0.0,70680071,1,0
0,1,0.0,0.0,70694113,1,0
0,1,0.0,0.0,69528193,1,0
0,2,0.0,0.0,82006530,2,0
0,1,0.0,0.0,80176297,1,0
0,14,0.0,0.0,80176303,14,0
0,1,0.0,0.0,80130750,1,0
0,2,0.0,0.0,66786370,2,0
0,1,0.0,0.0,68226963,1,0
2,0,1.0,1.0,80172561,1,1
2,1,0.5,0.0,67974256,2,1
2,0,1.0,1.0,72393181,2,2
0,1,0.0,0.0,70696605,1,0
2,0,1.0,1.0,80162152,1,1
2,0,1.0,1.0,54880756,1,1
2,1,0.5,0.8,71458912,2,1
2,0,1.0,1.0,71269681,1,1
0,1,0.0,0.0,80128172,1,0
2,1,0.5,0.9,82102517,2,1
0,1,0.0,0.0,66228274,1,0
0,1,0.0,0.0,66228652,1,0
0,2,0.0,0.0,70678622,2,0
2,1,0.6666666666666666,0.8,70780654,3,2
2,0,1.0,1.0,68020834,1,1
2,2,0.5,0.8823529411764706,70843304,4,2
2,0,1.0,1.0,70537495,3,3
0,2,0.3333333333333333,0.4,70691313,3,1
2,1,0.6666666666666666,0.5,72814056,3,2
1,2,0.3333333333333333,0.6,69033993,3,1
2,0,1.0,1.0,82102154,2,2
0,5,0.0,0.0,70792582,5,0
2,1,0.5,0.5,67815244,2,1
0,3,0.0,0.0,66885763,3,0
2,2,0.5,0.6666666666666666,68228363,4,2
0,1,0.0,0.0,79994425,1,0
0,1,0.0,0.0,80165431,1,0
2,1,0.5,0.8571428571428571,80084046,2,1
2,0,1.0,1.0,82145156,4,4
2,0,1.0,1.0,70537565,2,2
2,0,1.0,1.0,82038243,1,1
2,2,0.6666666666666666,0.875,80141476,6,4
2,0,1.0,1.0,82041284,3,3
2,0,1.0,1.0,80176451,2,2
2,0,1.0,1.0,75361755,3,3
0,6,0.0,0.0,80134744,6,0
2,0,1.0,1.0,63578011,1,1
2,0,1.0,1.0,69975871,3,3
2,1,0.5,0.75,66784543,2,1
0,5,0.0,0.0,66785922,5,0
0,3,0.0,0.0,70702863,3,0
0,2,0.0,0.0,69517756,2,0
2,0,1.0,1.0,82200583,1,1
0,5,0.0,0.0,70676144,5,0
0,4,0.0,0.0,69313055,4,0
2,0,1.0,1.0,69478493,1,1
2,1,0.5,0.0,80165353,2,1
0,2,0.0,0.0,80145881,2,0
1,2,0.3333333333333333,0.5,82024192,3,1
2,2,0.5,0.8,82024244,4,2
0,1,0.0,0.0,82010290,1,0
2,0,1.0,1.0,80119019,2,2
0,7,0.125,0.11764705882352941,68273506,8,1
0,2,0.0,0.0,82247758,2,0
0,6,0.45454545454545453,0.42857142857142855,70646240,11,5
2,0,1.0,1.0,82247775,2,2
2,2,0.5,0.5,62143620,4,2
0,1,0.0,0.0,68765494,1,0
2,0,1.0,1.0,82060549,1,1
2,0,1.0,1.0,69961374,1,1
0,2,0.0,0.0,80126886,2,0
2,0,1.0,1.0,82039190,1,1
0,2,0.3333333333333333,0.3333333333333333,68785206,3,1
2,1,0.5,0.5,82061920,2,1
0,1,0.0,0.0,64235493,1,0
0,1,0.0,0.0,69732782,1,0
0,2,0.0,0.0,82102381,2,0
2,0,1.0,1.0,82095120,5,5
2,0,1.0,1.0,70752976,3,3
0,1,0.0,0.0,69701296,1,0
0,1,0.0,0.0,68635560,1,0
0,1,0.0,0.0,69547891,1,0
2,0,1.0,1.0,280224,2,2
2,1,0.6666666666666666,0.5,74032434,3,2
2,3,0.5,0.25,80135345,6,3
0,1,0.0,0.0,80092390,1,0
2,3,0.5,0.8571428571428571,69482413,6,3
2,1,0.5,0.6666666666666666,65897321,2,1
2,0,1.0,1.0,74511612,3,3
0,2,0.0,0.0,68040441,2,0
2,0,1.0,1.0,80004162,2,2
2,0,1.0,1.0,70408135,1,1
2,1,0.5,0.6666666666666666,67208463,2,1
0,1,0.0,0.0,67779516,1,0
0,1,0.0,0.0,67923982,1,0
0,4,0.0,0.0,70683830,4,0
2,1,0.6666666666666666,0.5,80094273,3,2
2,1,0.75,0.6666666666666666,80151035,4,3
0,1,0.0,0.0,67917136,1,0
0,1,0.0,0.0,80128346,1,0
0,1,0.0,0.0,66081302,1,0
1,8,0.2727272727272727,0.7872340425531915,67454793,11,3
2,0,1.0,1.0,70821590,1,1
0,2,0.0,0.0,69669222,2,0
0,1,0.0,0.0,72910236,1,0
2,4,0.6,0.875,80137916,10,6
2,0,1.0,1.0,82037816,1,1
0,2,0.0,0.0,68560765,2,0
0,1,0.0,0.0,70250656,1,0
0,1,0.0,0.0,70691516,1,0
0,2,0.0,0.0,67208610,2,0
2,0,1.0,1.0,69908790,1,1
0,1,0.0,0.0,67667145,1,0
0,3,0.0,0.0,66379054,3,0
0,2,0.0,0.0,69980281,2,0
2,0,1.0,1.0,69624933,1,1
2,0,1.0,1.0,82061929,1,1
2,1,0.6666666666666666,0.5,82019865,3,2
0,3,0.0,0.0,71081514,3,0
2,4,0.5,0.5714285714285714,80045595,8,4
0,4,0.0,0.0,73295656,4,0
2,0,1.0,1.0,63737842,1,1
2,0,1.0,1.0,73255133,1,1
0,1,0.0,0.0,82016186,1,0
0,2,0.0,0.0,82038252,2,0
2,0,1.0,1.0,82062245,3,3
2,0,1.0,1.0,82020095,2,2
2,0,1.0,1.0,82054737,1,1
2,1,0.5,0.5,67910402,2,1
0,5,0.16666666666666666,0.3,80176344,6,1
2,5,0.5,0.9473684210526315,80158294,10,5
2,0,1.0,1.0,81902744,1,1
2,0,1.0,1.0,82052067,1,1
2,0,1.0,1.0,67725280,2,2
2,1,0.5,0.3333333333333333,69483113,2,1
2,0,1.0,1.0,80156761,1,1
0,8,0.0,0.0,63969045,8,0
0,5,0.0,0.0,66783626,5,0
1,3,0.25,0.7111111111111111,67435221,4,1
1,2,0.3333333333333333,0.9285714285714286,70818090,3,1
2,0,1.0,1.0,64458044,2,2
2,1,0.5,0.75,66496066,2,1
2,1,0.75,0.5,82163422,4,3
0,1,0.0,0.0,69718523,1,0
2,0,1.0,1.0,70675255,1,1
2,0,1.0,1.0,80178762,1,1
0,2,0.0,0.0,79787400,2,0
0,4,0.0,0.0,69994841,4,0
0,1,0.0,0.0,70694610,1,0
0,1,0.0,0.0,69519863,1,0
0,5,0.16666666666666666,0.375,69316961,6,1
0,1,0.0,0.0,70761586,1,0
0,1,0.0,0.0,70761915,1,0
0,2,0.0,0.0,74389553,2,0
2,0,1.0,1.0,80165253,1,1
0,1,0.0,0.0,69479606,1,0
0,2,0.0,0.0,67376561,2,0
0,4,0.0,0.0,68497674,4,0
0,1,0.0,0.0,69006476,1,0
1,5,0.16666666666666666,0.5806451612903226,70694015,6,1
0,1,0.0,0.0,82039299,1,0
1,5,0.2857142857142857,0.7,69151922,7,2
2,0,1.0,1.0,61171971,2,2
2,0,1.0,1.0,82170910,1,1
1,2,0.3333333333333333,0.8,69997795,3,1
2,0,1.0,1.0,69474916,1,1
1,7,0.125,0.7115384615384616,70238266,8,1
0,1,0.0,0.0,82021503,1,0
0,1,0.0,0.0,82182806,1,0
0,1,0.0,0.0,80083535,1,0
0,1,0.0,0.0,70678923,1,0
0,4,0.0,0.0,68039062,4,0
0,1,0.0,0.0,80080196,1,0
0,3,0.0,0.0,67703615,3,0
1,3,0.25,0.6666666666666666,67703671,4,1
0,4,0.0,0.0,67703902,4,0
0,7,0.2222222222222222,0.4482758620689655,80118877,9,2
2,1,0.5,0.6666666666666666,80083563,2,1
0,1,0.0,0.0,82117687,1,0
0,1,0.0,0.0,69597143,1,0
2,0,1.0,1.0,82019646,1,1
2,2,0.6,0.75,80118892,5,3
0,1,0.0,0.0,70759094,1,0
2,3,0.5,0.9090909090909091,70395472,6,3
1,8,0.2727272727272727,0.65,80069983,11,3
0,2,0.0,0.0,82047070,2,0
0,4,0.0,0.0,72802310,4,0
2,1,0.75,0.75,63180145,4,3
1,4,0.2,0.6923076923076923,82102548,5,1
0,1,0.0,0.0,69973561,1,0
0,8,0.0,0.0,80123456,8,0
0,1,0.0,0.0,80165407,1,0
1,3,0.25,0.6470588235294118,70527513,4,1
0,5,0.0,0.0,70618044,5,0
0,1,0.0,0.0,71082046,1,0
0,5,0.0,0.0,70482741,5,0
2,0,1.0,1.0,69732873,1,1
1,4,0.2,0.7058823529411765,82006643,5,1
1,5,0.2857142857142857,0.7391304347826086,69736450,7,2
0,3,0.0,0.0,63984193,3,0
0,1,0.0,0.0,70629272,1,0
2,1,0.5,0.75,80170920,2,1
0,3,0.0,0.0,80162904,3,0
0,1,0.0,0.0,82006667,1,0
0,1,0.0,0.0,70704921,1,0
2,0,1.0,1.0,65728810,1,1
0,2,0.0,0.0,66997763,2,0
2,0,1.0,1.0,66237521,1,1
2,0,1.0,1.0,82018773,1,1
2,0,1.0,1.0,80132927,1,1
1,6,0.25,0.8461538461538461,80125960,8,2
2,0,1.0,1.0,82110453,1,1
2,0,1.0,1.0,80128824,1,1
2,1,0.5,0.5,82102757,2,1
2,0,1.0,1.0,73102421,6,6
1,5,0.375,0.8333333333333334,62580665,8,3
2,0,1.0,1.0,68163116,1,1
1,3,0.4,0.8666666666666667,69873384,5,2
2,0,1.0,1.0,58866486,2,2
0,4,0.0,0.0,70229152,4,0
0,3,0.25,0.4090909090909091,69164410,4,1
2,0,1.0,1.0,66228932,2,2
2,1,0.5,0.5,79989532,2,1
2,0,1.0,1.0,80174105,1,1
2,0,1.0,1.0,82145186,4,4
2,0,1.0,1.0,82015859,1,1
2,1,0.75,0.5,80018183,4,3
2,0,1.0,1.0,80003931,1,1
2,0,1.0,1.0,82000707,1,1
0,11,0.21428571428571427,0.4,80141478,14,3
2,0,1.0,1.0,82039332,1,1
2,0,1.0,1.0,80159734,2,2
2,0,1.0,1.0,82047573,1,1
2,2,0.5,0.0,82060557,4,2
2,0,1.0,1.0,70684663,2,2
0,1,0.0,0.0,70747656,1,0
0,3,0.0,0.0,70488362,3,0
2,1,0.8,0.6666666666666666,80127015,5,4
0,4,0.0,0.0,66784305,4,0
0,1,0.0,0.0,64501640,1,0
0,3,0.0,0.0,67703706,3,0
0,1,0.0,0.0,67846772,1,0
0,1,0.0,0.0,66782604,1,0
1,2,0.3333333333333333,0.6,82037235,3,1
2,0,1.0,1.0,71618876,2,2
2,2,0.6,0.6666666666666666,181265,5,3
2,1,0.8571428571428571,0.5,66237794,7,6
0,3,0.25,0.3333333333333333,70580853,4,1
2,2,0.5,0.9375,70344043,4,2
2,2,0.5,0.8888888888888888,80145434,4,2
1,6,0.14285714285714285,0.5909090909090909,70758905,7,1
0,5,0.0,0.0,82102477,5,0
1,2,0.3333333333333333,0.8,69560120,3,1
0,2,0.0,0.0,66237493,2,0
2,0,1.0,1.0,74129321,3,3
0,1,0.0,0.0,70398741,1,0
2,0,1.0,1.0,82110395,1,1
2,0,1.0,1.0,80128826,2,2
0,3,0.0,0.0,70908082,3,0
0,1,0.0,0.0,82247820,1,0
0,1,0.0,0.0,82182784,1,0
2,0,1.0,1.0,69071380,1,1
2,0,1.0,1.0,68186531,1,1
2,1,0.5,0.5,70562135,2,1
1,3,0.25,0.6666666666666666,70691796,4,1
0,1,0.0,0.0,70474446,1,0
1,4,0.2,0.5,67756395,5,1
0,1,0.0,0.0,70048076,1,0
2,1,0.5,0.875,82013522,2,1
0,1,0.0,0.0,67258142,1,0
0,1,0.0,0.0,63277781,1,0
2,0,1.0,1.0,64250634,3,3
2,0,1.0,1.0,82023127,3,3
0,2,0.0,0.0,70701365,2,0
2,0,1.0,1.0,72803801,5,5
0,1,0.0,0.0,64241555,1,0
0,4,0.2,0.14285714285714285,69705181,5,1
2,0,1.0,1.0,79817101,1,1
2,2,0.5,0.6666666666666666,80181927,4,2
0,6,0.14285714285714285,0.23809523809523808,72945971,7,1
2,0,1.0,1.0,80149460,1,1
0,4,0.0,0.0,67285561,4,0
2,0,1.0,1.0,78252776,4,4
2,0,1.0,1.0,70485940,1,1
2,0,1.0,1.0,80094623,1,1
0,2,0.0,0.0,70040124,2,0
0,1,0.0,0.0,68748624,1,0
0,2,0.0,0.0,69164494,2,0
1,2,0.3333333333333333,0.75,69482546,3,1
1,3,0.25,0.7142857142857143,78266720,4,1
1,2,0.3333333333333333,0.9333333333333333,70183722,3,1
2,1,0.5,0.0,70718480,2,1
0,1,0.0,0.0,70843731,1,0
2,0,1.0,1.0,68748281,3,3
2,0,1.0,1.0,82019751,1,1
0,5,0.0,0.0,68390070,5,0
0,1,0.0,0.0,80172611,1,0
0,2,0.0,0.0,67838386,2,0
0,1,0.0,0.0,80170901,1,0
0,3,0.0,0.0,80173409,3,0
0,2,0.0,0.0,70621572,2,0
0,2,0.0,0.0,71619296,2,0
0,1,0.0,0.0,69042701,1,0
2,0,1.0,1.0,82012803,1,1
0,1,0.0,0.0,82024243,1,0
2,0,1.0,1.0,70829955,1,1
0,2,0.0,0.0,63273714,2,0
2,0,1.0,1.0,67823413,2,2
0,1,0.0,0.0,70562184,1,0
0,1,0.0,0.0,70489496,1,0
0,1,0.0,0.0,69091533,1,0
0,1,0.0,0.0,70238833,1,0
0,4,0.0,0.0,70843150,4,0
0,1,0.0,0.0,67821915,1,0
0,3,0.0,0.0,70747810,3,0
2,1,0.6666666666666666,0.5,66229352,3,2
1,2,0.3333333333333333,0.8,80029180,3,1
0,3,0.0,0.0,70699706,3,0
0,2,0.0,0.0,76036541,2,0
2,0,1.0,1.0,78623580,1,1
2,1,0.5,0.75,80176651,2,1
0,4,0.0,0.0,82024207,4,0
0,1,0.0,0.0,70468930,1,0
0,1,0.0,0.0,70468951,1,0
0,2,0.0,0.0,70282772,2,0
0,1,0.0,0.0,67224710,1,0
0,6,0.0,0.0,65852430,6,0
0,6,0.14285714285714285,0.30952380952380953,70175812,7,1
0,2,0.3333333333333333,0.3333333333333333,70175574,3,1
2,0,1.0,1.0,82090255,2,2
2,0,1.0,1.0,70036645,2,2
2,0,1.0,1.0,80159270,1,1
2,0,1.0,1.0,74363324,3,3
2,0,1.0,1.0,18592631,1,1
2,0,1.0,1.0,67199153,3,3
0,1,0.0,0.0,80177419,1,0
2,1,0.6666666666666666,0.6666666666666666,70399294,3,2
0,1,0.0,0.0,80150824,1,0
0,1,0.0,0.0,80150825,1,0
1,3,0.4,0.7692307692307693,70707154,5,2
0,4,0.0,0.0,66785705,4,0
0,4,0.0,0.0,66785726,4,0
1,2,0.3333333333333333,0.7777777777777778,66786314,3,1
0,1,0.0,0.0,66786321,1,0
2,3,0.5,0.8666666666666667,69705020,6,3
2,1,0.75,0.8571428571428571,80055066,4,3
2,0,1.0,1.0,80083640,1,1
2,0,1.0,1.0,82052072,4,4
0,1,0.0,0.0,67423692,1,0
0,2,0.0,0.0,82019449,2,0
2,1,0.5,0.75,82019457,2,1
0,1,0.0,0.0,66233111,1,0
0,1,0.0,0.0,82070204,1,0
2,0,1.0,1.0,79785916,3,3
0,1,0.0,0.0,66188514,1,0
2,0,1.0,1.0,82037163,1,1
0,5,0.0,0.0,82206076,5,0
1,5,0.2857142857142857,0.5882352941176471,70646576,7,2
2,0,1.0,1.0,82121162,1,1
2,0,1.0,1.0,82046207,1,1
2,1,0.5,0.0,69041861,2,1
2,0,1.0,1.0,66233314,1,1
2,2,0.5,0.75,82001119,4,2
2,0,1.0,1.0,70748615,1,1
0,1,0.0,0.0,80118526,1,0
1,2,0.3333333333333333,0.6666666666666666,70229810,3,1
0,2,0.0,0.0,80028564,2,0
2,0,1.0,1.0,70178990,1,1
0,2,0.0,0.0,70927395,2,0
2,0,1.0,1.0,82102244,1,1
0,2,0.0,0.0,70681492,2,0
2,0,1.0,1.0,81989177,3,3
0,1,0.0,0.0,67291504,1,0
2,0,1.0,1.0,82020793,1,1
1,3,0.4,0.5714285714285714,66379243,5,2
2,0,1.0,1.0,67065726,2,2
2,0,1.0,1.0,82060532,1,1
0,2,0.0,0.0,82023069,2,0
0,1,0.0,0.0,76540002,1,0
2,1,0.8888888888888888,0.5,68804701,9,8
0,1,0.0,0.0,19167071,1,0
2,0,1.0,1.0,82055817,1,1
0,1,0.0,0.0,279755,1,0
0,1,0.0,0.0,279776,1,0
0,8,0.0,0.0,70684670,8,0
0,4,0.0,0.0,80133802,4,0
2,0,1.0,1.0,82016258,1,1
2,2,0.5,0.75,74089344,4,2
0,3,0.0,0.0,70696206,3,0
2,0,1.0,1.0,72822631,1,1
2,0,1.0,1.0,67311391,2,2
0,4,0.0,0.0,70702233,4,0
0,1,0.0,0.0,80167275,1,0
2,1,0.75,0.6666666666666666,80128554,4,3
0,1,0.0,0.0,80150634,1,0
0,2,0.0,0.0,80128390,2,0
0,1,0.0,0.0,73634771,1,0
0,3,0.0,0.0,82118232,3,0
0,1,0.0,0.0,80169905,1,0
1,2,0.3333333333333333,0.7142857142857143,82152442,3,1
1,2,0.3333333333333333,0.6666666666666666,82039857,3,1
2,1,0.5,0.5,80056025,2,1
2,1,0.5,0.6666666666666666,80079671,2,1
2,1,0.5,0.6666666666666666,72803955,2,1
0,1,0.0,0.0,68544644,1,0
2,1,0.5,0.6666666666666666,68544994,2,1
2,2,0.5,0.8333333333333334,79787393,4,2
2,0,1.0,1.0,82046103,2,2
2,0,1.0,1.0,69082874,1,1
0,2,0.0,0.0,80177546,2,0
2,0,1.0,1.0,80095204,1,1
2,1,0.5,0.6666666666666666,70701120,2,1
2,1,0.5,0.9166666666666666,70692524,2,1
0,3,0.0,0.0,70635005,3,0
0,2,0.0,0.0,79953916,2,0
2,2,0.5,0.9,70712950,4,2
0,1,0.0,0.0,80150045,1,0
1,2,0.3333333333333333,0.7142857142857143,82010286,3,1
0,4,0.0,0.0,69895483,4,0
2,1,0.5,0.6,82127535,2,1
0,1,0.0,0.0,65201934,1,0
0,1,0.0,0.0,66586800,1,0
0,3,0.0,0.0,72762711,3,0
0,8,0.0,0.0,67434752,8,0
0,1,0.0,0.0,69604080,1,0
0,1,0.0,0.0,66221953,1,0
0,2,0.0,0.0,67620630,2,0
2,0,1.0,1.0,67423825,2,2
0,1,0.0,0.0,68549306,1,0
2,0,1.0,1.0,79796101,1,1
0,5,0.0,0.0,70463764,5,0
0,1,0.0,0.0,62117482,1,0
0,3,0.0,0.0,70175224,3,0
2,1,0.5,0.7777777777777778,70843654,2,1
2,0,1.0,1.0,82052094,2,2
2,0,1.0,1.0,80178241,2,2
2,0,1.0,1.0,80177698,1,1
2,1,0.5,0.0,69975696,2,1
2,0,1.0,1.0,67821943,1,1
2,0,1.0,1.0,69487530,1,1
0,1,0.0,0.0,69201335,1,0
2,1,0.5,0.6666666666666666,82059799,2,1
2,0,1.0,1.0,80159561,1,1
0,4,0.0,0.0,70238602,4,0
1,2,0.3333333333333333,0.8,69638114,3,1
2,1,0.5,0.8,66783745,2,1
1,4,0.3333333333333333,0.9090909090909091,80135306,6,2
0,1,0.0,0.0,64457484,1,0
0,1,0.0,0.0,64457491,1,0
2,0,1.0,1.0,70189140,3,3
0,4,0.0,0.0,66741654,4,0
2,0,1.0,1.0,79462516,1,1
0,1,0.0,0.0,78735314,1,0
0,1,0.0,0.0,73036964,1,0
0,1,0.0,0.0,70399280,1,0
1,3,0.25,0.5652173913043478,67620756,4,1
2,0,1.0,1.0,82142703,1,1
0,2,0.3333333333333333,0.42857142857142855,65008111,3,1
2,1,0.6666666666666666,0.5,70225211,3,2
0,1,0.0,0.0,82251456,1,0
1,3,0.25,0.8888888888888888,80029222,4,1
2,1,0.5,0.0,80022033,2,1
2,0,1.0,1.0,82247774,1,1
2,1,0.5,0.5,82247818,2,1
2,0,1.0,1.0,65595943,2,2
0,1,0.0,0.0,67888170,1,0
2,0,1.0,1.0,70397852,1,1
2,1,0.8333333333333334,0.75,69394003,6,5
2,0,1.0,1.0,71278725,1,1
2,0,1.0,1.0,70593355,2,2
0,5,0.0,0.0,70680162,5,0
0,2,0.0,0.0,61748806,2,0
2,1,0.6666666666666666,0.6666666666666666,63980091,3,2
2,1,0.6666666666666666,0.5,70697186,3,2
0,1,0.0,0.0,72512510,1,0
2,1,0.5,0.0,72376864,2,1
2,1,0.6666666666666666,0.75,70492912,3,2
0,1,0.0,0.0,70703255,1,0
0,1,0.0,0.0,72337293,1,0
2,0,1.0,1.0,67751271,2,2
1,2,0.3333333333333333,0.5,82133035,3,1
2,0,1.0,1.0,68538323,1,1
2,1,0.6666666666666666,0.6666666666666666,65965865,3,2
2,1,0.5,0.5,70595210,2,1
2,0,1.0,1.0,80156928,1,1
1,2,0.3333333333333333,0.5,70699916,3,1
1,4,0.3333333333333333,0.8333333333333334,70252763,6,2
0,1,0.0,0.0,68521054,1,0
2,1,0.6666666666666666,0.0,82053819,3,2
2,0,1.0,1.0,82016284,2,2
2,0,1.0,1.0,80133915,1,1
2,2,0.5,0.9333333333333333,80126792,4,2
2,0,1.0,1.0,70350560,2,2
0,2,0.0,0.0,70692265,2,0
0,6,0.14285714285714285,0.4827586206896552,73295481,7,1
0,1,0.0,0.0,68805443,1,0
2,1,0.5,0.75,70417522,2,1
2,1,0.5,0.8,69006371,2,1
0,5,0.0,0.0,68018566,5,0
2,0,1.0,1.0,67803050,1,1
0,1,0.0,0.0,69905843,1,0
1,2,0.3333333333333333,0.8888888888888888,82150103,3,1
0,2,0.0,0.0,69007036,2,0
2,1,0.5,0.6,68060846,2,1
2,0,1.0,1.0,67172525,1,1
2,1,0.5,0.9583333333333334,70858662,2,1
0,1,0.0,0.0,67526592,1,0
2,0,1.0,1.0,65267174,1,1
0,1,0.0,0.0,80125961,1,0
2,1,0.5,0.5,70189882,2,1
2,1,0.5,0.75,66379313,2,1
0,2,0.0,0.0,70697361,2,0
1,2,0.3333333333333333,0.5,66469816,3,1
0,2,0.0,0.0,70692475,2,0
0,1,0.0,0.0,77352093,1,0
0,3,0.0,0.0,77352100,3,0
0,2,0.0,0.0,68256160,2,0
0,3,0.0,0.0,68256202,3,0
0,1,0.0,0.0,70189553,1,0
0,7,0.125,0.38636363636363635,68519766,8,1
2,0,1.0,1.0,82019670,4,4
2,0,1.0,1.0,70693553,1,1
1,2,0.3333333333333333,0.7142857142857143,82024344,3,1
2,1,0.6666666666666666,0.6666666666666666,65714894,3,2
2,0,1.0,1.0,70854322,1,1
0,7,0.2222222222222222,0.3684210526315789,70600586,9,2
2,2,0.7142857142857143,0.8333333333333334,57210475,7,5
0,1,0.0,0.0,70746305,1,0
2,0,1.0,1.0,82054046,2,2
2,0,1.0,1.0,80176654,2,2
2,0,1.0,1.0,69975766,3,3
2,0,1.0,1.0,69958476,2,2
0,1,0.0,0.0,82018733,1,0
0,1,0.0,0.0,82018734,1,0
0,2,0.0,0.0,82095515,2,0
2,0,1.0,1.0,82041269,2,2
0,2,0.0,0.0,82024228,2,0
2,0,1.0,1.0,75362623,2,2
1,3,0.4,0.8333333333333334,80158278,5,2
2,0,1.0,1.0,82039396,1,1
2,0,1.0,1.0,82054728,2,2
2,1,0.8333333333333334,0.5,82038266,6,5
2,0,1.0,1.0,66083220,1,1
0,1,0.0,0.0,80176811,1,0
2,1,0.6666666666666666,0.9230769230769231,82010288,3,2
1,2,0.3333333333333333,0.9090909090909091,64359505,3,1
0,1,0.0,0.0,66782212,1,0
0,4,0.2,0.25,80053393,5,1
0,2,0.3333333333333333,0.3333333333333333,70718333,3,1
2,0,1.0,1.0,66046890,1,1
0,1,0.0,0.0,80177541,1,0
2,0,1.0,1.0,68186412,1,1
0,5,0.0,0.0,69400562,5,0
2,2,0.5,0.95,71359442,4,2
0,3,0.0,0.0,66304763,3,0
0,1,0.0,0.0,80126860,1,0
0,3,0.0,0.0,68596080,3,0
0,2,0.0,0.0,70682493,2,0
0,2,0.0,0.0,70684992,2,0
0,1,0.0,0.0,69997550,1,0
0,1,0.0,0.0,82051755,1,0
2,4,0.5,0.8888888888888888,65289616,8,4
2,0,1.0,1.0,70063273,1,1
2,0,1.0,1.0,74448346,3,3
2,0,1.0,1.0,68531806,1,1
2,0,1.0,1.0,68340930,4,4
2,1,0.5,0.5,73701362,2,1
0,2,0.0,0.0,70229376,2,0
2,0,1.0,1.0,82037834,1,1
0,2,0.0,0.0,70682836,2,0
2,1,0.5,0.5,68987254,2,1
0,1,0.0,0.0,66560606,1,0
0,1,0.0,0.0,65278633,1,0
2,1,0.5,0.7777777777777778,82247763,2,1
0,2,0.0,0.0,70698292,2,0
2,0,1.0,1.0,80176377,1,1
2,0,1.0,1.0,69144460,1,1
0,2,0.0,0.0,70674555,2,0
2,2,0.7142857142857143,0.8,62912185,7,5
2,0,1.0,1.0,67529196,2,2
2,1,0.5,0.7142857142857143,68060720,2,1
0,2,0.0,0.0,69182743,2,0
0,3,0.0,0.0,80150279,3,0
2,1,0.6666666666666666,0.6666666666666666,73652404,3,2
2,0,1.0,1.0,36084160,2,2
0,2,0.0,0.0,80150937,2,0
0,2,0.0,0.0,70702576,2,0
2,1,0.6666666666666666,0.8,62375621,3,2
2,1,0.5,0.8,69924841,2,1
0,2,0.0,0.0,70704760,2,0
0,1,0.0,0.0,70109655,1,0
2,0,1.0,1.0,80162168,2,2
1,2,0.3333333333333333,0.6666666666666666,72362192,3,1
2,0,1.0,1.0,67652935,1,1
2,0,1.0,1.0,66281005,2,2
2,1,0.5,0.0,67374195,2,1
2,1,0.5,0.6666666666666666,80132893,2,1
2,1,0.5,0.5,68789791,2,1
0,4,0.0,0.0,69100661,4,0
0,3,0.25,0.3333333333333333,80131103,4,1
2,1,0.5,0.9,70482580,2,1
0,3,0.0,0.0,80167314,3,0
0,2,0.0,0.0,69867322,2,0
0,9,0.0,0.0,82158893,9,0
0,9,0.0,0.0,82158894,9,0
0,3,0.25,0.42857142857142855,65981790,4,1
2,1,0.75,0.9230769230769231,69611402,4,3
0,2,0.0,0.0,69499031,2,0
0,1,0.0,0.0,69831706,1,0
2,0,1.0,1.0,80176636,4,4
0,7,0.0,0.0,82061337,7,0
2,0,1.0,1.0,65866003,1,1
0,6,0.0,0.0,68784835,6,0
0,1,0.0,0.0,71972880,1,0
0,2,0.0,0.0,69594854,2,0
2,0,1.0,1.0,61102552,3,3
2,2,0.5,0.75,69146924,4,2
1,3,0.25,0.6666666666666666,82102783,4,1
2,1,0.75,0.8333333333333334,74432911,4,3
2,0,1.0,1.0,66233020,2,2
2,1,0.6666666666666666,0.5,80125954,3,2
1,2,0.3333333333333333,0.8,70064036,3,1
2,1,0.5,0.5,80165347,2,1
2,0,1.0,1.0,69539953,1,1
2,0,1.0,1.0,82041898,1,1
2,1,0.6666666666666666,0.5,70459354,3,2
0,1,0.0,0.0,70459361,1,0
2,1,0.5,0.6666666666666666,80165154,2,1
0,2,0.3333333333333333,0.3333333333333333,69094725,3,1
0,4,0.2,0.125,68191172,5,1
2,1,0.8571428571428571,0.5,68330255,7,6
0,1,0.0,0.0,70175700,1,0
2,0,1.0,1.0,80139894,2,2
2,1,0.75,0.5,80118136,4,3
1,2,0.3333333333333333,0.6153846153846154,82022886,3,1
0,1,0.0,0.0,70488943,1,0
0,1,0.0,0.0,70489272,1,0
1,2,0.3333333333333333,0.75,64976226,3,1
2,1,0.8333333333333334,0.5,80126941,6,5
2,0,1.0,1.0,70314223,2,2
0,1,0.0,0.0,80158266,1,0
2,4,0.5,0.9629629629629629,66226902,8,4
2,0,1.0,1.0,70712411,9,9
2,0,1.0,1.0,68748456,2,2
2,0,1.0,1.0,19488021,1,1
0,1,0.0,0.0,67286296,1,0
0,4,0.0,0.0,69006840,4,0
0,5,0.0,0.0,70692482,5,0
0,1,0.0,0.0,70743701,1,0
0,2,0.0,0.0,66786342,2,0
0,1,0.0,0.0,70398405,1,0
2,1,0.5,0.5,80172581,2,1
0,2,0.0,0.0,82006371,2,0
2,0,1.0,1.0,80092775,2,2
0,7,0.2222222222222222,0.25,63064302,9,2
1,2,0.3333333333333333,0.7272727272727273,69562752,3,1
2,0,1.0,1.0,82037888,1,1
0,5,0.0,0.0,69100752,5,0
0,1,0.0,0.0,70705726,1,0
0,2,0.0,0.0,66169943,2,0
2,1,0.6666666666666666,0.6666666666666666,61366606,3,2
1,2,0.3333333333333333,0.5714285714285714,70215775,3,1
0,2,0.0,0.0,67756423,2,0
0,1,0.0,0.0,80150678,1,0
0,3,0.0,0.0,69469281,3,0
2,1,0.5,0.5,82022960,2,1
0,4,0.0,0.0,80154394,4,0
2,0,1.0,1.0,65323804,1,1
1,2,0.3333333333333333,0.6,80056704,3,1
0,1,0.0,0.0,70675304,1,0
2,2,0.5,0.8,68625844,4,2
2,0,1.0,1.0,66240195,2,2
2,0,1.0,1.0,66232180,1,1
2,0,1.0,1.0,82024225,1,1
2,1,0.5,0.6666666666666666,69644750,2,1
0,1,0.0,0.0,75149473,1,0
2,0,1.0,1.0,80159682,1,1
0,3,0.0,0.0,69946891,3,0
0,2,0.0,0.0,70801451,2,0
2,1,0.6666666666666666,0.5,82041719,3,2
0,2,0.3333333333333333,0.4,80150264,3,1
1,3,0.25,0.5625,70759591,4,1
0,1,0.0,0.0,70694911,1,0
1,4,0.2,0.5,70677712,5,1
1,3,0.25,0.8571428571428571,67815300,4,1
2,1,0.5,0.6666666666666666,68605376,2,1
2,0,1.0,1.0,66958171,2,2
2,1,0.6666666666666666,0.6666666666666666,65866073,3,2
0,4,0.2,0.16666666666666666,65291436,5,1
2,0,1.0,1.0,82016140,1,1
2,0,1.0,1.0,82200596,1,1
0,1,0.0,0.0,70680631,1,0
0,2,0.0,0.0,70193123,2,0
2,0,1.0,1.0,81909278,1,1
0,2,0.0,0.0,67731944,2,0
0,1,0.0,0.0,80153651,1,0
0,2,0.0,0.0,82102554,2,0
2,0,1.0,1.0,80022040,1,1
2,1,0.6666666666666666,0.5,66092586,3,2
0,2,0.0,0.0,67910220,2,0
2,1,0.5,0.5,65812383,2,1
2,0,1.0,1.0,67822034,1,1
0,2,0.0,0.0,80092383,2,0
0,1,0.0,0.0,69311403,1,0
0,1,0.0,0.0,69313062,1,0
2,0,1.0,1.0,82017797,1,1
0,4,0.0,0.0,70629230,4,0
1,3,0.25,0.7333333333333333,80128037,4,1
2,0,1.0,1.0,72446080,1,1
2,0,1.0,1.0,68556726,1,1
0,1,0.0,0.0,69321035,1,0
2,1,0.8,0.5,67822832,5,4
0,1,0.0,0.0,60735255,1,0
1,3,0.25,0.5833333333333334,70720944,4,1
0,2,0.0,0.0,80056060,2,0
2,0,1.0,1.0,80159264,2,2
2,0,1.0,1.0,67786712,1,1
2,1,0.5,0.8,68952856,2,1
2,0,1.0,1.0,82144701,1,1
0,1,0.0,0.0,82046297,1,0
0,1,0.0,0.0,82046303,1,0
2,0,1.0,1.0,80118477,1,1
2,0,1.0,1.0,72426095,3,3
0,2,0.0,0.0,80177434,2,0
2,0,1.0,1.0,82138710,1,1
0,2,0.0,0.0,70705656,2,0
0,6,0.0,0.0,70707000,6,0
0,2,0.0,0.0,68538400,2,0
2,0,1.0,1.0,69006896,1,1
2,0,1.0,1.0,70410774,1,1
0,3,0.4,0.3333333333333333,80095022,5,2
1,2,0.3333333333333333,0.75,68149270,3,1
0,1,0.0,0.0,82102493,1,0
2,0,1.0,1.0,80159232,4,4
0,2,0.0,0.0,74335961,2,0
2,1,0.5,0.6666666666666666,80092523,2,1
0,4,0.0,0.0,82024277,4,0
0,2,0.0,0.0,69478962,2,0
0,2,0.0,0.0,69479291,2,0
0,1,0.0,0.0,70229586,1,0
0,2,0.3333333333333333,0.3333333333333333,82002283,3,1
0,1,0.0,0.0,70702765,1,0
2,0,1.0,1.0,62375614,1,1
2,0,1.0,1.0,80136611,1,1
0,2,0.0,0.0,70591906,2,0
0,2,0.0,0.0,68498892,2,0
0,1,0.0,0.0,69693330,1,0
0,1,0.0,0.0,72805334,1,0
2,0,1.0,1.0,80139787,1,1
2,1,0.6666666666666666,0.5,72802205,3,2
2,0,1.0,1.0,80084172,1,1
0,1,0.0,0.0,67810113,1,0
2,1,0.5,0.6,62748203,2,1
2,0,1.0,1.0,67053875,1,1
1,4,0.3333333333333333,0.8,72874396,6,2
0,10,0.0,0.0,67094734,10,0
2,1,0.5,0.9166666666666666,70223720,2,1
0,1,0.0,0.0,70684635,1,0
2,1,0.6666666666666666,0.3333333333333333,80159300,3,2
2,1,0.6666666666666666,0.5,70919303,3,2
0,1,0.0,0.0,70703640,1,0
2,1,0.5,0.5,70494165,2,1
2,0,1.0,1.0,70700266,1,1
0,1,0.0,0.0,68451593,1,0
2,0,1.0,1.0,68250273,4,4
0,1,0.0,0.0,78735524,1,0
0,1,0.0,0.0,67290230,1,0
0,1,0.0,0.0,67290244,1,0
0,1,0.0,0.0,70706391,1,0
0,1,0.0,0.0,69870241,1,0
2,0,1.0,1.0,80176062,1,1
0,3,0.0,0.0,71619114,3,0
0,4,0.0,0.0,71620010,4,0
0,1,0.0,0.0,80173398,1,0
0,2,0.0,0.0,69042890,2,0
0,2,0.0,0.0,73650675,2,0
0,2,0.0,0.0,82118224,2,0
0,5,0.16666666666666666,0.4090909090909091,75855640,6,1
0,1,0.0,0.0,69925044,1,0
0,1,0.0,0.0,72376885,1,0
0,1,0.0,0.0,72377312,1,0
0,2,0.3333333333333333,0.0,80163696,3,1
2,0,1.0,1.0,82061213,1,1
2,1,0.8333333333333334,0.5,75048050,6,5
2,1,0.75,0.6666666666666666,66237703,4,3
0,1,0.0,0.0,70699650,1,0
2,0,1.0,1.0,66234462,1,1
2,0,1.0,1.0,67311314,3,3
2,1,0.5,0.0,82127539,2,1
1,3,0.25,0.7619047619047619,69163213,4,1
0,4,0.0,0.0,80128552,4,0
2,0,1.0,1.0,80132905,2,2
2,0,1.0,1.0,74858161,1,1
2,1,0.6666666666666666,0.3333333333333333,70407526,3,2
2,0,1.0,1.0,69151222,1,1
2,0,1.0,1.0,65977303,1,1
0,1,0.0,0.0,82019072,1,0
2,2,0.5,0.6666666666666666,63086793,4,2
0,2,0.3333333333333333,0.2,80165334,3,1
0,2,0.0,0.0,70674646,2,0
0,1,0.0,0.0,70681772,1,0
0,1,0.0,0.0,70395633,1,0
2,0,1.0,1.0,66899161,2,2
2,0,1.0,1.0,82020623,2,2
2,0,1.0,1.0,80159761,2,2
0,1,0.0,0.0,68656112,1,0
0,3,0.0,0.0,68656196,3,0
2,0,1.0,1.0,73651053,1,1
2,0,1.0,1.0,82015877,2,2
2,0,1.0,1.0,70184702,1,1
2,0,1.0,1.0,80159725,1,1
2,0,1.0,1.0,80137594,2,2
2,0,1.0,1.0,82016254,1,1
2,0,1.0,1.0,80089380,2,2
2,0,1.0,1.0,82175572,3,3
0,1,0.0,0.0,64457995,1,0
1,5,0.2857142857142857,0.8846153846153846,80149974,7,2
0,5,0.0,0.0,66784620,5,0
0,1,0.0,0.0,64457806,1,0
0,2,0.0,0.0,82006321,2,0
2,2,0.5,0.9166666666666666,68021583,4,2
0,1,0.0,0.0,70459333,1,0
0,1,0.0,0.0,68498094,1,0
1,4,0.3333333333333333,0.5,69703914,6,2
2,0,1.0,1.0,80057432,1,1
0,1,0.0,0.0,67786635,1,0
0,2,0.0,0.0,70704746,2,0
2,1,0.6666666666666666,0.6666666666666666,80117834,3,2
2,1,0.5,0.5,70821506,2,1
2,1,0.5,0.5,68286813,2,1
0,2,0.0,0.0,70398776,2,0
0,1,0.0,0.0,70707462,1,0
2,0,1.0,1.0,80094063,1,1
0,2,0.0,0.0,75663063,2,0
2,0,1.0,1.0,68380102,1,1
0,4,0.0,0.0,69948830,4,0
2,1,0.5,0.5,82051997,2,1
2,0,1.0,1.0,67744586,2,2
2,3,0.625,0.7142857142857143,70752836,8,5
2,0,1.0,1.0,82102243,1,1
2,1,0.6666666666666666,0.6666666666666666,66110394,3,2
2,1,0.5,0.7272727272727273,70747803,2,1
2,2,0.5,0.75,70844032,4,2
2,0,1.0,1.0,79030063,1,1
2,0,1.0,1.0,69468994,1,1
2,0,1.0,1.0,82016125,1,1
0,3,0.25,0.3333333333333333,69701170,4,1
2,1,0.75,0.75,66848201,4,3
2,1,0.6666666666666666,0.5,74955461,3,2
0,2,0.0,0.0,69693764,2,0
0,1,0.0,0.0,80160083,1,0
2,1,0.6666666666666666,0.5,68039923,3,2
2,0,1.0,1.0,80134958,2,2
0,2,0.0,0.0,70677096,2,0
2,0,1.0,1.0,67498375,2,2
2,0,1.0,1.0,67314534,1,1
2,0,1.0,1.0,67799354,1,1
0,1,0.0,0.0,75347020,1,0
1,2,0.3333333333333333,0.5,68199544,3,1
0,2,0.0,0.0,69241774,2,0
0,1,0.0,0.0,69226374,1,0
2,1,0.5,0.0,82054065,2,1
1,4,0.3333333333333333,0.8333333333333334,69117230,6,2
0,2,0.0,0.0,80172520,2,0
0,6,0.0,0.0,82006483,6,0
0,2,0.0,0.0,69640795,2,0
0,2,0.0,0.0,80172559,2,0
0,6,0.0,0.0,80150704,6,0
0,2,0.0,0.0,82006536,2,0
0,2,0.0,0.0,66126774,2,0
0,1,0.0,0.0,69975633,1,0
1,6,0.14285714285714285,0.5757575757575758,70489384,7,1
0,1,0.0,0.0,69510546,1,0
2,1,0.5,0.6666666666666666,70063161,2,1
2,0,1.0,1.0,70092701,1,1
0,1,0.0,0.0,69603436,1,0
2,0,1.0,1.0,70542864,4,4
1,2,0.3333333333333333,0.7777777777777778,80155197,3,1
0,2,0.0,0.0,68805863,2,0
1,2,0.3333333333333333,0.8333333333333334,80067421,3,1
0,2,0.0,0.0,65112635,2,0
0,3,0.25,0.3333333333333333,80165143,4,1
2,0,1.0,1.0,68174120,1,1
0,1,0.0,0.0,80126826,1,0
0,1,0.0,0.0,80126835,1,0
1,4,0.42857142857142855,0.8888888888888888,70066052,7,3
2,1,0.8,0.5,75264273,5,4
0,1,0.0,0.0,70494333,1,0
2,0,1.0,1.0,69057800,1,1
2,1,0.6666666666666666,0.8888888888888888,70185003,3,2
0,2,0.0,0.0,80165371,2,0
0,1,0.0,0.0,67428473,1,0
0,2,0.0,0.0,69482343,2,0
2,0,1.0,1.0,77319683,2,2
0,1,0.0,0.0,65981825,1,0
2,0,1.0,1.0,74362484,1,1
2,0,1.0,1.0,80004106,2,2
2,0,1.0,1.0,82052074,2,2
0,1,0.0,0.0,82036990,1,0
0,1,0.0,0.0,82036993,1,0
0,1,0.0,0.0,73366076,1,0
1,2,0.3333333333333333,0.7,73632363,3,1
0,2,0.0,0.0,64041852,2,0
0,3,0.0,0.0,66786503,3,0
0,2,0.0,0.0,82006219,2,0
2,1,0.5,0.6666666666666666,66784865,2,1
0,1,0.0,0.0,80135273,1,0
1,3,0.25,0.6666666666666666,67195471,4,1
0,2,0.0,0.0,67195520,2,0
0,3,0.0,0.0,67195541,3,0
0,1,0.0,0.0,66442061,1,0
2,0,1.0,1.0,66228575,2,2
1,2,0.3333333333333333,0.5,73801553,3,1
2,0,1.0,1.0,80054926,1,1
0,1,0.0,0.0,80128684,1,0
0,3,0.0,0.0,82019814,3,0
0,1,0.0,0.0,82019883,1,0
2,0,1.0,1.0,80051594,3,3
0,2,0.0,0.0,69578565,2,0
0,3,0.0,0.0,73411933,3,0
0,1,0.0,0.0,70459256,1,0
2,0,1.0,1.0,72803934,3,3
0,5,0.0,0.0,70701351,5,0
2,1,0.6666666666666666,0.9230769230769231,80176846,3,2
1,3,0.25,0.6666666666666666,82090263,4,1
0,2,0.0,0.0,82090268,2,0
0,2,0.0,0.0,65828616,2,0
0,1,0.0,0.0,68519920,1,0
2,0,1.0,1.0,69950083,1,1
0,1,0.0,0.0,70493766,1,0
0,1,0.0,0.0,70493864,1,0
0,1,0.0,0.0,68532163,1,0
0,2,0.0,0.0,70490945,2,0
1,3,0.25,0.875,70239484,4,1
0,3,0.0,0.0,70680533,3,0
0,2,0.0,0.0,70677481,2,0
2,0,1.0,1.0,64994223,1,1
0,1,0.0,0.0,69498800,1,0
0,3,0.25,0.25,68254550,4,1
0,1,0.0,0.0,69424523,1,0
0,1,0.0,0.0,80128661,1,0
0,1,0.0,0.0,72480492,1,0
0,1,0.0,0.0,80117833,1,0
1,4,0.3333333333333333,0.68,72910243,6,2
0,1,0.0,0.0,70675955,1,0
0,2,0.0,0.0,70697116,2,0
0,2,0.0,0.0,68805611,2,0
0,5,0.16666666666666666,0.38461538461538464,80170980,6,1
0,2,0.0,0.0,82006477,2,0
0,1,0.0,0.0,82102601,1,0
0,1,0.0,0.0,80165871,1,0
0,3,0.0,0.0,80150630,3,0
0,3,0.0,0.0,82006687,3,0
0,1,0.0,0.0,67917185,1,0
2,1,0.5,0.75,80127901,2,1
2,2,0.6,0.8571428571428571,64195740,5,3
1,4,0.3333333333333333,0.9512195121951219,67668783,6,2
0,2,0.0,0.0,70395542,2,0
1,2,0.3333333333333333,0.8181818181818182,69170710,3,1
0,1,0.0,0.0,72540293,1,0
0,4,0.0,0.0,82102490,4,0
2,0,1.0,1.0,80052735,4,4
1,4,0.3333333333333333,0.5714285714285714,75377022,6,2
2,0,1.0,1.0,67779523,1,1
2,0,1.0,1.0,80156705,1,1
2,0,1.0,1.0,75338200,1,1
2,0,1.0,1.0,57206625,3,3
0,1,0.0,0.0,67748982,1,0
2,0,1.0,1.0,82018699,3,3
2,0,1.0,1.0,69662621,1,1
0,1,0.0,0.0,70672364,1,0
2,0,1.0,1.0,70058695,1,1
0,6,0.14285714285714285,0.21428571428571427,72785811,7,1
0,1,0.0,0.0,69021883,1,0
2,0,1.0,1.0,80128023,1,1
2,1,0.5,0.5,67384135,2,1
2,0,1.0,1.0,69412301,1,1
0,2,0.3333333333333333,0.0,80177557,3,1
2,1,0.5,0.5,62940283,2,1
2,0,1.0,1.0,80178218,2,2
2,1,0.6666666666666666,0.9655172413793104,68498822,3,2
0,4,0.0,0.0,68499011,4,0
0,3,0.0,0.0,69479130,3,0
0,3,0.0,0.0,70706440,3,0
0,1,0.0,0.0,64458646,1,0
2,1,0.5,0.3333333333333333,65289602,2,1
2,1,0.5,0.75,70685405,2,1
2,0,1.0,1.0,80079545,5,5
2,0,1.0,1.0,80057691,1,1
2,0,1.0,1.0,80150283,2,2
0,3,0.0,0.0,70680092,3,0
0,1,0.0,0.0,66233293,1,0
1,2,0.3333333333333333,0.6666666666666666,69596184,3,1
0,2,0.3333333333333333,0.4,69597080,3,1
2,1,0.5,0.6666666666666666,70639331,2,1
2,0,1.0,1.0,75061021,1,1
2,0,1.0,1.0,81989185,1,1
0,2,0.0,0.0,70672126,2,0
2,0,1.0,1.0,82247773,1,1
2,1,0.5,0.5,68784002,2,1
0,1,0.0,0.0,68747714,1,0
2,0,1.0,1.0,70680883,1,1
2,0,1.0,1.0,74749626,3,3
2,0,1.0,1.0,82041251,2,2
2,3,0.5,0.5,68163032,6,3
0,2,0.0,0.0,70682346,2,0
0,1,0.0,0.0,70698915,1,0
0,1,0.0,0.0,64252384,1,0
0,1,0.0,0.0,74032350,1,0
1,2,0.3333333333333333,0.5714285714285714,68658772,3,1
1,2,0.3333333333333333,0.5,80094070,3,1
1,2,0.3333333333333333,0.8333333333333334,79218895,3,1
2,2,0.5,0.8571428571428571,69483225,4,2
0,1,0.0,0.0,69693505,1,0
0,5,0.0,0.0,73295565,5,0
0,7,0.125,0.10526315789473684,65278815,8,1
0,1,0.0,0.0,69391791,1,0
2,0,1.0,1.0,66757460,2,2
0,2,0.0,0.0,70494102,2,0
0,1,0.0,0.0,80145717,1,0
2,1,0.75,0.9,70474313,4,3
2,0,1.0,1.0,70175154,1,1
2,1,0.5,0.0,74443964,2,1
0,2,0.0,0.0,68519850,2,0
0,5,0.0,0.0,67620693,5,0
0,3,0.0,0.0,70238700,3,0
0,3,0.0,0.0,73535553,3,0
0,1,0.0,0.0,82043181,1,0
2,1,0.5,0.5,82043182,2,1
2,0,1.0,1.0,82016260,1,1
2,1,0.5,0.5,72802254,2,1
0,1,0.0,0.0,70653730,1,0
2,0,1.0,1.0,69626361,1,1
2,1,0.5,0.875,69603114,2,1
2,2,0.5,0.9,66842216,4,2
0,1,0.0,0.0,69525743,1,0
2,1,0.5,0.9090909090909091,82006787,2,1
0,1,0.0,0.0,80150551,1,0
0,4,0.0,0.0,70635201,4,0
0,1,0.0,0.0,80172557,1,0
1,2,0.3333333333333333,0.5,64469342,3,1
0,1,0.0,0.0,70703724,1,0
2,0,1.0,1.0,67429236,1,1
0,1,0.0,0.0,68680605,1,0
0,1,0.0,0.0,73801434,1,0
2,0,1.0,1.0,80092481,2,2
2,0,1.0,1.0,80159196,7,7
0,1,0.0,0.0,70525434,1,0
0,3,0.0,0.0,75147940,3,0
2,0,1.0,1.0,82135123,1,1
2,2,0.5,0.6666666666666666,64272096,4,2
2,2,0.6,0.6666666666666666,82041280,5,3
0,2,0.0,0.0,70279405,2,0
2,1,0.6666666666666666,0.5,80091935,3,2
2,0,1.0,1.0,80165464,1,1
2,1,0.5,0.6666666666666666,66237220,2,1
2,0,1.0,1.0,82020621,1,1
2,1,0.6666666666666666,0.6666666666666666,68191711,3,2
2,1,0.5,0.6666666666666666,68647131,2,1
2,0,1.0,1.0,67335520,1,1
0,4,0.2,0.36363636363636365,70854063,5,1
0,3,0.25,0.4090909090909091,70685713,4,1
0,2,0.0,0.0,72790102,2,0
2,1,0.6666666666666666,0.5,80092922,3,2
0,1,0.0,0.0,70698222,1,0
0,1,0.0,0.0,73653664,1,0
2,0,1.0,1.0,70702506,2,2
2,1,0.5,0.0,80149252,2,1
2,0,1.0,1.0,80165228,2,2
2,0,1.0,1.0,82020831,3,3
0,4,0.0,0.0,75033196,4,0
2,0,1.0,1.0,68385492,3,3
0,2,0.0,0.0,80132919,2,0
1,5,0.16666666666666666,0.6551724137931034,70693196,6,1
0,1,0.0,0.0,69517651,1,0
0,1,0.0,0.0,70705390,1,0
0,1,0.0,0.0,68461575,1,0
2,0,1.0,1.0,66235064,1,1
2,0,1.0,1.0,70063581,1,1
2,0,1.0,1.0,74442963,4,4
2,1,0.6666666666666666,0.5,71374800,3,2
0,2,0.0,0.0,80126884,2,0
0,3,0.0,0.0,70801416,3,0
0,3,0.0,0.0,70801906,3,0
2,0,1.0,1.0,66236583,1,1
0,1,0.0,0.0,70682395,1,0
2,2,0.5,0.8888888888888888,70475013,4,2
0,1,0.0,0.0,65294936,1,0
2,1,0.5,0.5,82052042,2,1
0,2,0.3333333333333333,0.42857142857142855,82110454,3,1
0,5,0.0,0.0,81989191,5,0
1,3,0.4,0.7142857142857143,66110632,5,2
0,2,0.0,0.0,70941633,2,0
0,4,0.0,0.0,69179586,4,0
0,2,0.0,0.0,64234632,2,0
2,1,0.6666666666666666,0.5,72802135,3,2
0,5,0.0,0.0,80174909,5,0
2,1,0.6666666666666666,0.8,70700966,3,2
2,0,1.0,1.0,63142590,3,3
0,1,0.0,0.0,69701674,1,0
0,1,0.0,0.0,72522793,1,0
0,1,0.0,0.0,80165780,1,0
1,3,0.25,0.5263157894736842,69642916,4,1
0,6,0.14285714285714285,0.40625,80170938,7,1
0,1,0.0,0.0,82006656,1,0
1,2,0.3333333333333333,0.7142857142857143,64469461,3,1
0,1,0.0,0.0,70213171,1,0
2,1,0.5,0.9230769230769231,80150549,2,1
0,2,0.0,0.0,73801693,2,0
0,3,0.25,0.2857142857142857,80163685,4,1
2,3,0.5714285714285714,0.8888888888888888,67551715,7,4
2,0,1.0,1.0,70780360,1,1
0,2,0.0,0.0,70684824,2,0
2,0,1.0,1.0,82200610,1,1
2,1,0.5,0.8571428571428571,64066800,2,1
0,3,0.25,0.35714285714285715,70702534,4,1
2,0,1.0,1.0,70344736,1,1
2,0,1.0,1.0,66227364,1,1
0,1,0.0,0.0,70685832,1,0
0,1,0.0,0.0,82182776,1,0
0,2,0.0,0.0,70678475,2,0
2,0,1.0,1.0,82039373,1,1
2,0,1.0,1.0,80092243,1,1
0,1,0.0,0.0,82095218,1,0
1,2,0.3333333333333333,0.6666666666666666,68953150,3,1
2,0,1.0,1.0,80162147,3,3
2,0,1.0,1.0,82095283,2,2
2,0,1.0,1.0,68346481,2,2
2,0,1.0,1.0,82016178,1,1
2,0,1.0,1.0,82039886,3,3
2,0,1.0,1.0,80161916,4,4
2,0,1.0,1.0,82102153,1,1
2,0,1.0,1.0,80145780,2,2
0,4,0.2,0.2857142857142857,80154110,5,1
2,0,1.0,1.0,66899000,2,2
0,2,0.3333333333333333,0.2857142857142857,67839814,3,1
0,1,0.0,0.0,64457841,1,0
2,3,0.625,0.9444444444444444,74289614,8,5
2,3,0.5714285714285714,0.6666666666666666,79849126,7,4
2,1,0.5,0.5,70868560,2,1
2,0,1.0,1.0,79785853,3,3
0,2,0.0,0.0,70702870,2,0
0,1,0.0,0.0,72804326,1,0
2,0,1.0,1.0,80057005,1,1
2,0,1.0,1.0,67782771,2,2
2,0,1.0,1.0,82137383,1,1
2,2,0.5,0.3333333333333333,66560550,4,2
0,2,0.0,0.0,71212330,2,0
0,1,0.0,0.0,70492996,1,0
2,0,1.0,1.0,70109914,1,1
2,1,0.5,0.8333333333333334,70674226,2,1
0,1,0.0,0.0,81985332,1,0
2,1,0.5,0.5,82021455,2,1
0,2,0.0,0.0,80176456,2,0
0,1,0.0,0.0,70238056,1,0
1,2,0.3333333333333333,0.8571428571428571,80150939,3,1
0,1,0.0,0.0,72376906,1,0
0,2,0.0,0.0,66847984,2,0
2,0,1.0,1.0,69207334,1,1
0,1,0.0,0.0,67366103,1,0
2,0,1.0,1.0,80150294,1,1
0,2,0.0,0.0,69094060,2,0
2,2,0.5,0.8,68805394,4,2
1,2,0.3333333333333333,0.8,82013590,3,1
0,2,0.0,0.0,70703801,2,0
1,2,0.3333333333333333,0.6923076923076923,80126885,3,1
2,0,1.0,1.0,68538456,3,3
2,0,1.0,1.0,80176453,2,2
0,2,0.0,0.0,69182400,2,0
2,0,1.0,1.0,72803941,2,2
2,1,0.6666666666666666,0.5,66229464,3,2
2,0,1.0,1.0,72804193,1,1
2,1,0.5,0.6666666666666666,72804032,2,1
2,1,0.5,0.5,82023067,2,1
2,0,1.0,1.0,80165210,2,2
2,0,1.0,1.0,68229105,2,2
2,0,1.0,1.0,82090149,1,1
0,1,0.0,0.0,67917171,1,0
0,1,0.0,0.0,82205872,1,0
0,1,0.0,0.0,67978022,1,0
1,2,0.3333333333333333,0.6,68283026,3,1
1,2,0.3333333333333333,0.9375,67510870,3,1
2,1,0.6666666666666666,0.8,69187972,3,2
0,6,0.0,0.0,82049178,6,0
0,2,0.0,0.0,61579133,2,0
2,0,1.0,1.0,69701142,2,2
0,1,0.0,0.0,54681816,1,0
0,1,0.0,0.0,78479793,1,0
0,7,0.0,0.0,70238945,7,0
1,4,0.3333333333333333,0.8181818181818182,64000300,6,2
2,0,1.0,1.0,70565110,1,1
1,2,0.3333333333333333,0.6,64345295,3,1
2,0,1.0,1.0,82016281,1,1
0,1,0.0,0.0,68234453,1,0
0,4,0.0,0.0,69007351,4,0
2,1,0.75,0.5,75479936,4,3
0,2,0.0,0.0,61440421,2,0
2,1,0.6666666666666666,0.5,69172642,3,2
2,0,1.0,1.0,80092936,2,2
2,0,1.0,1.0,80118353,2,2
0,2,0.0,0.0,80158315,2,0
0,5,0.0,0.0,70703290,5,0
0,4,0.0,0.0,70743855,4,0
2,0,1.0,1.0,70629363,2,2
0,4,0.0,0.0,82102643,4,0
0,2,0.0,0.0,67352866,2,0
1,4,0.3333333333333333,0.75,80160442,6,2
0,2,0.0,0.0,69222020,2,0
0,1,0.0,0.0,68499116,1,0
1,4,0.3333333333333333,0.7272727272727273,65191280,6,2
0,2,0.0,0.0,64485183,2,0
0,2,0.0,0.0,67898796,2,0
0,2,0.0,0.0,67898803,2,0
0,1,0.0,0.0,82247745,1,0
2,1,0.5,0.5,68952310,2,1
0,1,0.0,0.0,70684173,1,0
2,0,1.0,1.0,68364506,2,2
2,0,1.0,1.0,80049893,2,2
0,1,0.0,0.0,67595171,1,0
2,1,0.5,0.5,74595920,2,1
2,1,0.5,0.5,66569454,2,1
1,2,0.3333333333333333,0.5,68273534,3,1
0,1,0.0,0.0,68359354,1,0
1,2,0.3333333333333333,0.8461538461538461,69603156,3,1
2,0,1.0,1.0,72814602,2,2
0,2,0.0,0.0,69319390,2,0
2,0,1.0,1.0,64226330,2,2
2,2,0.6,0.75,82061335,5,3
0,1,0.0,0.0,67120312,1,0
0,1,0.0,0.0,67120326,1,0
2,0,1.0,1.0,73652390,1,1
2,0,1.0,1.0,82010326,1,1
0,2,0.0,0.0,69739222,2,0
0,1,0.0,0.0,67892776,1,0
0,1,0.0,0.0,70059360,1,0
0,1,0.0,0.0,80150872,1,0
0,2,0.0,0.0,80150581,2,0
0,2,0.0,0.0,80167291,2,0
0,2,0.0,0.0,82102797,2,0
2,0,1.0,1.0,68171614,1,1
0,1,0.0,0.0,68498934,1,0
0,1,0.0,0.0,68499424,1,0
0,4,0.0,0.0,68499452,4,0
0,1,0.0,0.0,69479431,1,0
0,1,0.0,0.0,69980253,1,0
0,5,0.16666666666666666,0.4146341463414634,82041706,6,1
0,1,0.0,0.0,70279783,1,0
2,0,1.0,1.0,68144013,1,1
1,5,0.375,0.9583333333333334,69424530,8,3
0,1,0.0,0.0,69216602,1,0
0,2,0.0,0.0,82102809,2,0
0,1,0.0,0.0,82145134,1,0
0,1,0.0,0.0,70524552,1,0
0,2,0.0,0.0,80145779,2,0
2,2,0.6,0.75,80155211,5,3
2,1,0.8,0.5,82018740,5,4
2,0,1.0,1.0,80176426,2,2
2,0,1.0,1.0,82061835,4,4
2,0,1.0,1.0,80175977,2,2
2,0,1.0,1.0,82095254,2,2
0,2,0.0,0.0,80019016,2,0
2,0,1.0,1.0,80165214,3,3
2,0,1.0,1.0,69973344,1,1
0,1,0.0,0.0,70565103,1,0
0,1,0.0,0.0,69311774,1,0
0,1,0.0,0.0,69315596,1,0
0,2,0.0,0.0,69723752,2,0
0,2,0.0,0.0,70633416,2,0
0,3,0.0,0.0,66782681,3,0
2,0,1.0,1.0,82205614,1,1
0,1,0.0,0.0,82018925,1,0
2,0,1.0,1.0,82036938,1,1
2,1,0.5,0.8,82018782,2,1
0,3,0.25,0.3333333333333333,65279396,4,1
2,0,1.0,1.0,72356893,1,1
0,4,0.0,0.0,70692440,4,0
2,1,0.6666666666666666,0.75,82095516,3,2
2,0,1.0,1.0,82047574,1,1
0,2,0.0,0.0,70699181,2,0
2,0,1.0,1.0,80159234,4,4
2,1,0.5,0.9,69479473,2,1
2,1,0.6666666666666666,0.0,80128772,3,2
0,1,0.0,0.0,608160,1,0
2,1,0.5,0.5,70808276,2,1
2,1,0.5,0.5,80165438,2,1
0,2,0.0,0.0,69996640,2,0
2,0,1.0,1.0,73652355,1,1
0,2,0.3333333333333333,0.0,68174092,3,1
2,0,1.0,1.0,72802436,1,1
0,2,0.0,0.0,69693512,2,0
0,1,0.0,0.0,69693582,1,0
2,1,0.6666666666666666,0.5,82054070,3,2
0,2,0.0,0.0,63613200,2,0
0,1,0.0,0.0,69036065,1,0
2,0,1.0,1.0,68659423,3,3
0,1,0.0,0.0,72813930,1,0
0,1,0.0,0.0,70238112,1,0
0,2,0.0,0.0,70417501,2,0
2,1,0.75,0.6666666666666666,82143844,4,3
0,1,0.0,0.0,80162781,1,0
0,10,0.0,0.0,80131206,10,0
2,1,0.6666666666666666,0.5,69981730,3,2
2,2,0.5,0.9,66646510,4,2
0,4,0.0,0.0,80150846,4,0
0,1,0.0,0.0,80165849,1,0
2,0,1.0,1.0,65826866,2,2
0,4,0.0,0.0,80150593,4,0
0,2,0.0,0.0,80165854,2,0
0,1,0.0,0.0,80171047,1,0
0,1,0.0,0.0,80171048,1,0
0,3,0.0,0.0,80086755,3,0
0,3,0.0,0.0,80150622,3,0
0,2,0.0,0.0,82102556,2,0
1,2,0.3333333333333333,0.5,70194824,3,1
2,0,1.0,1.0,82022235,1,1
0,1,0.0,0.0,73535693,1,0
0,1,0.0,0.0,71220674,1,0
0,1,0.0,0.0,69069231,1,0
1,2,0.3333333333333333,0.6666666666666666,69555521,3,1
0,3,0.25,0.4,74088476,4,1
2,0,1.0,1.0,69045732,1,1
0,1,0.0,0.0,79689043,1,0
2,0,1.0,1.0,82101074,1,1
0,1,0.0,0.0,69021876,1,0
2,1,0.6666666666666666,0.5,82022983,3,2
0,2,0.0,0.0,68021646,2,0
0,3,0.0,0.0,63245224,3,0
0,2,0.0,0.0,65544885,2,0
0,2,0.0,0.0,66227336,2,0
0,2,0.0,0.0,66227686,2,0
0,2,0.0,0.0,67822503,2,0
0,1,0.0,0.0,68169360,1,0
2,0,1.0,1.0,80057985,1,1
2,0,1.0,1.0,67786950,1,1
2,0,1.0,1.0,80128906,1,1
0,2,0.0,0.0,70694932,2,0
2,0,1.0,1.0,82015774,2,2
2,0,1.0,1.0,82175544,1,1
2,0,1.0,1.0,82110461,2,2
2,0,1.0,1.0,82062186,3,3
2,0,1.0,1.0,70924945,2,2
2,0,1.0,1.0,80136580,2,2
2,1,0.5,0.6666666666666666,69033601,2,1
0,1,0.0,0.0,82041286,1,0
2,0,1.0,1.0,74362505,2,2
0,3,0.0,0.0,70322644,3,0
2,0,1.0,1.0,69973526,1,1
2,1,0.75,0.0,82019709,4,3
0,1,0.0,0.0,80136776,1,0
2,1,0.5,0.5,73253446,2,1
2,0,1.0,1.0,80094700,1,1
0,1,0.0,0.0,82020345,1,0
2,0,1.0,1.0,75362952,2,2
0,1,0.0,0.0,70706475,1,0
1,2,0.3333333333333333,0.8571428571428571,80126785,3,1
0,1,0.0,0.0,72176181,1,0
2,1,0.6666666666666666,0.6666666666666666,80135246,3,2
0,1,0.0,0.0,65913673,1,0
2,1,0.5,0.3333333333333333,82019736,2,1
2,0,1.0,1.0,82060544,1,1
2,0,1.0,1.0,80118293,3,3
2,0,1.0,1.0,67305504,2,2
0,1,0.0,0.0,80133933,1,0
0,6,0.0,0.0,70702996,6,0
0,3,0.25,0.375,69152545,4,1
0,2,0.0,0.0,72809121,2,0
0,2,0.0,0.0,68625641,2,0
0,2,0.0,0.0,70678440,2,0
0,1,0.0,0.0,69693260,1,0
2,0,1.0,1.0,82018159,1,1
0,1,0.0,0.0,70417564,1,0
0,2,0.0,0.0,70224301,2,0
2,0,1.0,1.0,69193705,1,1
2,1,0.5,0.8333333333333334,66092565,2,1
0,3,0.25,0.3,80137611,4,1
0,1,0.0,0.0,58866465,1,0
0,1,0.0,0.0,68784030,1,0
0,1,0.0,0.0,69101774,1,0
0,1,0.0,0.0,69873650,1,0
0,1,0.0,0.0,66354022,1,0
0,1,0.0,0.0,67657905,1,0
0,1,0.0,0.0,80055150,1,0
2,0,1.0,1.0,67787615,1,1
2,0,1.0,1.0,69975850,2,2
0,1,0.0,0.0,82059801,1,0
2,1,0.6666666666666666,0.9642857142857143,70009730,3,2
0,1,0.0,0.0,66226944,1,0
2,0,1.0,1.0,70868126,2,2
2,0,1.0,1.0,80178169,2,2
2,0,1.0,1.0,70343651,1,1
0,1,0.0,0.0,67053252,1,0
2,1,0.6666666666666666,0.5,80134737,3,2
0,1,0.0,0.0,68465530,1,0
2,0,1.0,1.0,68748323,1,1
2,0,1.0,1.0,80165234,1,1
0,2,0.0,0.0,69458613,2,0
2,0,1.0,1.0,80094224,2,2
2,0,1.0,1.0,80150666,1,1
0,4,0.0,0.0,80150649,4,0
0,2,0.0,0.0,70629104,2,0
0,1,0.0,0.0,70629181,1,0
0,1,0.0,0.0,70463351,1,0
0,1,0.0,0.0,80118506,1,0
2,0,1.0,1.0,82041891,5,5
2,0,1.0,1.0,82102261,1,1
0,3,0.0,0.0,68255173,3,0
0,1,0.0,0.0,82024394,1,0
2,0,1.0,1.0,62408976,1,1
0,1,0.0,0.0,70683774,1,0
2,0,1.0,1.0,65913652,1,1
0,1,0.0,0.0,80154091,1,0
2,0,1.0,1.0,69469113,1,1
0,4,0.2,0.3076923076923077,54417972,5,1
2,0,1.0,1.0,80094861,1,1
0,3,0.0,0.0,68805541,3,0
0,1,0.0,0.0,69187895,1,0
0,1,0.0,0.0,70701484,1,0
1,2,0.3333333333333333,0.6666666666666666,70398706,3,1
2,0,1.0,1.0,82009399,4,4
2,1,0.5,0.6666666666666666,82017801,2,1
2,1,0.8,0.6666666666666666,69394325,5,4
2,1,0.5,0.3333333333333333,68275263,2,1
2,1,0.6666666666666666,0.8571428571428571,80176856,3,2
2,0,1.0,1.0,72803864,1,1
2,1,0.5,0.3333333333333333,65714355,2,1
2,1,0.6666666666666666,0.8,72803570,3,2
0,1,0.0,0.0,82041261,1,0
2,3,0.5,0.75,70253022,6,3
2,0,1.0,1.0,82019685,1,1
0,1,0.0,0.0,82205986,1,0
2,0,1.0,1.0,70070602,1,1
0,4,0.0,0.0,66784382,4,0
0,1,0.0,0.0,82006271,1,0
2,0,1.0,1.0,70350553,1,1
0,1,0.0,0.0,70048993,1,0
2,1,0.5,0.75,80168243,2,1
0,3,0.25,0.4,69548430,4,1
0,1,0.0,0.0,70930881,1,0
0,1,0.0,0.0,69608763,1,0
0,1,0.0,0.0,69616526,1,0
0,1,0.0,0.0,69616533,1,0
0,1,0.0,0.0,69616540,1,0
0,2,0.0,0.0,78228066,2,0
0,3,0.0,0.0,70683151,3,0
2,1,0.5,0.6666666666666666,65289931,2,1
2,0,1.0,1.0,82025210,1,1
2,1,0.5,0.875,64948891,2,1
2,0,1.0,1.0,82023070,1,1
0,2,0.0,0.0,67120305,2,0
0,2,0.0,0.0,70238182,2,0
0,1,0.0,0.0,70745542,1,0
2,0,1.0,1.0,82007845,3,3
0,1,0.0,0.0,67830294,1,0
0,1,0.0,0.0,67830406,1,0
2,0,1.0,1.0,69457752,1,1
0,1,0.0,0.0,70968926,1,0
0,3,0.0,0.0,70488950,3,0
2,0,1.0,1.0,75295164,2,2
2,0,1.0,1.0,70857402,1,1
2,0,1.0,1.0,75149515,1,1
2,2,0.5,0.6,74360776,4,2
2,0,1.0,1.0,70780423,1,1
0,1,0.0,0.0,73295866,1,0
0,3,0.0,0.0,82068730,3,0
0,2,0.0,0.0,70686420,2,0
2,0,1.0,1.0,82052090,1,1
0,1,0.0,0.0,63051821,1,0
2,0,1.0,1.0,67297580,1,1
2,1,0.5,0.0,82022318,2,1
0,1,0.0,0.0,68440694,1,0
0,5,0.0,0.0,82038356,5,0
0,1,0.0,0.0,70491043,1,0
2,0,1.0,1.0,80180395,1,1
2,0,1.0,1.0,82046286,2,2
2,1,0.5,0.9333333333333333,79990183,2,1
2,0,1.0,1.0,79854201,2,2
0,4,0.0,0.0,70694680,4,0
0,4,0.0,0.0,80150527,4,0
0,3,0.0,0.0,80150535,3,0
0,3,0.0,0.0,80162832,3,0
2,0,1.0,1.0,69188392,1,1
2,0,1.0,1.0,80168241,1,1
1,3,0.25,0.625,70779205,4,1
2,1,0.5,0.875,70463316,2,1
0,1,0.0,0.0,69910211,1,0
0,1,0.0,0.0,70692944,1,0
2,0,1.0,1.0,79785174,5,5
0,1,0.0,0.0,68144104,1,0
0,1,0.0,0.0,82208211,1,0
2,0,1.0,1.0,80181401,1,1
0,1,0.0,0.0,80156530,1,0
2,1,0.6666666666666666,0.9230769230769231,72804004,3,2
2,2,0.5,0.9166666666666666,73490095,4,2
0,1,0.0,0.0,70175322,1,0
0,1,0.0,0.0,80128205,1,0
1,4,0.42857142857142855,0.8333333333333334,72691976,7,3
2,0,1.0,1.0,67831351,1,1
2,1,0.5,0.5,70721140,2,1
0,2,0.0,0.0,74688852,2,0
0,3,0.25,0.25,65623145,4,1
0,2,0.0,0.0,80134765,2,0
2,0,1.0,1.0,68656021,1,1
0,2,0.0,0.0,68273625,2,0
0,4,0.2,0.4782608695652174,70677180,5,1
2,0,1.0,1.0,70280630,1,1
0,1,0.0,0.0,82062188,1,0
0,1,0.0,0.0,70693210,1,0
2,0,1.0,1.0,19432735,1,1
2,1,0.5,0.5,66238032,2,1
2,0,1.0,1.0,82041722,3,3
2,0,1.0,1.0,69055315,1,1
0,4,0.0,0.0,70843773,4,0
0,1,0.0,0.0,70691894,1,0
0,1,0.0,0.0,70693511,1,0
2,1,0.5,0.6666666666666666,82127543,2,1
2,0,1.0,1.0,80092432,1,1
0,1,0.0,0.0,61228825,1,0
2,0,1.0,1.0,338982,5,5
1,2,0.3333333333333333,0.8,67148963,3,1
1,2,0.3333333333333333,0.7142857142857143,67743816,3,1
2,1,0.5,0.5,68058942,2,1
2,1,0.6666666666666666,0.5,67831316,3,2
0,2,0.0,0.0,69997823,2,0
0,2,0.0,0.0,67276524,2,0
0,4,0.0,0.0,80010812,4,0
1,3,0.25,0.6,65282791,4,1
0,3,0.0,0.0,69478696,3,0
0,2,0.0,0.0,69478731,2,0
0,5,0.0,0.0,54468400,5,0
0,1,0.0,0.0,80177423,1,0
2,0,1.0,1.0,80093181,1,1
0,1,0.0,0.0,69484345,1,0
2,1,0.5,0.75,66379523,2,1
1,3,0.25,0.8421052631578947,66221295,4,1
2,0,1.0,1.0,67529140,1,1
0,1,0.0,0.0,69024403,1,0
2,0,1.0,1.0,82013501,1,1
2,2,0.6,0.7142857142857143,68241810,5,3
1,2,0.3333333333333333,0.5555555555555556,70843241,3,1
0,1,0.0,0.0,73634736,1,0
0,1,0.0,0.0,69073543,1,0
0,3,0.0,0.0,72909956,3,0
0,4,0.0,0.0,73295754,4,0
2,0,1.0,1.0,69550313,1,1
2,0,1.0,1.0,68546772,1,1
0,1,0.0,0.0,82013606,1,0
0,1,0.0,0.0,66849860,1,0
0,1,0.0,0.0,70493983,1,0
0,1,0.0,0.0,77237482,1,0
2,0,1.0,1.0,72804242,2,2
0,1,0.0,0.0,69178816,1,0
0,2,0.0,0.0,68273660,2,0
0,2,0.0,0.0,72706130,2,0
1,2,0.3333333333333333,0.5,68675012,3,1
2,0,1.0,1.0,70866852,1,1
0,3,0.0,0.0,80167288,3,0
2,1,0.5,0.6666666666666666,69865950,2,1
2,1,0.5,0.9090909090909091,68365605,2,1
0,1,0.0,0.0,82006172,1,0
0,2,0.0,0.0,71619331,2,0
2,0,1.0,1.0,64473073,3,3
0,3,0.0,0.0,82006534,3,0
0,2,0.0,0.0,67917563,2,0
0,2,0.0,0.0,70408065,2,0
0,1,0.0,0.0,80150272,1,0
2,0,1.0,1.0,80094770,1,1
2,0,1.0,1.0,82020257,1,1
1,4,0.42857142857142855,0.9411764705882353,72425563,7,3
0,1,0.0,0.0,68657890,1,0
2,0,1.0,1.0,82102159,4,4
2,0,1.0,1.0,80105326,2,2
0,3,0.0,0.0,69404573,3,0
2,0,1.0,1.0,71878471,1,1
2,0,1.0,1.0,68167953,2,2
2,0,1.0,1.0,67066825,1,1
2,0,1.0,1.0,70756056,2,2
2,0,1.0,1.0,82046129,2,2
0,1,0.0,0.0,79854194,1,0
2,0,1.0,1.0,70637413,5,5
2,0,1.0,1.0,80159756,3,3
2,0,1.0,1.0,82096367,1,1
2,0,1.0,1.0,80126996,2,2
2,0,1.0,1.0,82038370,9,9
2,2,0.5,0.0,69158845,4,2
0,2,0.0,0.0,80150483,2,0
0,2,0.0,0.0,80150484,2,0
0,1,0.0,0.0,70682353,1,0
0,1,0.0,0.0,70691565,1,0
0,2,0.0,0.0,70696185,2,0
2,1,0.6666666666666666,0.75,61685113,3,2
0,2,0.0,0.0,69499836,2,0
0,3,0.0,0.0,82062264,3,0
0,2,0.0,0.0,69469463,2,0
0,1,0.0,0.0,70184660,1,0
0,2,0.0,0.0,70692433,2,0
2,2,0.6,0.25,82108143,5,3
0,2,0.0,0.0,70694981,2,0
2,1,0.5,0.5,67831302,2,1
2,2,0.5,0.9375,70063994,4,2
0,1,0.0,0.0,69575184,1,0
0,2,0.0,0.0,69575520,2,0
2,0,1.0,1.0,80136656,1,1
1,3,0.25,0.6666666666666666,62006980,4,1
2,0,1.0,1.0,70566923,1,1
2,1,0.5,0.9090909090909091,69536383,2,1
2,1,0.5,0.5,82090219,2,1
2,0,1.0,1.0,61392674,1,1
0,1,0.0,0.0,70649425,1,0
2,0,1.0,1.0,80132915,1,1
2,0,1.0,1.0,69415850,1,1
2,1,0.6666666666666666,0.5,82163468,3,2
0,2,0.0,0.0,63692146,2,0
0,1,0.0,0.0,82024397,1,0
0,1,0.0,0.0,69483582,1,0
0,3,0.25,0.25,69483876,4,1
0,1,0.0,0.0,70685055,1,0
1,7,0.2222222222222222,0.7714285714285715,70036652,9,2
2,1,0.5,0.5,69071394,2,1
1,2,0.3333333333333333,0.8333333333333334,70482356,3,1
0,1,0.0,0.0,80172655,1,0
0,4,0.0,0.0,80167308,4,0
1,3,0.25,0.7272727272727273,80172658,4,1
0,2,0.0,0.0,67422460,2,0
2,0,1.0,1.0,82090271,1,1
0,1,0.0,0.0,69526184,1,0
0,8,0.0,0.0,82134977,8,0
0,2,0.0,0.0,62403096,2,0
0,1,0.0,0.0,67813676,1,0
2,0,1.0,1.0,82019840,1,1
0,1,0.0,0.0,68254690,1,0
0,2,0.0,0.0,68498003,2,0
2,1,0.5,0.6,69483470,2,1
0,4,0.0,0.0,70822675,4,0
2,0,1.0,1.0,82024235,2,2
1,3,0.4,0.9333333333333333,70675094,5,2
0,10,0.0,0.0,82102893,10,0
0,1,0.0,0.0,82001120,1,0
2,1,0.75,0.8,69594861,4,3
0,1,0.0,0.0,69267751,1,0
0,2,0.0,0.0,70198282,2,0
2,0,1.0,1.0,68167393,1,1
0,1,0.0,0.0,70474334,1,0
0,1,0.0,0.0,80092033,1,0
2,0,1.0,1.0,68960234,3,3
2,1,0.5,0.5,70711333,2,1
2,0,1.0,1.0,77112924,1,1
2,1,0.9,0.5,69394220,10,9
2,0,1.0,1.0,80136597,4,4
2,0,1.0,1.0,82046082,1,1
2,0,1.0,1.0,82023095,2,2
2,0,1.0,1.0,82059896,1,1
0,1,0.0,0.0,70591556,1,0
2,0,1.0,1.0,69980316,2,2
0,1,0.0,0.0,75346992,1,0
0,1,0.0,0.0,75347006,1,0
2,1,0.5,0.6666666666666666,80132283,2,1
0,4,0.0,0.0,66785306,4,0
0,6,0.0,0.0,67754484,6,0
0,8,0.0,0.0,66785642,8,0
0,5,0.16666666666666666,0.45454545454545453,69637743,6,1
2,0,1.0,1.0,66324391,2,2
0,1,0.0,0.0,82018771,1,0
0,3,0.0,0.0,70691383,3,0
0,1,0.0,0.0,17860864,1,0
0,1,0.0,0.0,75456843,1,0
2,1,0.6666666666666666,0.5,61102566,3,2
2,1,0.75,0.75,67162235,4,3
2,1,0.5,0.5,82250574,2,1
0,1,0.0,0.0,80165884,1,0
0,1,0.0,0.0,71689555,1,0
2,2,0.6,0.8888888888888888,82002252,5,3
0,2,0.0,0.0,66971142,2,0
1,3,0.25,0.5,69887125,4,1
2,0,1.0,1.0,73161473,1,1
0,1,0.0,0.0,74611614,1,0
0,1,0.0,0.0,79989553,1,0
0,2,0.0,0.0,72909725,2,0
0,2,0.0,0.0,70967876,2,0
0,4,0.0,0.0,70744240,4,0
0,1,0.0,0.0,70704172,1,0
0,1,0.0,0.0,65962064,1,0
0,1,0.0,0.0,70481544,1,0
2,0,1.0,1.0,67736123,2,2
0,1,0.0,0.0,82074912,1,0
2,0,1.0,1.0,65842910,1,1
2,0,1.0,1.0,60438896,3,3
1,4,0.3333333333333333,0.5,70596064,6,2
0,2,0.0,0.0,70092694,2,0
2,0,1.0,1.0,65116786,1,1
2,1,0.5,0.5,66786552,2,1
2,0,1.0,1.0,82018717,2,2
2,0,1.0,1.0,66237346,1,1
0,2,0.0,0.0,66228253,2,0
0,1,0.0,0.0,65619253,1,0
0,2,0.0,0.0,82006619,2,0
0,5,0.0,0.0,80172661,5,0
0,1,0.0,0.0,78762656,1,0
2,1,0.5,0.6666666666666666,70545293,2,1
0,1,0.0,0.0,80128449,1,0
0,1,0.0,0.0,66353532,1,0
2,1,0.6666666666666666,0.75,75346362,3,2
0,1,0.0,0.0,68538855,1,0
0,1,0.0,0.0,70937643,1,0
2,0,1.0,1.0,80134074,1,1
0,2,0.0,0.0,69410593,2,0
0,1,0.0,0.0,67665465,1,0
0,1,0.0,0.0,68798044,1,0
0,1,0.0,0.0,70674912,1,0
0,1,0.0,0.0,70677152,1,0
0,5,0.0,0.0,72717743,5,0
0,1,0.0,0.0,67704224,1,0
0,1,0.0,0.0,68656182,1,0
0,1,0.0,0.0,81888452,1,0
2,0,1.0,1.0,82102152,2,2
2,0,1.0,1.0,79758273,2,2
1,2,0.3333333333333333,0.6666666666666666,82126255,3,1
2,0,1.0,1.0,70813106,1,1
0,1,0.0,0.0,64354640,1,0
1,6,0.25,0.7368421052631579,70621544,8,2
0,1,0.0,0.0,80168315,1,0
0,2,0.0,0.0,70635642,2,0
2,1,0.5,0.0,64457820,2,1
2,4,0.6363636363636364,0.9473684210526315,69404020,11,7
2,0,1.0,1.0,70224063,1,1
0,1,0.0,0.0,68561633,1,0
2,0,1.0,1.0,80165447,1,1
2,0,1.0,1.0,80092852,3,3
2,1,0.5,0.8571428571428571,70216881,2,1
2,0,1.0,1.0,82121133,2,2
0,2,0.0,0.0,74708830,2,0
0,1,0.0,0.0,68748365,1,0
0,2,0.0,0.0,68748974,2,0
0,2,0.0,0.0,82018588,2,0
2,0,1.0,1.0,70686350,1,1
1,4,0.2,0.5714285714285714,82022523,5,1
0,1,0.0,0.0,80149804,1,0
0,6,0.0,0.0,69967625,6,0
1,2,0.3333333333333333,0.5,81976886,3,1
2,0,1.0,1.0,80176411,1,1
2,1,0.5,0.5,69633151,2,1
2,1,0.5,0.75,62461294,2,1
0,2,0.0,0.0,72909921,2,0
2,2,0.5,0.9375,70036190,4,2
2,0,1.0,1.0,80141494,3,3
2,0,1.0,1.0,82102264,1,1
2,0,1.0,1.0,70230426,1,1
2,0,1.0,1.0,82018787,2,2
2,0,1.0,1.0,80092964,1,1
2,1,0.6666666666666666,0.8333333333333334,73295810,3,2
0,3,0.25,0.4,66110331,4,1
2,1,0.5,0.8571428571428571,80141336,2,1
2,0,1.0,1.0,78858955,1,1
0,1,0.0,0.0,80117836,1,0
0,1,0.0,0.0,80122882,1,0
1,2,0.3333333333333333,0.6666666666666666,67822566,3,1
0,4,0.2,0.08333333333333333,72539901,5,1
0,2,0.0,0.0,69479186,2,0
0,1,0.0,0.0,67818345,1,0
2,0,1.0,1.0,77114135,2,2
0,3,0.0,0.0,67304111,3,0
2,0,1.0,1.0,69547814,1,1
2,1,0.6666666666666666,0.5,69408206,3,2
0,2,0.0,0.0,68639053,2,0
2,0,1.0,1.0,69901692,3,3
2,1,0.5,0.8461538461538461,82022303,2,1
0,3,0.0,0.0,70233653,3,0
2,0,1.0,1.0,80162579,1,1
1,3,0.4,0.7142857142857143,69948690,5,2
2,0,1.0,1.0,69483834,1,1
2,0,1.0,1.0,80145878,1,1
2,1,0.6666666666666666,0.6666666666666666,70658903,3,2
2,0,1.0,1.0,82012781,2,2
0,1,0.0,0.0,64183021,1,0
0,3,0.0,0.0,80165788,3,0
0,2,0.0,0.0,70474733,2,0
2,1,0.5,0.75,70474782,2,1
0,1,0.0,0.0,80172524,1,0
0,4,0.0,0.0,82102569,4,0
0,1,0.0,0.0,67051411,1,0
2,1,0.5,0.0,67686304,2,1
2,1,0.5,0.8,68402124,2,1
2,0,1.0,1.0,82024374,1,1
0,4,0.0,0.0,69638051,4,0
0,1,0.0,0.0,82096297,1,0
0,1,0.0,0.0,80165352,1,0
0,4,0.0,0.0,66742802,4,0
0,1,0.0,0.0,69498786,1,0
0,3,0.0,0.0,66225992,3,0
2,0,1.0,1.0,82020626,1,1
2,0,1.0,1.0,80165337,1,1
2,0,1.0,1.0,80025190,1,1
2,0,1.0,1.0,70074312,3,3
0,4,0.0,0.0,70694001,4,0
2,0,1.0,1.0,80165286,4,4
0,4,0.2,0.4444444444444444,67195513,5,1
2,0,1.0,1.0,82053166,1,1
0,1,0.0,0.0,82020783,1,0
2,1,0.5,0.75,80128328,2,1
0,1,0.0,0.0,82206135,1,0
0,1,0.0,0.0,80153582,1,0
0,3,0.0,0.0,66786013,3,0
0,3,0.25,0.36363636363636365,80158268,4,1
0,4,0.0,0.0,69034301,4,0
2,1,0.5,0.6666666666666666,70493696,2,1
0,1,0.0,0.0,67665276,1,0
0,1,0.0,0.0,66225502,1,0
2,0,1.0,1.0,80162121,2,2
2,0,1.0,1.0,81971435,1,1
2,0,1.0,1.0,70809172,4,4
2,1,0.5,0.6666666666666666,80141337,2,1
0,6,0.0,0.0,69596366,6,0
0,2,0.0,0.0,70470106,2,0
2,1,0.8,0.6666666666666666,80176257,5,4
0,2,0.0,0.0,69633095,2,0
0,2,0.0,0.0,69058773,2,0
2,0,1.0,1.0,80128901,2,2
0,2,0.0,0.0,66238641,2,0
2,1,0.6666666666666666,0.6666666666666666,70821072,3,2
0,1,0.0,0.0,70680211,1,0
0,1,0.0,0.0,69954255,1,0
0,3,0.0,0.0,69731382,3,0
1,3,0.25,0.6363636363636364,70679742,4,1
2,0,1.0,1.0,73337131,2,2
0,1,0.0,0.0,75148710,1,0
2,1,0.75,0.5,70873740,4,3
2,0,1.0,1.0,74027786,4,4
2,0,1.0,1.0,82019674,1,1
2,0,1.0,1.0,69064135,1,1
2,1,0.5,0.75,70702296,2,1
2,0,1.0,1.0,70747600,4,4
2,1,0.5,0.5,68520760,2,1
0,2,0.0,0.0,80093636,2,0
2,2,0.5,0.8333333333333334,82182777,4,2
2,0,1.0,1.0,67786873,1,1
2,0,1.0,1.0,70779086,1,1
0,1,0.0,0.0,70474306,1,0
0,1,0.0,0.0,70049056,1,0
2,0,1.0,1.0,80126590,1,1
2,0,1.0,1.0,67703923,2,2
2,0,1.0,1.0,80176461,2,2
0,3,0.0,0.0,80150538,3,0
1,2,0.3333333333333333,0.75,82152445,3,1
0,1,0.0,0.0,68193160,1,0
0,3,0.0,0.0,82006646,3,0
0,5,0.0,0.0,64233925,5,0
0,7,0.0,0.0,70635012,7,0
0,3,0.0,0.0,80150533,3,0
2,0,1.0,1.0,73634666,2,2
2,0,1.0,1.0,82033549,2,2
0,1,0.0,0.0,68255824,1,0
0,1,0.0,0.0,68255866,1,0
0,1,0.0,0.0,68255971,1,0
0,1,0.0,0.0,68256174,1,0
0,1,0.0,0.0,68256216,1,0
0,1,0.0,0.0,68256335,1,0
0,1,0.0,0.0,68256384,1,0
0,1,0.0,0.0,68256426,1,0
2,1,0.5,0.9,69596716,2,1
1,7,0.125,0.6382978723404256,70746522,8,1
1,4,0.42857142857142855,0.8095238095238095,69940374,7,3
2,1,0.5,0.8,70685580,2,1
0,1,0.0,0.0,70685643,1,0
2,1,0.6666666666666666,0.75,65919994,3,2
2,1,0.8,0.6666666666666666,74027730,5,4
2,0,1.0,1.0,82182748,2,2
2,0,1.0,1.0,80092831,1,1
2,0,1.0,1.0,63036050,1,1
0,1,0.0,0.0,82102210,1,0
0,1,0.0,0.0,82102231,1,0
0,1,0.0,0.0,70679420,1,0
0,1,0.0,0.0,70698005,1,0
2,0,1.0,1.0,62667143,3,3
0,1,0.0,0.0,66459162,1,0
0,2,0.0,0.0,70691404,2,0
0,2,0.0,0.0,70674415,2,0
1,3,0.4,0.7142857142857143,66379362,5,2
0,3,0.0,0.0,69182372,3,0
2,0,1.0,1.0,68531113,2,2
0,2,0.0,0.0,82047563,2,0
2,0,1.0,1.0,82022352,1,1
0,1,0.0,0.0,72866801,1,0
2,0,1.0,1.0,80136595,2,2
2,0,1.0,1.0,70851361,1,1
2,0,1.0,1.0,70343896,4,4
2,0,1.0,1.0,80159720,2,2
2,0,1.0,1.0,73337992,1,1
2,0,1.0,1.0,80152793,1,1
2,1,0.6666666666666666,0.6666666666666666,75576543,3,2
2,0,1.0,1.0,82041260,1,1
2,1,0.5,0.5,70073591,2,1
0,1,0.0,0.0,66783913,1,0
2,1,0.6666666666666666,0.8333333333333334,80135303,3,2
2,0,1.0,1.0,80055780,1,1
2,1,0.5,0.75,80125450,2,1
0,1,0.0,0.0,68747161,1,0
0,2,0.0,0.0,69640361,2,0
0,1,0.0,0.0,70037513,1,0
0,1,0.0,0.0,70250873,1,0
2,0,1.0,1.0,82214063,1,1
2,0,1.0,1.0,69832315,1,1
0,4,0.0,0.0,80150325,4,0
0,1,0.0,0.0,80118188,1,0
2,1,0.5,0.8333333333333334,80177415,2,1
0,1,0.0,0.0,70843766,1,0
0,2,0.0,0.0,82010249,2,0
1,2,0.3333333333333333,0.7058823529411765,70850661,3,1
0,1,0.0,0.0,68167666,1,0
0,3,0.0,0.0,68167785,3,0
0,1,0.0,0.0,70239204,1,0
2,0,1.0,1.0,66229765,2,2
0,1,0.0,0.0,82024271,1,0
0,1,0.0,0.0,82024390,1,0
0,2,0.0,0.0,82023364,2,0
0,1,0.0,0.0,66015663,1,0
0,1,0.0,0.0,70704403,1,0
0,4,0.0,0.0,70235193,4,0
0,1,0.0,0.0,68521901,1,0
2,1,0.5,0.5,66442005,2,1
0,2,0.0,0.0,82010264,2,0
0,1,0.0,0.0,68746496,1,0
0,2,0.0,0.0,68746510,2,0
0,4,0.2,0.25,70493430,5,1
2,0,1.0,1.0,74511633,1,1
0,1,0.0,0.0,67321506,1,0
2,0,1.0,1.0,70566153,1,1
0,4,0.0,0.0,69598081,4,0
0,1,0.0,0.0,80172517,1,0
0,1,0.0,0.0,66646573,1,0
0,2,0.0,0.0,71357314,2,0
0,4,0.0,0.0,82006603,4,0
0,1,0.0,0.0,80131208,1,0
1,3,0.4,0.75,68035303,5,2
2,2,0.5,0.75,69143326,4,2
2,0,1.0,1.0,69530874,1,1
2,0,1.0,1.0,77318990,2,2
2,0,1.0,1.0,82018622,1,1
0,4,0.0,0.0,65282861,4,0
2,1,0.5,0.6666666666666666,69702724,2,1
2,0,1.0,1.0,70857395,1,1
1,2,0.3333333333333333,0.5,79678683,3,1
0,1,0.0,0.0,80156586,1,0
2,1,0.5,0.5,69623701,2,1
2,0,1.0,1.0,71277654,1,1
2,0,1.0,1.0,12200783,2,2
0,1,0.0,0.0,70684474,1,0
0,2,0.0,0.0,67903374,2,0
2,0,1.0,1.0,69591312,1,1
2,0,1.0,1.0,66227693,1,1
2,2,0.5,0.6666666666666666,68932423,4,2
2,0,1.0,1.0,82016182,1,1
2,0,1.0,1.0,82019686,1,1
2,0,1.0,1.0,66826676,1,1
0,2,0.0,0.0,72480576,2,0
2,0,1.0,1.0,69702206,1,1
0,1,0.0,0.0,68952772,1,0
2,2,0.5,0.9,82017802,4,2
2,0,1.0,1.0,82101063,1,1
0,2,0.3333333333333333,0.0,68960276,3,1
0,2,0.0,0.0,82024202,2,0
2,0,1.0,1.0,70563234,1,1
2,1,0.8,0.5,70747341,5,4
2,0,1.0,1.0,82038933,1,1
0,1,0.0,0.0,81910842,1,0
2,0,1.0,1.0,80053764,1,1
2,1,0.5,0.75,82163484,2,1
0,1,0.0,0.0,80128330,1,0
0,1,0.0,0.0,68747770,1,0
2,0,1.0,1.0,68960255,2,2
2,0,1.0,1.0,69084666,4,4
0,1,0.0,0.0,68656035,1,0
0,1,0.0,0.0,82024280,1,0
0,1,0.0,0.0,73635261,1,0
2,0,1.0,1.0,82019761,1,1
2,0,1.0,1.0,54880770,1,1
2,0,1.0,1.0,67672451,1,1
2,2,0.6666666666666666,0.6666666666666666,80093034,6,4
2,0,1.0,1.0,82125468,2,2
0,3,0.0,0.0,70190113,3,0
0,2,0.0,0.0,80132368,2,0
2,1,0.6666666666666666,0.5,72803731,3,2
2,1,0.6666666666666666,0.9333333333333333,71212344,3,2
0,1,0.0,0.0,66062766,1,0
0,3,0.0,0.0,681863,3,0
0,1,0.0,0.0,82002226,1,0
2,0,1.0,1.0,70183414,2,2
0,2,0.0,0.0,69644834,2,0
0,2,0.0,0.0,70699923,2,0
0,3,0.0,0.0,70700000,3,0
2,1,0.5,0.5,65899316,2,1
2,0,1.0,1.0,80083745,1,1
2,0,1.0,1.0,80159164,4,4
2,1,0.6666666666666666,0.5,72843932,3,2
2,0,1.0,1.0,80117738,1,1
0,3,0.0,0.0,70704655,3,0
2,0,1.0,1.0,82013626,2,2
2,0,1.0,1.0,80134251,1,1
2,0,1.0,1.0,66404520,1,1
0,3,0.0,0.0,80131218,3,0
2,0,1.0,1.0,82023663,1,1
2,0,1.0,1.0,69951434,2,2
0,4,0.2,0.4,82022519,5,1
0,1,0.0,0.0,82152130,1,0
0,1,0.0,0.0,80135807,1,0
0,1,0.0,0.0,80162774,1,0
1,2,0.3333333333333333,0.9090909090909091,80172632,3,1
0,1,0.0,0.0,80169888,1,0
0,1,0.0,0.0,80176301,1,0
0,3,0.0,0.0,70821646,3,0
2,0,1.0,1.0,70780535,1,1
2,1,0.5,0.5,69943475,2,1
0,3,0.0,0.0,15012256,3,0
0,1,0.0,0.0,67335814,1,0
0,1,0.0,0.0,80130727,1,0
2,0,1.0,1.0,72510480,2,2
0,2,0.0,0.0,70681835,2,0
2,0,1.0,1.0,65290813,1,1
2,0,1.0,1.0,82201361,1,1
2,0,1.0,1.0,80113621,2,2
2,0,1.0,1.0,80158300,2,2
0,2,0.0,0.0,70675864,2,0
2,1,0.5,0.6666666666666666,70683312,2,1
2,0,1.0,1.0,74452553,2,2
2,0,1.0,1.0,80159757,2,2
0,2,0.0,0.0,66212783,2,0
2,1,0.5,0.6666666666666666,72540244,2,1
0,2,0.0,0.0,70704200,2,0
2,0,1.0,1.0,69940570,1,1
2,1,0.5,0.5,62512002,2,1
2,1,0.6666666666666666,0.9166666666666666,68746874,3,2
0,3,0.0,0.0,71510180,3,0
2,0,1.0,1.0,69609043,3,3
0,1,0.0,0.0,69138573,1,0
2,0,1.0,1.0,82021467,2,2
2,0,1.0,1.0,80149482,4,4
2,0,1.0,1.0,80118245,2,2
0,4,0.0,0.0,67467855,4,0
0,1,0.0,0.0,66203830,1,0
2,0,1.0,1.0,70527611,1,1
2,0,1.0,1.0,73859863,1,1
2,0,1.0,1.0,67641385,2,2
0,1,0.0,0.0,80047786,1,0
0,3,0.0,0.0,70692405,3,0
0,1,0.0,0.0,70692692,1,0
1,2,0.3333333333333333,0.8461538461538461,80150240,3,1
0,1,0.0,0.0,70678181,1,0
2,1,0.5,0.75,69061720,2,1
0,1,0.0,0.0,70701533,1,0
0,1,0.0,0.0,70706356,1,0
2,1,0.5,0.8333333333333334,71618960,2,1
2,0,1.0,1.0,80162718,1,1
2,0,1.0,1.0,80074470,2,2
2,0,1.0,1.0,82019790,1,1
0,1,0.0,0.0,70493682,1,0
2,0,1.0,1.0,80092061,1,1
0,1,0.0,0.0,70036673,1,0
2,1,0.5,0.8,70697151,2,1
1,4,0.3333333333333333,0.5714285714285714,69003326,6,2
0,5,0.0,0.0,70674660,5,0
0,1,0.0,0.0,75974164,1,0
2,1,0.5,0.5,82247826,2,1
0,1,0.0,0.0,70489195,1,0
0,1,0.0,0.0,62711705,1,0
2,0,1.0,1.0,82039362,1,1
1,3,0.4,0.7777777777777778,69064380,5,2
2,1,0.6666666666666666,0.5,67665241,3,2
2,1,0.6666666666666666,0.6666666666666666,82010255,3,2
1,2,0.3333333333333333,0.5,69498954,3,1
2,1,0.5,0.5,69499024,2,1
2,1,0.5,0.3333333333333333,80165477,2,1
2,0,1.0,1.0,79989476,1,1
2,2,0.5,0.8333333333333334,80126581,4,2
0,1,0.0,0.0,69418006,1,0
2,0,1.0,1.0,67822104,1,1
0,1,0.0,0.0,67344270,1,0
0,1,0.0,0.0,70698565,1,0
2,0,1.0,1.0,82163435,1,1
0,1,0.0,0.0,80069836,1,0
2,0,1.0,1.0,73652194,1,1
0,2,0.3333333333333333,0.2857142857142857,69666842,3,1
1,3,0.25,0.5789473684210527,70697102,4,1
0,1,0.0,0.0,80177422,1,0
2,0,1.0,1.0,73345223,2,2
0,1,0.0,0.0,69198472,1,0
2,0,1.0,1.0,57024716,1,1
2,0,1.0,1.0,80134848,1,1
2,0,1.0,1.0,66253551,2,2
2,2,0.5,0.5,80118187,4,2
0,4,0.0,0.0,82102527,4,0
0,1,0.0,0.0,70922740,1,0
0,3,0.0,0.0,82006763,3,0
0,1,0.0,0.0,65277814,1,0
2,0,1.0,1.0,82016272,2,2
0,1,0.0,0.0,70682913,1,0
2,0,1.0,1.0,70720755,1,1
2,0,1.0,1.0,70944804,1,1
2,0,1.0,1.0,66237850,1,1
0,2,0.0,0.0,82038353,2,0
2,1,0.5,0.5,68380312,2,1
0,1,0.0,0.0,68747392,1,0
0,1,0.0,0.0,68747840,1,0
0,2,0.0,0.0,68747882,2,0
0,1,0.0,0.0,68748400,1,0
0,1,0.0,0.0,68765403,1,0
2,0,1.0,1.0,82020365,1,1
2,0,1.0,1.0,69735624,1,1
2,1,0.5,0.6666666666666666,69484191,2,1
0,1,0.0,0.0,70674170,1,0
0,1,0.0,0.0,70684712,1,0
2,0,1.0,1.0,70843262,1,1
0,1,0.0,0.0,70702800,1,0
2,1,0.6666666666666666,0.9,69021533,3,2
0,1,0.0,0.0,82050082,1,0
2,1,0.5,0.5,681695,2,1
0,1,0.0,0.0,82037833,1,0
0,2,0.3333333333333333,0.2,68370666,3,1
2,0,1.0,1.0,72844786,3,3
2,0,1.0,1.0,80079573,3,3
2,0,1.0,1.0,68163256,1,1
2,0,1.0,1.0,82046078,6,6
2,0,1.0,1.0,80178166,1,1
2,1,0.75,0.6666666666666666,80018274,4,3
2,0,1.0,1.0,82046063,1,1
0,1,0.0,0.0,80158274,1,0
2,0,1.0,1.0,82039348,5,5
2,0,1.0,1.0,68047875,1,1
2,1,0.5,0.8571428571428571,70047985,2,1
0,1,0.0,0.0,70702975,1,0
2,1,0.6666666666666666,0.5,70121093,3,2
2,0,1.0,1.0,82100950,1,1
0,1,0.0,0.0,15216005,1,0
0,1,0.0,0.0,82021447,1,0
0,1,0.0,0.0,82008043,1,0
0,3,0.0,0.0,70351631,3,0
0,3,0.25,0.2222222222222222,70685286,4,1
0,2,0.0,0.0,82102775,2,0
0,1,0.0,0.0,70672084,1,0
0,1,0.0,0.0,82247766,1,0
0,2,0.0,0.0,82247778,2,0
2,0,1.0,1.0,67423251,1,1
0,1,0.0,0.0,68017866,1,0
0,1,0.0,0.0,68784793,1,0
2,1,0.6666666666666666,0.8,69571103,3,2
2,0,1.0,1.0,76610821,1,1
2,1,0.5,0.5,67455423,2,1
0,3,0.0,0.0,80123390,3,0
0,1,0.0,0.0,80004442,1,0
2,0,1.0,1.0,82070198,1,1
2,0,1.0,1.0,70758583,1,1
0,1,0.0,0.0,82102613,1,0
0,1,0.0,0.0,70674464,1,0
0,8,0.1111111111111111,0.3333333333333333,80018834,9,1
1,3,0.25,0.6,72413901,4,1
2,0,1.0,1.0,80141325,4,4
0,4,0.0,0.0,70063756,4,0
0,3,0.25,0.36363636363636365,69800115,4,1
2,1,0.5,0.8888888888888888,70693000,2,1
0,2,0.0,0.0,70685846,2,0
2,0,1.0,1.0,80118472,1,1
0,1,0.0,0.0,72814721,1,0
2,0,1.0,1.0,82019837,1,1
0,1,0.0,0.0,74510513,1,0
2,0,1.0,1.0,70743155,1,1
2,1,0.5,0.5,80125944,2,1
2,1,0.6666666666666666,0.5,70873754,3,2
0,3,0.25,0.2222222222222222,69315841,4,1
2,0,1.0,1.0,70110110,1,1
2,0,1.0,1.0,67485880,1,1
0,1,0.0,0.0,79796143,1,0
0,4,0.2,0.46153846153846156,80161520,5,1
0,1,0.0,0.0,82050507,1,0
0,4,0.0,0.0,68227061,4,0
1,3,0.25,0.5714285714285714,82118230,4,1
0,1,0.0,0.0,80162809,1,0
2,0,1.0,1.0,68169353,1,1
2,0,1.0,1.0,65007446,1,1
2,0,1.0,1.0,80176641,1,1
0,1,0.0,0.0,69007302,1,0
1,8,0.1111111111111111,0.5471698113207547,75147954,9,1
2,0,1.0,1.0,70925701,1,1
2,0,1.0,1.0,67751411,2,2
0,1,0.0,0.0,70703962,1,0
0,1,0.0,0.0,73295740,1,0
0,1,0.0,0.0,68747980,1,0
0,1,0.0,0.0,69391154,1,0
1,3,0.25,0.6923076923076923,69117146,4,1
0,1,0.0,0.0,73870055,1,0
0,1,0.0,0.0,72377361,1,0
2,0,1.0,1.0,82039417,1,1
2,0,1.0,1.0,82110455,1,1
2,0,1.0,1.0,69530440,2,2
2,0,1.0,1.0,80162135,2,2
0,2,0.0,0.0,80126872,2,0
2,0,1.0,1.0,72805621,1,1
0,1,0.0,0.0,70671860,1,0
0,1,0.0,0.0,67195534,1,0
2,0,1.0,1.0,80136530,2,2
2,0,1.0,1.0,70746956,3,3
2,1,0.6666666666666666,0.8333333333333334,69484072,3,2
2,0,1.0,1.0,80054793,1,1
0,1,0.0,0.0,82042129,1,0
2,0,1.0,1.0,73652180,1,1
2,0,1.0,1.0,66231865,1,1
0,1,0.0,0.0,66782534,1,0
2,0,1.0,1.0,64305416,2,2
2,0,1.0,1.0,82020309,1,1
1,2,0.3333333333333333,0.8,74443355,3,1
0,4,0.0,0.0,69551062,4,0
0,1,0.0,0.0,70081046,1,0
2,0,1.0,1.0,82053996,2,2
0,1,0.0,0.0,67259773,1,0
2,2,0.6,0.9166666666666666,82121127,5,3
0,1,0.0,0.0,70699860,1,0
0,1,0.0,0.0,69478780,1,0
0,1,0.0,0.0,75347076,1,0
2,1,0.5,0.7142857142857143,75347475,2,1
2,1,0.5,0.5,71588300,2,1
0,1,0.0,0.0,69484485,1,0
2,1,0.5,0.5,74761470,2,1
1,2,0.3333333333333333,0.7142857142857143,65286795,3,1
2,0,1.0,1.0,82102374,1,1
0,1,0.0,0.0,79795170,1,0
0,1,0.0,0.0,79795184,1,0
2,1,0.5,0.6666666666666666,70005236,2,1
0,1,0.0,0.0,70005341,1,0
1,2,0.3333333333333333,0.5,79843960,3,1
0,2,0.0,0.0,69722786,2,0
2,0,1.0,1.0,75276936,1,1
0,1,0.0,0.0,82018865,1,0
2,0,1.0,1.0,82044525,1,1
0,1,0.0,0.0,67654825,1,0
2,0,1.0,1.0,70747215,1,1
0,1,0.0,0.0,80150315,1,0
0,1,0.0,0.0,80150244,1,0
2,0,1.0,1.0,82163443,1,1
1,2,0.3333333333333333,0.75,69000715,3,1
0,2,0.0,0.0,68234425,2,0
0,5,0.0,0.0,70588161,5,0
2,1,0.5,0.8,66770683,2,1
0,1,0.0,0.0,70744002,1,0
0,1,0.0,0.0,70238133,1,0
0,1,0.0,0.0,69541045,1,0
1,2,0.3333333333333333,0.95,69961220,3,1
2,1,0.8,0.5,72814574,5,4
0,3,0.0,0.0,80150648,3,0
0,1,0.0,0.0,70916944,1,0
0,1,0.0,0.0,82019760,1,0
2,1,0.5,0.5,73871063,2,1
0,3,0.0,0.0,82006538,3,0
0,1,0.0,0.0,65609285,1,0
0,1,0.0,0.0,80168256,1,0
0,4,0.0,0.0,82143529,4,0
0,1,0.0,0.0,82006728,1,0
0,1,0.0,0.0,82006732,1,0
2,0,1.0,1.0,73610432,1,1
0,1,0.0,0.0,65899813,1,0
0,1,0.0,0.0,69500333,1,0
2,0,1.0,1.0,72561496,1,1
0,1,0.0,0.0,68805800,1,0
2,0,1.0,1.0,67786145,1,1
0,2,0.0,0.0,65252523,2,0
0,4,0.0,0.0,63992775,4,0
2,0,1.0,1.0,66235652,1,1
2,0,1.0,1.0,68256356,1,1
2,0,1.0,1.0,69241872,1,1
0,2,0.0,0.0,80150270,2,0
2,0,1.0,1.0,80162549,1,1
0,2,0.0,0.0,69500326,2,0
2,0,1.0,1.0,82039401,1,1
0,1,0.0,0.0,69693393,1,0
1,2,0.3333333333333333,0.6666666666666666,80122918,3,1
0,4,0.0,0.0,80136721,4,0
2,0,1.0,1.0,80165216,3,3
2,1,0.75,0.8571428571428571,70719082,4,3
0,2,0.0,0.0,70696612,2,0
0,2,0.0,0.0,68112674,2,0
0,1,0.0,0.0,68273800,1,0
0,2,0.0,0.0,80162590,2,0
0,1,0.0,0.0,80162603,1,0
2,0,1.0,1.0,82018079,1,1
2,0,1.0,1.0,73079370,1,1
2,0,1.0,1.0,80125214,2,2
2,1,0.5,0.6,80055031,2,1
2,2,0.6,0.8888888888888888,82095533,5,3
2,0,1.0,1.0,82037232,1,1
2,0,1.0,1.0,82039408,2,2
2,0,1.0,1.0,82039427,3,3
0,1,0.0,0.0,69143354,1,0
0,2,0.0,0.0,69422500,2,0
2,1,0.5,0.5,67327190,2,1
0,3,0.0,0.0,80126794,3,0
0,2,0.0,0.0,80165446,2,0
0,2,0.0,0.0,80172637,2,0
2,1,0.5,0.5,64458471,2,1
0,1,0.0,0.0,70814506,1,0
0,2,0.0,0.0,70707371,2,0
2,0,1.0,1.0,69619991,1,1
0,3,0.0,0.0,70679875,3,0
0,1,0.0,0.0,80105445,1,0
0,1,0.0,0.0,82067331,1,0
0,2,0.0,0.0,63372932,2,0
2,1,0.5,0.0,67787622,2,1
0,2,0.0,0.0,70697746,2,0
2,0,1.0,1.0,80159198,2,2
0,3,0.0,0.0,70753186,3,0
2,0,1.0,1.0,80117730,1,1
0,2,0.3333333333333333,0.4,82018828,3,1
0,2,0.0,0.0,69997655,2,0
0,1,0.0,0.0,69478815,1,0
0,1,0.0,0.0,68373802,1,0
0,4,0.0,0.0,70814590,4,0
0,2,0.0,0.0,70702142,2,0
0,1,0.0,0.0,70704445,1,0
0,4,0.42857142857142855,0.2,80180396,7,3
0,4,0.42857142857142855,0.4,80149484,7,3
1,2,0.3333333333333333,0.75,72784684,3,1
0,1,0.0,0.0,67052916,1,0
0,2,0.0,0.0,82019251,2,0
1,2,0.3333333333333333,0.6923076923076923,70320376,3,1
0,1,0.0,0.0,64044064,1,0
0,3,0.0,0.0,63778652,3,0
1,3,0.4,0.5555555555555556,75061035,5,2
0,1,0.0,0.0,67822853,1,0
1,2,0.3333333333333333,0.8333333333333334,80119021,3,1
0,3,0.0,0.0,79783655,3,0
0,1,0.0,0.0,70698250,1,0
2,0,1.0,1.0,69066550,1,1
0,1,0.0,0.0,70063434,1,0
0,5,0.0,0.0,82102858,5,0
0,4,0.0,0.0,80150670,4,0
0,2,0.0,0.0,70908586,2,0
2,0,1.0,1.0,66869691,2,2
2,0,1.0,1.0,72844023,1,1
0,1,0.0,0.0,80086713,1,0
0,2,0.0,0.0,68497562,2,0
0,3,0.0,0.0,68499382,3,0
0,1,0.0,0.0,68538330,1,0
0,2,0.0,0.0,68676986,2,0
0,5,0.0,0.0,69596562,5,0
0,2,0.0,0.0,70699510,2,0
0,4,0.0,0.0,68318110,4,0
0,2,0.0,0.0,70597891,2,0
0,1,0.0,0.0,69638205,1,0
1,3,0.25,0.8571428571428571,73905951,4,1
0,1,0.0,0.0,72362206,1,0
2,2,0.6666666666666666,0.8333333333333334,80179206,6,4
0,1,0.0,0.0,82019821,1,0
0,1,0.0,0.0,70061124,1,0
0,2,0.0,0.0,68255565,2,0
0,2,0.0,0.0,68255586,2,0
0,3,0.0,0.0,68256433,3,0
0,2,0.0,0.0,68656084,2,0
0,2,0.0,0.0,68656126,2,0
0,2,0.0,0.0,68656161,2,0
0,1,0.0,0.0,70680911,1,0
0,1,0.0,0.0,69412560,1,0
2,1,0.5,0.5,69975773,2,1
2,0,1.0,1.0,80092635,1,1
0,2,0.0,0.0,67888653,2,0
2,0,1.0,1.0,69483484,2,2
2,0,1.0,1.0,65787561,3,3
2,0,1.0,1.0,82046224,1,1
2,0,1.0,1.0,80079552,1,1
2,0,1.0,1.0,80174164,1,1
2,0,1.0,1.0,80161982,1,1
2,2,0.6,0.9,80125389,5,3
2,0,1.0,1.0,80176054,1,1
2,0,1.0,1.0,67374202,1,1
2,1,0.5,0.5,82042125,2,1
2,0,1.0,1.0,80165291,2,2
2,0,1.0,1.0,69036093,4,4
0,3,0.0,0.0,80128402,3,0
2,2,0.6,0.8333333333333334,69701800,5,3
0,1,0.0,0.0,68746734,1,0
0,6,0.14285714285714285,0.2857142857142857,82050496,7,1
2,0,1.0,1.0,66495975,2,2
0,1,0.0,0.0,82006773,1,0
0,2,0.0,0.0,80176175,2,0
2,0,1.0,1.0,70416983,2,2
2,0,1.0,1.0,80128907,1,1
2,1,0.5,0.8,65280383,2,1
2,0,1.0,1.0,82051769,1,1
0,2,0.0,0.0,70866803,2,0
0,1,0.0,0.0,69170682,1,0
2,0,1.0,1.0,80081225,4,4
2,0,1.0,1.0,70705194,1,1
0,1,0.0,0.0,68541242,1,0
2,0,1.0,1.0,66741640,3,3
0,2,0.0,0.0,72809030,2,0
0,1,0.0,0.0,80145563,1,0
2,0,1.0,1.0,70014616,1,1
2,0,1.0,1.0,74362554,2,2
2,0,1.0,1.0,72801953,2,2
0,7,0.0,0.0,15012382,7,0
2,1,0.5,0.8571428571428571,65280334,2,1
0,2,0.0,0.0,70631036,2,0
2,1,0.5,0.9375,80145817,2,1
0,1,0.0,0.0,82023367,1,0
2,1,0.8,0.5,69041840,5,4
2,0,1.0,1.0,70771085,1,1
2,0,1.0,1.0,70513730,1,1
2,1,0.75,0.5,72801596,4,3
2,0,1.0,1.0,82090154,2,2
2,0,1.0,1.0,82182743,3,3
2,1,0.5,0.5,72803850,2,1
0,1,0.0,0.0,70669354,1,0
2,1,0.75,0.6666666666666666,80134727,4,3
0,1,0.0,0.0,80177417,1,0
2,0,1.0,1.0,70492905,1,1
2,1,0.5,0.5,82205964,2,1
0,1,0.0,0.0,70821751,1,0
0,2,0.0,0.0,80162901,2,0
0,2,0.0,0.0,67917731,2,0
2,0,1.0,1.0,69536824,1,1
2,0,1.0,1.0,66972024,1,1
0,2,0.0,0.0,67226124,2,0
0,1,0.0,0.0,69619921,1,0
2,0,1.0,1.0,80094910,2,2
2,0,1.0,1.0,79788443,1,1
2,0,1.0,1.0,82010254,1,1
2,1,0.5,0.5,82021509,2,1
0,3,0.0,0.0,66784396,3,0
2,0,1.0,1.0,66229254,1,1
2,0,1.0,1.0,67982110,1,1
0,2,0.0,0.0,65277772,2,0
0,1,0.0,0.0,69621762,1,0
0,1,0.0,0.0,67428753,1,0
0,2,0.0,0.0,80095281,2,0
2,1,0.5,0.8,64976520,2,1
0,2,0.0,0.0,82010279,2,0
0,2,0.3333333333333333,0.42857142857142855,70487613,3,1
2,0,1.0,1.0,67845050,1,1
0,2,0.0,0.0,70037541,2,0
2,0,1.0,1.0,65595971,1,1
2,0,1.0,1.0,82025204,2,2
2,0,1.0,1.0,82039345,4,4
2,0,1.0,1.0,80054954,1,1
2,0,1.0,1.0,69069063,2,2
0,1,0.0,0.0,66229135,1,0
0,1,0.0,0.0,66229520,1,0
0,1,0.0,0.0,66229625,1,0
2,0,1.0,1.0,62940353,6,6
0,5,0.16666666666666666,0.25,71619422,6,1
0,4,0.0,0.0,73459946,4,0
0,3,0.0,0.0,66782856,3,0
0,1,0.0,0.0,66784942,1,0
0,2,0.0,0.0,67754631,2,0
2,0,1.0,1.0,82039400,1,1
0,2,0.3333333333333333,0.25,66817324,3,1
0,1,0.0,0.0,70459494,1,0
2,1,0.75,0.8333333333333334,70459550,4,3
0,1,0.0,0.0,67402181,1,0
2,0,1.0,1.0,68167834,1,1
0,2,0.0,0.0,70743785,2,0
2,1,0.5,0.7142857142857143,80126753,2,1
2,0,1.0,1.0,72446073,1,1
0,1,0.0,0.0,69945064,1,0
2,0,1.0,1.0,70693273,2,2
0,1,0.0,0.0,67311594,1,0
0,1,0.0,0.0,67311776,1,0
2,0,1.0,1.0,68601176,1,1
0,3,0.0,0.0,66812165,3,0
2,0,1.0,1.0,69572846,1,1
2,0,1.0,1.0,67690623,2,2
0,1,0.0,0.0,79576091,1,0
2,0,1.0,1.0,68747434,1,1
1,3,0.25,0.8235294117647058,69961171,4,1
0,1,0.0,0.0,81982983,1,0
0,1,0.0,0.0,81982997,1,0
2,0,1.0,1.0,80165420,1,1
0,1,0.0,0.0,63725984,1,0
2,0,1.0,1.0,70645330,1,1
0,1,0.0,0.0,70705635,1,0
2,0,1.0,1.0,68561591,1,1
2,0,1.0,1.0,82037889,1,1
0,1,0.0,0.0,69153231,1,0
2,0,1.0,1.0,70077980,1,1
2,1,0.5,0.6666666666666666,69071450,2,1
0,3,0.0,0.0,69548423,3,0
0,1,0.0,0.0,69967646,1,0
2,1,0.75,0.6666666666666666,72804270,4,3
0,2,0.0,0.0,75813913,2,0
2,1,0.5,0.6666666666666666,82024237,2,1
1,3,0.25,0.7058823529411765,70693364,4,1
2,1,0.75,0.5,65965935,4,3
2,0,1.0,1.0,69484541,1,1
2,1,0.5,0.75,80150304,2,1
0,1,0.0,0.0,69314994,1,0
2,0,1.0,1.0,68531652,1,1
0,1,0.0,0.0,69187930,1,0
2,0,1.0,1.0,80162066,1,1
0,6,0.0,0.0,80150728,6,0
0,5,0.0,0.0,82006711,5,0
0,2,0.0,0.0,80167285,2,0
0,2,0.3333333333333333,0.14285714285714285,69867273,3,1
0,1,0.0,0.0,68143831,1,0
0,2,0.0,0.0,68538351,2,0
0,1,0.0,0.0,68538386,1,0
0,1,0.0,0.0,68538442,1,0
2,0,1.0,1.0,67277672,3,3
0,1,0.0,0.0,80057285,1,0
0,4,0.0,0.0,70677684,4,0
0,1,0.0,0.0,65288566,1,0
0,3,0.0,0.0,71081654,3,0
0,2,0.0,0.0,70678132,2,0
2,0,1.0,1.0,73623585,1,1
0,2,0.0,0.0,70758562,2,0
2,1,0.75,0.5,72697863,4,3
1,2,0.3333333333333333,0.875,70595462,3,1
2,0,1.0,1.0,80025225,1,1
0,1,0.0,0.0,66973802,1,0
0,1,0.0,0.0,70615146,1,0
2,1,0.6666666666666666,0.5,80128543,3,2
2,0,1.0,1.0,68170970,3,3
0,1,0.0,0.0,82024392,1,0
2,1,0.75,0.0,70521514,4,3
2,0,1.0,1.0,80159759,3,3
0,1,0.0,0.0,18545543,1,0
0,2,0.0,0.0,80118356,2,0
2,0,1.0,1.0,82042165,2,2
2,0,1.0,1.0,82046247,1,1
2,0,1.0,1.0,82144702,4,4
2,1,0.5,0.6666666666666666,66782303,2,1
0,3,0.0,0.0,69637883,3,0
2,2,0.5,0.8,69621706,4,2
0,2,0.0,0.0,80022061,2,0
2,0,1.0,1.0,82020261,1,1
0,4,0.2,0.3333333333333333,78301251,5,1
2,0,1.0,1.0,82020286,1,1
2,1,0.5,0.8,69489392,2,1
0,2,0.0,0.0,70703542,2,0
0,1,0.0,0.0,82121058,1,0
0,1,0.0,0.0,82121060,1,0
0,1,0.0,0.0,82121061,1,0
0,1,0.0,0.0,82121120,1,0
0,1,0.0,0.0,82121121,1,0
2,2,0.6,0.9444444444444444,70508522,5,3
0,1,0.0,0.0,67291455,1,0
0,2,0.0,0.0,80132921,2,0
0,2,0.0,0.0,80132955,2,0
2,1,0.5,0.5,65836295,2,1
2,1,0.5,0.8333333333333334,69240941,2,1
0,3,0.0,0.0,69604150,3,0
0,4,0.0,0.0,70068222,4,0
2,0,1.0,1.0,70192570,1,1
2,0,1.0,1.0,82019703,2,2
0,1,0.0,0.0,70745346,1,0
1,2,0.3333333333333333,0.5,68625816,3,1
2,0,1.0,1.0,82025220,2,2
2,0,1.0,1.0,82019887,1,1
0,1,0.0,0.0,70703815,1,0
0,3,0.0,0.0,80132957,3,0
0,1,0.0,0.0,74708823,1,0
0,2,0.0,0.0,66814972,2,0
0,1,0.0,0.0,67665780,1,0
0,4,0.0,0.0,70693854,4,0
2,0,1.0,1.0,68746440,1,1
2,1,0.6666666666666666,0.5,69064373,3,2
2,0,1.0,1.0,80165409,1,1
2,1,0.5,0.5,82006785,2,1
2,0,1.0,1.0,80124531,1,1
1,3,0.4,0.8571428571428571,69527990,5,2
0,1,0.0,0.0,82205591,1,0
0,1,0.0,0.0,68143852,1,0
2,0,1.0,1.0,68144062,1,1
2,0,1.0,1.0,68531694,1,1
1,5,0.16666666666666666,0.5,69554184,6,1
2,1,0.5,0.0,82102173,2,1
2,1,0.5,0.9655172413793104,70494550,2,1
2,0,1.0,1.0,65293193,2,2
2,0,1.0,1.0,82061912,4,4
0,2,0.0,0.0,71081885,2,0
0,2,0.0,0.0,82061925,2,0
2,2,0.5,0.9,66784144,4,2
0,2,0.0,0.0,80116883,2,0
2,0,1.0,1.0,82062058,2,2
2,0,1.0,1.0,15012291,1,1
2,1,0.5,0.8,80019352,2,1
2,0,1.0,1.0,69390356,1,1
2,0,1.0,1.0,80093475,2,2
2,0,1.0,1.0,76941732,2,2
0,1,0.0,0.0,66257723,1,0
2,0,1.0,1.0,82046242,2,2
2,0,1.0,1.0,80062332,1,1
2,0,1.0,1.0,82125472,1,1
2,0,1.0,1.0,82102194,2,2
2,0,1.0,1.0,70925134,1,1
2,0,1.0,1.0,82038267,4,4
2,1,0.6666666666666666,0.6666666666666666,73859954,3,2
0,1,0.0,0.0,63942970,1,0
0,2,0.0,0.0,80069661,2,0
2,0,1.0,1.0,67833311,3,3
2,0,1.0,1.0,80094742,1,1
0,1,0.0,0.0,69160455,1,0
2,0,1.0,1.0,80135040,1,1
1,2,0.3333333333333333,0.7083333333333334,80126831,3,1
2,0,1.0,1.0,66237843,1,1
0,2,0.0,0.0,70703836,2,0
0,1,0.0,0.0,70674674,1,0
2,0,1.0,1.0,70720153,1,1
0,1,0.0,0.0,69693603,1,0
0,1,0.0,0.0,69693792,1,0
2,0,1.0,1.0,82135117,1,1
2,1,0.5,0.0,62913116,2,1
2,0,1.0,1.0,70234801,1,1
2,1,0.5,0.5,69604682,2,1
2,1,0.5,0.5,68987240,2,1
0,2,0.0,0.0,80156473,2,0
0,3,0.0,0.0,67072334,3,0
0,1,0.0,0.0,80165443,1,0
2,0,1.0,1.0,80172949,1,1
0,4,0.0,0.0,80159898,4,0
0,1,0.0,0.0,70508655,1,0
0,1,0.0,0.0,67065593,1,0
0,2,0.0,0.0,68190472,2,0
0,1,0.0,0.0,68281423,1,0
1,2,0.3333333333333333,0.6046511627906976,69164396,3,1
0,3,0.25,0.40425531914893614,69164445,4,1
2,1,0.5,0.5,70674443,2,1
0,1,0.0,0.0,70677516,1,0
0,1,0.0,0.0,68258435,1,0
2,0,1.0,1.0,80165436,2,2
0,3,0.0,0.0,61264182,3,0
2,1,0.8333333333333334,0.75,80162651,6,5
0,5,0.0,0.0,82152090,5,0
2,0,1.0,1.0,82041624,1,1
0,5,0.16666666666666666,0.0,68032055,6,1
0,2,0.0,0.0,80150241,2,0
2,0,1.0,1.0,70693413,1,1
0,4,0.2,0.25,80153620,5,1
0,2,0.0,0.0,69104511,2,0
0,1,0.0,0.0,69104574,1,0
0,3,0.0,0.0,82164468,3,0
0,3,0.0,0.0,82164469,3,0
2,0,1.0,1.0,70779226,1,1
1,2,0.3333333333333333,0.6,73801700,3,1
0,1,0.0,0.0,67036305,1,0
0,1,0.0,0.0,70408044,1,0
2,0,1.0,1.0,67304216,2,2
2,0,1.0,1.0,66337796,2,2
0,6,0.14285714285714285,0.045454545454545456,65286704,7,1
0,1,0.0,0.0,70706636,1,0
2,1,0.6666666666666666,0.75,73634925,3,2
0,1,0.0,0.0,82006645,1,0
0,1,0.0,0.0,80128347,1,0
0,2,0.0,0.0,63166691,2,0
0,2,0.0,0.0,82006862,2,0
0,1,0.0,0.0,70080374,1,0
2,1,0.5,0.6666666666666666,69866153,2,1
0,2,0.0,0.0,80126758,2,0
0,3,0.0,0.0,80176817,3,0
2,2,0.7142857142857143,0.96,79791173,7,5
0,1,0.0,0.0,67160772,1,0
0,1,0.0,0.0,73255616,1,0
0,1,0.0,0.0,81989614,1,0
2,1,0.5,0.6666666666666666,82023738,2,1
2,1,0.5,0.8,70595406,2,1
2,0,1.0,1.0,80145776,1,1
2,0,1.0,1.0,72802156,1,1
0,1,0.0,0.0,66225782,1,0
2,0,1.0,1.0,82033542,2,2
0,3,0.25,0.42857142857142855,78763741,4,1
2,0,1.0,1.0,80165321,1,1
0,2,0.3333333333333333,0.4,69964720,3,1
2,0,1.0,1.0,75124273,2,2
0,5,0.0,0.0,69640683,5,0
2,0,1.0,1.0,72813636,1,1
0,1,0.0,0.0,64858696,1,0
1,4,0.2,0.6666666666666666,72909662,5,1
2,1,0.75,0.6666666666666666,76572153,4,3
0,2,0.0,0.0,73870090,2,0
2,0,1.0,1.0,68457823,1,1
0,1,0.0,0.0,66737825,1,0
0,1,0.0,0.0,80067365,1,0
0,1,0.0,0.0,82018627,1,0
2,0,1.0,1.0,68675033,3,3
2,0,1.0,1.0,80118354,2,2
2,0,1.0,1.0,67725273,1,1
2,0,1.0,1.0,80165258,1,1
2,0,1.0,1.0,82126575,1,1
0,1,0.0,0.0,80150407,1,0
2,0,1.0,1.0,80176367,5,5
2,0,1.0,1.0,80159712,3,3
2,0,1.0,1.0,82102263,2,2
2,0,1.0,1.0,82145173,1,1
1,2,0.3333333333333333,0.8333333333333334,66228386,3,1
0,1,0.0,0.0,82022981,1,0
2,1,0.5,0.5,78301265,2,1
0,2,0.0,0.0,70692132,2,0
0,4,0.0,0.0,66782023,4,0
0,2,0.0,0.0,82006291,2,0
0,1,0.0,0.0,68740490,1,0
0,1,0.0,0.0,70184436,1,0
0,1,0.0,0.0,60561480,1,0
0,1,0.0,0.0,60561494,1,0
0,1,0.0,0.0,82070193,1,0
0,2,0.0,0.0,67505606,2,0
0,1,0.0,0.0,65634940,1,0
0,3,0.0,0.0,64998003,3,0
0,1,0.0,0.0,73489535,1,0
0,1,0.0,0.0,82250581,1,0
0,2,0.0,0.0,62834562,2,0
2,0,1.0,1.0,80141390,1,1
2,1,0.5,0.5,80092026,2,1
2,1,0.5,0.75,68469205,2,1
2,1,0.5,0.7142857142857143,82247797,2,1
0,1,0.0,0.0,80132982,1,0
0,1,0.0,0.0,75813920,1,0
2,0,1.0,1.0,82182746,1,1
0,1,0.0,0.0,70238280,1,0
2,1,0.6666666666666666,0.9523809523809523,79816051,3,2
0,1,0.0,0.0,82102602,1,0
0,2,0.0,0.0,67667173,2,0
0,1,0.0,0.0,70703073,1,0
0,2,0.0,0.0,80122884,2,0
0,4,0.2,0.3333333333333333,82041711,5,1
2,0,1.0,1.0,82019303,2,2
2,1,0.5,0.5,72964556,2,1
0,1,0.0,0.0,72813713,1,0
2,0,1.0,1.0,67376575,1,1
2,0,1.0,1.0,69164424,1,1
0,5,0.0,0.0,82013669,5,0
2,0,1.0,1.0,80084095,1,1
1,3,0.4,0.625,80141490,5,2
0,2,0.0,0.0,70820176,2,0
0,3,0.0,0.0,67993653,3,0
2,1,0.5,0.9,65903803,2,1
0,3,0.0,0.0,72480604,3,0
2,0,1.0,1.0,79999402,1,1
2,0,1.0,1.0,80093006,1,1
0,1,0.0,0.0,69912052,1,0
0,3,0.0,0.0,82006300,3,0
0,1,0.0,0.0,80150572,1,0
0,5,0.0,0.0,80150599,5,0
0,3,0.0,0.0,82062270,3,0
2,3,0.5714285714285714,0.6666666666666666,80092180,7,4
0,2,0.0,0.0,67276412,2,0
2,0,1.0,1.0,82018948,1,1
2,1,0.5,0.0,70632366,2,1
2,0,1.0,1.0,78449063,1,1
0,2,0.0,0.0,68748176,2,0
0,1,0.0,0.0,68748330,1,0
0,2,0.0,0.0,82151104,2,0
2,1,0.6666666666666666,0.8,69134170,3,2
2,0,1.0,1.0,82102270,1,1
0,2,0.0,0.0,72909893,2,0
0,1,0.0,0.0,69638884,1,0
0,4,0.0,0.0,69653101,4,0
1,3,0.25,0.75,67897382,4,1
2,0,1.0,1.0,69975626,1,1
2,0,1.0,1.0,72324133,4,4
2,0,1.0,1.0,80093363,1,1
2,1,0.5,0.75,66969672,2,1
0,2,0.3333333333333333,0.3333333333333333,65279956,3,1
2,2,0.5,0.7777777777777778,78507450,4,2
2,0,1.0,1.0,69514606,2,2
0,6,0.14285714285714285,0.0,77676921,7,1
0,1,0.0,0.0,78301286,1,0
2,1,0.75,0.5,79785895,4,3
2,0,1.0,1.0,80162569,5,5
2,1,0.5,0.75,70679231,2,1
2,0,1.0,1.0,80165449,1,1
0,2,0.0,0.0,70820120,2,0
2,0,1.0,1.0,69233983,1,1
2,0,1.0,1.0,82020756,1,1
2,0,1.0,1.0,82046098,1,1
0,2,0.0,0.0,72808715,2,0
0,2,0.0,0.0,80137597,2,0
0,2,0.0,0.0,64197105,2,0
0,4,0.0,0.0,70467712,4,0
2,0,1.0,1.0,82096372,1,1
0,1,0.0,0.0,82003718,1,0
0,1,0.0,0.0,82050106,1,0
0,2,0.0,0.0,65281104,2,0
2,2,0.6,0.8,72801575,5,3
2,0,1.0,1.0,69926024,1,1
0,1,0.0,0.0,70509194,1,0
0,1,0.0,0.0,67053504,1,0
0,1,0.0,0.0,69697810,1,0
0,3,0.25,0.0,69483904,4,1
2,0,1.0,1.0,80118297,1,1
2,0,1.0,1.0,74546374,2,2
0,1,0.0,0.0,80133934,1,0
1,2,0.3333333333333333,0.5,82022374,3,1
2,0,1.0,1.0,69169926,1,1
0,4,0.0,0.0,80128152,4,0
0,1,0.0,0.0,68193902,1,0
0,1,0.0,0.0,80053960,1,0
2,1,0.5,0.8,80053953,2,1
0,1,0.0,0.0,80067533,1,0
2,1,0.6666666666666666,0.6666666666666666,70712271,3,2
2,1,0.5,0.5,70026670,2,1
0,2,0.0,0.0,72809366,2,0
2,1,0.5,0.5,68047700,2,1
2,0,1.0,1.0,63948486,1,1
0,1,0.0,0.0,65278080,1,0
2,1,0.5,0.75,68746685,2,1
2,1,0.75,0.75,82090253,4,3
2,0,1.0,1.0,62580196,1,1
0,1,0.0,0.0,68595233,1,0
0,1,0.0,0.0,82041713,1,0
2,0,1.0,1.0,80153671,1,1
2,0,1.0,1.0,82036945,1,1
2,1,0.5,0.875,70250663,2,1
2,1,0.5,0.75,69167476,2,1
2,1,0.5,0.6666666666666666,82019652,2,1
0,1,0.0,0.0,80145455,1,0
0,1,0.0,0.0,82006724,1,0
0,3,0.0,0.0,82006778,3,0
0,1,0.0,0.0,64318576,1,0
0,2,0.0,0.0,69640242,2,0
0,2,0.0,0.0,64318716,2,0
0,1,0.0,0.0,68424783,1,0
1,2,0.3333333333333333,0.85,82046316,3,1
2,0,1.0,1.0,66237801,1,1
1,5,0.2857142857142857,0.7777777777777778,80155195,7,2
0,1,0.0,0.0,73623865,1,0
1,3,0.4,0.6666666666666666,68600763,5,2
2,1,0.6666666666666666,0.75,65201675,3,2
0,1,0.0,0.0,68157271,1,0
0,1,0.0,0.0,69701030,1,0
0,3,0.0,0.0,71588244,3,0
0,1,0.0,0.0,70672504,1,0
0,3,0.0,0.0,69653045,3,0
0,2,0.0,0.0,71536570,2,0
0,3,0.0,0.0,69640802,3,0
0,2,0.0,0.0,80126878,2,0
2,1,0.5,0.6,80134762,2,1
0,3,0.25,0.46153846153846156,69701555,4,1
2,0,1.0,1.0,58870154,2,2
2,2,0.5,0.8571428571428571,68239934,4,2
2,0,1.0,1.0,82038900,1,1
2,0,1.0,1.0,70968940,1,1
0,1,0.0,0.0,70238385,1,0
2,0,1.0,1.0,80165310,1,1
2,0,1.0,1.0,82113377,1,1
2,0,1.0,1.0,69693183,2,2
2,0,1.0,1.0,82038880,1,1
0,1,0.0,0.0,14397070,1,0
0,2,0.0,0.0,67666970,2,0
2,1,0.5,0.0,80145897,2,1
0,3,0.0,0.0,80126816,3,0
0,2,0.0,0.0,65947952,2,0
0,1,0.0,0.0,65290925,1,0
0,1,0.0,0.0,67091395,1,0
2,1,0.8333333333333334,0.5,70341600,6,5
1,2,0.3333333333333333,0.6428571428571429,69975703,3,1
0,2,0.3333333333333333,0.3333333333333333,72834622,3,1
2,0,1.0,1.0,82033544,3,3
0,1,0.0,0.0,70705124,1,0
2,0,1.0,1.0,79793721,1,1
2,2,0.5,0.75,66257002,4,2
2,0,1.0,1.0,67792011,2,2
0,1,0.0,0.0,72906771,1,0
0,2,0.0,0.0,70930930,2,0
0,1,0.0,0.0,69164235,1,0
2,0,1.0,1.0,68747602,1,1
2,1,0.75,0.6666666666666666,70866810,4,3
0,2,0.0,0.0,61717936,2,0
0,1,0.0,0.0,70674401,1,0
0,2,0.0,0.0,69555283,2,0
0,1,0.0,0.0,70509376,1,0
0,1,0.0,0.0,82018825,1,0
0,1,0.0,0.0,69317080,1,0
2,0,1.0,1.0,82039333,2,2
0,5,0.0,0.0,65065140,5,0
0,2,0.0,0.0,69064352,2,0
2,0,1.0,1.0,67672465,1,1
0,3,0.0,0.0,70681996,3,0
0,1,0.0,0.0,70692062,1,0
0,1,0.0,0.0,70692454,1,0
0,1,0.0,0.0,80126798,1,0
2,1,0.5,0.8,70699132,2,1
0,1,0.0,0.0,63239092,1,0
0,1,0.0,0.0,69700022,1,0
0,3,0.0,0.0,69700043,3,0
0,1,0.0,0.0,73556742,1,0
0,4,0.0,0.0,80172527,4,0
0,2,0.0,0.0,82006334,2,0
0,2,0.0,0.0,73459974,2,0
0,2,0.0,0.0,80172555,2,0
0,1,0.0,0.0,70482195,1,0
0,2,0.0,0.0,69911926,2,0
2,0,1.0,1.0,705775,1,1
0,1,0.0,0.0,68020204,1,0
0,1,0.0,0.0,61440442,1,0
2,0,1.0,1.0,82012771,1,1
2,0,1.0,1.0,80161917,2,2
2,1,0.5,0.7142857142857143,70744492,2,1
0,1,0.0,0.0,82204383,1,0
0,1,0.0,0.0,70682185,1,0
2,0,1.0,1.0,82020009,1,1
0,1,0.0,0.0,82102644,1,0
0,2,0.0,0.0,82019729,2,0
2,0,1.0,1.0,82102235,1,1
2,0,1.0,1.0,68747280,2,2
2,1,0.5,0.5,65826040,2,1
2,1,0.6666666666666666,0.95,70063686,3,2
0,2,0.0,0.0,82182807,2,0
0,1,0.0,0.0,69041252,1,0
0,3,0.0,0.0,72803822,3,0
2,0,1.0,1.0,82016271,3,3
0,2,0.0,0.0,69007022,2,0
0,6,0.14285714285714285,0.35714285714285715,70633122,7,1
2,0,1.0,1.0,69207131,1,1
2,0,1.0,1.0,80054044,1,1
2,0,1.0,1.0,75149620,2,2
2,0,1.0,1.0,80092530,2,2
2,0,1.0,1.0,82041539,2,2
2,0,1.0,1.0,80136579,2,2
2,0,1.0,1.0,80159698,1,1
2,2,0.5,0.5,68600700,4,2
2,1,0.5,0.6666666666666666,69638212,2,1
0,1,0.0,0.0,67754421,1,0
0,1,0.0,0.0,71292704,1,0
0,1,0.0,0.0,70684985,1,0
2,1,0.5,0.7142857142857143,70744254,2,1
0,2,0.0,0.0,70683781,2,0
2,0,1.0,1.0,82142698,1,1
0,1,0.0,0.0,82250568,1,0
2,0,1.0,1.0,66257240,1,1
2,0,1.0,1.0,67328534,1,1
0,1,0.0,0.0,67890032,1,0
2,0,1.0,1.0,80139926,1,1
2,1,0.5,0.5,82247785,2,1
0,1,0.0,0.0,82251447,1,0
0,1,0.0,0.0,69479536,1,0
0,1,0.0,0.0,67259150,1,0
0,1,0.0,0.0,65994551,1,0
0,1,0.0,0.0,68499431,1,0
0,1,0.0,0.0,69158040,1,0
0,1,0.0,0.0,69478682,1,0
0,1,0.0,0.0,70229726,1,0
2,1,0.5,0.75,69074593,2,1
0,1,0.0,0.0,80118388,1,0
0,2,0.0,0.0,80055136,2,0
2,0,1.0,1.0,80175975,1,1
2,0,1.0,1.0,82042070,1,1
0,2,0.0,0.0,70697466,2,0
0,2,0.3333333333333333,0.25,70865284,3,1
0,1,0.0,0.0,66235512,1,0
0,2,0.0,0.0,80178110,2,0
2,0,1.0,1.0,70109816,1,1
2,0,1.0,1.0,70343294,1,1
2,1,0.5,0.5,72804123,2,1
0,1,0.0,0.0,82102795,1,0
2,0,1.0,1.0,72803640,1,1
0,2,0.0,0.0,68272526,2,0
0,2,0.0,0.0,67888996,2,0
0,1,0.0,0.0,80150528,1,0
0,2,0.0,0.0,65940546,2,0
2,0,1.0,1.0,69159314,2,2
2,1,0.5,0.6666666666666666,70923860,2,1
0,2,0.0,0.0,80153469,2,0
2,1,0.5,0.8,67138134,2,1
0,1,0.0,0.0,67049402,1,0
0,1,0.0,0.0,66857546,1,0
2,1,0.5,0.0,80135228,2,1
2,0,1.0,1.0,70566755,1,1
0,1,0.0,0.0,78013705,1,0
0,3,0.0,0.0,69391196,3,0
0,1,0.0,0.0,80114811,1,0
1,2,0.3333333333333333,0.5,69152650,3,1
0,1,0.0,0.0,70680750,1,0
0,1,0.0,0.0,70697326,1,0
0,1,0.0,0.0,67346713,1,0
2,1,0.6666666666666666,0.5,68044536,3,2
2,1,0.5,0.5,69868512,2,1
0,1,0.0,0.0,70745990,1,0
0,1,0.0,0.0,70746221,1,0
0,2,0.0,0.0,70746312,2,0
0,2,0.0,0.0,70746662,2,0
2,0,1.0,1.0,80018505,1,1
0,3,0.0,0.0,65280005,3,0
0,1,0.0,0.0,80092411,1,0
0,4,0.0,0.0,82018989,4,0
2,0,1.0,1.0,82020249,2,2
2,0,1.0,1.0,82102229,1,1
2,0,1.0,1.0,82037242,4,4
2,0,1.0,1.0,67256700,1,1
2,0,1.0,1.0,80159649,1,1
0,1,0.0,0.0,69896540,1,0
2,0,1.0,1.0,80128403,1,1
0,2,0.0,0.0,70748055,2,0
0,1,0.0,0.0,80165278,1,0
0,3,0.0,0.0,66783493,3,0
0,3,0.0,0.0,76551846,3,0
2,0,1.0,1.0,67804611,1,1
0,1,0.0,0.0,70681863,1,0
0,1,0.0,0.0,73245816,1,0
2,1,0.6666666666666666,0.6666666666666666,70637196,3,2
0,1,0.0,0.0,68044221,1,0
2,0,1.0,1.0,69976235,1,1
0,3,0.0,0.0,70704102,3,0
0,1,0.0,0.0,67455206,1,0
0,1,0.0,0.0,65282483,1,0
0,1,0.0,0.0,82019859,1,0
1,6,0.3333333333333333,0.8095238095238095,65395820,9,3
1,2,0.3333333333333333,0.8,82251464,3,1
0,1,0.0,0.0,61204045,1,0
2,0,1.0,1.0,66227791,1,1
0,1,0.0,0.0,67053154,1,0
0,1,0.0,0.0,68538883,1,0
1,8,0.1111111111111111,0.6739130434782609,63182525,9,1
2,0,1.0,1.0,69976340,1,1
1,2,0.3333333333333333,0.7,82024309,3,1
2,0,1.0,1.0,68633243,1,1
2,0,1.0,1.0,67843265,3,3
0,2,0.0,0.0,80119393,2,0
2,0,1.0,1.0,82037228,2,2
0,1,0.0,0.0,70761201,1,0
0,2,0.0,0.0,67822356,2,0
2,1,0.5,0.5,69866125,2,1
2,0,1.0,1.0,82019942,1,1
2,1,0.5,0.3333333333333333,70474201,2,1
2,1,0.5,0.9,68498850,2,1
2,0,1.0,1.0,68474511,1,1
2,0,1.0,1.0,62711663,1,1
0,1,0.0,0.0,61746874,1,0
0,1,0.0,0.0,80122861,1,0
2,0,1.0,1.0,79785160,2,2
0,1,0.0,0.0,80172562,1,0
0,3,0.0,0.0,78771406,3,0
0,1,0.0,0.0,69581232,1,0
2,1,0.6666666666666666,0.5,75149494,3,2
2,0,1.0,1.0,69036030,1,1
0,1,0.0,0.0,68143845,1,0
2,0,1.0,1.0,70045675,1,1
0,3,0.0,0.0,80093706,3,0
2,0,1.0,1.0,82049151,3,3
0,3,0.0,0.0,71588195,3,0
2,0,1.0,1.0,70693994,1,1
0,2,0.0,0.0,82062265,2,0
2,0,1.0,1.0,70190295,2,2
2,0,1.0,1.0,68540304,1,1
0,2,0.0,0.0,80123394,2,0
2,0,1.0,1.0,73651193,2,2
2,0,1.0,1.0,82014938,1,1
2,0,1.0,1.0,82138732,2,2
2,0,1.0,1.0,82144699,1,1
2,0,1.0,1.0,68945296,2,2
2,1,0.8333333333333334,0.6666666666666666,73650962,6,5
0,1,0.0,0.0,70073542,1,0
0,1,0.0,0.0,72809051,1,0
0,1,0.0,0.0,70508592,1,0
0,1,0.0,0.0,70691880,1,0
2,0,1.0,1.0,80132890,1,1
2,0,1.0,1.0,72377326,2,2
0,2,0.0,0.0,70184296,2,0
0,1,0.0,0.0,68741001,1,0
2,1,0.5,0.7777777777777778,62972805,2,1
2,0,1.0,1.0,69961192,1,1
0,1,0.0,0.0,70110075,1,0
2,0,1.0,1.0,70706881,1,1
2,0,1.0,1.0,82019889,1,1
0,1,0.0,0.0,70742896,1,0
2,1,0.6666666666666666,0.5,65098733,3,2
2,0,1.0,1.0,80165405,1,1
0,1,0.0,0.0,70692825,1,0
2,1,0.5,0.5,80137956,2,1
0,2,0.0,0.0,70702170,2,0
2,0,1.0,1.0,80162623,2,2
2,0,1.0,1.0,66229380,1,1
0,1,0.0,0.0,80165835,1,0
0,2,0.0,0.0,80165836,2,0
0,2,0.0,0.0,82006869,2,0
2,0,1.0,1.0,82118233,1,1
0,3,0.0,0.0,82006654,3,0
1,3,0.25,0.5,82006669,4,1
0,1,0.0,0.0,82006575,1,0
0,1,0.0,0.0,67978533,1,0
0,2,0.0,0.0,67428564,2,0
2,0,1.0,1.0,62088061,1,1
0,1,0.0,0.0,69544265,1,0
0,2,0.0,0.0,73072433,2,0
1,2,0.3333333333333333,0.6,82102805,3,1
0,2,0.0,0.0,65543975,2,0
2,0,1.0,1.0,82061923,2,2
0,1,0.0,0.0,66224893,1,0
2,1,0.5,0.8,66227420,2,1
0,1,0.0,0.0,66227441,1,0
0,2,0.0,0.0,73801546,2,0
2,0,1.0,1.0,82020800,1,1
0,1,0.0,0.0,68394011,1,0
0,2,0.0,0.0,73489563,2,0
2,0,1.0,1.0,65863525,1,1
1,3,0.25,0.8571428571428571,70675143,4,1
2,1,0.5,0.8571428571428571,69603184,2,1
1,2,0.3333333333333333,0.5,70641060,3,1
2,1,0.6666666666666666,0.8888888888888888,82145138,3,2
2,0,1.0,1.0,66237325,1,1
2,0,1.0,1.0,67822951,1,1
1,3,0.25,0.75,74926915,4,1
2,1,0.6666666666666666,0.6666666666666666,67884222,3,2
2,0,1.0,1.0,80149253,1,1
0,1,0.0,0.0,82018994,1,0
2,0,1.0,1.0,82045974,2,2
2,0,1.0,1.0,80093230,1,1
0,1,0.0,0.0,70679196,1,0
0,1,0.0,0.0,80145778,1,0
2,0,1.0,1.0,67276846,1,1
2,1,0.5,0.5,80118271,2,1
2,0,1.0,1.0,82013515,2,2
2,0,1.0,1.0,69173944,1,1
2,0,1.0,1.0,80165426,1,1
0,1,0.0,0.0,70694533,1,0
0,1,0.0,0.0,70700224,1,0
0,1,0.0,0.0,70109781,1,0
2,1,0.5,0.5,82121154,2,1
0,1,0.0,0.0,82121158,1,0
2,0,1.0,1.0,80134069,3,3
2,1,0.5,0.5,80165370,2,1
2,0,1.0,1.0,82023722,1,1
0,3,0.0,0.0,68905620,3,0
0,1,0.0,0.0,70413546,1,0
2,0,1.0,1.0,67307905,1,1
0,1,0.0,0.0,70909251,1,0
0,2,0.0,0.0,67811800,2,0
0,3,0.0,0.0,68356785,3,0
2,1,0.5,0.875,69555241,2,1
2,0,1.0,1.0,68803770,1,1
0,1,0.0,0.0,66381973,1,0
0,1,0.0,0.0,74770885,1,0
0,1,0.0,0.0,65557583,1,0
0,2,0.0,0.0,66800573,2,0
0,1,0.0,0.0,70703941,1,0
0,1,0.0,0.0,70704095,1,0
1,2,0.3333333333333333,0.8571428571428571,70000805,3,1
0,1,0.0,0.0,80118390,1,0
0,1,0.0,0.0,70698901,1,0
2,1,0.5,0.6666666666666666,65613632,2,1
0,1,0.0,0.0,66898314,1,0
0,1,0.0,0.0,70493591,1,0
0,1,0.0,0.0,69478360,1,0
0,1,0.0,0.0,82041250,1,0
0,2,0.0,0.0,75033182,2,0
0,1,0.0,0.0,80124758,1,0
2,0,1.0,1.0,70654724,1,1
2,2,0.5,0.7647058823529411,82013545,4,2
2,1,0.5,0.5,69410586,2,1
0,2,0.0,0.0,80156159,2,0
2,0,1.0,1.0,82019666,1,1
0,3,0.0,0.0,80150602,3,0
0,1,0.0,0.0,67797345,1,0
0,2,0.0,0.0,80165770,2,0
0,3,0.0,0.0,80165771,3,0
0,1,0.0,0.0,70672070,1,0
2,1,0.5,0.5,68749002,2,1
2,0,1.0,1.0,70459263,1,1
0,2,0.0,0.0,69701506,2,0
0,1,0.0,0.0,82019918,1,0
0,1,0.0,0.0,72905945,1,0
0,1,0.0,0.0,66228190,1,0
0,1,0.0,0.0,66228225,1,0
0,1,0.0,0.0,80122904,1,0
2,0,1.0,1.0,68747651,1,1
2,2,0.5,0.8,70073906,4,2
0,1,0.0,0.0,80165879,1,0
2,0,1.0,1.0,69943566,1,1
0,1,0.0,0.0,72801512,1,0
0,1,0.0,0.0,70718585,1,0
0,2,0.0,0.0,66848565,2,0
0,1,0.0,0.0,70676340,1,0
2,1,0.6666666666666666,0.6666666666666666,70184352,3,2
2,0,1.0,1.0,82037283,2,2
0,1,0.0,0.0,70674576,1,0
2,0,1.0,1.0,80159743,2,2
2,1,0.5,0.0,65249450,2,1
0,2,0.0,0.0,82037822,2,0
0,3,0.0,0.0,69469344,3,0
0,1,0.0,0.0,80093496,1,0
2,0,1.0,1.0,69618626,1,1
0,1,0.0,0.0,70745521,1,0
2,0,1.0,1.0,82070181,1,1
2,1,0.5,0.8,70494361,2,1
2,0,1.0,1.0,82022381,1,1
0,1,0.0,0.0,82019948,1,0
2,0,1.0,1.0,80145436,1,1
0,3,0.25,0.0,82052030,4,1
0,1,0.0,0.0,70660240,1,0
2,0,1.0,1.0,73623151,1,1
2,1,0.5,0.5,80091914,2,1
2,0,1.0,1.0,68163193,1,1
0,1,0.0,0.0,68545022,1,0
0,1,0.0,0.0,67823063,1,0
2,0,1.0,1.0,69780865,1,1
2,0,1.0,1.0,75295206,1,1
2,0,1.0,1.0,82018847,1,1
0,1,0.0,0.0,70696563,1,0
1,2,0.3333333333333333,0.6153846153846154,82024188,3,1
2,0,1.0,1.0,69006616,1,1
2,0,1.0,1.0,69976025,1,1
2,1,0.5,0.6666666666666666,80145727,2,1
0,2,0.0,0.0,62563830,2,0
2,0,1.0,1.0,80165894,1,1
2,0,1.0,1.0,70611394,2,2
0,1,0.0,0.0,70707280,1,0
0,4,0.0,0.0,70465885,4,0
0,4,0.0,0.0,80150585,4,0
2,1,0.5,0.6666666666666666,82012221,2,1
0,2,0.0,0.0,80150473,2,0
0,1,0.0,0.0,70719243,1,0
0,2,0.0,0.0,62957496,2,0
0,1,0.0,0.0,62957503,1,0
2,1,0.5,0.3333333333333333,70919310,2,1
0,1,0.0,0.0,68498423,1,0
0,1,0.0,0.0,68498465,1,0
0,3,0.0,0.0,73535392,3,0
0,1,0.0,0.0,73535581,1,0
0,1,0.0,0.0,73536792,1,0
0,1,0.0,0.0,67464194,1,0
0,1,0.0,0.0,70565390,1,0
0,1,0.0,0.0,67052482,1,0
0,3,0.0,0.0,67625642,3,0
0,1,0.0,0.0,69873804,1,0
2,0,1.0,1.0,69207110,1,1
0,1,0.0,0.0,80122908,1,0
0,1,0.0,0.0,67335730,1,0
0,1,0.0,0.0,67823546,1,0
1,2,0.3333333333333333,0.8,75124392,3,1
2,0,1.0,1.0,80176413,1,1
0,1,0.0,0.0,80128036,1,0
2,1,0.5,0.9047619047619048,82010312,2,1
0,1,0.0,0.0,82019462,1,0
2,1,0.6666666666666666,0.5,80177688,3,2
0,1,0.0,0.0,76941760,1,0
2,1,0.6666666666666666,0.6666666666666666,80165146,3,2
0,1,0.0,0.0,66997742,1,0
0,1,0.0,0.0,67703713,1,0
0,2,0.0,0.0,67703783,2,0
0,2,0.0,0.0,67846793,2,0
2,0,1.0,1.0,79218923,1,1
2,0,1.0,1.0,70639905,2,2
2,0,1.0,1.0,82020773,1,1
2,0,1.0,1.0,79838563,1,1
2,0,1.0,1.0,70707301,1,1
0,3,0.25,0.4,78762901,4,1
2,0,1.0,1.0,70767354,1,1
2,0,1.0,1.0,69701331,1,1
2,0,1.0,1.0,70706223,2,2
0,2,0.0,0.0,70745563,2,0
0,1,0.0,0.0,72480555,1,0
0,1,0.0,0.0,72523101,1,0
0,1,0.0,0.0,70686273,1,0
0,4,0.0,0.0,75342141,4,0
2,0,1.0,1.0,80159186,1,1
0,1,0.0,0.0,67344641,1,0
0,1,0.0,0.0,80083661,1,0
0,1,0.0,0.0,66234504,1,0
2,0,1.0,1.0,67831526,1,1
0,1,0.0,0.0,80067456,1,0
2,0,1.0,1.0,70623875,1,1
2,0,1.0,1.0,68174106,1,1
0,1,0.0,0.0,54467945,1,0
0,1,0.0,0.0,68760223,1,0
2,1,0.5,0.5,68402775,2,1
0,1,0.0,0.0,80132365,1,0
0,1,0.0,0.0,70565096,1,0
2,1,0.6666666666666666,0.8,69484254,3,2
2,1,0.5,0.6666666666666666,69241802,2,1
1,5,0.16666666666666666,0.6428571428571429,70629713,6,1
0,1,0.0,0.0,80167280,1,0
0,1,0.0,0.0,67917290,1,0
1,2,0.3333333333333333,0.8,70481782,3,1
0,1,0.0,0.0,63162883,1,0
0,2,0.0,0.0,80150565,2,0
0,5,0.0,0.0,68390133,5,0
2,1,0.6666666666666666,0.3333333333333333,68631605,3,2
1,3,0.4,0.8333333333333334,72775542,5,2
2,0,1.0,1.0,71277633,1,1
2,0,1.0,1.0,80165448,2,2
2,0,1.0,1.0,80093300,1,1
2,1,0.6666666666666666,0.75,70694281,3,2
2,0,1.0,1.0,70716786,2,2
2,1,0.5,0.8333333333333334,81971197,2,1
2,1,0.6666666666666666,0.8,67990454,3,2
2,1,0.5,0.3333333333333333,80134722,2,1
0,3,0.0,0.0,70491351,3,0
2,0,1.0,1.0,80137035,1,1
0,1,0.0,0.0,82015770,1,0
2,0,1.0,1.0,80159546,1,1
0,1,0.0,0.0,69498674,1,0
0,2,0.0,0.0,70701393,2,0
2,0,1.0,1.0,66243233,1,1
2,0,1.0,1.0,70759836,1,1
2,0,1.0,1.0,72480583,2,2
0,3,0.0,0.0,70014812,3,0
2,2,0.5,0.8888888888888888,70597205,4,2
2,0,1.0,1.0,82039737,1,1
0,2,0.0,0.0,70702205,2,0
2,0,1.0,1.0,82042066,1,1
0,1,0.0,0.0,80091816,1,0
0,1,0.0,0.0,70691831,1,0
0,2,0.0,0.0,70696780,2,0
0,1,0.0,0.0,80126863,1,0
0,1,0.0,0.0,82102512,1,0
2,0,1.0,1.0,74027716,2,2
2,0,1.0,1.0,82020810,1,1
2,0,1.0,1.0,67199111,2,2
0,1,0.0,0.0,67072621,1,0
0,1,0.0,0.0,67653131,1,0
2,0,1.0,1.0,80156004,1,1
0,1,0.0,0.0,69582884,1,0
0,2,0.0,0.0,67831225,2,0
2,0,1.0,1.0,82054045,2,2
2,0,1.0,1.0,72785804,1,1
0,3,0.25,0.4,67625040,4,1
2,2,0.6,0.75,68989452,5,3
0,3,0.25,0.45454545454545453,65286690,4,1
0,1,0.0,0.0,68228825,1,0
2,1,0.5,0.8,67291273,2,1
0,1,0.0,0.0,66353973,1,0
0,1,0.0,0.0,82152772,1,0
2,0,1.0,1.0,82022894,2,2
2,1,0.5,0.6666666666666666,70250950,2,1
0,2,0.0,0.0,70325122,2,0
0,1,0.0,0.0,82022945,1,0
0,1,0.0,0.0,62839364,1,0
0,1,0.0,0.0,80145447,1,0
0,1,0.0,0.0,64929823,1,0
2,0,1.0,1.0,80165453,1,1
0,1,0.0,0.0,72900142,1,0
0,1,0.0,0.0,70685461,1,0
0,2,0.0,0.0,70694190,2,0
0,1,0.0,0.0,82012769,1,0
0,2,0.0,0.0,70014756,2,0
0,1,0.0,0.0,65293242,1,0
0,1,0.0,0.0,82096416,1,0
0,2,0.0,0.0,80165856,2,0
0,1,0.0,0.0,80150668,1,0
0,1,0.0,0.0,80172619,1,0
2,0,1.0,1.0,82022943,1,1
0,3,0.0,0.0,68805590,3,0
0,1,0.0,0.0,64344945,1,0
0,1,0.0,0.0,64344952,1,0
0,1,0.0,0.0,73536043,1,0
2,0,1.0,1.0,68748960,1,1
0,1,0.0,0.0,69577816,1,0
2,0,1.0,1.0,69622133,1,1
2,0,1.0,1.0,80165285,1,1
0,2,0.0,0.0,70706755,2,0
0,3,0.0,0.0,70489055,3,0
0,1,0.0,0.0,67667390,1,0
2,1,0.5,0.0,70756742,2,1
0,1,0.0,0.0,70485394,1,0
0,1,0.0,0.0,68805653,1,0
0,1,0.0,0.0,68805772,1,0
2,1,0.5,0.75,82018609,2,1
0,1,0.0,0.0,64197084,1,0
0,1,0.0,0.0,69390335,1,0
2,0,1.0,1.0,66280074,1,1
2,0,1.0,1.0,80079580,3,3
0,1,0.0,0.0,70693455,1,0
0,1,0.0,0.0,70696472,1,0
2,0,1.0,1.0,82046915,2,2
2,0,1.0,1.0,82024198,1,1
2,0,1.0,1.0,80003693,1,1
2,0,1.0,1.0,69980260,2,2
0,1,0.0,0.0,72204741,1,0
0,2,0.0,0.0,82006181,2,0
0,1,0.0,0.0,82006198,1,0
0,1,0.0,0.0,66782261,1,0
2,0,1.0,1.0,70459221,1,1
2,0,1.0,1.0,67311265,1,1
0,2,0.0,0.0,69469540,2,0
2,0,1.0,1.0,68039370,3,3
2,0,1.0,1.0,68171642,1,1
0,2,0.0,0.0,70691705,2,0
2,0,1.0,1.0,74032462,1,1
2,0,1.0,1.0,69838692,2,2
0,2,0.0,0.0,82062271,2,0
1,3,0.4,0.75,70649775,5,2
0,1,0.0,0.0,67052944,1,0
0,2,0.0,0.0,68167792,2,0
2,2,0.5,0.9,70173453,4,2
2,1,0.5,0.0,70078435,2,1
0,1,0.0,0.0,62798540,1,0
0,2,0.0,0.0,70702191,2,0
0,2,0.0,0.0,70675941,2,0
2,0,1.0,1.0,82018637,1,1
2,0,1.0,1.0,80128304,1,1
0,1,0.0,0.0,69479494,1,0
0,2,0.0,0.0,69575135,2,0
0,1,0.0,0.0,68763772,1,0
0,1,0.0,0.0,66229114,1,0
2,0,1.0,1.0,82024300,1,1
2,0,1.0,1.0,82039734,1,1
0,1,0.0,0.0,73800874,1,0
2,0,1.0,1.0,82020093,3,3
2,0,1.0,1.0,69976144,1,1
2,0,1.0,1.0,71597330,1,1
0,2,0.0,0.0,70499632,2,0
2,1,0.5,0.8,79678676,2,1
0,2,0.0,0.0,70917301,2,0
0,4,0.0,0.0,80168247,4,0
0,2,0.0,0.0,82006165,2,0
2,0,1.0,1.0,82021231,1,1
0,1,0.0,0.0,70698922,1,0
0,1,0.0,0.0,76694730,1,0
0,2,0.0,0.0,68237624,2,0
0,2,0.0,0.0,68715584,2,0
2,1,0.6666666666666666,0.5,70525756,3,2
1,2,0.3333333333333333,0.6666666666666666,78621382,3,1
1,4,0.2,0.6923076923076923,65713585,5,1
0,3,0.0,0.0,82102804,3,0
0,3,0.0,0.0,66503094,3,0
0,2,0.0,0.0,69160154,2,0
2,1,0.75,0.5,70407540,4,3
2,0,1.0,1.0,67669105,2,2
2,1,0.5,0.5,69049561,2,1
2,0,1.0,1.0,69158691,1,1
0,1,0.0,0.0,80150280,1,0
2,0,1.0,1.0,80139897,1,1
2,0,1.0,1.0,82038223,1,1
0,1,0.0,0.0,67120361,1,0
2,0,1.0,1.0,80161948,1,1
2,0,1.0,1.0,82020750,1,1
2,0,1.0,1.0,82018124,1,1
2,0,1.0,1.0,82000482,1,1
2,1,0.6666666666666666,0.5,80054842,3,2
0,1,0.0,0.0,80159296,1,0
2,0,1.0,1.0,80018463,1,1
2,1,0.5,0.0,82039325,2,1
0,1,0.0,0.0,68278511,1,0
2,0,1.0,1.0,80126883,1,1
2,0,1.0,1.0,80165328,1,1
0,1,0.0,0.0,68467700,1,0
2,0,1.0,1.0,67672710,1,1
2,1,0.5,0.8888888888888888,70685041,2,1
2,0,1.0,1.0,80178434,1,1
0,2,0.0,0.0,72906386,2,0
0,1,0.0,0.0,80165330,1,0
2,0,1.0,1.0,82127537,1,1
0,1,0.0,0.0,70491694,1,0
0,1,0.0,0.0,73536302,1,0
1,3,0.25,0.6,65279452,4,1
0,1,0.0,0.0,70675794,1,0
0,2,0.0,0.0,70679861,2,0
0,1,0.0,0.0,70215635,1,0
2,1,0.5,0.8,82040645,2,1
0,1,0.0,0.0,70702814,1,0
0,1,0.0,0.0,69701072,1,0
0,1,0.0,0.0,69701604,1,0
0,1,0.0,0.0,67208505,1,0
2,0,1.0,1.0,80054786,3,3
0,1,0.0,0.0,80126851,1,0
1,3,0.4,0.8,80055101,5,2
0,3,0.0,0.0,82152091,3,0
2,0,1.0,1.0,67910353,1,1
0,1,0.0,0.0,68498024,1,0
0,2,0.0,0.0,70487480,2,0
0,1,0.0,0.0,82002405,1,0
0,1,0.0,0.0,70691495,1,0
0,1,0.0,0.0,70696213,1,0
0,1,0.0,0.0,70697060,1,0
0,3,0.0,0.0,76694744,3,0
0,2,0.0,0.0,71619744,2,0
0,1,0.0,0.0,70482636,1,0
2,0,1.0,1.0,82102596,1,1
0,2,0.0,0.0,70597905,2,0
2,1,0.5,0.5,80128522,2,1
2,0,1.0,1.0,70713230,2,2
2,0,1.0,1.0,74513866,1,1
2,1,0.5,0.5,72802261,2,1
0,1,0.0,0.0,67322822,1,0
0,1,0.0,0.0,70525392,1,0
0,2,0.0,0.0,68498864,2,0
0,2,0.0,0.0,68500215,2,0
2,0,1.0,1.0,82039881,2,2
2,0,1.0,1.0,70682745,1,1
0,1,0.0,0.0,68656154,1,0
2,0,1.0,1.0,69735435,1,1
0,3,0.0,0.0,70489356,3,0
1,3,0.25,0.75,64345253,4,1
0,1,0.0,0.0,63245175,1,0
0,1,0.0,0.0,64983072,1,0
0,4,0.0,0.0,80150363,4,0
2,0,1.0,1.0,70580881,1,1
0,1,0.0,0.0,80093790,1,0
0,2,0.0,0.0,80095106,2,0
2,0,1.0,1.0,70760480,1,1
2,0,1.0,1.0,80165213,2,2
2,2,0.6,0.875,69173195,5,3
2,0,1.0,1.0,79976533,1,1
2,0,1.0,1.0,82102182,2,2
2,0,1.0,1.0,69078562,1,1
2,0,1.0,1.0,80163490,1,1
2,0,1.0,1.0,70779926,1,1
0,1,0.0,0.0,82023075,1,0
2,0,1.0,1.0,80080084,2,2
2,0,1.0,1.0,70768194,3,3
0,1,0.0,0.0,82185030,1,0
0,1,0.0,0.0,82185032,1,0
0,1,0.0,0.0,69064212,1,0
1,2,0.3333333333333333,0.5,68254116,3,1
0,1,0.0,0.0,69500802,1,0
2,0,1.0,1.0,73635345,1,1
0,1,0.0,0.0,67722011,1,0
0,1,0.0,0.0,80057425,1,0
2,2,0.6,0.875,82070205,5,3
0,1,0.0,0.0,73102316,1,0
2,0,1.0,1.0,69167574,2,2
2,0,1.0,1.0,69214901,2,2
0,1,0.0,0.0,70703192,1,0
0,4,0.2,0.3888888888888889,80128574,5,1
0,1,0.0,0.0,70506282,1,0
0,2,0.0,0.0,510272,2,0
2,0,1.0,1.0,66923290,1,1
0,1,0.0,0.0,69697880,1,0
2,0,1.0,1.0,62157613,1,1
0,1,0.0,0.0,70036743,1,0
0,1,0.0,0.0,63631841,1,0
0,1,0.0,0.0,80172518,1,0
0,1,0.0,0.0,80149916,1,0
1,2,0.3333333333333333,0.6666666666666666,82006350,3,1
2,0,1.0,1.0,70767326,1,1
0,1,0.0,0.0,69998110,1,0
0,1,0.0,0.0,68440526,1,0
1,2,0.3333333333333333,0.8333333333333334,70707014,3,1
2,1,0.5,0.5,80125471,2,1
2,0,1.0,1.0,69240962,1,1
0,3,0.0,0.0,68249965,3,0
0,1,0.0,0.0,68254515,1,0
0,1,0.0,0.0,70779905,1,0
2,0,1.0,1.0,80165276,1,1
2,0,1.0,1.0,80165265,1,1
2,0,1.0,1.0,70184366,1,1
2,0,1.0,1.0,82046095,1,1
0,1,0.0,0.0,69041875,1,0
2,0,1.0,1.0,70062573,1,1
2,0,1.0,1.0,70492142,1,1
2,0,1.0,1.0,68344640,2,2
0,1,0.0,0.0,18735646,1,0
0,1,0.0,0.0,73877293,1,0
0,1,0.0,0.0,67384072,1,0
0,3,0.0,0.0,70698586,3,0
0,1,0.0,0.0,80126874,1,0
2,0,1.0,1.0,70189476,2,2
2,0,1.0,1.0,82023366,1,1
2,0,1.0,1.0,82038184,1,1
2,0,1.0,1.0,82250566,1,1
2,0,1.0,1.0,69064534,2,2
2,3,0.625,0.9629629629629629,69588883,8,5
0,1,0.0,0.0,66770655,1,0
2,0,1.0,1.0,82023762,1,1
0,1,0.0,0.0,82024314,1,0
0,1,0.0,0.0,80139019,1,0
2,1,0.5,0.5,80118199,2,1
2,1,0.6666666666666666,0.5,76571796,3,2
0,1,0.0,0.0,70676305,1,0
2,2,0.5,0.75,66304952,4,2
0,1,0.0,0.0,69955186,1,0
2,0,1.0,1.0,80145760,1,1
2,0,1.0,1.0,69733944,5,5
2,1,0.5,0.5,82054010,2,1
2,2,0.5,0.3333333333333333,80124697,4,2
2,0,1.0,1.0,70173460,1,1
2,0,1.0,1.0,82135126,5,5
0,1,0.0,0.0,70474635,1,0
0,2,0.0,0.0,82118227,2,0
0,1,0.0,0.0,69910876,1,0
0,1,0.0,0.0,82102874,1,0
2,0,1.0,1.0,65559571,2,2
2,0,1.0,1.0,66839360,1,1
1,2,0.3333333333333333,0.5,82012804,3,1
2,1,0.6666666666666666,0.5,82019722,3,2
0,1,0.0,0.0,68402761,1,0
0,4,0.0,0.0,80149956,4,0
0,4,0.0,0.0,70238546,4,0
0,2,0.0,0.0,63993566,2,0
2,0,1.0,1.0,69701541,1,1
2,0,1.0,1.0,68567065,2,2
0,3,0.0,0.0,69169541,3,0
0,3,0.0,0.0,70705782,3,0
2,0,1.0,1.0,70598101,1,1
0,1,0.0,0.0,80093580,1,0
2,0,1.0,1.0,68060734,3,3
0,1,0.0,0.0,80137362,1,0
2,0,1.0,1.0,82052093,2,2
2,0,1.0,1.0,80176000,1,1
2,0,1.0,1.0,69975591,1,1
0,1,0.0,0.0,70707476,1,0
0,1,0.0,0.0,80134739,1,0
0,1,0.0,0.0,70680463,1,0
2,0,1.0,1.0,82051986,1,1
0,1,0.0,0.0,68352501,1,0
2,1,0.5,0.8333333333333334,67059902,2,1
0,1,0.0,0.0,65291072,1,0
2,0,1.0,1.0,82105373,1,1
0,1,0.0,0.0,68115481,1,0
2,0,1.0,1.0,80118248,1,1
0,3,0.0,0.0,70850850,3,0
2,0,1.0,1.0,80174106,1,1
2,0,1.0,1.0,82247754,1,1
0,2,0.0,0.0,67787013,2,0
0,1,0.0,0.0,70422261,1,0
2,0,1.0,1.0,67744684,2,2
0,3,0.0,0.0,70706321,3,0
0,1,0.0,0.0,65053583,1,0
0,2,0.0,0.0,69164256,2,0
0,1,0.0,0.0,82023110,1,0
2,0,1.0,1.0,80176374,1,1
0,4,0.0,0.0,68234474,4,0
0,1,0.0,0.0,80150616,1,0
0,4,0.0,0.0,80150652,4,0
0,1,0.0,0.0,70684243,1,0
0,1,0.0,0.0,68138616,1,0
0,1,0.0,0.0,82012782,1,0
2,0,1.0,1.0,82113203,1,1
0,1,0.0,0.0,70697480,1,0
0,2,0.0,0.0,80176822,2,0
0,1,0.0,0.0,80176827,1,0
0,2,0.0,0.0,70704781,2,0
0,1,0.0,0.0,80132274,1,0
0,1,0.0,0.0,80118299,1,0
0,1,0.0,0.0,67225963,1,0
0,1,0.0,0.0,71341823,1,0
2,0,1.0,1.0,70599102,1,1
2,0,1.0,1.0,69482833,1,1
2,0,1.0,1.0,66237402,1,1
2,0,1.0,1.0,82059905,2,2
0,1,0.0,0.0,82159203,1,0
0,8,0.1111111111111111,0.2222222222222222,82159204,9,1
0,4,0.0,0.0,82159205,4,0
2,1,0.6666666666666666,0.875,67067455,3,2
0,1,0.0,0.0,17871735,1,0
2,0,1.0,1.0,80093104,2,2
0,1,0.0,0.0,82023769,1,0
0,3,0.0,0.0,66225600,3,0
0,1,0.0,0.0,70706930,1,0
0,2,0.0,0.0,82018917,2,0
0,1,0.0,0.0,77283696,1,0
0,2,0.0,0.0,82061901,2,0
0,2,0.0,0.0,82061902,2,0
0,2,0.0,0.0,82062669,2,0
2,1,0.5,0.6,70491316,2,1
0,1,0.0,0.0,70743694,1,0
2,1,0.5,0.8333333333333334,70697732,2,1
2,0,1.0,1.0,70694344,2,2
2,0,1.0,1.0,77112455,1,1
2,1,0.6666666666666666,0.75,69634460,3,2
0,2,0.0,0.0,67672682,2,0
2,0,1.0,1.0,82061905,2,2
2,0,1.0,1.0,80159729,1,1
2,0,1.0,1.0,68952975,1,1
2,0,1.0,1.0,82102252,2,2
2,1,0.5,0.5,66228813,2,1
0,3,0.0,0.0,68639634,3,0
2,0,1.0,1.0,80168251,1,1
0,2,0.0,0.0,64043301,2,0
0,1,0.0,0.0,69525764,1,0
0,1,0.0,0.0,68457431,1,0
0,1,0.0,0.0,66015705,1,0
0,4,0.2,0.14285714285714285,69064310,5,1
2,0,1.0,1.0,80177691,2,2
0,1,0.0,0.0,70702884,1,0
0,2,0.0,0.0,69006413,2,0
2,0,1.0,1.0,80150296,1,1
1,2,0.3333333333333333,0.6666666666666666,69469246,3,1
0,2,0.0,0.0,68043255,2,0
2,0,1.0,1.0,68155801,1,1
0,2,0.0,0.0,80150368,2,0
0,1,0.0,0.0,72376871,1,0
2,1,0.5,0.5,72377270,2,1
2,0,1.0,1.0,80161920,2,2
0,1,0.0,0.0,80053666,1,0
2,0,1.0,1.0,13102874,1,1
2,0,1.0,1.0,82018993,1,1
2,0,1.0,1.0,82096381,1,1
0,1,0.0,0.0,75060762,1,0
0,2,0.0,0.0,69585593,2,0
2,0,1.0,1.0,82070189,1,1
0,2,0.0,0.0,72480513,2,0
2,0,1.0,1.0,82019899,1,1
0,1,0.0,0.0,70678433,1,0
2,0,1.0,1.0,66914792,1,1
0,1,0.0,0.0,69212311,1,0
0,1,0.0,0.0,70703045,1,0
0,3,0.0,0.0,69153833,3,0
0,2,0.0,0.0,69226514,2,0
2,1,0.5,0.5,82010309,2,1
0,1,0.0,0.0,66237906,1,0
1,2,0.3333333333333333,0.6666666666666666,74725686,3,1
1,3,0.25,0.5,76606054,4,1
2,0,1.0,1.0,74032441,2,2
0,1,0.0,0.0,80150994,1,0
0,1,0.0,0.0,69311732,1,0
0,1,0.0,0.0,69311795,1,0
0,2,0.0,0.0,69313013,2,0
2,0,1.0,1.0,62408955,1,1
0,1,0.0,0.0,70279531,1,0
0,2,0.0,0.0,67801615,2,0
0,2,0.0,0.0,70680862,2,0
0,3,0.0,0.0,70706146,3,0
0,3,0.0,0.0,82021415,3,0
2,0,1.0,1.0,80133909,1,1
0,2,0.0,0.0,70239211,2,0
0,3,0.0,0.0,67669035,3,0
0,1,0.0,0.0,67917192,1,0
2,0,1.0,1.0,70923181,1,1
2,0,1.0,1.0,82006854,1,1
0,3,0.0,0.0,82006719,3,0
0,1,0.0,0.0,67510282,1,0
0,2,0.3333333333333333,0.3333333333333333,67993674,3,1
1,2,0.3333333333333333,0.8181818181818182,70250901,3,1
2,0,1.0,1.0,70058450,1,1
2,2,0.5,0.6666666666666666,80137915,4,2
2,0,1.0,1.0,70769580,1,1
0,1,0.0,0.0,66235701,1,0
0,1,0.0,0.0,69626172,1,0
0,1,0.0,0.0,70821030,1,0
2,0,1.0,1.0,80172950,1,1
2,1,0.5,0.6666666666666666,80150247,2,1
0,1,0.0,0.0,70489433,1,0
0,1,0.0,0.0,70680736,1,0
0,3,0.0,0.0,70680582,3,0
0,2,0.0,0.0,70693602,2,0
0,1,0.0,0.0,80094203,1,0
2,0,1.0,1.0,69055322,1,1
2,2,0.5,0.625,70685671,4,2
2,1,0.5,0.75,69310213,2,1
2,0,1.0,1.0,69547961,2,2
0,2,0.0,0.0,69110475,2,0
0,3,0.0,0.0,67467820,3,0
0,1,0.0,0.0,66783535,1,0
0,1,0.0,0.0,80163198,1,0
2,1,0.5,0.6666666666666666,69104665,2,1
2,0,1.0,1.0,70707042,1,1
2,0,1.0,1.0,82013569,1,1
0,1,0.0,0.0,82005803,1,0
0,1,0.0,0.0,68018720,1,0
0,4,0.0,0.0,70398314,4,0
0,1,0.0,0.0,82247822,1,0
2,0,1.0,1.0,67792116,1,1
1,2,0.3333333333333333,0.6,75278910,3,1
2,0,1.0,1.0,68742996,1,1
0,1,0.0,0.0,82145161,1,0
2,1,0.5,0.5,80165354,2,1
2,1,0.6666666666666666,0.0,82016269,3,2
0,3,0.25,0.2,82163483,4,1
2,1,0.5,0.8181818181818182,70649684,2,1
0,1,0.0,0.0,77224854,1,0
2,0,1.0,1.0,70279055,1,1
1,2,0.3333333333333333,0.6,60892090,3,1
0,1,0.0,0.0,80126755,1,0
0,1,0.0,0.0,70238504,1,0
2,1,0.6666666666666666,0.8888888888888888,70719250,3,2
2,1,0.5,0.7692307692307693,80172027,2,1
0,2,0.0,0.0,80171046,2,0
0,1,0.0,0.0,69055210,1,0
2,0,1.0,1.0,69127681,2,2
0,3,0.0,0.0,70686133,3,0
2,0,1.0,1.0,80159678,1,1
2,0,1.0,1.0,82070166,1,1
0,1,0.0,0.0,69629084,1,0
2,1,0.5,0.6666666666666666,80172944,2,1
0,1,0.0,0.0,70843451,1,0
2,0,1.0,1.0,67307744,2,2
0,1,0.0,0.0,82090218,1,0
2,0,1.0,1.0,69483106,1,1
0,1,0.0,0.0,70282723,1,0
2,0,1.0,1.0,82033550,1,1
2,0,1.0,1.0,80165218,3,3
2,0,1.0,1.0,82102233,1,1
0,1,0.0,0.0,80094784,1,0
2,0,1.0,1.0,80025204,1,1
2,0,1.0,1.0,82037170,2,2
2,0,1.0,1.0,74362533,1,1
0,3,0.25,0.4,72809191,4,1
0,1,0.0,0.0,70698376,1,0
2,1,0.5,0.3333333333333333,70700511,2,1
0,1,0.0,0.0,69591354,1,0
0,2,0.0,0.0,64866704,2,0
0,1,0.0,0.0,67665514,1,0
0,2,0.3333333333333333,0.42857142857142855,64976212,3,1
2,0,1.0,1.0,69168610,1,1
0,1,0.0,0.0,68952793,1,0
2,1,0.6666666666666666,0.5,70092652,3,2
0,2,0.0,0.0,68715934,2,0
0,3,0.0,0.0,73783591,3,0
2,0,1.0,1.0,82247772,1,1
2,0,1.0,1.0,82145106,2,2
0,1,0.0,0.0,82247816,1,0
2,0,1.0,1.0,70004970,2,2
2,1,0.5,0.8,65281461,2,1
0,3,0.0,0.0,64086582,3,0
0,1,0.0,0.0,66848005,1,0
0,1,0.0,0.0,71879094,1,0
0,2,0.0,0.0,69499010,2,0
0,3,0.0,0.0,67822272,3,0
2,0,1.0,1.0,82037971,1,1
0,1,0.0,0.0,80153697,1,0
2,0,1.0,1.0,80161943,1,1
0,1,0.0,0.0,66792600,1,0
0,1,0.0,0.0,68666773,1,0
2,1,0.6666666666666666,0.5,68250266,3,2
0,1,0.0,0.0,70843010,1,0
0,3,0.0,0.0,70684740,3,0
0,1,0.0,0.0,68017796,1,0
0,2,0.0,0.0,80167272,2,0
0,2,0.0,0.0,80150671,2,0
0,4,0.0,0.0,80150586,4,0
2,0,1.0,1.0,65596286,1,1
2,1,0.5,0.6,74027744,2,1
2,1,0.5,0.5,82022375,2,1
0,1,0.0,0.0,82022429,1,0
2,0,1.0,1.0,66187401,1,1
0,1,0.0,0.0,66470194,1,0
0,1,0.0,0.0,69488860,1,0
0,1,0.0,0.0,80132907,1,0
0,1,0.0,0.0,70684131,1,0
2,0,1.0,1.0,80165243,1,1
2,0,1.0,1.0,70912646,1,1
0,4,0.0,0.0,70174174,4,0
0,1,0.0,0.0,70672602,1,0
2,0,1.0,1.0,80176419,1,1
2,0,1.0,1.0,78479842,1,1
2,0,1.0,1.0,80175995,2,2
2,0,1.0,1.0,82102256,1,1
0,1,0.0,0.0,70703913,1,0
0,1,0.0,0.0,68008913,1,0
2,0,1.0,1.0,70930790,1,1
0,1,0.0,0.0,82037234,1,0
2,0,1.0,1.0,82023129,1,1
2,1,0.6666666666666666,0.5,69867343,3,2
0,3,0.25,0.2,61172006,4,1
2,0,1.0,1.0,69026951,1,1
0,1,0.0,0.0,79816100,1,0
0,1,0.0,0.0,69464584,1,0
2,1,0.5,0.6666666666666666,69549634,2,1
2,0,1.0,1.0,82250560,1,1
0,2,0.0,0.0,70282485,2,0
2,0,1.0,1.0,82020357,1,1
2,0,1.0,1.0,69613985,1,1
0,1,0.0,0.0,68393990,1,0
2,0,1.0,1.0,66240265,2,2
2,0,1.0,1.0,80181399,1,1
2,1,0.5,0.8333333333333334,68613972,2,1
0,1,0.0,0.0,63779436,1,0
2,0,1.0,1.0,71878506,1,1
2,1,0.5,0.5,80150371,2,1
2,0,1.0,1.0,75295213,1,1
2,0,1.0,1.0,80165335,1,1
2,1,0.5,0.5,74986163,2,1
2,0,1.0,1.0,69701562,1,1
2,0,1.0,1.0,71533602,1,1
2,0,1.0,1.0,80136614,1,1
2,0,1.0,1.0,76023416,1,1
0,1,0.0,0.0,75338235,1,0
0,2,0.0,0.0,69470856,2,0
2,0,1.0,1.0,82012796,1,1
2,1,0.5,0.875,80169902,2,1
0,1,0.0,0.0,80172629,1,0
1,3,0.25,0.8823529411764706,82152443,4,1
1,2,0.3333333333333333,0.8,70566692,3,1
2,0,1.0,1.0,73623942,1,1
2,0,1.0,1.0,82127530,3,3
0,1,0.0,0.0,75048141,1,0
2,0,1.0,1.0,82016054,2,2
2,0,1.0,1.0,67067511,1,1
0,1,0.0,0.0,82019877,1,0
1,4,0.3333333333333333,0.6666666666666666,72866913,6,2
2,1,0.5,0.0,82090921,2,1
2,0,1.0,1.0,74363331,2,2
2,0,1.0,1.0,82037266,1,1
2,0,1.0,1.0,82093726,1,1
2,0,1.0,1.0,66060722,1,1
0,2,0.0,0.0,82021453,2,0
2,0,1.0,1.0,80176663,1,1
0,2,0.0,0.0,80094084,2,0
0,2,0.0,0.0,70399364,2,0
2,0,1.0,1.0,82070203,1,1
2,1,0.5,0.5,73102484,2,1
0,1,0.0,0.0,70706181,1,0
2,0,1.0,1.0,69510343,1,1
0,2,0.0,0.0,70705075,2,0
0,1,0.0,0.0,70250852,1,0
0,2,0.0,0.0,69633046,2,0
0,2,0.0,0.0,74770822,2,0
0,2,0.0,0.0,82053972,2,0
0,1,0.0,0.0,82202304,1,0
0,1,0.0,0.0,70680421,1,0
0,2,0.0,0.0,75124371,2,0
2,0,1.0,1.0,82018654,1,1
2,1,0.5,0.75,63980070,2,1
2,1,0.5,0.8,67153072,2,1
0,1,0.0,0.0,69499066,1,0
2,0,1.0,1.0,69994505,1,1
0,1,0.0,0.0,80124690,1,0
0,1,0.0,0.0,62497855,1,0
2,0,1.0,1.0,80178174,1,1
0,1,0.0,0.0,80165858,1,0
0,2,0.0,0.0,82102489,2,0
0,1,0.0,0.0,68440645,1,0
0,7,0.0,0.0,69640690,7,0
2,0,1.0,1.0,62385302,1,1
2,0,1.0,1.0,69510455,2,2
2,0,1.0,1.0,78266692,1,1
0,3,0.25,0.2727272727272727,65286753,4,1
2,0,1.0,1.0,80118236,1,1
2,1,0.75,0.5,70615755,4,3
0,3,0.0,0.0,70843381,3,0
0,3,0.0,0.0,66785761,3,0
0,1,0.0,0.0,62087802,1,0
2,1,0.75,0.5,69195014,4,3
2,0,1.0,1.0,72768465,1,1
2,0,1.0,1.0,60098591,1,1
0,2,0.0,0.0,62841604,2,0
0,1,0.0,0.0,67384121,1,0
2,0,1.0,1.0,70184555,3,3
2,0,1.0,1.0,82102207,1,1
2,2,0.5,0.5,80178964,4,2
2,0,1.0,1.0,81959413,1,1
2,0,1.0,1.0,82051758,1,1
2,1,0.5,0.8333333333333334,70245833,2,1
2,0,1.0,1.0,75149641,1,1
2,0,1.0,1.0,67823553,1,1
0,2,0.0,0.0,71618946,2,0
0,1,0.0,0.0,70842464,1,0
2,1,0.6666666666666666,0.3333333333333333,82127541,3,2
0,1,0.0,0.0,69061755,1,0
2,0,1.0,1.0,69127961,1,1
2,0,1.0,1.0,69500081,1,1
0,1,0.0,0.0,68500012,1,0
2,0,1.0,1.0,70036260,1,1
0,1,0.0,0.0,80133922,1,0
0,1,0.0,0.0,80133928,1,0
0,1,0.0,0.0,70700630,1,0
0,1,0.0,0.0,70779394,1,0
2,0,1.0,1.0,68044634,1,1
0,1,0.0,0.0,65971983,1,0
2,1,0.6666666666666666,0.5,69708912,3,2
2,0,1.0,1.0,80132895,2,2
2,0,1.0,1.0,72803612,2,2
2,0,1.0,1.0,80165366,1,1
0,1,0.0,0.0,70683893,1,0
2,1,0.5,0.5,68587400,2,1
2,0,1.0,1.0,67899370,1,1
0,1,0.0,0.0,69950692,1,0
0,1,0.0,0.0,66156916,1,0
2,1,0.6666666666666666,0.5,80153690,3,2
2,0,1.0,1.0,73459715,1,1
0,1,0.0,0.0,70230125,1,0
0,1,0.0,0.0,68255243,1,0
0,1,0.0,0.0,82102645,1,0
0,1,0.0,0.0,82006187,1,0
2,1,0.5,0.6666666666666666,82006739,2,1
2,0,1.0,1.0,66234084,1,1
2,1,0.5,0.75,70417592,2,1
2,0,1.0,1.0,75347496,2,2
0,1,0.0,0.0,68021625,1,0
0,1,0.0,0.0,67173204,1,0
0,1,0.0,0.0,82013534,1,0
0,1,0.0,0.0,82022330,1,0
0,1,0.0,0.0,73623921,1,0
0,1,0.0,0.0,69484352,1,0
0,1,0.0,0.0,67862431,1,0
0,1,0.0,0.0,69954220,1,0
0,1,0.0,0.0,65280096,1,0
2,0,1.0,1.0,68436921,1,1
2,0,1.0,1.0,70701155,1,1
2,0,1.0,1.0,82095304,2,2
2,0,1.0,1.0,80178240,1,1
2,0,1.0,1.0,82025222,1,1
2,0,1.0,1.0,80165322,1,1
0,3,0.25,0.0,74094951,4,1
0,1,0.0,0.0,82022979,1,0
0,2,0.0,0.0,73161522,2,0
2,0,1.0,1.0,68748253,1,1
0,1,0.0,0.0,80161519,1,0
0,3,0.0,0.0,70059024,3,0
0,3,0.0,0.0,69517595,3,0
2,0,1.0,1.0,82000483,2,2
2,0,1.0,1.0,82016112,1,1
0,1,0.0,0.0,80012702,1,0
2,1,0.5,0.5,80133906,2,1
0,1,0.0,0.0,68338585,1,0
0,1,0.0,0.0,70692531,1,0
2,0,1.0,1.0,66849874,1,1
0,2,0.0,0.0,69092415,2,0
2,1,0.5,0.6666666666666666,79462565,2,1
0,1,0.0,0.0,70700105,1,0
2,0,1.0,1.0,69036114,1,1
2,1,0.5,0.5,82019727,2,1
2,0,1.0,1.0,80176874,1,1
0,1,0.0,0.0,70707336,1,0
0,1,0.0,0.0,15012396,1,0
0,1,0.0,0.0,70684271,1,0
0,1,0.0,0.0,70699811,1,0
0,2,0.0,0.0,70853720,2,0
0,1,0.0,0.0,68540262,1,0
2,0,1.0,1.0,68785094,1,1
0,2,0.0,0.0,70675822,2,0
2,0,1.0,1.0,69604675,1,1
0,1,0.0,0.0,70758933,1,0
0,2,0.0,0.0,82006490,2,0
0,1,0.0,0.0,70674982,1,0
2,1,0.6666666666666666,0.6666666666666666,66825990,3,2
1,2,0.3333333333333333,0.9,82013607,3,1
0,1,0.0,0.0,70704081,1,0
2,0,1.0,1.0,80145423,1,1
2,1,0.5,0.5,70615776,2,1
0,1,0.0,0.0,80137565,1,0
0,1,0.0,0.0,80168311,1,0
0,1,0.0,0.0,68498115,1,0
2,0,1.0,1.0,80165254,1,1
0,1,0.0,0.0,82039300,1,0
1,2,0.3333333333333333,0.5,66263484,3,1
2,1,0.5,0.9090909090909091,70680414,2,1
2,0,1.0,1.0,67823000,1,1
0,1,0.0,0.0,82041908,1,0
2,1,0.5,0.5,54565294,2,1
0,1,0.0,0.0,68663532,1,0
2,0,1.0,1.0,64458940,1,1
0,1,0.0,0.0,72480520,1,0
2,0,1.0,1.0,72814595,1,1
2,0,1.0,1.0,73295852,1,1
2,0,1.0,1.0,76238981,1,1
0,1,0.0,0.0,80093062,1,0
0,1,0.0,0.0,80150290,1,0
2,0,1.0,1.0,66917760,2,2
2,0,1.0,1.0,72670185,2,2
0,1,0.0,0.0,67714941,1,0
2,0,1.0,1.0,70474740,1,1
2,0,1.0,1.0,82016293,1,1
0,1,0.0,0.0,70610813,1,0
0,1,0.0,0.0,66553361,1,0
2,1,0.5,0.8888888888888888,70801850,2,1
0,1,0.0,0.0,80176807,1,0
2,0,1.0,1.0,69069371,1,1
0,1,0.0,0.0,70705481,1,0
0,1,0.0,0.0,75346446,1,0
2,1,0.5,0.5,74882556,2,1
2,0,1.0,1.0,82060538,1,1
0,1,0.0,0.0,80105340,1,0
0,1,0.0,0.0,80153675,1,0
0,1,0.0,0.0,70524496,1,0
0,2,0.0,0.0,82041710,2,0
1,2,0.3333333333333333,0.6,70009541,3,1
0,1,0.0,0.0,67887141,1,0
2,0,1.0,1.0,70246743,1,1
0,1,0.0,0.0,82006532,1,0
0,1,0.0,0.0,82006555,1,0
0,2,0.0,0.0,82006690,2,0
0,2,0.0,0.0,70678503,2,0
2,0,1.0,1.0,69597584,1,1
0,1,0.0,0.0,70703220,1,0
2,0,1.0,1.0,70216363,3,3
0,3,0.0,0.0,80125201,3,0
2,0,1.0,1.0,82008042,2,2
2,0,1.0,1.0,80094973,1,1
0,1,0.0,0.0,69841065,1,0
2,0,1.0,1.0,82061911,1,1
0,1,0.0,0.0,66232880,1,0
0,1,0.0,0.0,70685076,1,0
0,1,0.0,0.0,70699251,1,0
2,0,1.0,1.0,68732671,1,1
0,1,0.0,0.0,70239183,1,0
2,1,0.6666666666666666,0.6666666666666666,70237881,3,2
2,0,1.0,1.0,80136609,3,3
2,0,1.0,1.0,65014481,1,1
2,1,0.6666666666666666,0.5,68287366,3,2
0,1,0.0,0.0,70821086,1,0
0,3,0.0,0.0,82020103,3,0
0,1,0.0,0.0,80125060,1,0
0,1,0.0,0.0,67305721,1,0
2,0,1.0,1.0,70036834,3,3
0,1,0.0,0.0,70683963,1,0
0,1,0.0,0.0,70694575,1,0
0,1,0.0,0.0,80132935,1,0
0,1,0.0,0.0,68047602,1,0
2,0,1.0,1.0,67072740,1,1
2,0,1.0,1.0,70654430,1,1
2,0,1.0,1.0,67830924,1,1
0,1,0.0,0.0,70694295,1,0
0,2,0.0,0.0,70744611,2,0
0,1,0.0,0.0,67657625,1,0
2,1,0.6666666666666666,0.5,69575513,3,2
0,2,0.0,0.0,75147506,2,0
0,1,0.0,0.0,73716293,1,0
0,1,0.0,0.0,70701330,1,0
0,4,0.0,0.0,70702051,4,0
0,1,0.0,0.0,54678736,1,0
2,0,1.0,1.0,68952324,1,1
0,1,0.0,0.0,69483750,1,0
2,0,1.0,1.0,80159696,2,2
0,3,0.0,0.0,69997522,3,0
2,0,1.0,1.0,72813594,3,3
2,0,1.0,1.0,68286981,1,1
2,0,1.0,1.0,70184695,4,4
0,3,0.0,0.0,68635651,3,0
0,2,0.0,0.0,68226886,2,0
0,2,0.0,0.0,67359586,2,0
2,0,1.0,1.0,70635026,1,1
0,2,0.0,0.0,82118278,2,0
1,3,0.25,0.9090909090909091,82118225,4,1
0,1,0.0,0.0,67136664,1,0
2,0,1.0,1.0,68741701,2,2
1,3,0.25,0.5833333333333334,66110702,4,1
0,1,0.0,0.0,69599341,1,0
0,1,0.0,0.0,69599362,1,0
0,1,0.0,0.0,69599432,1,0
0,1,0.0,0.0,69599460,1,0
0,1,0.0,0.0,69599481,1,0
0,1,0.0,0.0,82019653,1,0
0,1,0.0,0.0,82019673,1,0
2,1,0.5,0.6666666666666666,67824141,2,1
0,2,0.0,0.0,66806600,2,0
0,1,0.0,0.0,69545574,1,0
0,1,0.0,0.0,69545630,1,0
0,1,0.0,0.0,82054052,1,0
0,1,0.0,0.0,70759955,1,0
1,3,0.4,0.7,69507424,5,2
2,0,1.0,1.0,67131533,1,1
0,1,0.0,0.0,80150346,1,0
2,0,1.0,1.0,80155227,1,1
0,2,0.0,0.0,62841352,2,0
0,2,0.0,0.0,66231746,2,0
2,0,1.0,1.0,77114170,1,1
0,1,0.0,0.0,82021399,1,0
2,0,1.0,1.0,36085154,1,1
0,1,0.0,0.0,70743484,1,0
2,0,1.0,1.0,82041273,2,2
2,0,1.0,1.0,80136699,1,1
2,0,1.0,1.0,74029431,1,1
2,0,1.0,1.0,82109287,2,2
2,0,1.0,1.0,749406,1,1
0,1,0.0,0.0,82012780,1,0
0,1,0.0,0.0,69399904,1,0
0,3,0.0,0.0,69638184,3,0
2,1,0.6666666666666666,0.8571428571428571,72931040,3,2
0,1,0.0,0.0,70706860,1,0
0,1,0.0,0.0,73421460,1,0
0,6,0.0,0.0,69640641,6,0
0,1,0.0,0.0,82116589,1,0
2,0,1.0,1.0,66761821,4,4
0,2,0.0,0.0,70179641,2,0
0,1,0.0,0.0,70760431,1,0
0,1,0.0,0.0,69241025,1,0
0,1,0.0,0.0,68635595,1,0
0,1,0.0,0.0,70801486,1,0
0,1,0.0,0.0,82250586,1,0
2,1,0.6666666666666666,0.8,80018932,3,2
2,0,1.0,1.0,72766204,1,1
2,0,1.0,1.0,80168265,1,1
0,2,0.0,0.0,60081686,2,0
2,0,1.0,1.0,77283724,1,1
0,1,0.0,0.0,82152779,1,0
0,1,0.0,0.0,82152783,1,0
2,0,1.0,1.0,82015773,1,1
2,0,1.0,1.0,70406182,1,1
0,1,0.0,0.0,70658686,1,0
2,0,1.0,1.0,67584965,2,2
0,1,0.0,0.0,70199584,1,0
2,0,1.0,1.0,80165786,2,2
0,1,0.0,0.0,69021015,1,0
0,2,0.0,0.0,70686336,2,0
0,1,0.0,0.0,69006714,1,0
2,0,1.0,1.0,72814672,1,1
0,2,0.0,0.0,66224585,2,0
2,1,0.5,0.0,67834564,2,1
0,1,0.0,0.0,68130972,1,0
2,0,1.0,1.0,66786496,1,1
2,0,1.0,1.0,82006713,2,2
0,1,0.0,0.0,80170933,1,0
0,2,0.0,0.0,80167271,2,0
0,1,0.0,0.0,70923601,1,0
2,0,1.0,1.0,80178182,1,1
0,3,0.25,0.0,82024317,4,1
2,1,0.5,0.5,71588363,2,1
0,2,0.0,0.0,82096303,2,0
0,1,0.0,0.0,82096306,1,0
0,1,0.0,0.0,67221042,1,0
0,2,0.0,0.0,82018827,2,0
2,0,1.0,1.0,80135805,1,1
2,0,1.0,1.0,68285854,3,3
2,0,1.0,1.0,82060552,1,1
2,1,0.5,0.5,70625975,2,1
2,0,1.0,1.0,68677000,1,1
2,0,1.0,1.0,70189322,1,1
2,0,1.0,1.0,82038899,1,1
0,1,0.0,0.0,82143625,1,0
2,0,1.0,1.0,81913891,2,2
0,2,0.0,0.0,71878394,2,0
0,1,0.0,0.0,79794232,1,0
0,1,0.0,0.0,64209530,1,0
1,2,0.3333333333333333,0.8,67836482,3,1
0,1,0.0,0.0,80150273,1,0
1,2,0.3333333333333333,0.75,82144785,3,1
0,1,0.0,0.0,70687001,1,0
0,1,0.0,0.0,82022889,1,0
2,0,1.0,1.0,82002311,1,1
0,2,0.0,0.0,66212671,2,0
0,4,0.0,0.0,80167323,4,0
0,1,0.0,0.0,69691566,1,0
0,1,0.0,0.0,68007660,1,0
2,0,1.0,1.0,73652313,1,1
0,1,0.0,0.0,82152076,1,0
0,2,0.0,0.0,69693596,2,0
0,3,0.0,0.0,69005860,3,0
2,1,0.5,0.5,70680645,2,1
2,0,1.0,1.0,77112462,1,1
0,1,0.0,0.0,66238620,1,0
2,0,1.0,1.0,82019664,1,1
0,1,0.0,0.0,73634680,1,0
2,0,1.0,1.0,82002251,1,1
2,0,1.0,1.0,70670796,2,2
2,0,1.0,1.0,80159175,2,2
0,1,0.0,0.0,70408030,1,0
2,0,1.0,1.0,68441954,1,1
0,1,0.0,0.0,68498640,1,0
0,1,0.0,0.0,70675815,1,0
2,0,1.0,1.0,68907125,1,1
0,1,0.0,0.0,72909676,1,0
0,1,0.0,0.0,81989176,1,0
2,1,0.5,0.5,69144425,2,1
2,0,1.0,1.0,70674450,1,1
2,0,1.0,1.0,80178442,1,1
2,0,1.0,1.0,68044564,1,1
2,0,1.0,1.0,70537572,1,1
0,2,0.0,0.0,80163529,2,0
2,0,1.0,1.0,80159675,2,2
0,4,0.0,0.0,80165825,4,0
2,0,1.0,1.0,73634841,1,1
0,1,0.0,0.0,80169899,1,0
0,1,0.0,0.0,66793741,1,0
2,0,1.0,1.0,68628840,1,1
2,0,1.0,1.0,80139970,2,2
2,0,1.0,1.0,70525441,1,1
2,0,1.0,1.0,68543006,1,1
0,1,0.0,0.0,70674541,1,0
0,1,0.0,0.0,70679903,1,0
0,1,0.0,0.0,82012812,1,0
0,1,0.0,0.0,82012813,1,0
0,2,0.0,0.0,15012410,2,0
0,1,0.0,0.0,70693035,1,0
0,1,0.0,0.0,68539184,1,0
2,1,0.5,0.8888888888888888,73848670,2,1
2,0,1.0,1.0,73410841,2,2
0,1,0.0,0.0,68239633,1,0
0,1,0.0,0.0,70583394,1,0
0,1,0.0,0.0,70718816,1,0
2,0,1.0,1.0,82041574,1,1
2,0,1.0,1.0,69975941,1,1
2,0,1.0,1.0,82041572,1,1
2,0,1.0,1.0,82047513,1,1
2,1,0.5,0.5,80053645,2,1
0,1,0.0,0.0,80159083,1,0
0,1,0.0,0.0,71618673,1,0
2,0,1.0,1.0,82102160,1,1
0,1,0.0,0.0,82119875,1,0
0,2,0.0,0.0,82119902,2,0
0,1,0.0,0.0,82121131,1,0
2,0,1.0,1.0,65963975,2,2
0,1,0.0,0.0,65634982,1,0
2,0,1.0,1.0,82019867,1,1
0,2,0.0,0.0,82061963,2,0
0,1,0.0,0.0,82061964,1,0
2,0,1.0,1.0,82247757,1,1
0,2,0.0,0.0,70703094,2,0
1,2,0.3333333333333333,0.6923076923076923,82102801,3,1
2,0,1.0,1.0,68437390,1,1
2,0,1.0,1.0,80047765,1,1
0,1,0.0,0.0,70743260,1,0
2,0,1.0,1.0,80155831,1,1
0,2,0.0,0.0,72809345,2,0
2,0,1.0,1.0,70892724,1,1
0,1,0.0,0.0,70532924,1,0
2,0,1.0,1.0,82022329,1,1
0,3,0.25,0.4375,70842905,4,1
0,1,0.0,0.0,82024315,1,0
0,1,0.0,0.0,70683193,1,0
0,1,0.0,0.0,70671881,1,0
0,1,0.0,0.0,80136736,1,0
2,0,1.0,1.0,70694456,1,1
2,0,1.0,1.0,82018608,1,1
2,1,0.5,0.6666666666666666,70696556,2,1
2,0,1.0,1.0,70945056,1,1
0,1,0.0,0.0,80135236,1,0
2,0,1.0,1.0,80172575,1,1
0,2,0.0,0.0,82102532,2,0
0,1,0.0,0.0,80172567,1,0
0,1,0.0,0.0,68042121,1,0
0,2,0.0,0.0,82006494,2,0
0,2,0.0,0.0,82006497,2,0
2,0,1.0,1.0,80028613,1,1
0,2,0.0,0.0,73489521,2,0
2,0,1.0,1.0,82016172,2,2
2,0,1.0,1.0,72822645,1,1
0,1,0.0,0.0,67052860,1,0
2,0,1.0,1.0,80152804,3,3
2,2,0.5,0.6666666666666666,69617562,4,2
0,1,0.0,0.0,69164193,1,0
0,1,0.0,0.0,82024874,1,0
2,0,1.0,1.0,82041877,1,1
2,0,1.0,1.0,70747201,1,1
2,1,0.5,0.875,80154109,2,1
0,2,0.0,0.0,82006241,2,0
0,1,0.0,0.0,82006306,1,0
0,2,0.0,0.0,66783213,2,0
0,1,0.0,0.0,66785334,1,0
0,2,0.0,0.0,66786216,2,0
0,1,0.0,0.0,80124761,1,0
0,1,0.0,0.0,80150317,1,0
0,1,0.0,0.0,82022888,1,0
2,0,1.0,1.0,67028416,1,1
0,1,0.0,0.0,67226173,1,0
0,1,0.0,0.0,64234471,1,0
0,1,0.0,0.0,80067400,1,0
2,0,1.0,1.0,68544903,1,1
2,0,1.0,1.0,80179194,1,1
2,0,1.0,1.0,67822944,1,1
0,1,0.0,0.0,82110460,1,0
0,1,0.0,0.0,70060382,1,0
1,3,0.25,0.5833333333333334,70682850,4,1
2,0,1.0,1.0,66632230,1,1
0,1,0.0,0.0,67831246,1,0
0,1,0.0,0.0,70713286,1,0
0,1,0.0,0.0,70676172,1,0
0,1,0.0,0.0,82019695,1,0
0,1,0.0,0.0,82153544,1,0
0,1,0.0,0.0,67245220,1,0
0,1,0.0,0.0,69535053,1,0
2,0,1.0,1.0,68907804,1,1
2,0,1.0,1.0,80132369,1,1
0,1,0.0,0.0,69311340,1,0
0,1,0.0,0.0,69723794,1,0
0,2,0.0,0.0,66876103,2,0
0,1,0.0,0.0,71619751,1,0
2,0,1.0,1.0,70687155,1,1
0,1,0.0,0.0,67637031,1,0
0,1,0.0,0.0,70677901,1,0
0,1,0.0,0.0,70693322,1,0
0,1,0.0,0.0,70694155,1,0
0,1,0.0,0.0,70694785,1,0
0,3,0.0,0.0,64032332,3,0
0,1,0.0,0.0,58873360,1,0
0,1,0.0,0.0,80168309,1,0
0,1,0.0,0.0,70469154,1,0
0,1,0.0,0.0,65384375,1,0
0,1,0.0,0.0,66885735,1,0
2,0,1.0,1.0,75346425,2,2
2,0,1.0,1.0,70747502,3,3
2,1,0.5,0.5,72366014,2,1
2,0,1.0,1.0,80169310,2,2
2,0,1.0,1.0,80169824,1,1
2,1,0.5,0.7142857142857143,80145428,2,1
2,0,1.0,1.0,67821761,1,1
2,0,1.0,1.0,65963926,1,1
0,2,0.0,0.0,60343773,2,0
0,1,0.0,0.0,66229786,1,0
2,0,1.0,1.0,69640445,1,1
0,1,0.0,0.0,80163506,1,0
0,1,0.0,0.0,82121025,1,0
2,0,1.0,1.0,80141339,1,1
2,0,1.0,1.0,75613783,1,1
0,2,0.0,0.0,64881040,2,0
2,0,1.0,1.0,82013536,1,1
2,0,1.0,1.0,82010330,1,1
0,2,0.0,0.0,19445244,2,0
0,2,0.0,0.0,81875465,2,0
2,0,1.0,1.0,72813580,1,1
0,1,0.0,0.0,80141401,1,0
0,1,0.0,0.0,70516152,1,0
0,2,0.0,0.0,67053056,2,0
2,1,0.5,0.875,70037205,2,1
2,0,1.0,1.0,80135024,1,1
2,0,1.0,1.0,68795090,1,1
0,1,0.0,0.0,70703752,1,0
2,1,0.5,0.0,502530,2,1
0,1,0.0,0.0,80128892,1,0
2,1,0.5,0.8,70618002,2,1
2,0,1.0,1.0,80162555,3,3
0,2,0.0,0.0,62841856,2,0
2,0,1.0,1.0,67782911,1,1
0,1,0.0,0.0,80126850,1,0
0,1,0.0,0.0,68670700,1,0
2,1,0.5,0.9,80165774,2,1
2,2,0.6,0.875,74049871,5,3
2,1,0.5,0.8,70685755,2,1
2,0,1.0,1.0,67328450,2,2
2,0,1.0,1.0,68763534,1,1
2,0,1.0,1.0,68531771,1,1
2,0,1.0,1.0,67981130,2,2
0,1,0.0,0.0,67970686,1,0
0,1,0.0,0.0,66786020,1,0
0,1,0.0,0.0,70672560,1,0
0,1,0.0,0.0,70685006,1,0
0,1,0.0,0.0,70692643,1,0
0,1,0.0,0.0,82018746,1,0
2,0,1.0,1.0,70660646,1,1
0,1,0.0,0.0,82182761,1,0
0,1,0.0,0.0,82018868,1,0
0,1,0.0,0.0,82023368,1,0
2,0,1.0,1.0,82091034,1,1
2,0,1.0,1.0,70747152,3,3
2,0,1.0,1.0,82039903,2,2
2,1,0.6666666666666666,0.5,82041264,3,2
2,0,1.0,1.0,80159183,1,1
0,1,0.0,0.0,82036983,1,0
0,1,0.0,0.0,71964823,1,0
0,1,0.0,0.0,70597933,1,0
0,1,0.0,0.0,70693245,1,0
0,1,0.0,0.0,70743673,1,0
2,0,1.0,1.0,70189714,1,1
0,1,0.0,0.0,79791194,1,0
0,1,0.0,0.0,82022347,1,0
2,0,1.0,1.0,66189970,1,1
0,1,0.0,0.0,79989483,1,0
2,0,1.0,1.0,69731620,1,1
2,0,1.0,1.0,82034222,1,1
0,1,0.0,0.0,82202293,1,0
0,1,0.0,0.0,82003737,1,0
2,0,1.0,1.0,80156460,1,1
0,3,0.0,0.0,82250616,3,0
0,1,0.0,0.0,82250590,1,0
2,0,1.0,1.0,82247789,1,1
0,1,0.0,0.0,69541024,1,0
2,0,1.0,1.0,80092614,1,1
0,1,0.0,0.0,67706681,1,0
0,2,0.0,0.0,67830182,2,0
0,1,0.0,0.0,67830343,1,0
0,1,0.0,0.0,67830574,1,0
0,2,0.0,0.0,67706156,2,0
2,0,1.0,1.0,75362182,1,1
0,1,0.0,0.0,70681590,1,0
0,1,0.0,0.0,69548514,1,0
0,1,0.0,0.0,70573342,1,0
0,1,0.0,0.0,70545895,1,0
0,1,0.0,0.0,64953721,1,0
2,1,0.5,0.5,71230124,2,1
0,1,0.0,0.0,70779233,1,0
0,1,0.0,0.0,72137163,1,0
0,1,0.0,0.0,72930956,1,0
0,1,0.0,0.0,70744562,1,0
0,1,0.0,0.0,63858592,1,0
2,0,1.0,1.0,67657716,1,1
2,0,1.0,1.0,67704301,1,1
0,1,0.0,0.0,68286400,1,0
0,2,0.0,0.0,82118265,2,0
0,1,0.0,0.0,63981771,1,0
0,1,0.0,0.0,69644631,1,0
0,1,0.0,0.0,69644722,1,0
0,1,0.0,0.0,69644764,1,0
0,1,0.0,0.0,69603555,1,0
0,1,0.0,0.0,66392060,1,0
2,0,1.0,1.0,68008962,1,1
2,0,1.0,1.0,82135141,1,1
0,1,0.0,0.0,70063511,1,0
2,1,0.5,0.875,63992656,2,1
2,0,1.0,1.0,73652215,1,1
2,0,1.0,1.0,70189742,1,1
2,0,1.0,1.0,82020816,1,1
0,3,0.0,0.0,69479256,3,0
2,0,1.0,1.0,82024240,1,1
2,0,1.0,1.0,80136663,1,1
0,1,0.0,0.0,82013506,1,0
2,0,1.0,1.0,70356734,1,1
0,2,0.0,0.0,80128404,2,0
2,0,1.0,1.0,68402040,1,1
2,0,1.0,1.0,76032642,1,1
2,0,1.0,1.0,82018765,1,1
0,2,0.0,0.0,70706433,2,0
2,0,1.0,1.0,82135130,4,4
0,1,0.0,0.0,82102744,1,0
2,0,1.0,1.0,82037285,1,1
2,0,1.0,1.0,80163128,1,1
0,1,0.0,0.0,69955606,1,0
2,0,1.0,1.0,72804410,2,2
2,0,1.0,1.0,67665304,1,1
2,1,0.5,0.6,68344556,2,1
0,1,0.0,0.0,70683473,1,0
0,1,0.0,0.0,70698481,1,0
0,2,0.0,0.0,70697130,2,0
0,1,0.0,0.0,70679896,1,0
2,1,0.5,0.5,82009385,2,1
0,1,0.0,0.0,70697410,1,0
0,1,0.0,0.0,70674653,1,0
2,1,0.5,0.8571428571428571,80141335,2,1
0,1,0.0,0.0,70686000,1,0
0,1,0.0,0.0,80170907,1,0
0,1,0.0,0.0,80170908,1,0
0,2,0.0,0.0,69188203,2,0
0,1,0.0,0.0,80176645,1,0
0,2,0.0,0.0,79849133,2,0
0,1,0.0,0.0,70700315,1,0
1,2,0.3333333333333333,0.8181818181818182,70744345,3,1
2,0,1.0,1.0,67751432,2,2
1,2,0.3333333333333333,0.8888888888888888,67464054,3,1
0,2,0.0,0.0,70197694,2,0
0,1,0.0,0.0,69511932,1,0
2,0,1.0,1.0,66896340,1,1
2,0,1.0,1.0,68749016,1,1
0,1,0.0,0.0,70701260,1,0
0,1,0.0,0.0,72910110,1,0
0,1,0.0,0.0,82152774,1,0
2,0,1.0,1.0,80159157,1,1
2,0,1.0,1.0,80092544,1,1
2,0,1.0,1.0,69333705,2,2
2,0,1.0,1.0,69976130,1,1
2,0,1.0,1.0,80080063,2,2
2,0,1.0,1.0,63159782,2,2
0,1,0.0,0.0,71588160,1,0
0,1,0.0,0.0,82006284,1,0
0,1,0.0,0.0,80172587,1,0
2,0,1.0,1.0,66859604,1,1
1,2,0.3333333333333333,0.7777777777777778,69003263,3,1
2,0,1.0,1.0,80150399,1,1
0,1,0.0,0.0,70080465,1,0
0,1,0.0,0.0,82247770,1,0
2,0,1.0,1.0,75967164,1,1
2,0,1.0,1.0,70018361,1,1
0,2,0.0,0.0,65899722,2,0
2,0,1.0,1.0,82019064,1,1
2,0,1.0,1.0,66503395,1,1
2,0,1.0,1.0,68999343,1,1
2,0,1.0,1.0,82009389,1,1
2,0,1.0,1.0,70493563,1,1
0,1,0.0,0.0,80165341,1,0
2,2,0.5,0.8,70058380,4,2
0,1,0.0,0.0,80150357,1,0
0,1,0.0,0.0,72357733,1,0
0,2,0.0,0.0,64355634,2,0
2,1,0.5,0.75,63767116,2,1
0,1,0.0,0.0,70239512,1,0
2,0,1.0,1.0,70597233,1,1
0,1,0.0,0.0,80165159,1,0
0,1,0.0,0.0,82182750,1,0
0,1,0.0,0.0,80156171,1,0
0,1,0.0,0.0,68805583,1,0
0,2,0.0,0.0,71878702,2,0
2,0,1.0,1.0,67924080,1,1
0,1,0.0,0.0,68227040,1,0
0,1,0.0,0.0,82006368,1,0
0,2,0.0,0.0,82006193,2,0
0,1,0.0,0.0,82006194,1,0
2,0,1.0,1.0,70213843,1,1
0,1,0.0,0.0,70698523,1,0
0,1,0.0,0.0,79793805,1,0
0,1,0.0,0.0,79796094,1,0
2,0,1.0,1.0,66761884,1,1
2,1,0.5,0.5,65286200,2,1
2,1,0.5,0.8333333333333334,66971121,2,1
0,1,0.0,0.0,69188294,1,0
0,1,0.0,0.0,73535826,1,0
2,0,1.0,1.0,82054720,2,2
0,1,0.0,0.0,69163444,1,0
0,1,0.0,0.0,70707056,1,0
2,0,1.0,1.0,69621804,1,1
2,0,1.0,1.0,67870530,1,1
0,4,0.0,0.0,69596282,4,0
0,2,0.0,0.0,69577466,2,0
0,1,0.0,0.0,70683046,1,0
2,0,1.0,1.0,70184576,1,1
2,0,1.0,1.0,82041907,1,1
2,0,1.0,1.0,82145540,1,1
2,0,1.0,1.0,80133930,1,1
2,1,0.5,0.5,80128384,2,1
0,1,0.0,0.0,69110566,1,0
0,1,0.0,0.0,70629020,1,0
0,2,0.0,0.0,66783206,2,0
0,1,0.0,0.0,70635362,1,0
0,1,0.0,0.0,69637946,1,0
0,2,0.0,0.0,69581204,2,0
2,0,1.0,1.0,69549046,1,1
2,1,0.5,0.5,82137408,2,1
0,1,0.0,0.0,70574721,1,0
0,1,0.0,0.0,70574763,1,0
0,1,0.0,0.0,70574812,1,0
0,1,0.0,0.0,70574854,1,0
0,1,0.0,0.0,70574980,1,0
0,1,0.0,0.0,70679812,1,0
2,0,1.0,1.0,80162154,1,1
2,1,0.5,0.5,82019788,2,1
2,1,0.6666666666666666,0.5,67300212,3,2
0,1,0.0,0.0,69997830,1,0
0,1,0.0,0.0,62563844,1,0
2,0,1.0,1.0,69047440,2,2
2,0,1.0,1.0,80150987,1,1
0,1,0.0,0.0,70679105,1,0
2,0,1.0,1.0,60191922,1,1
2,1,0.5,0.0,66229303,2,1
2,0,1.0,1.0,70111286,1,1
0,1,0.0,0.0,69547821,1,0
2,0,1.0,1.0,82037604,1,1
0,2,0.0,0.0,70467845,2,0
0,2,0.0,0.0,80132286,2,0
2,1,0.6666666666666666,0.96,70759612,3,2
2,1,0.5,0.6666666666666666,71619646,2,1
0,1,0.0,0.0,80131203,1,0
2,0,1.0,1.0,80172560,1,1
2,0,1.0,1.0,68174113,1,1
0,1,0.0,0.0,71588342,1,0
0,3,0.0,0.0,54676020,3,0
0,3,0.0,0.0,70703465,3,0
0,1,0.0,0.0,82070183,1,0
0,2,0.0,0.0,82102646,2,0
0,1,0.0,0.0,80150321,1,0
0,2,0.0,0.0,70682206,2,0
0,1,0.0,0.0,70684383,1,0
0,2,0.0,0.0,70686154,2,0
0,2,0.0,0.0,80125413,2,0
2,0,1.0,1.0,82142697,1,1
2,0,1.0,1.0,80158237,1,1
2,1,0.6666666666666666,0.6666666666666666,73632433,3,2
2,0,1.0,1.0,82020052,1,1
2,0,1.0,1.0,67098990,1,1
0,3,0.0,0.0,69394276,3,0
0,1,0.0,0.0,70674366,1,0
0,1,0.0,0.0,70675360,1,0
0,1,0.0,0.0,70680134,1,0
2,0,1.0,1.0,70743890,1,1
2,0,1.0,1.0,70192542,1,1
2,0,1.0,1.0,67816154,2,2
0,1,0.0,0.0,64225686,1,0
0,1,0.0,0.0,69701135,1,0
0,2,0.0,0.0,70927346,2,0
1,2,0.3333333333333333,0.6,69187034,3,1
2,0,1.0,1.0,63728035,1,1
2,0,1.0,1.0,69733706,1,1
2,0,1.0,1.0,80083416,1,1
2,1,0.6666666666666666,0.8571428571428571,69499920,3,2
1,2,0.3333333333333333,0.8333333333333334,82145538,3,1
0,1,0.0,0.0,82038354,1,0
0,1,0.0,0.0,67732532,1,0
2,0,1.0,1.0,70341586,1,1
2,0,1.0,1.0,70600313,1,1
2,0,1.0,1.0,67328520,1,1
0,1,0.0,0.0,62451403,1,0
0,1,0.0,0.0,64064805,1,0
0,1,0.0,0.0,67978260,1,0
0,1,0.0,0.0,82006601,1,0
2,0,1.0,1.0,69188371,1,1
0,2,0.0,0.0,67359474,2,0
0,1,0.0,0.0,70633094,1,0
0,1,0.0,0.0,80128368,1,0
2,1,0.5,0.5,82006879,2,1
0,2,0.0,0.0,82006781,2,0
0,1,0.0,0.0,80169884,1,0
2,1,0.5,0.6666666666666666,82062263,2,1
2,0,1.0,1.0,80057516,2,2
2,0,1.0,1.0,68545701,1,1
2,0,1.0,1.0,15233120,1,1
0,1,0.0,0.0,66778131,1,0
2,0,1.0,1.0,68254130,1,1
0,1,0.0,0.0,67291553,1,0
0,1,0.0,0.0,70494221,1,0
2,0,1.0,1.0,80083500,1,1
0,1,0.0,0.0,66784410,1,0
0,1,0.0,0.0,67754533,1,0
0,2,0.0,0.0,64468971,2,0
2,0,1.0,1.0,69205962,1,1
0,1,0.0,0.0,70705810,1,0
2,0,1.0,1.0,80176847,1,1
0,2,0.0,0.0,141113,2,0
2,0,1.0,1.0,68532240,1,1
2,0,1.0,1.0,69164144,1,1
2,0,1.0,1.0,66234952,1,1
2,1,0.5,0.0,69697761,2,1
0,1,0.0,0.0,70183680,1,0
0,1,0.0,0.0,68624073,1,0
2,0,1.0,1.0,82019672,1,1
2,0,1.0,1.0,67026526,1,1
2,0,1.0,1.0,80162112,1,1
2,0,1.0,1.0,70349552,1,1
0,1,0.0,0.0,70692636,1,0
0,1,0.0,0.0,70704816,1,0
2,0,1.0,1.0,80159294,1,1
0,1,0.0,0.0,82152782,1,0
2,0,1.0,1.0,70704284,1,1
0,1,0.0,0.0,66377640,1,0
2,0,1.0,1.0,70049196,1,1
2,0,1.0,1.0,82061336,1,1
2,0,1.0,1.0,77112504,1,1
0,2,0.0,0.0,71619485,2,0
0,1,0.0,0.0,69973120,1,0
0,2,0.0,0.0,82006721,2,0
0,1,0.0,0.0,82006746,1,0
0,1,0.0,0.0,82006747,1,0
2,1,0.5,0.8,80173407,2,1
0,1,0.0,0.0,67976132,1,0
2,1,0.5,0.6,71619030,2,1
0,2,0.0,0.0,82006520,2,0
0,1,0.0,0.0,82006551,1,0
0,1,0.0,0.0,82006567,1,0
0,1,0.0,0.0,68283936,1,0
0,1,0.0,0.0,68805786,1,0
0,2,0.0,0.0,62835962,2,0
0,4,0.0,0.0,72866661,4,0
2,1,0.5,0.5,69064156,2,1
0,2,0.0,0.0,80132880,2,0
2,2,0.6,0.875,66783640,5,3
0,1,0.0,0.0,69940346,1,0
2,0,1.0,1.0,80176003,1,1
0,1,0.0,0.0,70682241,1,0
2,1,0.5,0.8888888888888888,72802163,2,1
0,3,0.0,0.0,65280873,3,0
0,1,0.0,0.0,69575562,1,0
2,1,0.5,0.6666666666666666,69933465,2,1
0,4,0.2,0.4,80132908,5,1
2,0,1.0,1.0,80176462,1,1
2,0,1.0,1.0,82138714,1,1
2,0,1.0,1.0,82053164,1,1
2,0,1.0,1.0,82051753,1,1
0,1,0.0,0.0,66849664,1,0
0,1,0.0,0.0,69723801,1,0
0,1,0.0,0.0,70704606,1,0
2,0,1.0,1.0,67803890,1,1
2,0,1.0,1.0,67663043,1,1
0,1,0.0,0.0,69483505,1,0
2,0,1.0,1.0,72480562,1,1
0,1,0.0,0.0,69693806,1,0
2,1,0.5,0.9090909090909091,82042619,2,1
0,1,0.0,0.0,8016463,1,0
0,1,0.0,0.0,82021423,1,0
0,2,0.0,0.0,69463345,2,0
2,0,1.0,1.0,80163694,2,2
2,0,1.0,1.0,64190406,2,2
2,0,1.0,1.0,82018814,1,1
0,1,0.0,0.0,82145363,1,0
2,0,1.0,1.0,70221886,1,1
0,2,0.0,0.0,80145828,2,0
0,1,0.0,0.0,70756756,1,0
0,1,0.0,0.0,71878730,1,0
0,3,0.0,0.0,82102781,3,0
0,3,0.0,0.0,69185396,3,0
2,0,1.0,1.0,80163134,2,2
2,0,1.0,1.0,82012787,1,1
0,1,0.0,0.0,69979595,1,0
0,3,0.0,0.0,80162866,3,0
0,1,0.0,0.0,66803996,1,0
1,2,0.3333333333333333,0.8695652173913043,70489160,3,1
0,1,0.0,0.0,64173816,1,0
2,0,1.0,1.0,70494774,1,1
1,2,0.3333333333333333,0.8,82109299,3,1
0,2,0.0,0.0,70704823,2,0
0,2,0.0,0.0,70706650,2,0
2,0,1.0,1.0,72652230,1,1
0,1,0.0,0.0,82037809,1,0
0,1,0.0,0.0,62088012,1,0
2,0,1.0,1.0,70944776,1,1
0,1,0.0,0.0,67276580,1,0
0,1,0.0,0.0,69539981,1,0
2,0,1.0,1.0,82096409,1,1
2,0,1.0,1.0,67498361,1,1
2,0,1.0,1.0,82064807,1,1
2,0,1.0,1.0,80136654,1,1
0,2,0.0,0.0,68283915,2,0
2,0,1.0,1.0,80159702,1,1
2,0,1.0,1.0,80150256,1,1
0,1,0.0,0.0,70702044,1,0
2,1,0.5,0.0,69866020,2,1
0,3,0.0,0.0,68784380,3,0
0,1,0.0,0.0,80168318,1,0
0,2,0.0,0.0,82022387,2,0
2,0,1.0,1.0,69469652,1,1
2,0,1.0,1.0,68746601,1,1
2,0,1.0,1.0,82247794,1,1
2,1,0.6666666666666666,0.8888888888888888,69983452,3,2
2,0,1.0,1.0,67831092,1,1
0,1,0.0,0.0,67706611,1,0
0,1,0.0,0.0,77563885,1,0
0,1,0.0,0.0,67100446,1,0
0,1,0.0,0.0,80169835,1,0
2,0,1.0,1.0,70459375,2,2
2,0,1.0,1.0,82038208,1,1
0,1,0.0,0.0,69193712,1,0
0,2,0.0,0.0,67897011,2,0
2,0,1.0,1.0,66236933,1,1
0,1,0.0,0.0,67376582,1,0
2,1,0.6666666666666666,0.6666666666666666,80165144,3,2
0,4,0.0,0.0,80123727,4,0
2,0,1.0,1.0,65307382,1,1
2,0,1.0,1.0,82102248,1,1
0,2,0.0,0.0,80172633,2,0
0,2,0.0,0.0,82006335,2,0
0,1,0.0,0.0,68440666,1,0
0,2,0.0,0.0,80163176,2,0
0,1,0.0,0.0,68784590,1,0
2,0,1.0,1.0,69151334,1,1
0,1,0.0,0.0,72765931,1,0
0,1,0.0,0.0,72768325,1,0
2,0,1.0,1.0,80165433,1,1
0,2,0.0,0.0,70801535,2,0
2,0,1.0,1.0,66998316,1,1
0,1,0.0,0.0,69726426,1,0
0,1,0.0,0.0,68805695,1,0
0,2,0.3333333333333333,0.3333333333333333,70673981,3,1
2,0,1.0,1.0,80165225,1,1
2,1,0.5,0.9285714285714286,70843073,2,1
0,1,0.0,0.0,82059484,1,0
2,1,0.5,0.0,82062189,2,1
2,0,1.0,1.0,80049900,1,1
2,1,0.5,0.7777777777777778,70801570,2,1
0,1,0.0,0.0,80156740,1,0
2,0,1.0,1.0,73632580,1,1
2,1,0.5,0.6666666666666666,82053820,2,1
2,0,1.0,1.0,80122886,1,1
0,3,0.0,0.0,70821394,3,0
2,0,1.0,1.0,80135302,3,3
2,1,0.6666666666666666,0.5,70843220,3,2
2,0,1.0,1.0,67291770,1,1
0,3,0.25,0.2857142857142857,68951883,4,1
0,1,0.0,0.0,82022885,1,0
2,0,1.0,1.0,65806615,1,1
2,2,0.5,0.75,69458606,4,2
2,0,1.0,1.0,70716772,1,1
0,2,0.0,0.0,81963734,2,0
0,1,0.0,0.0,70683991,1,0
0,1,0.0,0.0,68149263,1,0
0,1,0.0,0.0,64028251,1,0
0,3,0.0,0.0,77283752,3,0
2,0,1.0,1.0,80176410,1,1
0,2,0.0,0.0,67822811,2,0
0,1,0.0,0.0,80051475,1,0
0,1,0.0,0.0,80165838,1,0
2,1,0.5,0.8333333333333334,69188280,2,1
0,1,0.0,0.0,66396211,1,0
0,1,0.0,0.0,69961304,1,0
2,0,1.0,1.0,72523164,1,1
0,1,0.0,0.0,65544262,1,0
0,1,0.0,0.0,80092992,1,0
0,1,0.0,0.0,70705222,1,0
0,1,0.0,0.0,70706776,1,0
0,1,0.0,0.0,66163251,1,0
2,0,1.0,1.0,80162545,1,1
0,2,0.0,0.0,79453164,2,0
2,1,0.6666666666666666,0.5,66235736,3,2
2,0,1.0,1.0,75362924,1,1
2,0,1.0,1.0,70238630,1,1
2,0,1.0,1.0,80162151,2,2
2,0,1.0,1.0,82037602,1,1
2,0,1.0,1.0,18770766,1,1
0,1,0.0,0.0,63981855,1,0
0,1,0.0,0.0,69545700,1,0
2,0,1.0,1.0,82016267,1,1
0,1,0.0,0.0,65282301,1,0
0,1,0.0,0.0,69153875,1,0
2,1,0.5,0.5,68960262,2,1
0,1,0.0,0.0,69887391,1,0
2,0,1.0,1.0,65939986,1,1
2,0,1.0,1.0,70491001,1,1
0,2,0.3333333333333333,0.2857142857142857,70843255,3,1
2,0,1.0,1.0,69157746,1,1
2,0,1.0,1.0,66849825,1,1
2,0,1.0,1.0,66228064,1,1
0,2,0.0,0.0,70674583,2,0
0,1,0.0,0.0,70682801,1,0
0,1,0.0,0.0,70698271,1,0
1,4,0.2,0.5,82047580,5,1
2,1,0.6666666666666666,0.5,65655345,3,2
2,0,1.0,1.0,81875440,1,1
0,1,0.0,0.0,70677936,1,0
1,2,0.3333333333333333,0.6666666666666666,70692713,3,1
2,0,1.0,1.0,73783605,1,1
0,1,0.0,0.0,70698810,1,0
2,0,1.0,1.0,65940273,1,1
0,1,0.0,0.0,69167525,1,0
0,1,0.0,0.0,82200617,1,0
0,1,0.0,0.0,66237822,1,0
2,0,1.0,1.0,70575120,1,1
2,0,1.0,1.0,70229866,1,1
0,1,0.0,0.0,82006366,1,0
0,1,0.0,0.0,70923594,1,0
2,1,0.5,0.75,70635180,2,1
2,0,1.0,1.0,68748736,1,1
2,0,1.0,1.0,80051342,2,2
0,1,0.0,0.0,82040655,1,0
0,3,0.0,0.0,78507464,3,0
2,0,1.0,1.0,70669494,1,1
1,2,0.3333333333333333,0.8,70703780,3,1
2,1,0.5,0.6666666666666666,65289784,2,1
2,0,1.0,1.0,74484060,4,4
0,1,0.0,0.0,70684264,1,0
0,2,0.0,0.0,62878235,2,0
0,1,0.0,0.0,80141410,1,0
2,0,1.0,1.0,80151039,4,4
2,0,1.0,1.0,69975885,1,1
2,0,1.0,1.0,82145122,1,1
2,0,1.0,1.0,80090976,2,2
0,1,0.0,0.0,70037471,1,0
2,1,0.5,0.5,82019696,2,1
0,1,0.0,0.0,65678004,1,0
0,3,0.0,0.0,80178967,3,0
0,1,0.0,0.0,65713984,1,0
0,2,0.0,0.0,70683144,2,0
0,2,0.0,0.0,70696374,2,0
0,1,0.0,0.0,70743113,1,0
0,1,0.0,0.0,70743743,1,0
2,0,1.0,1.0,80176424,1,1
2,1,0.5,0.0,67973780,2,1
2,0,1.0,1.0,82016063,1,1
0,1,0.0,0.0,80126523,1,0
0,1,0.0,0.0,60081791,1,0
2,0,1.0,1.0,75277160,1,1
0,1,0.0,0.0,80118389,1,0
0,1,0.0,0.0,82040648,1,0
2,0,1.0,1.0,80119180,2,2
0,1,0.0,0.0,68141066,1,0
0,1,0.0,0.0,69310241,1,0
2,0,1.0,1.0,61440253,1,1
0,1,0.0,0.0,66957184,1,0
2,0,1.0,1.0,82145130,1,1
0,1,0.0,0.0,82018662,1,0
2,0,1.0,1.0,82037966,1,1
0,1,0.0,0.0,82102574,1,0
2,0,1.0,1.0,80090962,2,2
0,1,0.0,0.0,65579710,1,0
2,0,1.0,1.0,67894253,1,1
0,1,0.0,0.0,82023668,1,0
0,1,0.0,0.0,69835752,1,0
2,0,1.0,1.0,73161515,1,1
0,7,0.0,0.0,82102597,7,0
0,1,0.0,0.0,80128306,1,0
2,0,1.0,1.0,79838542,2,2
0,1,0.0,0.0,82019733,1,0
2,0,1.0,1.0,70961065,1,1
2,0,1.0,1.0,82019715,2,2
0,1,0.0,0.0,69185711,1,0
2,0,1.0,1.0,80094336,1,1
2,1,0.5,0.0,67335800,2,1
0,3,0.0,0.0,515452,3,0
2,0,1.0,1.0,68341910,1,1
2,0,1.0,1.0,82167962,1,1
2,0,1.0,1.0,68167386,1,1
2,0,1.0,1.0,70193172,1,1
2,0,1.0,1.0,82042177,1,1
2,0,1.0,1.0,70521423,1,1
0,1,0.0,0.0,70621320,1,0
2,0,1.0,1.0,70748013,2,2
0,1,0.0,0.0,69391910,1,0
0,2,0.0,0.0,69031396,2,0
0,1,0.0,0.0,82119871,1,0
0,1,0.0,0.0,82119872,1,0
0,2,0.0,0.0,80122914,2,0
0,2,0.0,0.0,67965401,2,0
0,1,0.0,0.0,66770795,1,0
0,1,0.0,0.0,82247752,1,0
0,1,0.0,0.0,82247780,1,0
0,1,0.0,0.0,80156477,1,0
0,2,0.0,0.0,82024370,2,0
0,1,0.0,0.0,81909052,1,0
2,0,1.0,1.0,67411015,1,1
2,0,1.0,1.0,73700886,1,1
0,1,0.0,0.0,82134851,1,0
2,0,1.0,1.0,66234224,1,1
2,0,1.0,1.0,68543090,1,1
0,1,0.0,0.0,82018940,1,0
0,1,0.0,0.0,68544686,1,0
0,1,0.0,0.0,68544882,1,0
0,4,0.0,0.0,82110028,4,0
0,1,0.0,0.0,70000770,1,0
0,1,0.0,0.0,69064163,1,0
0,2,0.0,0.0,69058241,2,0
0,1,0.0,0.0,80149943,1,0
0,3,0.0,0.0,74028633,3,0
0,1,0.0,0.0,69551804,1,0
2,0,1.0,1.0,82102156,1,1
0,1,0.0,0.0,80156762,1,0
2,0,1.0,1.0,70575204,1,1
2,0,1.0,1.0,69151180,2,2
0,1,0.0,0.0,279762,1,0
2,0,1.0,1.0,80165417,1,1
2,0,1.0,1.0,66742641,1,1
2,1,0.5,0.5,68357835,2,1
2,0,1.0,1.0,79783732,2,2
2,0,1.0,1.0,80118357,1,1
2,0,1.0,1.0,67867723,1,1
0,1,0.0,0.0,75962964,1,0
0,1,0.0,0.0,68405274,1,0
0,1,0.0,0.0,69526023,1,0
0,3,0.0,0.0,66787133,3,0
0,3,0.0,0.0,82172731,3,0
0,2,0.0,0.0,82205989,2,0
0,1,0.0,0.0,71878961,1,0
0,1,0.0,0.0,66531080,1,0
0,1,0.0,0.0,72909942,1,0
0,1,0.0,0.0,82102673,1,0
0,3,0.0,0.0,72670122,3,0
0,1,0.0,0.0,70685293,1,0
2,1,0.5,0.875,69582751,2,1
0,1,0.0,0.0,70493794,1,0
2,0,1.0,1.0,80118870,1,1
0,1,0.0,0.0,72803206,1,0
2,1,0.5,0.8,80178155,2,1
2,0,1.0,1.0,82015873,1,1
0,1,0.0,0.0,69730136,1,0
0,1,0.0,0.0,70703682,1,0
0,1,0.0,0.0,70697522,1,0
0,1,0.0,0.0,77577745,1,0
0,1,0.0,0.0,73161606,1,0
0,1,0.0,0.0,68544665,1,0
0,1,0.0,0.0,68544672,1,0
0,2,0.0,0.0,68544763,2,0
0,1,0.0,0.0,70868266,1,0
2,0,1.0,1.0,69597626,1,1
0,2,0.0,0.0,80162915,2,0
0,1,0.0,0.0,82096368,1,0
0,1,0.0,0.0,82070162,1,0
1,3,0.25,0.6666666666666666,82150107,4,1
0,1,0.0,0.0,67404526,1,0
2,1,0.5,0.5,80150235,2,1
0,1,0.0,0.0,68191641,1,0
0,2,0.0,0.0,82010298,2,0
0,1,0.0,0.0,70250992,1,0
2,0,1.0,1.0,67779614,1,1
2,0,1.0,1.0,80003714,1,1
0,1,0.0,0.0,80161949,1,0
0,1,0.0,0.0,70842821,1,0
2,0,1.0,1.0,80158271,2,2
2,0,1.0,1.0,80165262,1,1
2,0,1.0,1.0,70968513,1,1
2,0,1.0,1.0,82095222,1,1
2,0,1.0,1.0,82041277,1,1
0,1,0.0,0.0,69693344,1,0
0,1,0.0,0.0,70610841,1,0
2,1,0.5,0.6666666666666666,64457904,2,1
0,1,0.0,0.0,72470160,1,0
1,3,0.25,0.75,69701023,4,1
2,0,1.0,1.0,18476525,2,2
0,1,0.0,0.0,69640403,1,0
2,0,1.0,1.0,82016078,1,1
2,0,1.0,1.0,80150545,1,1
0,1,0.0,0.0,80159201,1,0
2,0,1.0,1.0,80128577,3,3
0,1,0.0,0.0,82182768,1,0
0,1,0.0,0.0,82022411,1,0
2,0,1.0,1.0,82018616,2,2
2,0,1.0,1.0,70493710,2,2
0,1,0.0,0.0,65981860,1,0
0,1,0.0,0.0,69500494,1,0
0,1,0.0,0.0,70190435,1,0
2,0,1.0,1.0,80165206,1,1
0,1,0.0,0.0,80093923,1,0
0,1,0.0,0.0,70489510,1,0
0,1,0.0,0.0,80121284,1,0
0,1,0.0,0.0,70483455,1,0
0,1,0.0,0.0,67916940,1,0
0,1,0.0,0.0,67916954,1,0
0,1,0.0,0.0,69910813,1,0
0,2,0.0,0.0,66407936,2,0
0,1,0.0,0.0,80093601,1,0
0,2,0.0,0.0,70672140,2,0
0,2,0.0,0.0,70672315,2,0
0,1,0.0,0.0,68017880,1,0
2,0,1.0,1.0,70492240,1,1
0,1,0.0,0.0,80125213,1,0
2,1,0.5,0.75,82002291,2,1
0,1,0.0,0.0,70013671,1,0
2,0,1.0,1.0,67744530,1,1
2,1,0.5,0.8,64343482,2,1
0,1,0.0,0.0,64345050,1,0
2,1,0.5,0.8,82016283,2,1
0,1,0.0,0.0,69069672,1,0
0,1,0.0,0.0,66224942,1,0
2,1,0.5,0.7142857142857143,75148052,2,1
2,0,1.0,1.0,82137381,1,1
2,0,1.0,1.0,80178217,1,1
0,1,0.0,0.0,80018211,1,0
2,1,0.5,0.3333333333333333,72366035,2,1
2,0,1.0,1.0,66235785,1,1
2,0,1.0,1.0,80118525,2,2
2,0,1.0,1.0,70189133,2,2
2,0,1.0,1.0,70121793,1,1
0,1,0.0,0.0,82038245,1,0
0,1,0.0,0.0,82039183,1,0
0,1,0.0,0.0,66031210,1,0
0,2,0.0,0.0,66786566,2,0
0,1,0.0,0.0,82006191,1,0
0,1,0.0,0.0,70759024,1,0
2,0,1.0,1.0,82038838,1,1
2,0,1.0,1.0,80093223,2,2
0,1,0.0,0.0,70524433,1,0
0,1,0.0,0.0,66228561,1,0
2,0,1.0,1.0,80105200,1,1
2,0,1.0,1.0,80178186,2,2
0,1,0.0,0.0,65635024,1,0
2,0,1.0,1.0,69539771,1,1
0,1,0.0,0.0,70679931,1,0
2,0,1.0,1.0,69478941,1,1
2,0,1.0,1.0,82132588,2,2
0,1,0.0,0.0,69216000,1,0
2,0,1.0,1.0,65186065,1,1
0,1,0.0,0.0,70679546,1,0
0,1,0.0,0.0,70743512,1,0
0,1,0.0,0.0,70743722,1,0
2,0,1.0,1.0,75124294,1,1
0,1,0.0,0.0,71878660,1,0
0,1,0.0,0.0,82018636,1,0
2,1,0.5,0.0,82185031,2,1
2,0,1.0,1.0,82016265,1,1
2,1,0.5,0.6666666666666666,80133907,2,1
0,1,0.0,0.0,80133927,1,0
0,1,0.0,0.0,80133935,1,0
0,1,0.0,0.0,67298210,1,0
0,1,0.0,0.0,70685160,1,0
0,2,0.0,0.0,70691964,2,0
0,1,0.0,0.0,70700231,1,0
2,0,1.0,1.0,82182812,1,1
2,1,0.5,0.6666666666666666,65290785,2,1
2,1,0.5,0.5,82064863,2,1
0,1,0.0,0.0,70712355,1,0
0,1,0.0,0.0,69960891,1,0
0,1,0.0,0.0,69886334,1,0
0,1,0.0,0.0,82006729,1,0
0,1,0.0,0.0,82006734,1,0
0,2,0.0,0.0,80131213,2,0
2,0,1.0,1.0,70629573,2,2
0,1,0.0,0.0,82205959,1,0
2,1,0.6666666666666666,0.6666666666666666,77778022,3,2
2,0,1.0,1.0,70605332,1,1
2,0,1.0,1.0,80172954,1,1
2,0,1.0,1.0,80130737,1,1
2,0,1.0,1.0,80163446,1,1
2,1,0.5,0.875,69726405,2,1
2,0,1.0,1.0,80128422,1,1
0,1,0.0,0.0,82012809,1,0
2,0,1.0,1.0,69604143,2,2
2,0,1.0,1.0,68586805,1,1
0,1,0.0,0.0,76528711,1,0
0,1,0.0,0.0,74360762,1,0
2,1,0.5,0.5,82067329,2,1
0,1,0.0,0.0,68499004,1,0
0,1,0.0,0.0,68500271,1,0
0,1,0.0,0.0,69479193,1,0
0,1,0.0,0.0,69499542,1,0
2,0,1.0,1.0,70767382,1,1
0,1,0.0,0.0,69634201,1,0
0,1,0.0,0.0,70683823,1,0
0,1,0.0,0.0,71879136,1,0
0,1,0.0,0.0,71879395,1,0
2,0,1.0,1.0,69899795,2,2
2,0,1.0,1.0,80152787,1,1
0,1,0.0,0.0,66997791,1,0
2,1,0.5,0.6666666666666666,70223804,2,1
0,3,0.0,0.0,82152202,3,0
0,1,0.0,0.0,70703906,1,0
0,1,0.0,0.0,66567011,1,0
0,1,0.0,0.0,68255572,1,0
0,1,0.0,0.0,68255593,1,0
0,1,0.0,0.0,68255614,1,0
0,1,0.0,0.0,68256342,1,0
0,1,0.0,0.0,68256440,1,0
2,0,1.0,1.0,80095295,1,1
2,0,1.0,1.0,70215992,1,1
0,1,0.0,0.0,82016058,1,0
2,0,1.0,1.0,69500634,1,1
0,1,0.0,0.0,80070060,1,0
2,0,1.0,1.0,68770471,1,1
2,1,0.5,0.75,66234476,2,1
0,1,0.0,0.0,82156587,1,0
2,0,1.0,1.0,80169887,1,1
0,1,0.0,0.0,80167287,1,0
2,0,1.0,1.0,69585712,1,1
2,1,0.5,0.5,70575701,2,1
2,0,1.0,1.0,82132591,2,2
2,0,1.0,1.0,67823056,3,3
2,0,1.0,1.0,72659755,1,1
2,0,1.0,1.0,70744723,1,1
2,0,1.0,1.0,69858565,1,1
0,1,0.0,0.0,70543081,1,0
0,1,0.0,0.0,70508704,1,0
2,0,1.0,1.0,80117719,3,3
2,0,1.0,1.0,82102258,1,1
0,1,0.0,0.0,70684761,1,0
0,1,0.0,0.0,69421996,1,0
2,0,1.0,1.0,82102158,3,3
0,1,0.0,0.0,75000352,1,0
0,1,0.0,0.0,66785551,1,0
2,0,1.0,1.0,82154362,1,1
2,0,1.0,1.0,80054716,1,1
0,1,0.0,0.0,82163440,1,0
0,1,0.0,0.0,80122858,1,0
2,1,0.75,0.875,82018743,4,3
0,1,0.0,0.0,70967652,1,0
0,2,0.0,0.0,71112356,2,0
2,1,0.5,0.0,70620725,2,1
2,0,1.0,1.0,80118274,1,1
2,0,1.0,1.0,80159257,2,2
0,1,0.0,0.0,72539936,1,0
2,1,0.5,0.5,82022892,2,1
2,0,1.0,1.0,70314433,1,1
0,1,0.0,0.0,66229142,1,0
0,1,0.0,0.0,80069773,1,0
2,0,1.0,1.0,65005500,1,1
2,1,0.5,0.3333333333333333,79464532,2,1
2,1,0.5,0.6666666666666666,70700021,2,1
0,1,0.0,0.0,69664581,1,0
2,0,1.0,1.0,63706475,3,3
0,1,0.0,0.0,73366090,1,0
2,0,1.0,1.0,74335954,1,1
0,2,0.0,0.0,67052923,2,0
0,1,0.0,0.0,80153684,1,0
0,1,0.0,0.0,80153686,1,0
2,0,1.0,1.0,66886512,1,1
0,1,0.0,0.0,70702471,1,0
0,2,0.0,0.0,60808643,2,0
0,1,0.0,0.0,80159192,1,0
2,1,0.5,0.8,80153584,2,1
0,1,0.0,0.0,82046319,1,0
0,3,0.0,0.0,80153658,3,0
0,1,0.0,0.0,69564292,1,0
0,1,0.0,0.0,70683655,1,0
0,1,0.0,0.0,62711621,1,0
0,1,0.0,0.0,11942837,1,0
2,0,1.0,1.0,80084081,1,1
2,1,0.5,0.6666666666666666,66911852,2,1
2,0,1.0,1.0,80118478,1,1
2,0,1.0,1.0,82095269,1,1
0,1,0.0,0.0,74362113,1,0
2,0,1.0,1.0,70761852,1,1
0,2,0.0,0.0,70686203,2,0
2,0,1.0,1.0,70057715,1,1
0,1,0.0,0.0,73255595,1,0
2,1,0.5,0.5,68340034,2,1
2,0,1.0,1.0,80159273,2,2
2,1,0.5,0.5,70697270,2,1
0,1,0.0,0.0,67265114,1,0
0,1,0.0,0.0,67265135,1,0
0,1,0.0,0.0,80123462,1,0
0,1,0.0,0.0,68538274,1,0
2,0,1.0,1.0,82020781,1,1
0,1,0.0,0.0,70706153,1,0
2,0,1.0,1.0,69055693,2,2
2,0,1.0,1.0,69550124,1,1
2,0,1.0,1.0,72804102,1,1
2,0,1.0,1.0,70412825,1,1
0,2,0.0,0.0,66413683,2,0
0,1,0.0,0.0,82110386,1,0
0,1,0.0,0.0,68496652,1,0
0,1,0.0,0.0,80181014,1,0
0,1,0.0,0.0,70703395,1,0
0,1,0.0,0.0,68747413,1,0
0,1,0.0,0.0,68747441,1,0
0,2,0.0,0.0,67668762,2,0
0,1,0.0,0.0,80162902,1,0
0,1,0.0,0.0,82006352,1,0
0,1,0.0,0.0,82006382,1,0
0,2,0.0,0.0,82006685,2,0
2,0,1.0,1.0,82006354,1,1
0,1,0.0,0.0,80165784,1,0
0,2,0.3333333333333333,0.3333333333333333,67982152,3,1
0,1,0.0,0.0,67311573,1,0
0,2,0.0,0.0,67311601,2,0
2,1,0.5,0.6666666666666666,80156163,2,1
0,2,0.0,0.0,80176179,2,0
0,1,0.0,0.0,80117578,1,0
2,0,1.0,1.0,82052101,1,1
2,0,1.0,1.0,82061910,2,2
0,2,0.0,0.0,70691551,2,0
0,1,0.0,0.0,67830203,1,0
2,0,1.0,1.0,80141391,1,1
0,1,0.0,0.0,70282744,1,0
2,0,1.0,1.0,82038889,1,1
2,0,1.0,1.0,82038292,2,2
2,0,1.0,1.0,70851473,3,3
0,1,0.0,0.0,82042133,1,0
2,0,1.0,1.0,75362875,1,1
2,0,1.0,1.0,72392880,1,1
2,0,1.0,1.0,82093758,1,1
2,0,1.0,1.0,80117583,1,1
0,1,0.0,0.0,68038901,1,0
2,0,1.0,1.0,70865501,2,2
0,1,0.0,0.0,66031266,1,0
0,1,0.0,0.0,80126817,1,0
2,0,1.0,1.0,75264245,1,1
2,0,1.0,1.0,80133889,1,1
0,1,0.0,0.0,70250635,1,0
0,1,0.0,0.0,64141700,1,0
2,0,1.0,1.0,82018623,1,1
0,1,0.0,0.0,82019769,1,0
0,1,0.0,0.0,70562191,1,0
0,1,0.0,0.0,82019718,1,0
0,1,0.0,0.0,70621523,1,0
2,1,0.5,0.6666666666666666,82024222,2,1
2,0,1.0,1.0,70758884,1,1
0,1,0.0,0.0,80134731,1,0
0,1,0.0,0.0,69724214,1,0
2,0,1.0,1.0,66228743,1,1
0,1,0.0,0.0,67311580,1,0
0,1,0.0,0.0,67311615,1,0
0,1,0.0,0.0,80172623,1,0
0,2,0.0,0.0,63091630,2,0
2,0,1.0,1.0,82118283,1,1
0,1,0.0,0.0,69191682,1,0
2,0,1.0,1.0,75636204,3,3
0,1,0.0,0.0,69735596,1,0
0,1,0.0,0.0,70190246,1,0
0,1,0.0,0.0,68805723,1,0
0,5,0.0,0.0,82050077,5,0
1,3,0.4,0.7692307692307693,71439473,5,2
0,1,0.0,0.0,69633193,1,0
2,1,0.5,0.8,80177692,2,1
2,0,1.0,1.0,82016055,1,1
0,1,0.0,0.0,69317010,1,0
0,1,0.0,0.0,68237631,1,0
2,0,1.0,1.0,66235470,1,1
0,1,0.0,0.0,70759115,1,0
0,1,0.0,0.0,70820260,1,0
0,1,0.0,0.0,82110447,1,0
2,0,1.0,1.0,80165219,1,1
2,0,1.0,1.0,70121772,1,1
0,2,0.0,0.0,82051770,2,0
2,0,1.0,1.0,82046123,1,1
2,0,1.0,1.0,68656252,2,2
0,1,0.0,0.0,82046934,1,0
0,1,0.0,0.0,70037310,1,0
0,1,0.0,0.0,70862246,1,0
2,0,1.0,1.0,69041035,1,1
0,1,0.0,0.0,69596975,1,0
2,0,1.0,1.0,66319015,1,1
2,1,0.5,0.8461538461538461,82054060,2,1
0,1,0.0,0.0,70674702,1,0
0,1,0.0,0.0,70036253,1,0
2,0,1.0,1.0,82247809,1,1
0,1,0.0,0.0,70906941,1,0
0,1,0.0,0.0,69551034,1,0
0,1,0.0,0.0,70678566,1,0
0,1,0.0,0.0,71215025,1,0
0,2,0.0,0.0,69311571,2,0
0,1,0.0,0.0,69313132,1,0
0,1,0.0,0.0,74087860,1,0
0,2,0.0,0.0,69509615,2,0
1,2,0.3333333333333333,0.6666666666666666,69056302,3,1
0,1,0.0,0.0,69933822,1,0
0,2,0.0,0.0,70681856,2,0
0,1,0.0,0.0,66800622,1,0
0,1,0.0,0.0,70459536,1,0
0,1,0.0,0.0,70459592,1,0
2,0,1.0,1.0,82135134,1,1
1,2,0.3333333333333333,0.7,82022891,3,1
0,3,0.0,0.0,69520234,3,0
0,1,0.0,0.0,82006253,1,0
0,1,0.0,0.0,80165761,1,0
0,1,0.0,0.0,67917395,1,0
2,0,1.0,1.0,82019692,1,1
0,1,0.0,0.0,72474731,1,0
2,0,1.0,1.0,70563612,1,1
0,3,0.0,0.0,69479501,3,0
2,0,1.0,1.0,68007975,1,1
0,1,0.0,0.0,69870171,1,0
0,1,0.0,0.0,70683501,1,0
2,0,1.0,1.0,72718016,1,1
0,1,0.0,0.0,66257296,1,0
2,0,1.0,1.0,69868470,2,2
0,1,0.0,0.0,67667446,1,0
0,1,0.0,0.0,67667453,1,0
0,2,0.0,0.0,80159209,2,0
2,1,0.5,0.5,72804046,2,1
2,0,1.0,1.0,80128571,1,1
2,0,1.0,1.0,69207040,1,1
2,0,1.0,1.0,63737870,1,1
0,1,0.0,0.0,70758821,1,0
2,0,1.0,1.0,80136588,1,1
2,1,0.5,0.5,82018690,2,1
2,0,1.0,1.0,82054036,1,1
2,0,1.0,1.0,67256196,2,2
2,0,1.0,1.0,80118509,1,1
2,0,1.0,1.0,82125469,2,2
2,0,1.0,1.0,82095670,1,1
2,0,1.0,1.0,68747616,1,1
0,1,0.0,0.0,70679560,1,0
0,1,0.0,0.0,64347416,1,0
2,0,1.0,1.0,79785811,1,1
0,2,0.0,0.0,66495961,2,0
2,0,1.0,1.0,82202311,1,1
0,1,0.0,0.0,67215596,1,0
2,0,1.0,1.0,69699070,1,1
0,1,0.0,0.0,61365661,1,0
0,1,0.0,0.0,61365675,1,0
0,1,0.0,0.0,69125161,1,0
0,1,0.0,0.0,68710082,1,0
2,0,1.0,1.0,82037357,1,1
0,1,0.0,0.0,80105396,1,0
0,1,0.0,0.0,70597163,1,0
2,0,1.0,1.0,70190120,1,1
0,2,0.0,0.0,61986162,2,0
0,1,0.0,0.0,79990281,1,0
0,2,0.0,0.0,70674814,2,0
2,0,1.0,1.0,70626171,1,1
2,0,1.0,1.0,79994306,2,2
0,1,0.0,0.0,70701295,1,0
0,1,0.0,0.0,67866442,1,0
0,1,0.0,0.0,69634033,1,0
1,2,0.3333333333333333,0.6363636363636364,69924855,3,1
0,1,0.0,0.0,70527492,1,0
0,1,0.0,0.0,68680535,1,0
0,2,0.0,0.0,69458543,2,0
2,0,1.0,1.0,82059901,1,1
2,0,1.0,1.0,82020761,1,1
2,0,1.0,1.0,80134646,1,1
2,0,1.0,1.0,70687904,1,1
0,2,0.0,0.0,70494151,2,0
0,2,0.0,0.0,82096499,2,0
0,1,0.0,0.0,80128417,1,0
2,0,1.0,1.0,77113995,1,1
0,1,0.0,0.0,82006318,1,0
0,1,0.0,0.0,64512140,1,0
2,0,1.0,1.0,73634722,1,1
0,1,0.0,0.0,80162912,1,0
0,1,0.0,0.0,65714936,1,0
0,1,0.0,0.0,65715006,1,0
0,1,0.0,0.0,82006554,1,0
2,0,1.0,1.0,61751522,1,1
2,0,1.0,1.0,67822965,1,1
0,1,0.0,0.0,82172139,1,0
2,0,1.0,1.0,67276853,1,1
0,1,0.0,0.0,69693365,1,0
0,1,0.0,0.0,69693456,1,0
0,1,0.0,0.0,66784312,1,0
0,2,0.0,0.0,66784186,2,0
0,1,0.0,0.0,64356761,1,0
0,1,0.0,0.0,65007313,1,0
0,1,0.0,0.0,69458480,1,0
2,0,1.0,1.0,67786096,1,1
2,0,1.0,1.0,70704690,1,1
0,1,0.0,0.0,65905364,1,0
2,1,0.5,0.875,70695114,2,1
2,1,0.5,0.75,70693070,2,1
0,2,0.0,0.0,65812292,2,0
2,0,1.0,1.0,67404456,2,2
0,1,0.0,0.0,67751523,1,0
0,1,0.0,0.0,66973081,1,0
2,0,1.0,1.0,69972413,1,1
0,1,0.0,0.0,78763720,1,0
2,0,1.0,1.0,69635090,1,1
0,1,0.0,0.0,69110503,1,0
0,1,0.0,0.0,69633172,1,0
2,0,1.0,1.0,70120176,2,2
2,0,1.0,1.0,74660362,1,1
0,2,0.0,0.0,80126832,2,0
0,1,0.0,0.0,70598745,1,0
2,0,1.0,1.0,74027870,1,1
2,0,1.0,1.0,75636190,2,2
2,0,1.0,1.0,82135140,1,1
2,0,1.0,1.0,70676165,1,1
2,0,1.0,1.0,80165408,1,1
1,2,0.3333333333333333,0.6666666666666666,69998166,3,1
0,1,0.0,0.0,75149543,1,0
0,1,0.0,0.0,69701352,1,0
0,1,0.0,0.0,70677761,1,0
2,0,1.0,1.0,82016174,1,1
2,0,1.0,1.0,82054042,1,1
0,1,0.0,0.0,66239026,1,0
0,1,0.0,0.0,66250730,1,0
0,1,0.0,0.0,69031361,1,0
0,1,0.0,0.0,82090265,1,0
2,1,0.5,0.5,77681835,2,1
0,1,0.0,0.0,70843493,1,0
0,1,0.0,0.0,19989382,1,0
0,1,0.0,0.0,82164474,1,0
0,1,0.0,0.0,68497884,1,0
2,0,1.0,1.0,68289025,1,1
0,1,0.0,0.0,66237983,1,0
0,1,0.0,0.0,74027891,1,0
0,1,0.0,0.0,68457473,1,0
0,1,0.0,0.0,68477395,1,0
0,1,0.0,0.0,68635735,1,0
2,0,1.0,1.0,66425023,1,1
0,1,0.0,0.0,70212401,1,0
0,1,0.0,0.0,70279356,1,0
0,2,0.0,0.0,70597212,2,0
2,0,1.0,1.0,82024322,1,1
2,0,1.0,1.0,69840043,1,1
2,0,1.0,1.0,82037212,2,2
0,1,0.0,0.0,80132870,1,0
2,0,1.0,1.0,82037279,1,1
2,0,1.0,1.0,70545671,1,1
2,1,0.5,0.9230769230769231,70493703,2,1
1,2,0.3333333333333333,0.6153846153846154,70675780,3,1
2,0,1.0,1.0,82095268,1,1
2,0,1.0,1.0,73551436,1,1
0,1,0.0,0.0,69975843,1,0
2,0,1.0,1.0,82140132,1,1
0,1,0.0,0.0,82009414,1,0
2,0,1.0,1.0,82042175,2,2
2,0,1.0,1.0,82038278,1,1
2,0,1.0,1.0,80159706,2,2
0,1,0.0,0.0,70758982,1,0
0,1,0.0,0.0,70759325,1,0
0,1,0.0,0.0,70635222,1,0
0,1,0.0,0.0,61263272,1,0
2,0,1.0,1.0,82009396,1,1
2,0,1.0,1.0,82138583,1,1
2,0,1.0,1.0,68221342,1,1
2,0,1.0,1.0,70798924,1,1
0,2,0.0,0.0,69596660,2,0
0,1,0.0,0.0,69055301,1,0
0,1,0.0,0.0,82119901,1,0
0,1,0.0,0.0,82119903,1,0
0,1,0.0,0.0,70706286,1,0
0,2,0.0,0.0,66892903,2,0
2,0,1.0,1.0,82250617,1,1
0,4,0.0,0.0,78591520,4,0
0,1,0.0,0.0,68047595,1,0
0,1,0.0,0.0,76358534,1,0
0,1,0.0,0.0,70516201,1,0
0,1,0.0,0.0,69596863,1,0
2,0,1.0,1.0,80004274,1,1
2,0,1.0,1.0,77319543,1,1
1,2,0.3333333333333333,0.5714285714285714,36636523,3,1
2,0,1.0,1.0,69464563,1,1
2,0,1.0,1.0,70408114,1,1
0,1,0.0,0.0,64363243,1,0
0,1,0.0,0.0,69050233,1,0
2,1,0.5,0.75,69071471,2,1
2,1,0.5,0.0,82060537,2,1
2,0,1.0,1.0,82024292,1,1
0,1,0.0,0.0,82114246,1,0
2,0,1.0,1.0,72410961,1,1
0,1,0.0,0.0,80176808,1,0
2,0,1.0,1.0,67743802,2,2
2,0,1.0,1.0,68186664,1,1
0,1,0.0,0.0,67889346,1,0
0,1,0.0,0.0,68649301,1,0
2,0,1.0,1.0,82102485,1,1
2,1,0.5,0.75,71619660,2,1
2,0,1.0,1.0,82135132,2,2
2,0,1.0,1.0,69913053,1,1
0,1,0.0,0.0,69172705,1,0
0,1,0.0,0.0,82023106,1,0
0,1,0.0,0.0,82023111,1,0
0,1,0.0,0.0,73295775,1,0
2,1,0.6666666666666666,0.5,80091984,3,2
0,1,0.0,0.0,80135808,1,0
2,1,0.5,0.75,69424264,2,1
0,1,0.0,0.0,80132360,1,0
0,2,0.0,0.0,70488922,2,0
2,1,0.5,0.8181818181818182,70707665,2,1
0,1,0.0,0.0,82018995,1,0
2,0,1.0,1.0,80177747,2,2
2,0,1.0,1.0,69038193,1,1
2,0,1.0,1.0,70585935,1,1
0,1,0.0,0.0,67910423,1,0
0,1,0.0,0.0,68748652,1,0
2,0,1.0,1.0,82102184,1,1
2,0,1.0,1.0,80094966,2,2
2,0,1.0,1.0,82064810,1,1
0,1,0.0,0.0,70489062,1,0
0,2,0.0,0.0,72809114,2,0
0,1,0.0,0.0,82018620,1,0
0,1,0.0,0.0,66639594,1,0
2,1,0.5,0.0,80092880,2,1
0,1,0.0,0.0,69006756,1,0
0,1,0.0,0.0,82154384,1,0
2,0,1.0,1.0,72814581,1,1
0,2,0.0,0.0,70680050,2,0
0,1,0.0,0.0,19487951,1,0
2,1,0.6666666666666666,0.5,71458590,3,2
2,0,1.0,1.0,66256785,2,2
0,1,0.0,0.0,67730103,1,0
0,1,0.0,0.0,80124635,1,0
2,0,1.0,1.0,80092271,1,1
2,0,1.0,1.0,82018817,1,1
2,1,0.5,0.7,69469533,2,1
0,2,0.0,0.0,63290395,2,0
0,1,0.0,0.0,68521705,1,0
0,1,0.0,0.0,69484730,1,0
2,0,1.0,1.0,67519844,1,1
0,1,0.0,0.0,68657603,1,0
0,1,0.0,0.0,68663756,1,0
0,1,0.0,0.0,70683333,1,0
0,1,0.0,0.0,82105370,1,0
2,1,0.5,0.8571428571428571,70240940,2,1
0,1,0.0,0.0,70821331,1,0
0,1,0.0,0.0,63277844,1,0
0,1,0.0,0.0,70572950,1,0
0,1,0.0,0.0,80150373,1,0
0,1,0.0,0.0,69069742,1,0
0,1,0.0,0.0,70693014,1,0
2,0,1.0,1.0,72718282,1,1
2,0,1.0,1.0,80159086,1,1
2,1,0.5,0.8571428571428571,69597073,2,1
2,0,1.0,1.0,72953692,1,1
2,0,1.0,1.0,80176862,1,1
0,1,0.0,0.0,82020105,1,0
2,0,1.0,1.0,82024262,1,1
2,0,1.0,1.0,74965415,1,1
2,0,1.0,1.0,80175973,1,1
2,0,1.0,1.0,67258905,2,2
2,0,1.0,1.0,69221411,2,2
2,0,1.0,1.0,68366431,1,1
2,0,1.0,1.0,70869386,2,2
2,0,1.0,1.0,70693084,1,1
0,1,0.0,0.0,69482896,1,0
0,1,0.0,0.0,64456273,1,0
0,1,0.0,0.0,69159923,1,0
2,0,1.0,1.0,80093111,1,1
0,1,0.0,0.0,70696766,1,0
2,1,0.5,0.5,70484386,2,1
2,1,0.5,0.6666666666666666,67553633,2,1
0,1,0.0,0.0,80153969,1,0
2,0,1.0,1.0,67786453,1,1
2,1,0.5,0.5,68236861,2,1
0,1,0.0,0.0,70063224,1,0
2,0,1.0,1.0,68248852,1,1
2,0,1.0,1.0,69594833,1,1
2,0,1.0,1.0,82039346,1,1
2,0,1.0,1.0,82182767,1,1
0,2,0.0,0.0,68017712,2,0
0,1,0.0,0.0,82002236,1,0
2,0,1.0,1.0,70203945,1,1
2,1,0.5,0.0,82039340,2,1
2,1,0.5,0.75,72814714,2,1
2,0,1.0,1.0,69603240,1,1
2,0,1.0,1.0,81909075,1,1
0,1,0.0,0.0,69626410,1,0
2,0,1.0,1.0,82037277,1,1
0,1,0.0,0.0,70684600,1,0
0,2,0.0,0.0,80126824,2,0
2,0,1.0,1.0,82019763,1,1
2,1,0.5,0.6666666666666666,82182749,2,1
2,0,1.0,1.0,68239563,2,2
0,1,0.0,0.0,66016195,1,0
0,1,0.0,0.0,69158271,1,0
0,1,0.0,0.0,69158362,1,0
0,1,0.0,0.0,69634481,1,0
2,0,1.0,1.0,82020031,1,1
0,2,0.0,0.0,70680295,2,0
2,0,1.0,1.0,69177885,1,1
2,0,1.0,1.0,80175996,2,2
0,1,0.0,0.0,70184744,1,0
0,1,0.0,0.0,67830175,1,0
2,0,1.0,1.0,70175525,1,1
2,0,1.0,1.0,67099004,1,1
2,0,1.0,1.0,82018067,1,1
2,1,0.5,0.5,82041268,2,1
0,1,0.0,0.0,70493941,1,0
0,1,0.0,0.0,80150822,1,0
0,1,0.0,0.0,67899496,1,0
2,1,0.5,0.6,80176657,2,1
0,2,0.0,0.0,70704956,2,0
0,1,0.0,0.0,70697214,1,0
0,1,0.0,0.0,69997893,1,0
0,1,0.0,0.0,67525990,1,0
0,1,0.0,0.0,80150299,1,0
2,0,1.0,1.0,67838813,2,2
2,0,1.0,1.0,64125033,1,1
0,1,0.0,0.0,70681324,1,0
0,1,0.0,0.0,70684313,1,0
2,0,1.0,1.0,82179479,1,1
0,1,0.0,0.0,65404423,1,0
0,1,0.0,0.0,70707644,1,0
2,1,0.5,0.5,69603065,2,1
0,1,0.0,0.0,70238091,1,0
2,0,1.0,1.0,76805596,1,1
2,0,1.0,1.0,69669761,1,1
0,1,0.0,0.0,82019436,1,0
0,1,0.0,0.0,80145448,1,0
2,0,1.0,1.0,72930914,1,1
1,2,0.3333333333333333,0.8,75855612,3,1
0,2,0.0,0.0,80176288,2,0
0,1,0.0,0.0,70709163,1,0
0,1,0.0,0.0,67305511,1,0
0,1,0.0,0.0,62326656,1,0
0,1,0.0,0.0,73535364,1,0
0,1,0.0,0.0,69831895,1,0
0,2,0.0,0.0,61264231,2,0
2,0,1.0,1.0,80165401,1,1
0,1,0.0,0.0,70706811,1,0
2,1,0.5,0.5,80126881,2,1
2,0,1.0,1.0,72187535,1,1
2,0,1.0,1.0,82020762,1,1
2,0,1.0,1.0,80159713,1,1
0,2,0.0,0.0,72365993,2,0
2,1,0.5,0.6666666666666666,80165486,2,1
2,0,1.0,1.0,70968520,1,1
0,1,0.0,0.0,68499235,1,0
0,1,0.0,0.0,69634145,1,0
1,2,0.3333333333333333,0.6666666666666666,80133887,3,1
2,1,0.5,0.75,64053815,2,1
2,0,1.0,1.0,68748743,2,2
0,1,0.0,0.0,70704522,1,0
0,1,0.0,0.0,76686533,1,0
2,0,1.0,1.0,66834845,1,1
0,1,0.0,0.0,82046931,1,0
2,0,1.0,1.0,80165350,1,1
0,1,0.0,0.0,82250580,1,0
0,1,0.0,0.0,82022526,1,0
0,2,0.0,0.0,70926345,2,0
0,1,0.0,0.0,70908110,1,0
0,1,0.0,0.0,70701701,1,0
0,2,0.0,0.0,70705474,2,0
2,1,0.5,0.8,80150288,2,1
0,1,0.0,0.0,70675836,1,0
2,1,0.5,0.8333333333333334,70348796,2,1
2,1,0.5,0.6666666666666666,79462544,2,1
0,1,0.0,0.0,82019946,1,0
0,1,0.0,0.0,70760396,1,0
2,0,1.0,1.0,69483554,1,1
2,0,1.0,1.0,65112236,1,1
0,1,0.0,0.0,68327000,1,0
0,2,0.0,0.0,70213556,2,0
0,1,0.0,0.0,66166954,1,0
0,1,0.0,0.0,82070246,1,0
0,1,0.0,0.0,68391554,1,0
0,1,0.0,0.0,80104941,1,0
0,1,0.0,0.0,70279384,1,0
0,1,0.0,0.0,72474675,1,0
2,0,1.0,1.0,60909604,1,1
2,0,1.0,1.0,70420105,1,1
0,1,0.0,0.0,70704004,1,0
0,1,0.0,0.0,66779195,1,0
0,1,0.0,0.0,72866675,1,0
2,0,1.0,1.0,82042130,1,1
2,0,1.0,1.0,62581183,2,2
2,0,1.0,1.0,69479326,1,1
2,0,1.0,1.0,82051756,1,1
2,0,1.0,1.0,82138709,1,1
2,0,1.0,1.0,80161990,1,1
2,0,1.0,1.0,80168527,1,1
0,1,0.0,0.0,70562170,1,0
2,0,1.0,1.0,74511941,1,1
0,2,0.0,0.0,70230391,2,0
0,2,0.0,0.0,70704774,2,0
0,2,0.0,0.0,67516603,2,0
0,1,0.0,0.0,82206137,1,0
2,0,1.0,1.0,68773306,1,1
0,1,0.0,0.0,70591766,1,0
0,1,0.0,0.0,69484156,1,0
2,0,1.0,1.0,68628161,1,1
0,1,0.0,0.0,58873255,1,0
2,0,1.0,1.0,82149089,1,1
1,2,0.3333333333333333,0.8333333333333334,73399662,3,1
0,1,0.0,0.0,68235335,1,0
2,0,1.0,1.0,68236301,2,2
2,0,1.0,1.0,66237416,1,1
0,1,0.0,0.0,82070171,1,0
2,0,1.0,1.0,82019738,1,1
2,0,1.0,1.0,70214914,1,1
0,1,0.0,0.0,68338655,1,0
2,1,0.5,0.3333333333333333,68746986,2,1
2,1,0.5,0.5,69002276,2,1
2,0,1.0,1.0,65007404,1,1
2,0,1.0,1.0,69603023,1,1
2,0,1.0,1.0,80156701,1,1
2,0,1.0,1.0,70576786,1,1
2,0,1.0,1.0,66972010,1,1
0,1,0.0,0.0,80004064,1,0
0,1,0.0,0.0,70654556,1,0
2,0,1.0,1.0,71878856,1,1
2,1,0.5,0.0,82039331,2,1
2,0,1.0,1.0,68007961,1,1
2,0,1.0,1.0,73650143,2,2
2,0,1.0,1.0,73102323,1,1
2,0,1.0,1.0,73408762,1,1
2,0,1.0,1.0,80105053,1,1
2,1,0.5,0.5,68735646,2,1
2,0,1.0,1.0,69098344,1,1
2,0,1.0,1.0,80165268,1,1
2,0,1.0,1.0,82042155,1,1
2,0,1.0,1.0,69582926,1,1
2,0,1.0,1.0,82047749,1,1
2,1,0.5,0.0,69975794,2,1
0,1,0.0,0.0,80169825,1,0
0,1,0.0,0.0,80176225,1,0
2,0,1.0,1.0,82018164,1,1
2,0,1.0,1.0,70615125,1,1
2,0,1.0,1.0,64046066,1,1
0,1,0.0,0.0,69064506,1,0
0,2,0.0,0.0,69555556,2,0
2,0,1.0,1.0,82121115,1,1
0,2,0.0,0.0,69499710,2,0
2,1,0.6666666666666666,0.8,69482973,3,2
0,1,0.0,0.0,70704326,1,0
0,1,0.0,0.0,66770641,1,0
2,0,1.0,1.0,67786103,1,1
0,1,0.0,0.0,70706685,1,0
0,1,0.0,0.0,82182342,1,0
0,3,0.0,0.0,80159897,3,0
0,1,0.0,0.0,69668865,1,0
2,0,1.0,1.0,82218766,1,1
0,1,0.0,0.0,68149340,1,0
0,1,0.0,0.0,80150375,1,0
2,0,1.0,1.0,80159704,1,1
0,1,0.0,0.0,67514076,1,0
2,0,1.0,1.0,80176437,1,1
0,1,0.0,0.0,67665773,1,0
0,1,0.0,0.0,69424152,1,0
0,1,0.0,0.0,68805702,1,0
0,1,0.0,0.0,82006513,1,0
0,1,0.0,0.0,82006515,1,0
0,1,0.0,0.0,80131212,1,0
0,2,0.0,0.0,82006712,2,0
2,0,1.0,1.0,80091011,2,2
0,1,0.0,0.0,63279580,1,0
0,2,0.0,0.0,79792566,2,0
0,1,0.0,0.0,69701744,1,0
0,1,0.0,0.0,70691446,1,0
2,0,1.0,1.0,68402782,1,1
2,1,0.5,0.6666666666666666,70250761,2,1
2,0,1.0,1.0,69958490,1,1
2,0,1.0,1.0,82095256,1,1
2,0,1.0,1.0,70314594,2,2
1,2,0.3333333333333333,0.9333333333333333,70240702,3,1
1,2,0.3333333333333333,0.75,69107780,3,1
0,1,0.0,0.0,70855771,1,0
2,0,1.0,1.0,68519752,1,1
0,1,0.0,0.0,72921674,1,0
0,1,0.0,0.0,67257771,1,0
2,0,1.0,1.0,70744716,1,1
2,0,1.0,1.0,80177749,1,1
2,1,0.5,0.0,82185021,2,1
2,1,0.5,0.6,69487761,2,1
2,1,0.5,0.6,70868280,2,1
2,0,1.0,1.0,61509686,1,1
2,0,1.0,1.0,70395563,1,1
2,0,1.0,1.0,66233076,1,1
0,1,0.0,0.0,78266664,1,0
2,0,1.0,1.0,69464920,1,1
2,0,1.0,1.0,70407960,1,1
0,2,0.0,0.0,80083430,2,0
0,1,0.0,0.0,64234653,1,0
0,1,0.0,0.0,70692615,1,0
0,1,0.0,0.0,60785312,1,0
0,1,0.0,0.0,67281732,1,0
0,1,0.0,0.0,67690805,1,0
0,1,0.0,0.0,68046482,1,0
2,1,0.5,0.75,70320362,2,1
0,1,0.0,0.0,68138441,1,0
0,1,0.0,0.0,67053140,1,0
2,0,1.0,1.0,70700735,2,2
2,0,1.0,1.0,82039347,1,1
0,1,0.0,0.0,82024266,1,0
0,2,0.0,0.0,82018936,2,0
0,1,0.0,0.0,80170903,1,0
2,1,0.5,0.5,67434934,2,1
0,1,0.0,0.0,70759381,1,0
2,0,1.0,1.0,72813916,1,1
2,0,1.0,1.0,74027695,1,1
0,1,0.0,0.0,74360734,1,0
2,0,1.0,1.0,70395514,1,1
2,0,1.0,1.0,82024334,1,1
2,0,1.0,1.0,82145185,1,1
2,0,1.0,1.0,70240562,1,1
2,1,0.5,0.8571428571428571,66264296,2,1
2,0,1.0,1.0,70688296,2,2
0,1,0.0,0.0,80159184,1,0
0,1,0.0,0.0,80159211,1,0
0,1,0.0,0.0,80159224,1,0
0,1,0.0,0.0,69117174,1,0
2,0,1.0,1.0,69463170,2,2
0,1,0.0,0.0,19445552,1,0
0,1,0.0,0.0,82006348,1,0
0,2,0.0,0.0,82006389,2,0
0,1,0.0,0.0,82102500,1,0
0,1,0.0,0.0,64459094,1,0
0,1,0.0,0.0,70675024,1,0
2,0,1.0,1.0,70703521,1,1
0,1,0.0,0.0,15012305,1,0
2,0,1.0,1.0,70696255,1,1
2,0,1.0,1.0,63767095,1,1
0,1,0.0,0.0,69596744,1,0
0,1,0.0,0.0,70744793,1,0
2,0,1.0,1.0,70747383,2,2
2,0,1.0,1.0,81909053,1,1
0,1,0.0,0.0,70674716,1,0
2,0,1.0,1.0,66379705,1,1
2,0,1.0,1.0,65276806,1,1
2,0,1.0,1.0,81989163,2,2
0,1,0.0,0.0,69056750,1,0
0,1,0.0,0.0,67966962,1,0
2,0,1.0,1.0,82018736,1,1
0,1,0.0,0.0,82102522,1,0
2,1,0.5,0.5,80176362,2,1
0,1,0.0,0.0,68058326,1,0
0,1,0.0,0.0,70593992,1,0
2,0,1.0,1.0,70356923,1,1
2,0,1.0,1.0,80095260,2,2
2,0,1.0,1.0,80003602,1,1
2,0,1.0,1.0,69144411,1,1
2,0,1.0,1.0,80118906,1,1
0,1,0.0,0.0,69134261,1,0
0,1,0.0,0.0,82006346,1,0
0,1,0.0,0.0,80172642,1,0
0,2,0.0,0.0,82006328,2,0
2,0,1.0,1.0,66190103,1,1
0,1,0.0,0.0,70037366,1,0
2,0,1.0,1.0,66834516,1,1
0,1,0.0,0.0,68402831,1,0
0,1,0.0,0.0,68402845,1,0
0,1,0.0,0.0,68749044,1,0
2,0,1.0,1.0,73102302,2,2
2,0,1.0,1.0,71359435,1,1
2,0,1.0,1.0,82020050,2,2
2,0,1.0,1.0,69206893,1,1
0,1,0.0,0.0,67658381,1,0
0,1,0.0,0.0,70047971,1,0
0,1,0.0,0.0,69415794,1,0
2,0,1.0,1.0,67744334,2,2
0,1,0.0,0.0,71974483,1,0
1,2,0.3333333333333333,0.5,70599886,3,1
0,1,0.0,0.0,80165482,1,0
0,1,0.0,0.0,82039189,1,0
2,0,1.0,1.0,80128281,1,1
2,0,1.0,1.0,72813664,1,1
2,0,1.0,1.0,69954304,1,1
0,1,0.0,0.0,69078611,1,0
0,1,0.0,0.0,69475413,1,0
2,0,1.0,1.0,66238354,2,2
0,1,0.0,0.0,80128430,1,0
0,1,0.0,0.0,80170926,1,0
0,2,0.0,0.0,67917304,2,0
0,1,0.0,0.0,63981610,1,0
0,1,0.0,0.0,70744016,1,0
0,1,0.0,0.0,80105193,1,0
0,1,0.0,0.0,69483085,1,0
0,1,0.0,0.0,70745584,1,0
0,1,0.0,0.0,74660432,1,0
0,1,0.0,0.0,65135525,1,0
0,1,0.0,0.0,67174226,1,0
0,1,0.0,0.0,70677880,1,0
2,0,1.0,1.0,82039425,2,2
0,1,0.0,0.0,80132359,1,0
2,0,1.0,1.0,61819912,1,1
0,1,0.0,0.0,70699580,1,0
2,0,1.0,1.0,80062290,1,1
0,1,0.0,0.0,67066860,1,0
0,1,0.0,0.0,82013513,1,0
2,0,1.0,1.0,80161938,1,1
0,1,0.0,0.0,69152594,1,0
0,1,0.0,0.0,69577445,1,0
0,1,0.0,0.0,81995627,1,0
0,2,0.0,0.0,68524022,2,0
0,1,0.0,0.0,68798254,1,0
0,1,0.0,0.0,82043125,1,0
2,0,1.0,1.0,80141345,1,1
0,1,0.0,0.0,66236975,1,0
2,0,1.0,1.0,67988375,1,1
0,1,0.0,0.0,68710194,1,0
2,0,1.0,1.0,73064481,1,1
2,0,1.0,1.0,66235806,1,1
0,1,0.0,0.0,82041707,1,0
2,0,1.0,1.0,70694673,1,1
0,1,0.0,0.0,66240356,1,0
0,1,0.0,0.0,66250905,1,0
0,1,0.0,0.0,71619555,1,0
2,0,1.0,1.0,80150650,1,1
0,1,0.0,0.0,82006622,1,0
2,0,1.0,1.0,82037852,2,2
0,1,0.0,0.0,70239344,1,0
0,1,0.0,0.0,79953832,1,0
2,0,1.0,1.0,80093594,1,1
0,1,0.0,0.0,70758576,1,0
2,0,1.0,1.0,66232992,1,1
0,1,0.0,0.0,69955354,1,0
0,1,0.0,0.0,82050081,1,0
0,1,0.0,0.0,69318046,1,0
0,1,0.0,0.0,66783024,1,0
2,0,1.0,1.0,80156043,1,1
2,0,1.0,1.0,69116936,1,1
2,0,1.0,1.0,66229660,1,1
2,0,1.0,1.0,68659682,1,1
0,1,0.0,0.0,82009534,1,0
2,0,1.0,1.0,80136718,1,1
2,0,1.0,1.0,80137366,1,1
2,0,1.0,1.0,77112910,1,1
0,1,0.0,0.0,80150356,1,0
0,1,0.0,0.0,70695184,1,0
0,1,0.0,0.0,82041142,1,0
0,1,0.0,0.0,82024354,1,0
2,0,1.0,1.0,71878590,1,1
2,1,0.5,0.8,69735652,2,1
2,0,1.0,1.0,68531232,1,1
0,1,0.0,0.0,82013516,1,0
0,1,0.0,0.0,71536472,1,0
2,0,1.0,1.0,68236763,1,1
2,0,1.0,1.0,80051314,1,1
0,2,0.0,0.0,63320236,2,0
0,3,0.0,0.0,68476884,3,0
2,0,1.0,1.0,70417060,1,1
2,0,1.0,1.0,70638113,1,1
0,1,0.0,0.0,66939103,1,0
0,1,0.0,0.0,64470392,1,0
0,1,0.0,0.0,82006378,1,0
0,1,0.0,0.0,82006380,1,0
0,1,0.0,0.0,82102579,1,0
0,1,0.0,0.0,65957003,1,0
2,0,1.0,1.0,82022371,1,1
0,1,0.0,0.0,66848215,1,0
0,1,0.0,0.0,68163270,1,0
0,1,0.0,0.0,63245315,1,0
0,1,0.0,0.0,68539170,1,0
0,1,0.0,0.0,63977074,1,0
0,1,0.0,0.0,70682136,1,0
2,1,0.5,0.5,70324982,2,1
2,0,1.0,1.0,65813013,1,1
2,0,1.0,1.0,80051461,1,1
0,1,0.0,0.0,82013520,1,0
2,0,1.0,1.0,80136694,1,1
2,0,1.0,1.0,82023219,1,1
0,1,0.0,0.0,69064513,1,0
2,0,1.0,1.0,82038289,1,1
0,1,0.0,0.0,69617380,1,0
0,1,0.0,0.0,69724095,1,0
0,1,0.0,0.0,72474570,1,0
0,2,0.0,0.0,67668741,2,0
2,0,1.0,1.0,80176211,1,1
0,1,0.0,0.0,82033989,1,0
0,1,0.0,0.0,70693616,1,0
0,1,0.0,0.0,80176356,1,0
2,0,1.0,1.0,72659671,1,1
2,1,0.5,0.0,80162114,2,1
0,1,0.0,0.0,70694260,1,0
2,0,1.0,1.0,66236891,1,1
2,0,1.0,1.0,80156021,1,1
0,1,0.0,0.0,69069735,1,0
2,0,1.0,1.0,80128164,1,1
0,1,0.0,0.0,80155199,1,0
0,1,0.0,0.0,82102508,1,0
0,1,0.0,0.0,82009548,1,0
0,1,0.0,0.0,82153545,1,0
2,0,1.0,1.0,67782610,1,1
2,0,1.0,1.0,69983424,1,1
0,1,0.0,0.0,80105676,1,0
0,1,0.0,0.0,70508816,1,0
0,1,0.0,0.0,80083423,1,0
0,1,0.0,0.0,69311725,1,0
0,1,0.0,0.0,69041203,1,0
0,1,0.0,0.0,70707420,1,0
0,2,0.0,0.0,70230482,2,0
2,0,1.0,1.0,82054726,1,1
2,0,1.0,1.0,90622,1,1
0,1,0.0,0.0,82054022,1,0
2,0,1.0,1.0,66785061,1,1
0,1,0.0,0.0,69579440,1,0
2,0,1.0,1.0,80176371,1,1
0,2,0.0,0.0,80133921,2,0
2,0,1.0,1.0,82127542,1,1
0,2,0.0,0.0,82163485,2,0
0,1,0.0,0.0,81875461,1,0
2,1,0.5,0.5,69976361,2,1
2,0,1.0,1.0,72522163,1,1
0,1,0.0,0.0,73800860,1,0
0,1,0.0,0.0,69544580,1,0
0,1,0.0,0.0,70239050,1,0
0,1,0.0,0.0,80113474,1,0
0,1,0.0,0.0,80153695,1,0
0,1,0.0,0.0,70694855,1,0
0,1,0.0,0.0,70744394,1,0
2,0,1.0,1.0,82201012,1,1
2,0,1.0,1.0,82022879,1,1
0,1,0.0,0.0,66383184,1,0
0,2,0.0,0.0,80169892,2,0
2,0,1.0,1.0,63968282,1,1
2,0,1.0,1.0,69548934,2,2
2,0,1.0,1.0,72377186,1,1
0,1,0.0,0.0,65110773,1,0
0,1,0.0,0.0,82018706,1,0
2,0,1.0,1.0,80132887,2,2
2,0,1.0,1.0,82023074,1,1
2,0,1.0,1.0,68574121,1,1
0,1,0.0,0.0,70417130,1,0
0,1,0.0,0.0,66806621,1,0
0,1,0.0,0.0,70684446,1,0
2,1,0.5,0.0,67831540,2,1
2,0,1.0,1.0,82102155,1,1
2,0,1.0,1.0,67836412,1,1
2,0,1.0,1.0,82100937,1,1
2,0,1.0,1.0,80165281,1,1
2,0,1.0,1.0,82046289,1,1
2,0,1.0,1.0,82126272,1,1
0,1,0.0,0.0,70701610,1,0
0,1,0.0,0.0,70681933,1,0
2,0,1.0,1.0,69042862,2,2
2,0,1.0,1.0,82053997,1,1
2,0,1.0,1.0,70395682,1,1
2,0,1.0,1.0,72659811,1,1
2,0,1.0,1.0,80165333,1,1
2,1,0.5,0.0,80174141,2,1
2,0,1.0,1.0,82018653,1,1
2,0,1.0,1.0,70229222,1,1
2,0,1.0,1.0,79796654,1,1
0,1,0.0,0.0,80158277,1,0
0,1,0.0,0.0,67221931,1,0
2,0,1.0,1.0,67105500,1,1
2,0,1.0,1.0,68625760,1,1
0,1,0.0,0.0,80153696,1,0
2,0,1.0,1.0,70801423,1,1
2,1,0.75,0.6666666666666666,66237591,4,3
0,1,0.0,0.0,68441982,1,0
0,1,0.0,0.0,67966885,1,0
0,1,0.0,0.0,70692055,1,0
2,0,1.0,1.0,69043016,1,1
0,3,0.0,0.0,70184926,3,0
0,1,0.0,0.0,64248912,1,0
2,0,1.0,1.0,72717995,1,1
0,1,0.0,0.0,80135370,1,0
0,1,0.0,0.0,80133898,1,0
0,1,0.0,0.0,79794302,1,0
2,0,1.0,1.0,74032455,1,1
2,0,1.0,1.0,69653066,1,1
2,0,1.0,1.0,82010160,1,1
2,0,1.0,1.0,82126592,1,1
2,0,1.0,1.0,66891580,1,1
0,1,0.0,0.0,82024311,1,0
2,0,1.0,1.0,69160280,1,1
0,1,0.0,0.0,70351575,1,0
2,0,1.0,1.0,82024191,1,1
2,0,1.0,1.0,69187566,1,1
2,0,1.0,1.0,82125460,1,1
2,0,1.0,1.0,82052088,1,1
0,1,0.0,0.0,68370736,1,0
2,0,1.0,1.0,70655235,1,1
0,1,0.0,0.0,66620631,1,0
0,1,0.0,0.0,69704523,1,0
0,1,0.0,0.0,67335842,1,0
2,0,1.0,1.0,80092460,1,1
2,0,1.0,1.0,70078106,1,1
2,0,1.0,1.0,70678125,1,1
2,0,1.0,1.0,69214915,1,1
0,1,0.0,0.0,82247756,1,0
0,1,0.0,0.0,67072376,1,0
0,2,0.0,0.0,70684425,2,0
0,1,0.0,0.0,66877013,1,0
0,1,0.0,0.0,73645390,1,0
2,0,1.0,1.0,80094371,1,1
2,0,1.0,1.0,81982674,1,1
0,1,0.0,0.0,82035919,1,0
0,1,0.0,0.0,67128684,1,0
2,0,1.0,1.0,82052089,1,1
0,2,0.0,0.0,69313006,2,0
2,0,1.0,1.0,64355676,1,1
2,0,1.0,1.0,82069225,1,1
0,1,0.0,0.0,70646660,1,0
2,0,1.0,1.0,69182813,1,1
0,2,0.0,0.0,69479263,2,0
0,1,0.0,0.0,69068475,1,0
2,0,1.0,1.0,67276384,1,1
0,1,0.0,0.0,69603044,1,0
0,1,0.0,0.0,69865971,1,0
0,1,0.0,0.0,70476336,1,0
0,1,0.0,0.0,64237054,1,0
0,1,0.0,0.0,80093160,1,0
0,1,0.0,0.0,73863020,1,0
0,1,0.0,0.0,69034133,1,0
2,0,1.0,1.0,67199062,1,1
2,1,0.5,0.8,69866062,2,1
2,0,1.0,1.0,70061726,1,1
0,1,0.0,0.0,82020814,1,0
0,1,0.0,0.0,82020815,1,0
0,1,0.0,0.0,69066193,1,0
0,1,0.0,0.0,70179725,1,0
2,0,1.0,1.0,82126259,1,1
2,0,1.0,1.0,82102167,1,1
2,0,1.0,1.0,82102188,1,1
2,0,1.0,1.0,80174099,1,1
2,0,1.0,1.0,82102176,2,2
2,0,1.0,1.0,80136531,1,1
0,1,0.0,0.0,69164564,1,0
2,0,1.0,1.0,80105305,1,1
0,1,0.0,0.0,72526055,1,0
2,0,1.0,1.0,65972963,1,1
2,0,1.0,1.0,73634960,1,1
0,1,0.0,0.0,68789672,1,0
0,2,0.0,0.0,69597206,2,0
2,1,0.5,0.5,80093671,2,1
2,0,1.0,1.0,69976060,1,1
2,0,1.0,1.0,69904716,1,1
0,1,0.0,0.0,70459235,1,0
0,1,0.0,0.0,69633130,1,0
0,1,0.0,0.0,70109662,1,0
0,1,0.0,0.0,70109963,1,0
0,1,0.0,0.0,70409983,1,0
2,1,0.5,0.6666666666666666,80105074,2,1
0,1,0.0,0.0,80156443,1,0
0,1,0.0,0.0,80130718,1,0
0,1,0.0,0.0,67682580,1,0
2,0,1.0,1.0,69512254,1,1
2,0,1.0,1.0,68433344,1,1
0,1,0.0,0.0,64339233,1,0
2,0,1.0,1.0,67291546,2,2
0,1,0.0,0.0,65954301,1,0
2,0,1.0,1.0,82013505,1,1
2,0,1.0,1.0,70758604,1,1
2,0,1.0,1.0,68805716,2,2
2,0,1.0,1.0,79450364,1,1
2,0,1.0,1.0,70481684,1,1
0,1,0.0,0.0,69728442,1,0
2,1,0.5,0.625,80165870,2,1
2,0,1.0,1.0,79005465,1,1
0,1,0.0,0.0,82024386,1,0
2,0,1.0,1.0,82020771,1,1
2,0,1.0,1.0,68531673,1,1
0,1,0.0,0.0,67830350,1,0
2,0,1.0,1.0,14001012,1,1
2,1,0.5,0.0,70074200,2,1
2,0,1.0,1.0,82013509,2,2
2,0,1.0,1.0,67248370,1,1
2,0,1.0,1.0,65886534,1,1
2,0,1.0,1.0,80150800,1,1
2,0,1.0,1.0,80178171,1,1
0,1,0.0,0.0,70677691,1,0
0,1,0.0,0.0,70681765,1,0
2,0,1.0,1.0,70189315,1,1
0,1,0.0,0.0,70698096,1,0
2,0,1.0,1.0,70705432,1,1
2,0,1.0,1.0,69555332,1,1
2,0,1.0,1.0,82206015,1,1
2,0,1.0,1.0,80153700,1,1
2,0,1.0,1.0,82019878,1,1
2,1,0.5,0.8666666666666667,80150292,2,1
2,0,1.0,1.0,70492982,1,1
0,1,0.0,0.0,80130374,1,0
2,0,1.0,1.0,70632261,1,1
2,0,1.0,1.0,70862134,1,1
0,1,0.0,0.0,69021050,1,0
2,0,1.0,1.0,70190470,1,1
0,1,0.0,0.0,64355564,1,0
0,2,0.0,0.0,80165332,2,0
0,1,0.0,0.0,77160811,1,0
0,1,0.0,0.0,80163438,1,0
0,1,0.0,0.0,70699265,1,0
0,1,0.0,0.0,70705166,1,0
0,1,0.0,0.0,68373935,1,0
2,0,1.0,1.0,73716286,1,1
0,1,0.0,0.0,80172644,1,0
0,1,0.0,0.0,69134044,1,0
0,1,0.0,0.0,82006733,1,0
0,1,0.0,0.0,82006491,1,0
0,1,0.0,0.0,63999523,1,0
0,1,0.0,0.0,68060804,1,0
0,1,0.0,0.0,67224640,1,0
0,2,0.0,0.0,69311781,2,0
0,1,0.0,0.0,69313090,1,0
2,0,1.0,1.0,67316816,1,1
2,0,1.0,1.0,82110567,1,1
0,1,0.0,0.0,65919105,1,0
0,1,0.0,0.0,70704333,1,0
0,1,0.0,0.0,82095682,1,0
2,0,1.0,1.0,82041570,2,2
2,0,1.0,1.0,70720860,1,1
0,1,0.0,0.0,82179507,1,0
2,0,1.0,1.0,80145725,1,1
0,1,0.0,0.0,65596643,1,0
2,0,1.0,1.0,82096234,1,1
0,1,0.0,0.0,64457876,1,0
0,1,0.0,0.0,69955200,1,0
0,1,0.0,0.0,70671846,1,0
2,0,1.0,1.0,69002850,1,1
2,0,1.0,1.0,82121150,1,1
2,0,1.0,1.0,66110366,1,1
2,0,1.0,1.0,82163430,1,1
2,0,1.0,1.0,69166132,1,1
0,2,0.0,0.0,82251463,2,0
2,0,1.0,1.0,70674723,1,1
0,1,0.0,0.0,70691810,1,0
0,1,0.0,0.0,72847250,1,0
2,1,0.5,0.8,68748211,2,1
0,1,0.0,0.0,60561466,1,0
2,0,1.0,1.0,69039012,1,1
2,1,0.5,0.5,80094945,2,1
2,0,1.0,1.0,80163672,1,1
0,1,0.0,0.0,80134130,1,0
0,1,0.0,0.0,72882845,1,0
2,0,1.0,1.0,80134752,1,1
0,1,0.0,0.0,71081171,1,0
0,1,0.0,0.0,71618680,1,0
0,2,0.0,0.0,71619450,2,0
0,1,0.0,0.0,71619702,1,0
0,1,0.0,0.0,71619765,1,0
0,1,0.0,0.0,82090264,1,0
2,0,1.0,1.0,68200062,1,1
2,0,1.0,1.0,63189770,1,1
2,0,1.0,1.0,70746935,1,1
2,0,1.0,1.0,69483540,1,1
2,0,1.0,1.0,82024238,1,1
2,1,0.5,0.0,70279895,2,1
0,1,0.0,0.0,61579084,1,0
2,1,0.5,0.9090909090909091,68461603,2,1
2,0,1.0,1.0,82038273,6,6
2,0,1.0,1.0,80134060,1,1
2,1,0.5,0.0,82022166,2,1
2,0,1.0,1.0,69975612,1,1
2,0,1.0,1.0,82046288,1,1
2,0,1.0,1.0,80165860,1,1
2,0,1.0,1.0,70190323,1,1
0,1,0.0,0.0,70697473,1,0
0,1,0.0,0.0,69044843,1,0
2,0,1.0,1.0,75264252,2,2
0,1,0.0,0.0,72882852,1,0
0,1,0.0,0.0,82037582,1,0
0,1,0.0,0.0,82037584,1,0
0,1,0.0,0.0,82013548,1,0
0,1,0.0,0.0,70237965,1,0
0,1,0.0,0.0,65292591,1,0
0,1,0.0,0.0,70704032,1,0
0,1,0.0,0.0,68499025,1,0
2,0,1.0,1.0,69006924,1,1
2,1,0.5,0.5,67132541,2,1
0,1,0.0,0.0,70109683,1,0
2,1,0.5,0.5,79884203,2,1
2,0,1.0,1.0,80052420,1,1
0,1,0.0,0.0,72522114,1,0
0,1,0.0,0.0,70351561,1,0
2,1,0.5,0.5,73650955,2,1
2,0,1.0,1.0,80139959,1,1
2,0,1.0,1.0,80128421,1,1
2,0,1.0,1.0,82038294,1,1
2,0,1.0,1.0,68278343,1,1
0,1,0.0,0.0,82006684,1,0
0,1,0.0,0.0,82102576,1,0
2,0,1.0,1.0,82045540,1,1
0,1,0.0,0.0,66233286,1,0
2,0,1.0,1.0,74362246,2,2
2,0,1.0,1.0,79786273,1,1
0,1,0.0,0.0,68546681,1,0
0,1,0.0,0.0,71878464,1,0
2,0,1.0,1.0,80162139,1,1
0,1,0.0,0.0,69705041,1,0
2,1,0.5,0.8,70801395,2,1
0,1,0.0,0.0,68413156,1,0
2,0,1.0,1.0,69603324,1,1
0,1,0.0,0.0,66931473,1,0
2,0,1.0,1.0,70494011,1,1
2,0,1.0,1.0,80158302,1,1
2,0,1.0,1.0,70348103,1,1
0,1,0.0,0.0,82046923,1,0
2,0,1.0,1.0,82013591,1,1
2,0,1.0,1.0,66235435,1,1
0,1,0.0,0.0,73632440,1,0
2,0,1.0,1.0,67744341,1,1
0,1,0.0,0.0,69133701,1,0
2,0,1.0,1.0,75161702,2,2
0,1,0.0,0.0,66783696,1,0
0,1,0.0,0.0,73634974,1,0
2,0,1.0,1.0,82100946,1,1
2,0,1.0,1.0,81875841,1,1
2,0,1.0,1.0,68747105,1,1
2,0,1.0,1.0,72739520,1,1
0,1,0.0,0.0,71212260,1,0
2,0,1.0,1.0,77995554,1,1
0,1,0.0,0.0,64354724,1,0
2,0,1.0,1.0,82020801,1,1
0,1,0.0,0.0,69483253,1,0
0,2,0.0,0.0,69484625,2,0
0,1,0.0,0.0,80130349,1,0
0,2,0.0,0.0,69483162,2,0
2,0,1.0,1.0,73444882,1,1
0,1,0.0,0.0,68028723,1,0
2,1,0.5,0.5,69464570,2,1
0,1,0.0,0.0,70941626,1,0
0,1,0.0,0.0,80145445,1,0
2,0,1.0,1.0,67298203,1,1
2,0,1.0,1.0,82039419,2,2
2,0,1.0,1.0,69517714,1,1
0,1,0.0,0.0,65144870,1,0
2,0,1.0,1.0,67979555,1,1
0,1,0.0,0.0,70704851,1,0
0,1,0.0,0.0,80172528,1,0
0,1,0.0,0.0,70916300,1,0
2,0,1.0,1.0,69951763,1,1
0,1,0.0,0.0,82006488,1,0
0,1,0.0,0.0,70217301,1,0
1,3,0.25,0.5882352941176471,65286270,4,1
2,0,1.0,1.0,82018713,2,2
2,0,1.0,1.0,80156640,1,1
2,0,1.0,1.0,67066930,1,1
0,2,0.0,0.0,70702212,2,0
0,1,0.0,0.0,82201370,1,0
0,1,0.0,0.0,70691663,1,0
0,1,0.0,0.0,70744765,1,0
2,0,1.0,1.0,60637213,1,1
2,0,1.0,1.0,76204142,1,1
2,0,1.0,1.0,82095211,1,1
2,0,1.0,1.0,82042132,1,1
1,2,0.3333333333333333,0.75,70693371,3,1
2,1,0.5,0.5,66238193,2,1
0,3,0.0,0.0,74086726,3,0
0,1,0.0,0.0,73801210,1,0
0,1,0.0,0.0,82024195,1,0
0,1,0.0,0.0,80093776,1,0
0,1,0.0,0.0,68393423,1,0
0,1,0.0,0.0,70743645,1,0
0,1,0.0,0.0,70744163,1,0
0,1,0.0,0.0,80176632,1,0
0,1,0.0,0.0,72813951,1,0
2,0,1.0,1.0,63036022,1,1
2,0,1.0,1.0,67271260,1,1
0,2,0.0,0.0,13939142,2,0
0,1,0.0,0.0,69575226,1,0
0,1,0.0,0.0,68498570,1,0
0,1,0.0,0.0,69158124,1,0
0,1,0.0,0.0,70229481,1,0
2,0,1.0,1.0,70608181,1,1
2,0,1.0,1.0,70747222,1,1
2,0,1.0,1.0,65307795,1,1
2,0,1.0,1.0,80092313,1,1
0,1,0.0,0.0,68748155,1,0
0,1,0.0,0.0,68805821,1,0
0,1,0.0,0.0,68115292,1,0
2,0,1.0,1.0,72844030,1,1
0,2,0.0,0.0,70463666,2,0
2,0,1.0,1.0,69583003,1,1
0,1,0.0,0.0,70528206,1,0
0,1,0.0,0.0,66016216,1,0
2,1,0.5,0.8,67376533,2,1
2,0,1.0,1.0,82054014,1,1
0,1,0.0,0.0,82024206,1,0
0,1,0.0,0.0,82024260,1,0
0,1,0.0,0.0,82024387,1,0
2,0,1.0,1.0,80119160,1,1
0,2,0.0,0.0,70633073,2,0
2,0,1.0,1.0,66232271,1,1
0,1,0.0,0.0,65634996,1,0
0,1,0.0,0.0,61579063,1,0
2,0,1.0,1.0,80113593,1,1
0,1,0.0,0.0,82019864,1,0
2,0,1.0,1.0,82019949,1,1
0,1,0.0,0.0,73800944,1,0
0,1,0.0,0.0,73800951,1,0
0,1,0.0,0.0,71537571,1,0
0,1,0.0,0.0,70678426,1,0
2,0,1.0,1.0,70565544,1,1
2,0,1.0,1.0,70076391,1,1
2,0,1.0,1.0,72801533,1,1
0,1,0.0,0.0,70801731,1,0
0,1,0.0,0.0,70675213,1,0
0,1,0.0,0.0,70695121,1,0
2,0,1.0,1.0,73832563,1,1
2,0,1.0,1.0,80094756,1,1
2,0,1.0,1.0,80137906,1,1
1,2,0.3333333333333333,0.6,69596653,3,1
2,0,1.0,1.0,82009397,1,1
0,1,0.0,0.0,82118273,1,0
0,1,0.0,0.0,80168236,1,0
0,1,0.0,0.0,74595934,1,0
0,1,0.0,0.0,64858710,1,0
2,0,1.0,1.0,80093370,1,1
2,0,1.0,1.0,61102223,1,1
2,0,1.0,1.0,69003193,1,1
2,0,1.0,1.0,68167505,1,1
2,1,0.5,0.0,74565722,2,1
0,1,0.0,0.0,82037973,1,0
0,1,0.0,0.0,69596632,1,0
0,1,0.0,0.0,74218284,1,0
0,1,0.0,0.0,67672346,1,0
0,1,0.0,0.0,80118292,1,0
0,1,0.0,0.0,70599431,1,0
2,0,1.0,1.0,80136535,1,1
2,0,1.0,1.0,74386186,1,1
2,1,0.5,0.625,66495884,2,1
2,0,1.0,1.0,82020803,2,2
2,0,1.0,1.0,82102199,1,1
0,1,0.0,0.0,79994404,1,0
0,1,0.0,0.0,82022091,1,0
0,1,0.0,0.0,82206126,1,0
2,0,1.0,1.0,80165479,1,1
2,0,1.0,1.0,82038825,1,1
0,1,0.0,0.0,70680722,1,0
0,1,0.0,0.0,80150358,1,0
2,0,1.0,1.0,70063182,1,1
0,1,0.0,0.0,69464703,1,0
0,1,0.0,0.0,70748622,1,0
0,1,0.0,0.0,69997725,1,0
0,2,0.0,0.0,67626965,2,0
2,0,1.0,1.0,67317271,1,1
0,1,0.0,0.0,69866006,1,0
0,1,0.0,0.0,80176814,1,0
0,2,0.0,0.0,68373732,2,0
2,0,1.0,1.0,67802434,1,1
2,0,1.0,1.0,54681823,1,1
2,0,1.0,1.0,82018649,1,1
2,0,1.0,1.0,69634551,1,1
0,1,0.0,0.0,69701121,1,0
1,2,0.3333333333333333,0.8571428571428571,71341816,3,1
0,1,0.0,0.0,70759402,1,0
0,1,0.0,0.0,65308705,1,0
2,0,1.0,1.0,74124834,1,1
0,1,0.0,0.0,80165758,1,0
0,1,0.0,0.0,82153819,1,0
2,0,1.0,1.0,74129643,1,1
0,1,0.0,0.0,69912675,1,0
2,0,1.0,1.0,82135118,1,1
0,1,0.0,0.0,80128313,1,0
0,1,0.0,0.0,70856121,1,0
0,1,0.0,0.0,64345512,1,0
0,1,0.0,0.0,63832244,1,0
2,0,1.0,1.0,80025162,1,1
0,1,0.0,0.0,73623242,1,0
0,1,0.0,0.0,73623396,1,0
2,0,1.0,1.0,70217315,1,1
2,0,1.0,1.0,80122932,1,1
2,0,1.0,1.0,68167813,1,1
2,0,1.0,1.0,82102217,1,1
2,0,1.0,1.0,67322794,1,1
2,0,1.0,1.0,75361783,1,1
0,1,0.0,0.0,58873346,1,0
2,0,1.0,1.0,82138719,1,1
0,1,0.0,0.0,82126276,1,0
0,1,0.0,0.0,82126279,1,0
2,0,1.0,1.0,67786222,1,1
2,0,1.0,1.0,82208201,1,1
0,1,0.0,0.0,58865016,1,0
0,1,0.0,0.0,66423672,1,0
2,1,0.5,0.0,82018748,2,1
2,0,1.0,1.0,73328360,1,1
0,1,0.0,0.0,82019742,1,0
2,0,1.0,1.0,80056011,2,2
0,1,0.0,0.0,80165805,1,0
2,0,1.0,1.0,67646040,1,1
0,1,0.0,0.0,70417732,1,0
2,0,1.0,1.0,80150309,1,1
0,1,0.0,0.0,80118281,1,0
2,0,1.0,1.0,67726890,1,1
2,1,0.5,0.8333333333333334,72801694,2,1
2,0,1.0,1.0,71184365,1,1
0,1,0.0,0.0,80126834,1,0
2,0,1.0,1.0,69064233,1,1
0,1,0.0,0.0,82064824,1,0
2,0,1.0,1.0,65293354,1,1
2,0,1.0,1.0,80165162,1,1
2,0,1.0,1.0,82202274,1,1
2,0,1.0,1.0,82033536,1,1
0,1,0.0,0.0,62711145,1,0
0,1,0.0,0.0,69558503,1,0
0,1,0.0,0.0,80176350,1,0
0,1,0.0,0.0,70014791,1,0
0,1,0.0,0.0,82248771,1,0
0,1,0.0,0.0,70703605,1,0
0,1,0.0,0.0,82145519,1,0
2,0,1.0,1.0,82054067,1,1
2,0,1.0,1.0,70820841,1,1
0,1,0.0,0.0,64355662,1,0
2,0,1.0,1.0,72802212,1,1
0,1,0.0,0.0,69558531,1,0
0,1,0.0,0.0,70916776,1,0
2,0,1.0,1.0,64470175,2,2
0,1,0.0,0.0,70493045,1,0
0,1,0.0,0.0,72786056,1,0
0,1,0.0,0.0,80172539,1,0
0,1,0.0,0.0,80150314,1,0
0,1,0.0,0.0,67290090,1,0
2,0,1.0,1.0,68561185,1,1
0,1,0.0,0.0,80124533,1,0
2,0,1.0,1.0,70322672,1,1
2,0,1.0,1.0,73715551,1,1
2,0,1.0,1.0,64032570,1,1
2,0,1.0,1.0,67159806,1,1
0,1,0.0,0.0,68659913,1,0
0,1,0.0,0.0,82018600,1,0
0,1,0.0,0.0,69997851,1,0
0,1,0.0,0.0,60692135,1,0
2,0,1.0,1.0,82018618,2,2
2,0,1.0,1.0,18104415,1,1
2,0,1.0,1.0,67220566,1,1
2,0,1.0,1.0,82037594,1,1
0,1,0.0,0.0,82013622,1,0
0,2,0.0,0.0,67887295,2,0
2,0,1.0,1.0,70629160,1,1
0,1,0.0,0.0,72900275,1,0
2,0,1.0,1.0,70049112,1,1
0,1,0.0,0.0,68241684,1,0
0,1,0.0,0.0,16768234,1,0
0,1,0.0,0.0,82023113,1,0
2,0,1.0,1.0,82023666,1,1
0,1,0.0,0.0,82022393,1,0
0,1,0.0,0.0,69064261,1,0
0,1,0.0,0.0,82042832,1,0
0,1,0.0,0.0,68747315,1,0
2,0,1.0,1.0,70742140,1,1
0,1,0.0,0.0,70185045,1,0
2,0,1.0,1.0,66238095,1,1
0,1,0.0,0.0,82140172,1,0
2,0,1.0,1.0,82047570,1,1
0,1,0.0,0.0,71764196,1,0
0,1,0.0,0.0,82109300,1,0
0,1,0.0,0.0,82152446,1,0
0,1,0.0,0.0,82006872,1,0
0,1,0.0,0.0,67526830,1,0
2,0,1.0,1.0,67510961,1,1
0,1,0.0,0.0,82024272,1,0
0,1,0.0,0.0,76695045,1,0
2,0,1.0,1.0,80141412,1,1
0,1,0.0,0.0,70491022,1,0
0,1,0.0,0.0,57188460,1,0
2,0,1.0,1.0,68805912,1,1
2,0,1.0,1.0,81254262,1,1
0,1,0.0,0.0,72814070,1,0
0,1,0.0,0.0,69638121,1,0
2,0,1.0,1.0,70217364,1,1
0,2,0.0,0.0,69050254,2,0
2,0,1.0,1.0,70415450,1,1
2,0,1.0,1.0,82125474,1,1
0,1,0.0,0.0,80150408,1,0
2,0,1.0,1.0,80178242,1,1
2,0,1.0,1.0,69216623,1,1
0,1,0.0,0.0,80166921,1,0
0,1,0.0,0.0,70573384,1,0
0,1,0.0,0.0,80067484,1,0
2,0,1.0,1.0,82064803,1,1
2,0,1.0,1.0,69521431,1,1
0,1,0.0,0.0,68342736,1,0
2,0,1.0,1.0,82023220,2,2
2,0,1.0,1.0,67821845,1,1
0,1,0.0,0.0,70692104,1,0
2,0,1.0,1.0,68953094,1,1
0,1,0.0,0.0,69222034,1,0
2,0,1.0,1.0,72802471,1,1
2,1,0.5,0.5,70746543,2,1
2,0,1.0,1.0,80052364,1,1
0,1,0.0,0.0,70682465,1,0
0,1,0.0,0.0,82019325,1,0
0,1,0.0,0.0,70525126,1,0
0,1,0.0,0.0,74510030,1,0
2,0,1.0,1.0,80159735,1,1
2,0,1.0,1.0,79457371,1,1
0,1,0.0,0.0,70408100,1,0
0,1,0.0,0.0,70820064,1,0
2,0,1.0,1.0,82006249,1,1
0,1,0.0,0.0,69912584,1,0
0,1,0.0,0.0,62537265,1,0
0,1,0.0,0.0,73801021,1,0
0,2,0.0,0.0,68666990,2,0
0,1,0.0,0.0,72550212,1,0
0,1,0.0,0.0,72550226,1,0
2,0,1.0,1.0,77114016,1,1
2,0,1.0,1.0,63159922,1,1
0,1,0.0,0.0,79791166,1,0
0,1,0.0,0.0,68273681,1,0
2,0,1.0,1.0,67264015,1,1
2,0,1.0,1.0,67140045,1,1
0,1,0.0,0.0,69973414,1,0
2,0,1.0,1.0,82013529,1,1
0,1,0.0,0.0,80172028,1,0
0,1,0.0,0.0,70682962,1,0
0,1,0.0,0.0,70238042,1,0
2,0,1.0,1.0,66265003,1,1
2,0,1.0,1.0,80169813,1,1
0,1,0.0,0.0,67831582,1,0
0,1,0.0,0.0,67831624,1,0
2,0,1.0,1.0,74386333,1,1
0,1,0.0,0.0,69182505,1,0
2,0,1.0,1.0,80118312,1,1
0,1,0.0,0.0,70219695,1,0
2,0,1.0,1.0,70239113,1,1
2,0,1.0,1.0,82000701,1,1
2,0,1.0,1.0,70532966,1,1
2,0,1.0,1.0,67843202,1,1
0,1,0.0,0.0,69182862,1,0
0,1,0.0,0.0,70059535,1,0
0,1,0.0,0.0,82006311,1,0
2,1,0.5,0.5,63242970,2,1
0,1,0.0,0.0,70206521,1,0
0,1,0.0,0.0,70680540,1,0
2,0,1.0,1.0,72786035,1,1
0,2,0.0,0.0,82021413,2,0
2,0,1.0,1.0,70703661,1,1
0,1,0.0,0.0,69867896,1,0
2,0,1.0,1.0,72539922,1,1
2,0,1.0,1.0,61365612,1,1
0,1,0.0,0.0,68191123,1,0
0,1,0.0,0.0,80179951,1,0
2,0,1.0,1.0,80178239,1,1
2,0,1.0,1.0,80049830,1,1
2,0,1.0,1.0,80159724,1,1
2,0,1.0,1.0,80169305,1,1
2,0,1.0,1.0,82125461,1,1
0,1,0.0,0.0,80159193,1,0
0,1,0.0,0.0,80159216,1,0
2,0,1.0,1.0,82008306,1,1
0,1,0.0,0.0,69637995,1,0
0,1,0.0,0.0,68260941,1,0
2,0,1.0,1.0,82205950,1,1
2,0,1.0,1.0,69972616,1,1
2,1,0.5,0.5,75060286,2,1
0,1,0.0,0.0,80128726,1,0
2,0,1.0,1.0,82164476,1,1
2,0,1.0,1.0,80118298,1,1
0,1,0.0,0.0,69481265,1,0
0,1,0.0,0.0,82250583,1,0
0,1,0.0,0.0,65854663,1,0
0,1,0.0,0.0,82206220,1,0
0,1,0.0,0.0,69603905,1,0
2,0,1.0,1.0,70515494,1,1
0,1,0.0,0.0,69985566,1,0
0,1,0.0,0.0,67686290,1,0
0,1,0.0,0.0,66304903,1,0
0,1,0.0,0.0,80177442,1,0
2,0,1.0,1.0,82070169,1,1
2,0,1.0,1.0,68346453,2,2
0,1,0.0,0.0,72905931,1,0
2,0,1.0,1.0,70071183,1,1
0,2,0.0,0.0,82006176,2,0
0,1,0.0,0.0,66009461,1,0
0,1,0.0,0.0,66931501,1,0
2,0,1.0,1.0,70489664,1,1
0,1,0.0,0.0,69581764,1,0
2,0,1.0,1.0,65863322,1,1
0,1,0.0,0.0,67428746,1,0
0,1,0.0,0.0,67428795,1,0
0,1,0.0,0.0,70693714,1,0
2,0,1.0,1.0,82018652,2,2
2,0,1.0,1.0,82100934,1,1
2,0,1.0,1.0,82102251,1,1
0,1,0.0,0.0,69976123,1,0
2,0,1.0,1.0,82054745,1,1
0,1,0.0,0.0,73588851,1,0
0,1,0.0,0.0,66227063,1,0
0,1,0.0,0.0,66227070,1,0
2,0,1.0,1.0,68243273,1,1
0,1,0.0,0.0,70692734,1,0
0,1,0.0,0.0,69464696,1,0
2,0,1.0,1.0,70489671,2,2
2,0,1.0,1.0,63963732,1,1
2,0,1.0,1.0,82145509,1,1
0,1,0.0,0.0,73295761,1,0
0,1,0.0,0.0,66237360,1,0
0,1,0.0,0.0,79462614,1,0
0,1,0.0,0.0,66801784,1,0
0,1,0.0,0.0,60191880,1,0
0,1,0.0,0.0,70685594,1,0
0,1,0.0,0.0,80126819,1,0
2,0,1.0,1.0,82125457,1,1
0,1,0.0,0.0,69479074,1,0
0,1,0.0,0.0,72930893,1,0
0,1,0.0,0.0,80126784,1,0
0,1,0.0,0.0,67132485,1,0
0,1,0.0,0.0,82019778,1,0
2,1,0.5,0.8,82024193,2,1
0,1,0.0,0.0,70680946,1,0
2,0,1.0,1.0,82016193,1,1
2,0,1.0,1.0,80130728,2,2
0,1,0.0,0.0,82206078,1,0
0,1,0.0,0.0,69867784,1,0
0,1,0.0,0.0,70706034,1,0
2,0,1.0,1.0,67780615,1,1
0,1,0.0,0.0,82182797,1,0
2,0,1.0,1.0,82019645,1,1
0,1,0.0,0.0,73537044,1,0
0,1,0.0,0.0,70704935,1,0
2,0,1.0,1.0,70258090,1,1
0,1,0.0,0.0,82010259,1,0
2,0,1.0,1.0,82142218,1,1
2,0,1.0,1.0,82039897,1,1
0,1,0.0,0.0,69729345,1,0
0,1,0.0,0.0,70699006,1,0
0,1,0.0,0.0,70395605,1,0
0,1,0.0,0.0,69873944,1,0
2,0,1.0,1.0,64469090,1,1
0,1,0.0,0.0,66512824,1,0
0,1,0.0,0.0,70908250,1,0
0,1,0.0,0.0,66495891,1,0
0,1,0.0,0.0,82041715,1,0
0,1,0.0,0.0,80156409,1,0
2,0,1.0,1.0,70751240,1,1
0,1,0.0,0.0,68167652,1,0
0,1,0.0,0.0,80095176,1,0
0,1,0.0,0.0,67799424,1,0
2,0,1.0,1.0,67744726,1,1
0,1,0.0,0.0,67665234,1,0
0,1,0.0,0.0,67665255,1,0
2,0,1.0,1.0,75362266,1,1
2,0,1.0,1.0,67823294,1,1
2,0,1.0,1.0,80168523,1,1
0,1,0.0,0.0,80168110,1,0
0,1,0.0,0.0,82006313,1,0
2,0,1.0,1.0,68436956,1,1
2,0,1.0,1.0,68741393,1,1
0,1,0.0,0.0,70491813,1,0
2,0,1.0,1.0,80159203,2,2
0,1,0.0,0.0,69621664,1,0
0,1,0.0,0.0,82247782,1,0
0,1,0.0,0.0,67276811,1,0
2,0,1.0,1.0,66883306,1,1
2,0,1.0,1.0,69642930,1,1
0,1,0.0,0.0,68433995,1,0
0,1,0.0,0.0,67703741,1,0
2,0,1.0,1.0,70184394,1,1
2,0,1.0,1.0,65282406,1,1
2,0,1.0,1.0,70613382,1,1
2,0,1.0,1.0,80093041,1,1
0,1,0.0,0.0,80003616,1,0
0,1,0.0,0.0,69573273,1,0
2,0,1.0,1.0,64360233,1,1
2,0,1.0,1.0,67654811,1,1
2,0,1.0,1.0,80136571,1,1
0,1,0.0,0.0,80149843,1,0
0,1,0.0,0.0,67978253,1,0
0,1,0.0,0.0,68902624,1,0
0,1,0.0,0.0,82024232,1,0
2,0,1.0,1.0,70460180,1,1
0,1,0.0,0.0,67779264,1,0
0,1,0.0,0.0,65836421,1,0
0,1,0.0,0.0,68748183,1,0
2,0,1.0,1.0,69562794,1,1
0,1,0.0,0.0,69484450,1,0
0,1,0.0,0.0,70415513,1,0
2,0,1.0,1.0,82025199,1,1
2,0,1.0,1.0,82039339,1,1
0,1,0.0,0.0,80128382,1,0
2,0,1.0,1.0,80049914,1,1
0,1,0.0,0.0,70706972,1,0
0,1,0.0,0.0,82090191,1,0
0,1,0.0,0.0,82090192,1,0
2,0,1.0,1.0,69469484,1,1
0,1,0.0,0.0,70698992,1,0
0,1,0.0,0.0,69081495,1,0
0,1,0.0,0.0,68531785,1,0
0,1,0.0,0.0,68539212,1,0
0,1,0.0,0.0,68542992,1,0
2,0,1.0,1.0,70420091,1,1
0,1,0.0,0.0,70680204,1,0
2,0,1.0,1.0,67580142,1,1
0,1,0.0,0.0,67982124,1,0
0,1,0.0,0.0,70696234,1,0
2,0,1.0,1.0,71913331,1,1
0,1,0.0,0.0,62742162,1,0
0,1,0.0,0.0,82061900,1,0
0,1,0.0,0.0,82118290,1,0
2,0,1.0,1.0,80090920,1,1
0,1,0.0,0.0,68200426,1,0
2,0,1.0,1.0,69163304,1,1
0,1,0.0,0.0,72474612,1,0
2,0,1.0,1.0,69603800,1,1
0,1,0.0,0.0,80176826,1,0
2,0,1.0,1.0,80176446,1,1
2,0,1.0,1.0,74546255,1,1
0,1,0.0,0.0,69965182,1,0
2,0,1.0,1.0,80136697,1,1
2,0,1.0,1.0,82054723,1,1
0,1,0.0,0.0,70801612,1,0
0,1,0.0,0.0,80128359,1,0
0,1,0.0,0.0,69633235,1,0
0,1,0.0,0.0,74770801,1,0
2,0,1.0,1.0,82006244,1,1
0,1,0.0,0.0,82206088,1,0
0,1,0.0,0.0,72718030,1,0
0,1,0.0,0.0,69064331,1,0
0,1,0.0,0.0,69946100,1,0
2,0,1.0,1.0,82105374,1,1
0,1,0.0,0.0,72474682,1,0
2,0,1.0,1.0,82024291,1,1
0,1,0.0,0.0,69959232,1,0
0,1,0.0,0.0,68284601,1,0
0,1,0.0,0.0,80133931,1,0
0,1,0.0,0.0,70182511,1,0
2,0,1.0,1.0,65964640,1,1
2,0,1.0,1.0,69623764,1,1
2,0,1.0,1.0,80174114,1,1
2,0,1.0,1.0,80056375,1,1
0,1,0.0,0.0,80163692,1,0
0,1,0.0,0.0,67706121,1,0
2,0,1.0,1.0,80167235,1,1
2,0,1.0,1.0,68487153,1,1
0,1,0.0,0.0,81967369,1,0
0,1,0.0,0.0,67774035,1,0
0,1,0.0,0.0,69534003,1,0
2,0,1.0,1.0,80118278,1,1
2,0,1.0,1.0,80132994,1,1
2,0,1.0,1.0,75362903,1,1
0,1,0.0,0.0,82041905,1,0
0,1,0.0,0.0,65282490,1,0
0,1,0.0,0.0,70684460,1,0
2,0,1.0,1.0,69008856,1,1
2,0,1.0,1.0,75346460,1,1
2,0,1.0,1.0,67335625,1,1
0,1,0.0,0.0,80054016,1,0
2,0,1.0,1.0,80052581,1,1
2,0,1.0,1.0,82054050,1,1
2,0,1.0,1.0,82038280,1,1
2,0,1.0,1.0,81913923,1,1
2,0,1.0,1.0,80145761,1,1
2,0,1.0,1.0,81979376,1,1
2,0,1.0,1.0,73652236,1,1
0,1,0.0,0.0,81976830,1,0
0,1,0.0,0.0,80128361,1,0
0,1,0.0,0.0,79994362,1,0
0,1,0.0,0.0,67754526,1,0
0,1,0.0,0.0,70706580,1,0
2,0,1.0,1.0,68519836,1,1
0,1,0.0,0.0,80119161,1,0
0,1,0.0,0.0,82152092,1,0
2,0,1.0,1.0,82102242,1,1
0,1,0.0,0.0,66975244,1,0
2,0,1.0,1.0,66234322,1,1
0,1,0.0,0.0,67094580,1,0
2,0,1.0,1.0,70681170,1,1
0,1,0.0,0.0,70694974,1,0
0,1,0.0,0.0,82012789,1,0
0,1,0.0,0.0,67053035,1,0
0,1,0.0,0.0,82127531,1,0
0,1,0.0,0.0,82127546,1,0
2,0,1.0,1.0,64262233,1,1
0,1,0.0,0.0,70679735,1,0
0,1,0.0,0.0,80153643,1,0
0,1,0.0,0.0,69701534,1,0
0,1,0.0,0.0,67876494,1,0
0,1,0.0,0.0,70037170,1,0
2,0,1.0,1.0,68373900,1,1
0,1,0.0,0.0,80150525,1,0
2,0,1.0,1.0,80162797,1,1
0,1,0.0,0.0,82152437,1,0
0,1,0.0,0.0,80171063,1,0
0,1,0.0,0.0,80150849,1,0
0,1,0.0,0.0,69604115,1,0
2,0,1.0,1.0,72540503,1,1
0,1,0.0,0.0,62563865,1,0
2,0,1.0,1.0,68194175,1,1
2,0,1.0,1.0,82125467,1,1
0,1,0.0,0.0,80094504,1,0
2,0,1.0,1.0,63993741,1,1
0,1,0.0,0.0,70645414,1,0
2,0,1.0,1.0,69092163,1,1
0,1,0.0,0.0,69540156,1,0
0,1,0.0,0.0,67208085,1,0
2,0,1.0,1.0,67187120,1,1
2,0,1.0,1.0,82110444,1,1
2,0,1.0,1.0,82038224,1,1
2,0,1.0,1.0,80177697,1,1
2,0,1.0,1.0,80118124,1,1
0,1,0.0,0.0,80177535,1,0
0,1,0.0,0.0,80094735,1,0
2,0,1.0,1.0,80149977,1,1
2,0,1.0,1.0,67831442,1,1
0,1,0.0,0.0,67786880,1,0
0,1,0.0,0.0,66235631,1,0
0,1,0.0,0.0,69840253,1,0
2,0,1.0,1.0,82019739,1,1
0,1,0.0,0.0,65793070,1,0
2,0,1.0,1.0,80118392,1,1
2,0,1.0,1.0,74443831,1,1
2,0,1.0,1.0,70240583,1,1
0,1,0.0,0.0,80145417,1,0
2,0,1.0,1.0,69974450,1,1
0,1,0.0,0.0,82046922,1,0
2,0,1.0,1.0,70230153,1,1
2,0,1.0,1.0,69481314,2,2
0,1,0.0,0.0,77310702,1,0
0,1,0.0,0.0,80165481,1,0
2,0,1.0,1.0,80125903,1,1
0,1,0.0,0.0,65447970,1,0
0,1,0.0,0.0,70073976,1,0
2,0,1.0,1.0,72377221,1,1
0,1,0.0,0.0,69904541,1,0
2,0,1.0,1.0,75362966,1,1
2,0,1.0,1.0,82037253,1,1
2,1,0.5,0.0,82022169,2,1
2,0,1.0,1.0,82052096,1,1
0,1,0.0,0.0,15012214,1,0
2,0,1.0,1.0,80125436,1,1
0,1,0.0,0.0,70831852,1,0
0,1,0.0,0.0,80163204,1,0
0,1,0.0,0.0,69997592,1,0
0,1,0.0,0.0,67132513,1,0
0,1,0.0,0.0,80177420,1,0
0,1,0.0,0.0,76023402,1,0
0,1,0.0,0.0,67978855,1,0
0,1,0.0,0.0,67838540,1,0
2,0,1.0,1.0,82018109,1,1
2,0,1.0,1.0,82135131,1,1
0,1,0.0,0.0,73535441,1,0
0,1,0.0,0.0,73535504,1,0
0,1,0.0,0.0,75147646,1,0
2,0,1.0,1.0,70524503,1,1
2,1,0.5,0.75,237671,2,1
0,1,0.0,0.0,80150991,1,0
0,1,0.0,0.0,80132928,1,0
0,1,0.0,0.0,70628754,1,0
0,1,0.0,0.0,70683515,1,0
0,1,0.0,0.0,70508466,1,0
0,1,0.0,0.0,69911590,1,0
2,0,1.0,1.0,82006875,1,1
0,1,0.0,0.0,70184793,1,0
2,0,1.0,1.0,80165233,1,1
0,1,0.0,0.0,66235694,1,0
0,1,0.0,0.0,68500166,1,0
0,1,0.0,0.0,70230181,1,0
0,1,0.0,0.0,68260864,1,0
0,1,0.0,0.0,70683571,1,0
0,1,0.0,0.0,70702632,1,0
0,1,0.0,0.0,82042126,1,0
2,0,1.0,1.0,80161914,1,1
2,0,1.0,1.0,77114142,1,1
2,0,1.0,1.0,82138705,1,1
2,0,1.0,1.0,80093734,1,1
0,1,0.0,0.0,69633186,1,0
2,0,1.0,1.0,80176868,1,1
0,1,0.0,0.0,66786034,1,0
0,1,0.0,0.0,66786265,1,0
0,1,0.0,0.0,68009165,1,0
0,1,0.0,0.0,60804765,1,0
0,1,0.0,0.0,69591270,1,0
2,0,1.0,1.0,82127714,1,1
0,1,0.0,0.0,82121117,1,0
2,0,1.0,1.0,69395571,1,1
0,1,0.0,0.0,67207924,1,0
0,1,0.0,0.0,82019459,1,0
0,1,0.0,0.0,62024851,1,0
